DateRep,day,month,year,Cases,Deaths,Country,geoId,countryterritoryCode,popData2019,continentExp,Total Deaths,Total Cases,Days since tenth death
2020-04-08T00:00:00Z,8,4,2020,30,4,Afghanistan,AF,AFG,38041757,Asia,11,367,1
2020-04-09T00:00:00Z,9,4,2020,56,3,Afghanistan,AF,AFG,38041757,Asia,14,423,2
2020-04-10T00:00:00Z,10,4,2020,61,1,Afghanistan,AF,AFG,38041757,Asia,15,484,3
2020-04-11T00:00:00Z,11,4,2020,37,0,Afghanistan,AF,AFG,38041757,Asia,15,521,4
2020-04-12T00:00:00Z,12,4,2020,34,3,Afghanistan,AF,AFG,38041757,Asia,18,555,5
2020-04-13T00:00:00Z,13,4,2020,52,0,Afghanistan,AF,AFG,38041757,Asia,18,607,6
2020-04-14T00:00:00Z,14,4,2020,58,3,Afghanistan,AF,AFG,38041757,Asia,21,665,7
2020-04-15T00:00:00Z,15,4,2020,49,2,Afghanistan,AF,AFG,38041757,Asia,23,714,8
2020-04-16T00:00:00Z,16,4,2020,70,2,Afghanistan,AF,AFG,38041757,Asia,25,784,9
2020-04-17T00:00:00Z,17,4,2020,10,4,Afghanistan,AF,AFG,38041757,Asia,29,794,10
2020-04-18T00:00:00Z,18,4,2020,51,1,Afghanistan,AF,AFG,38041757,Asia,30,845,11
2020-04-19T00:00:00Z,19,4,2020,63,0,Afghanistan,AF,AFG,38041757,Asia,30,908,12
2020-04-20T00:00:00Z,20,4,2020,88,3,Afghanistan,AF,AFG,38041757,Asia,33,996,13
2020-04-21T00:00:00Z,21,4,2020,35,2,Afghanistan,AF,AFG,38041757,Asia,35,1031,14
2020-04-22T00:00:00Z,22,4,2020,61,1,Afghanistan,AF,AFG,38041757,Asia,36,1092,15
2020-04-23T00:00:00Z,23,4,2020,84,4,Afghanistan,AF,AFG,38041757,Asia,40,1176,16
2020-04-24T00:00:00Z,24,4,2020,105,2,Afghanistan,AF,AFG,38041757,Asia,42,1281,17
2020-04-25T00:00:00Z,25,4,2020,70,1,Afghanistan,AF,AFG,38041757,Asia,43,1351,18
2020-04-26T00:00:00Z,26,4,2020,112,4,Afghanistan,AF,AFG,38041757,Asia,47,1463,19
2020-04-27T00:00:00Z,27,4,2020,68,10,Afghanistan,AF,AFG,38041757,Asia,57,1531,20
2020-04-28T00:00:00Z,28,4,2020,172,0,Afghanistan,AF,AFG,38041757,Asia,57,1703,21
2020-04-29T00:00:00Z,29,4,2020,124,3,Afghanistan,AF,AFG,38041757,Asia,60,1827,22
2020-04-30T00:00:00Z,30,4,2020,122,0,Afghanistan,AF,AFG,38041757,Asia,60,1949,23
2020-05-01T00:00:00Z,1,5,2020,222,4,Afghanistan,AF,AFG,38041757,Asia,64,2171,24
2020-05-02T00:00:00Z,2,5,2020,164,4,Afghanistan,AF,AFG,38041757,Asia,68,2335,25
2020-05-03T00:00:00Z,3,5,2020,134,4,Afghanistan,AF,AFG,38041757,Asia,72,2469,26
2020-05-04T00:00:00Z,4,5,2020,235,13,Afghanistan,AF,AFG,38041757,Asia,85,2704,27
2020-05-05T00:00:00Z,5,5,2020,190,5,Afghanistan,AF,AFG,38041757,Asia,90,2894,28
2020-05-06T00:00:00Z,6,5,2020,330,5,Afghanistan,AF,AFG,38041757,Asia,95,3224,29
2020-05-07T00:00:00Z,7,5,2020,168,9,Afghanistan,AF,AFG,38041757,Asia,104,3392,30
2020-05-08T00:00:00Z,8,5,2020,171,2,Afghanistan,AF,AFG,38041757,Asia,106,3563,31
2020-05-09T00:00:00Z,9,5,2020,215,3,Afghanistan,AF,AFG,38041757,Asia,109,3778,32
2020-05-10T00:00:00Z,10,5,2020,255,6,Afghanistan,AF,AFG,38041757,Asia,115,4033,33
2020-05-11T00:00:00Z,11,5,2020,369,5,Afghanistan,AF,AFG,38041757,Asia,120,4402,34
2020-05-12T00:00:00Z,12,5,2020,285,2,Afghanistan,AF,AFG,38041757,Asia,122,4687,35
2020-05-13T00:00:00Z,13,5,2020,280,5,Afghanistan,AF,AFG,38041757,Asia,127,4967,36
2020-05-14T00:00:00Z,14,5,2020,259,3,Afghanistan,AF,AFG,38041757,Asia,130,5226,37
2020-05-15T00:00:00Z,15,5,2020,113,6,Afghanistan,AF,AFG,38041757,Asia,136,5339,38
2020-05-16T00:00:00Z,16,5,2020,1063,32,Afghanistan,AF,AFG,38041757,Asia,168,6402,39
2020-05-17T00:00:00Z,17,5,2020,0,0,Afghanistan,AF,AFG,38041757,Asia,168,6402,40
2020-05-18T00:00:00Z,18,5,2020,262,1,Afghanistan,AF,AFG,38041757,Asia,169,6664,41
2020-05-19T00:00:00Z,19,5,2020,408,4,Afghanistan,AF,AFG,38041757,Asia,173,7072,42
2020-05-20T00:00:00Z,20,5,2020,581,5,Afghanistan,AF,AFG,38041757,Asia,178,7653,43
2020-05-21T00:00:00Z,21,5,2020,492,9,Afghanistan,AF,AFG,38041757,Asia,187,8145,44
2020-05-22T00:00:00Z,22,5,2020,531,6,Afghanistan,AF,AFG,38041757,Asia,193,8676,45
2020-05-23T00:00:00Z,23,5,2020,540,12,Afghanistan,AF,AFG,38041757,Asia,205,9216,46
2020-05-24T00:00:00Z,24,5,2020,782,11,Afghanistan,AF,AFG,38041757,Asia,216,9998,47
2020-05-25T00:00:00Z,25,5,2020,584,2,Afghanistan,AF,AFG,38041757,Asia,218,10582,48
2020-05-26T00:00:00Z,26,5,2020,591,1,Afghanistan,AF,AFG,38041757,Asia,219,11173,49
2020-05-27T00:00:00Z,27,5,2020,658,1,Afghanistan,AF,AFG,38041757,Asia,220,11831,50
2020-05-28T00:00:00Z,28,5,2020,625,7,Afghanistan,AF,AFG,38041757,Asia,227,12456,51
2020-05-29T00:00:00Z,29,5,2020,580,8,Afghanistan,AF,AFG,38041757,Asia,235,13036,52
2020-05-30T00:00:00Z,30,5,2020,623,11,Afghanistan,AF,AFG,38041757,Asia,246,13659,53
2020-05-31T00:00:00Z,31,5,2020,866,3,Afghanistan,AF,AFG,38041757,Asia,249,14525,54
2020-06-01T00:00:00Z,1,6,2020,680,8,Afghanistan,AF,AFG,38041757,Asia,257,15205,55
2020-06-02T00:00:00Z,2,6,2020,545,8,Afghanistan,AF,AFG,38041757,Asia,265,15750,56
2020-06-03T00:00:00Z,3,6,2020,759,5,Afghanistan,AF,AFG,38041757,Asia,270,16509,57
2020-06-04T00:00:00Z,4,6,2020,758,24,Afghanistan,AF,AFG,38041757,Asia,294,17267,58
2020-06-05T00:00:00Z,5,6,2020,787,6,Afghanistan,AF,AFG,38041757,Asia,300,18054,59
2020-06-06T00:00:00Z,6,6,2020,915,9,Afghanistan,AF,AFG,38041757,Asia,309,18969,60
2020-06-07T00:00:00Z,7,6,2020,582,18,Afghanistan,AF,AFG,38041757,Asia,327,19551,61
2020-06-08T00:00:00Z,8,6,2020,791,30,Afghanistan,AF,AFG,38041757,Asia,357,20342,62
2020-06-09T00:00:00Z,9,6,2020,575,12,Afghanistan,AF,AFG,38041757,Asia,369,20917,63
2020-06-10T00:00:00Z,10,6,2020,542,15,Afghanistan,AF,AFG,38041757,Asia,384,21459,64
2020-06-11T00:00:00Z,11,6,2020,684,21,Afghanistan,AF,AFG,38041757,Asia,405,22143,65
2020-06-12T00:00:00Z,12,6,2020,747,21,Afghanistan,AF,AFG,38041757,Asia,426,22890,66
2020-06-13T00:00:00Z,13,6,2020,656,20,Afghanistan,AF,AFG,38041757,Asia,446,23546,67
2020-06-14T00:00:00Z,14,6,2020,556,5,Afghanistan,AF,AFG,38041757,Asia,451,24102,68
2020-06-15T00:00:00Z,15,6,2020,664,20,Afghanistan,AF,AFG,38041757,Asia,471,24766,69
2020-06-16T00:00:00Z,16,6,2020,761,7,Afghanistan,AF,AFG,38041757,Asia,478,25527,70
2020-06-17T00:00:00Z,17,6,2020,783,13,Afghanistan,AF,AFG,38041757,Asia,491,26310,71
2020-06-18T00:00:00Z,18,6,2020,564,13,Afghanistan,AF,AFG,38041757,Asia,504,26874,72
2020-06-19T00:00:00Z,19,6,2020,658,42,Afghanistan,AF,AFG,38041757,Asia,546,27532,73
2020-06-20T00:00:00Z,20,6,2020,346,2,Afghanistan,AF,AFG,38041757,Asia,548,27878,74
2020-06-21T00:00:00Z,21,6,2020,546,21,Afghanistan,AF,AFG,38041757,Asia,569,28424,75
2020-06-22T00:00:00Z,22,6,2020,409,12,Afghanistan,AF,AFG,38041757,Asia,581,28833,76
2020-06-23T00:00:00Z,23,6,2020,310,17,Afghanistan,AF,AFG,38041757,Asia,598,29143,77
2020-06-24T00:00:00Z,24,6,2020,338,20,Afghanistan,AF,AFG,38041757,Asia,618,29481,78
2020-06-25T00:00:00Z,25,6,2020,234,21,Afghanistan,AF,AFG,38041757,Asia,639,29715,79
2020-03-29T00:00:00Z,29,3,2020,11,1,Albania,AL,ALB,2862427,Europe,10,197,1
2020-03-30T00:00:00Z,30,3,2020,15,0,Albania,AL,ALB,2862427,Europe,10,212,2
2020-03-31T00:00:00Z,31,3,2020,11,2,Albania,AL,ALB,2862427,Europe,12,223,3
2020-04-01T00:00:00Z,1,4,2020,20,3,Albania,AL,ALB,2862427,Europe,15,243,4
2020-04-02T00:00:00Z,2,4,2020,16,0,Albania,AL,ALB,2862427,Europe,15,259,5
2020-04-03T00:00:00Z,3,4,2020,18,1,Albania,AL,ALB,2862427,Europe,16,277,6
2020-04-04T00:00:00Z,4,4,2020,27,1,Albania,AL,ALB,2862427,Europe,17,304,7
2020-04-05T00:00:00Z,5,4,2020,29,2,Albania,AL,ALB,2862427,Europe,19,333,8
2020-04-06T00:00:00Z,6,4,2020,28,2,Albania,AL,ALB,2862427,Europe,21,361,9
2020-04-07T00:00:00Z,7,4,2020,16,1,Albania,AL,ALB,2862427,Europe,22,377,10
2020-04-08T00:00:00Z,8,4,2020,6,0,Albania,AL,ALB,2862427,Europe,22,383,11
2020-04-09T00:00:00Z,9,4,2020,17,0,Albania,AL,ALB,2862427,Europe,22,400,12
2020-04-10T00:00:00Z,10,4,2020,9,1,Albania,AL,ALB,2862427,Europe,23,409,13
2020-04-11T00:00:00Z,11,4,2020,7,0,Albania,AL,ALB,2862427,Europe,23,416,14
2020-04-12T00:00:00Z,12,4,2020,17,0,Albania,AL,ALB,2862427,Europe,23,433,15
2020-04-13T00:00:00Z,13,4,2020,13,0,Albania,AL,ALB,2862427,Europe,23,446,16
2020-04-14T00:00:00Z,14,4,2020,21,0,Albania,AL,ALB,2862427,Europe,23,467,17
2020-04-15T00:00:00Z,15,4,2020,8,1,Albania,AL,ALB,2862427,Europe,24,475,18
2020-04-16T00:00:00Z,16,4,2020,19,1,Albania,AL,ALB,2862427,Europe,25,494,19
2020-04-17T00:00:00Z,17,4,2020,24,1,Albania,AL,ALB,2862427,Europe,26,518,20
2020-04-18T00:00:00Z,18,4,2020,21,0,Albania,AL,ALB,2862427,Europe,26,539,21
2020-04-19T00:00:00Z,19,4,2020,9,0,Albania,AL,ALB,2862427,Europe,26,548,22
2020-04-20T00:00:00Z,20,4,2020,14,0,Albania,AL,ALB,2862427,Europe,26,562,23
2020-04-21T00:00:00Z,21,4,2020,22,0,Albania,AL,ALB,2862427,Europe,26,584,24
2020-04-22T00:00:00Z,22,4,2020,25,0,Albania,AL,ALB,2862427,Europe,26,609,25
2020-04-23T00:00:00Z,23,4,2020,25,1,Albania,AL,ALB,2862427,Europe,27,634,26
2020-04-24T00:00:00Z,24,4,2020,29,0,Albania,AL,ALB,2862427,Europe,27,663,27
2020-04-25T00:00:00Z,25,4,2020,15,0,Albania,AL,ALB,2862427,Europe,27,678,28
2020-04-26T00:00:00Z,26,4,2020,34,0,Albania,AL,ALB,2862427,Europe,27,712,29
2020-04-27T00:00:00Z,27,4,2020,14,1,Albania,AL,ALB,2862427,Europe,28,726,30
2020-04-28T00:00:00Z,28,4,2020,10,0,Albania,AL,ALB,2862427,Europe,28,736,31
2020-04-29T00:00:00Z,29,4,2020,14,2,Albania,AL,ALB,2862427,Europe,30,750,32
2020-04-30T00:00:00Z,30,4,2020,16,1,Albania,AL,ALB,2862427,Europe,31,766,33
2020-05-01T00:00:00Z,1,5,2020,7,0,Albania,AL,ALB,2862427,Europe,31,773,34
2020-05-02T00:00:00Z,2,5,2020,9,0,Albania,AL,ALB,2862427,Europe,31,782,35
2020-05-03T00:00:00Z,3,5,2020,7,0,Albania,AL,ALB,2862427,Europe,31,789,36
2020-05-04T00:00:00Z,4,5,2020,6,0,Albania,AL,ALB,2862427,Europe,31,795,37
2020-05-05T00:00:00Z,5,5,2020,8,0,Albania,AL,ALB,2862427,Europe,31,803,38
2020-05-06T00:00:00Z,6,5,2020,17,0,Albania,AL,ALB,2862427,Europe,31,820,39
2020-05-07T00:00:00Z,7,5,2020,12,0,Albania,AL,ALB,2862427,Europe,31,832,40
2020-05-08T00:00:00Z,8,5,2020,10,0,Albania,AL,ALB,2862427,Europe,31,842,41
2020-05-09T00:00:00Z,9,5,2020,8,0,Albania,AL,ALB,2862427,Europe,31,850,42
2020-05-10T00:00:00Z,10,5,2020,6,0,Albania,AL,ALB,2862427,Europe,31,856,43
2020-05-11T00:00:00Z,11,5,2020,12,0,Albania,AL,ALB,2862427,Europe,31,868,44
2020-05-12T00:00:00Z,12,5,2020,4,0,Albania,AL,ALB,2862427,Europe,31,872,45
2020-05-13T00:00:00Z,13,5,2020,4,0,Albania,AL,ALB,2862427,Europe,31,876,46
2020-05-14T00:00:00Z,14,5,2020,4,0,Albania,AL,ALB,2862427,Europe,31,880,47
2020-05-15T00:00:00Z,15,5,2020,18,0,Albania,AL,ALB,2862427,Europe,31,898,48
2020-05-16T00:00:00Z,16,5,2020,18,0,Albania,AL,ALB,2862427,Europe,31,916,49
2020-05-17T00:00:00Z,17,5,2020,17,0,Albania,AL,ALB,2862427,Europe,31,933,50
2020-05-18T00:00:00Z,18,5,2020,13,0,Albania,AL,ALB,2862427,Europe,31,946,51
2020-05-19T00:00:00Z,19,5,2020,2,0,Albania,AL,ALB,2862427,Europe,31,948,52
2020-05-20T00:00:00Z,20,5,2020,1,0,Albania,AL,ALB,2862427,Europe,31,949,53
2020-05-21T00:00:00Z,21,5,2020,15,0,Albania,AL,ALB,2862427,Europe,31,964,54
2020-05-22T00:00:00Z,22,5,2020,5,0,Albania,AL,ALB,2862427,Europe,31,969,55
2020-05-23T00:00:00Z,23,5,2020,12,0,Albania,AL,ALB,2862427,Europe,31,981,56
2020-05-24T00:00:00Z,24,5,2020,8,0,Albania,AL,ALB,2862427,Europe,31,989,57
2020-05-25T00:00:00Z,25,5,2020,9,1,Albania,AL,ALB,2862427,Europe,32,998,58
2020-05-26T00:00:00Z,26,5,2020,6,0,Albania,AL,ALB,2862427,Europe,32,1004,59
2020-05-27T00:00:00Z,27,5,2020,25,1,Albania,AL,ALB,2862427,Europe,33,1029,60
2020-05-28T00:00:00Z,28,5,2020,21,0,Albania,AL,ALB,2862427,Europe,33,1050,61
2020-05-29T00:00:00Z,29,5,2020,26,0,Albania,AL,ALB,2862427,Europe,33,1076,62
2020-05-30T00:00:00Z,30,5,2020,23,0,Albania,AL,ALB,2862427,Europe,33,1099,63
2020-05-31T00:00:00Z,31,5,2020,23,0,Albania,AL,ALB,2862427,Europe,33,1122,64
2020-06-01T00:00:00Z,1,6,2020,15,0,Albania,AL,ALB,2862427,Europe,33,1137,65
2020-06-02T00:00:00Z,2,6,2020,6,0,Albania,AL,ALB,2862427,Europe,33,1143,66
2020-06-03T00:00:00Z,3,6,2020,21,0,Albania,AL,ALB,2862427,Europe,33,1164,67
2020-06-04T00:00:00Z,4,6,2020,20,0,Albania,AL,ALB,2862427,Europe,33,1184,68
2020-06-05T00:00:00Z,5,6,2020,13,0,Albania,AL,ALB,2862427,Europe,33,1197,69
2020-06-06T00:00:00Z,6,6,2020,15,0,Albania,AL,ALB,2862427,Europe,33,1212,70
2020-06-07T00:00:00Z,7,6,2020,20,1,Albania,AL,ALB,2862427,Europe,34,1232,71
2020-06-08T00:00:00Z,8,6,2020,14,0,Albania,AL,ALB,2862427,Europe,34,1246,72
2020-06-09T00:00:00Z,9,6,2020,17,0,Albania,AL,ALB,2862427,Europe,34,1263,73
2020-06-10T00:00:00Z,10,6,2020,36,0,Albania,AL,ALB,2862427,Europe,34,1299,74
2020-06-11T00:00:00Z,11,6,2020,42,0,Albania,AL,ALB,2862427,Europe,34,1341,75
2020-06-12T00:00:00Z,12,6,2020,44,1,Albania,AL,ALB,2862427,Europe,35,1385,76
2020-06-13T00:00:00Z,13,6,2020,31,1,Albania,AL,ALB,2862427,Europe,36,1416,77
2020-06-14T00:00:00Z,14,6,2020,48,0,Albania,AL,ALB,2862427,Europe,36,1464,78
2020-06-15T00:00:00Z,15,6,2020,57,0,Albania,AL,ALB,2862427,Europe,36,1521,79
2020-06-16T00:00:00Z,16,6,2020,69,0,Albania,AL,ALB,2862427,Europe,36,1590,80
2020-06-17T00:00:00Z,17,6,2020,82,1,Albania,AL,ALB,2862427,Europe,37,1672,81
2020-06-18T00:00:00Z,18,6,2020,50,1,Albania,AL,ALB,2862427,Europe,38,1722,82
2020-06-19T00:00:00Z,19,6,2020,66,1,Albania,AL,ALB,2862427,Europe,39,1788,83
2020-06-20T00:00:00Z,20,6,2020,50,3,Albania,AL,ALB,2862427,Europe,42,1838,84
2020-06-21T00:00:00Z,21,6,2020,53,1,Albania,AL,ALB,2862427,Europe,43,1891,85
2020-06-22T00:00:00Z,22,6,2020,36,1,Albania,AL,ALB,2862427,Europe,44,1927,86
2020-06-23T00:00:00Z,23,6,2020,68,0,Albania,AL,ALB,2862427,Europe,44,1995,87
2020-06-24T00:00:00Z,24,6,2020,52,1,Albania,AL,ALB,2862427,Europe,45,2047,88
2020-06-25T00:00:00Z,25,6,2020,67,2,Albania,AL,ALB,2862427,Europe,47,2114,89
2020-03-21T00:00:00Z,21,3,2020,12,3,Algeria,DZ,DZA,43053054,Africa,10,102,1
2020-03-22T00:00:00Z,22,3,2020,37,5,Algeria,DZ,DZA,43053054,Africa,15,139,2
2020-03-23T00:00:00Z,23,3,2020,62,2,Algeria,DZ,DZA,43053054,Africa,17,201,3
2020-03-24T00:00:00Z,24,3,2020,29,0,Algeria,DZ,DZA,43053054,Africa,17,230,4
2020-03-25T00:00:00Z,25,3,2020,34,2,Algeria,DZ,DZA,43053054,Africa,19,264,5
2020-03-26T00:00:00Z,26,3,2020,38,2,Algeria,DZ,DZA,43053054,Africa,21,302,6
2020-03-27T00:00:00Z,27,3,2020,65,4,Algeria,DZ,DZA,43053054,Africa,25,367,7
2020-03-28T00:00:00Z,28,3,2020,42,1,Algeria,DZ,DZA,43053054,Africa,26,409,8
2020-03-29T00:00:00Z,29,3,2020,45,3,Algeria,DZ,DZA,43053054,Africa,29,454,9
2020-03-30T00:00:00Z,30,3,2020,57,2,Algeria,DZ,DZA,43053054,Africa,31,511,10
2020-03-31T00:00:00Z,31,3,2020,73,4,Algeria,DZ,DZA,43053054,Africa,35,584,11
2020-04-01T00:00:00Z,1,4,2020,132,9,Algeria,DZ,DZA,43053054,Africa,44,716,12
2020-04-02T00:00:00Z,2,4,2020,131,14,Algeria,DZ,DZA,43053054,Africa,58,847,13
2020-04-03T00:00:00Z,3,4,2020,139,5,Algeria,DZ,DZA,43053054,Africa,63,986,14
2020-04-04T00:00:00Z,4,4,2020,185,42,Algeria,DZ,DZA,43053054,Africa,105,1171,15
2020-04-05T00:00:00Z,5,4,2020,80,25,Algeria,DZ,DZA,43053054,Africa,130,1251,16
2020-04-06T00:00:00Z,6,4,2020,69,22,Algeria,DZ,DZA,43053054,Africa,152,1320,17
2020-04-07T00:00:00Z,7,4,2020,103,21,Algeria,DZ,DZA,43053054,Africa,173,1423,18
2020-04-08T00:00:00Z,8,4,2020,45,20,Algeria,DZ,DZA,43053054,Africa,193,1468,19
2020-04-09T00:00:00Z,9,4,2020,104,12,Algeria,DZ,DZA,43053054,Africa,205,1572,20
2020-04-10T00:00:00Z,10,4,2020,94,30,Algeria,DZ,DZA,43053054,Africa,235,1666,21
2020-04-11T00:00:00Z,11,4,2020,95,21,Algeria,DZ,DZA,43053054,Africa,256,1761,22
2020-04-12T00:00:00Z,12,4,2020,64,19,Algeria,DZ,DZA,43053054,Africa,275,1825,23
2020-04-13T00:00:00Z,13,4,2020,89,18,Algeria,DZ,DZA,43053054,Africa,293,1914,24
2020-04-14T00:00:00Z,14,4,2020,69,20,Algeria,DZ,DZA,43053054,Africa,313,1983,25
2020-04-15T00:00:00Z,15,4,2020,87,12,Algeria,DZ,DZA,43053054,Africa,325,2070,26
2020-04-16T00:00:00Z,16,4,2020,90,11,Algeria,DZ,DZA,43053054,Africa,336,2160,27
2020-04-17T00:00:00Z,17,4,2020,108,12,Algeria,DZ,DZA,43053054,Africa,348,2268,28
2020-04-18T00:00:00Z,18,4,2020,150,16,Algeria,DZ,DZA,43053054,Africa,364,2418,29
2020-04-19T00:00:00Z,19,4,2020,117,3,Algeria,DZ,DZA,43053054,Africa,367,2535,30
2020-04-20T00:00:00Z,20,4,2020,94,8,Algeria,DZ,DZA,43053054,Africa,375,2629,31
2020-04-21T00:00:00Z,21,4,2020,89,9,Algeria,DZ,DZA,43053054,Africa,384,2718,32
2020-04-22T00:00:00Z,22,4,2020,93,8,Algeria,DZ,DZA,43053054,Africa,392,2811,33
2020-04-23T00:00:00Z,23,4,2020,99,10,Algeria,DZ,DZA,43053054,Africa,402,2910,34
2020-04-24T00:00:00Z,24,4,2020,97,5,Algeria,DZ,DZA,43053054,Africa,407,3007,35
2020-04-25T00:00:00Z,25,4,2020,120,8,Algeria,DZ,DZA,43053054,Africa,415,3127,36
2020-04-26T00:00:00Z,26,4,2020,129,4,Algeria,DZ,DZA,43053054,Africa,419,3256,37
2020-04-27T00:00:00Z,27,4,2020,126,6,Algeria,DZ,DZA,43053054,Africa,425,3382,38
2020-04-28T00:00:00Z,28,4,2020,135,7,Algeria,DZ,DZA,43053054,Africa,432,3517,39
2020-04-29T00:00:00Z,29,4,2020,132,5,Algeria,DZ,DZA,43053054,Africa,437,3649,40
2020-04-30T00:00:00Z,30,4,2020,199,7,Algeria,DZ,DZA,43053054,Africa,444,3848,41
2020-05-01T00:00:00Z,1,5,2020,158,6,Algeria,DZ,DZA,43053054,Africa,450,4006,42
2020-05-02T00:00:00Z,2,5,2020,148,3,Algeria,DZ,DZA,43053054,Africa,453,4154,43
2020-05-03T00:00:00Z,3,5,2020,141,6,Algeria,DZ,DZA,43053054,Africa,459,4295,44
2020-05-04T00:00:00Z,4,5,2020,179,4,Algeria,DZ,DZA,43053054,Africa,463,4474,45
2020-05-05T00:00:00Z,5,5,2020,174,2,Algeria,DZ,DZA,43053054,Africa,465,4648,46
2020-05-06T00:00:00Z,6,5,2020,190,5,Algeria,DZ,DZA,43053054,Africa,470,4838,47
2020-05-07T00:00:00Z,7,5,2020,159,6,Algeria,DZ,DZA,43053054,Africa,476,4997,48
2020-05-08T00:00:00Z,8,5,2020,185,7,Algeria,DZ,DZA,43053054,Africa,483,5182,49
2020-05-09T00:00:00Z,9,5,2020,187,5,Algeria,DZ,DZA,43053054,Africa,488,5369,50
2020-05-10T00:00:00Z,10,5,2020,189,6,Algeria,DZ,DZA,43053054,Africa,494,5558,51
2020-05-11T00:00:00Z,11,5,2020,165,8,Algeria,DZ,DZA,43053054,Africa,502,5723,52
2020-05-12T00:00:00Z,12,5,2020,168,5,Algeria,DZ,DZA,43053054,Africa,507,5891,53
2020-05-13T00:00:00Z,13,5,2020,176,8,Algeria,DZ,DZA,43053054,Africa,515,6067,54
2020-05-14T00:00:00Z,14,5,2020,186,7,Algeria,DZ,DZA,43053054,Africa,522,6253,55
2020-05-15T00:00:00Z,15,5,2020,189,7,Algeria,DZ,DZA,43053054,Africa,529,6442,56
2020-05-16T00:00:00Z,16,5,2020,187,7,Algeria,DZ,DZA,43053054,Africa,536,6629,57
2020-05-17T00:00:00Z,17,5,2020,192,6,Algeria,DZ,DZA,43053054,Africa,542,6821,58
2020-05-18T00:00:00Z,18,5,2020,198,6,Algeria,DZ,DZA,43053054,Africa,548,7019,59
2020-05-19T00:00:00Z,19,5,2020,182,7,Algeria,DZ,DZA,43053054,Africa,555,7201,60
2020-05-20T00:00:00Z,20,5,2020,176,6,Algeria,DZ,DZA,43053054,Africa,561,7377,61
2020-05-21T00:00:00Z,21,5,2020,165,7,Algeria,DZ,DZA,43053054,Africa,568,7542,62
2020-05-22T00:00:00Z,22,5,2020,186,7,Algeria,DZ,DZA,43053054,Africa,575,7728,63
2020-05-23T00:00:00Z,23,5,2020,190,7,Algeria,DZ,DZA,43053054,Africa,582,7918,64
2020-05-24T00:00:00Z,24,5,2020,195,10,Algeria,DZ,DZA,43053054,Africa,592,8113,65
2020-05-25T00:00:00Z,25,5,2020,193,8,Algeria,DZ,DZA,43053054,Africa,600,8306,66
2020-05-26T00:00:00Z,26,5,2020,197,9,Algeria,DZ,DZA,43053054,Africa,609,8503,67
2020-05-27T00:00:00Z,27,5,2020,194,8,Algeria,DZ,DZA,43053054,Africa,617,8697,68
2020-05-28T00:00:00Z,28,5,2020,160,6,Algeria,DZ,DZA,43053054,Africa,623,8857,69
2020-05-29T00:00:00Z,29,5,2020,140,7,Algeria,DZ,DZA,43053054,Africa,630,8997,70
2020-05-30T00:00:00Z,30,5,2020,137,8,Algeria,DZ,DZA,43053054,Africa,638,9134,71
2020-05-31T00:00:00Z,31,5,2020,133,8,Algeria,DZ,DZA,43053054,Africa,646,9267,72
2020-06-01T00:00:00Z,1,6,2020,127,7,Algeria,DZ,DZA,43053054,Africa,653,9394,73
2020-06-02T00:00:00Z,2,6,2020,119,8,Algeria,DZ,DZA,43053054,Africa,661,9513,74
2020-06-03T00:00:00Z,3,6,2020,113,6,Algeria,DZ,DZA,43053054,Africa,667,9626,75
2020-06-04T00:00:00Z,4,6,2020,0,0,Algeria,DZ,DZA,43053054,Africa,667,9626,76
2020-06-05T00:00:00Z,5,6,2020,205,14,Algeria,DZ,DZA,43053054,Africa,681,9831,77
2020-06-06T00:00:00Z,6,6,2020,104,9,Algeria,DZ,DZA,43053054,Africa,690,9935,78
2020-06-07T00:00:00Z,7,6,2020,115,8,Algeria,DZ,DZA,43053054,Africa,698,10050,79
2020-06-08T00:00:00Z,8,6,2020,104,9,Algeria,DZ,DZA,43053054,Africa,707,10154,80
2020-06-09T00:00:00Z,9,6,2020,111,8,Algeria,DZ,DZA,43053054,Africa,715,10265,81
2020-06-10T00:00:00Z,10,6,2020,117,9,Algeria,DZ,DZA,43053054,Africa,724,10382,82
2020-06-11T00:00:00Z,11,6,2020,102,8,Algeria,DZ,DZA,43053054,Africa,732,10484,83
2020-06-12T00:00:00Z,12,6,2020,105,9,Algeria,DZ,DZA,43053054,Africa,741,10589,84
2020-06-13T00:00:00Z,13,6,2020,109,10,Algeria,DZ,DZA,43053054,Africa,751,10698,85
2020-06-14T00:00:00Z,14,6,2020,112,9,Algeria,DZ,DZA,43053054,Africa,760,10810,86
2020-06-15T00:00:00Z,15,6,2020,109,7,Algeria,DZ,DZA,43053054,Africa,767,10919,87
2020-06-16T00:00:00Z,16,6,2020,112,10,Algeria,DZ,DZA,43053054,Africa,777,11031,88
2020-06-17T00:00:00Z,17,6,2020,116,11,Algeria,DZ,DZA,43053054,Africa,788,11147,89
2020-06-18T00:00:00Z,18,6,2020,121,11,Algeria,DZ,DZA,43053054,Africa,799,11268,90
2020-06-19T00:00:00Z,19,6,2020,117,12,Algeria,DZ,DZA,43053054,Africa,811,11385,91
2020-06-20T00:00:00Z,20,6,2020,119,14,Algeria,DZ,DZA,43053054,Africa,825,11504,92
2020-06-21T00:00:00Z,21,6,2020,127,12,Algeria,DZ,DZA,43053054,Africa,837,11631,93
2020-06-22T00:00:00Z,22,6,2020,140,8,Algeria,DZ,DZA,43053054,Africa,845,11771,94
2020-06-23T00:00:00Z,23,6,2020,149,7,Algeria,DZ,DZA,43053054,Africa,852,11920,95
2020-06-24T00:00:00Z,24,6,2020,156,9,Algeria,DZ,DZA,43053054,Africa,861,12076,96
2020-06-25T00:00:00Z,25,6,2020,172,8,Algeria,DZ,DZA,43053054,Africa,869,12248,97
2020-04-01T00:00:00Z,1,4,2020,6,4,Andorra,AD,AND,76177,Europe,12,376,1
2020-04-02T00:00:00Z,2,4,2020,14,2,Andorra,AD,AND,76177,Europe,14,390,2
2020-04-03T00:00:00Z,3,4,2020,38,1,Andorra,AD,AND,76177,Europe,15,428,3
2020-04-04T00:00:00Z,4,4,2020,11,1,Andorra,AD,AND,76177,Europe,16,439,4
2020-04-05T00:00:00Z,5,4,2020,27,1,Andorra,AD,AND,76177,Europe,17,466,5
2020-04-06T00:00:00Z,6,4,2020,35,1,Andorra,AD,AND,76177,Europe,18,501,6
2020-04-07T00:00:00Z,7,4,2020,25,3,Andorra,AD,AND,76177,Europe,21,526,7
2020-04-08T00:00:00Z,8,4,2020,19,1,Andorra,AD,AND,76177,Europe,22,545,8
2020-04-09T00:00:00Z,9,4,2020,19,1,Andorra,AD,AND,76177,Europe,23,564,9
2020-04-10T00:00:00Z,10,4,2020,19,2,Andorra,AD,AND,76177,Europe,25,583,10
2020-04-11T00:00:00Z,11,4,2020,18,1,Andorra,AD,AND,76177,Europe,26,601,11
2020-04-12T00:00:00Z,12,4,2020,21,2,Andorra,AD,AND,76177,Europe,28,622,12
2020-04-13T00:00:00Z,13,4,2020,16,1,Andorra,AD,AND,76177,Europe,29,638,13
2020-04-14T00:00:00Z,14,4,2020,8,0,Andorra,AD,AND,76177,Europe,29,646,14
2020-04-15T00:00:00Z,15,4,2020,13,2,Andorra,AD,AND,76177,Europe,31,659,15
2020-04-16T00:00:00Z,16,4,2020,14,2,Andorra,AD,AND,76177,Europe,33,673,16
2020-04-17T00:00:00Z,17,4,2020,9,0,Andorra,AD,AND,76177,Europe,33,682,17
2020-04-18T00:00:00Z,18,4,2020,14,2,Andorra,AD,AND,76177,Europe,35,696,18
2020-04-19T00:00:00Z,19,4,2020,8,0,Andorra,AD,AND,76177,Europe,35,704,19
2020-04-20T00:00:00Z,20,4,2020,9,1,Andorra,AD,AND,76177,Europe,36,713,20
2020-04-21T00:00:00Z,21,4,2020,4,0,Andorra,AD,AND,76177,Europe,36,717,21
2020-04-22T00:00:00Z,22,4,2020,0,1,Andorra,AD,AND,76177,Europe,37,717,22
2020-04-23T00:00:00Z,23,4,2020,6,0,Andorra,AD,AND,76177,Europe,37,723,23
2020-04-24T00:00:00Z,24,4,2020,1,0,Andorra,AD,AND,76177,Europe,37,724,24
2020-04-25T00:00:00Z,25,4,2020,7,3,Andorra,AD,AND,76177,Europe,40,731,25
2020-04-26T00:00:00Z,26,4,2020,2,0,Andorra,AD,AND,76177,Europe,40,733,26
2020-04-27T00:00:00Z,27,4,2020,7,0,Andorra,AD,AND,76177,Europe,40,740,27
2020-04-28T00:00:00Z,28,4,2020,3,0,Andorra,AD,AND,76177,Europe,40,743,28
2020-04-29T00:00:00Z,29,4,2020,0,1,Andorra,AD,AND,76177,Europe,41,743,29
2020-04-30T00:00:00Z,30,4,2020,0,1,Andorra,AD,AND,76177,Europe,42,743,30
2020-05-01T00:00:00Z,1,5,2020,2,0,Andorra,AD,AND,76177,Europe,42,745,31
2020-05-02T00:00:00Z,2,5,2020,1,1,Andorra,AD,AND,76177,Europe,43,746,32
2020-05-03T00:00:00Z,3,5,2020,1,1,Andorra,AD,AND,76177,Europe,44,747,33
2020-05-04T00:00:00Z,4,5,2020,1,1,Andorra,AD,AND,76177,Europe,45,748,34
2020-05-05T00:00:00Z,5,5,2020,2,0,Andorra,AD,AND,76177,Europe,45,750,35
2020-05-06T00:00:00Z,6,5,2020,1,1,Andorra,AD,AND,76177,Europe,46,751,36
2020-05-07T00:00:00Z,7,5,2020,0,0,Andorra,AD,AND,76177,Europe,46,751,37
2020-05-08T00:00:00Z,8,5,2020,1,1,Andorra,AD,AND,76177,Europe,47,752,38
2020-05-09T00:00:00Z,9,5,2020,0,0,Andorra,AD,AND,76177,Europe,47,752,39
2020-05-10T00:00:00Z,10,5,2020,2,1,Andorra,AD,AND,76177,Europe,48,754,40
2020-05-11T00:00:00Z,11,5,2020,1,0,Andorra,AD,AND,76177,Europe,48,755,41
2020-05-12T00:00:00Z,12,5,2020,1,0,Andorra,AD,AND,76177,Europe,48,756,42
2020-05-13T00:00:00Z,13,5,2020,2,0,Andorra,AD,AND,76177,Europe,48,758,43
2020-05-14T00:00:00Z,14,5,2020,2,1,Andorra,AD,AND,76177,Europe,49,760,44
2020-05-15T00:00:00Z,15,5,2020,1,0,Andorra,AD,AND,76177,Europe,49,761,45
2020-05-16T00:00:00Z,16,5,2020,0,0,Andorra,AD,AND,76177,Europe,49,761,46
2020-05-17T00:00:00Z,17,5,2020,0,2,Andorra,AD,AND,76177,Europe,51,761,47
2020-05-18T00:00:00Z,18,5,2020,0,0,Andorra,AD,AND,76177,Europe,51,761,48
2020-05-19T00:00:00Z,19,5,2020,0,0,Andorra,AD,AND,76177,Europe,51,761,49
2020-05-20T00:00:00Z,20,5,2020,0,0,Andorra,AD,AND,76177,Europe,51,761,50
2020-05-21T00:00:00Z,21,5,2020,1,0,Andorra,AD,AND,76177,Europe,51,762,51
2020-05-22T00:00:00Z,22,5,2020,0,0,Andorra,AD,AND,76177,Europe,51,762,52
2020-05-23T00:00:00Z,23,5,2020,0,0,Andorra,AD,AND,76177,Europe,51,762,53
2020-05-24T00:00:00Z,24,5,2020,0,0,Andorra,AD,AND,76177,Europe,51,762,54
2020-05-25T00:00:00Z,25,5,2020,1,0,Andorra,AD,AND,76177,Europe,51,763,55
2020-05-26T00:00:00Z,26,5,2020,0,0,Andorra,AD,AND,76177,Europe,51,763,56
2020-05-27T00:00:00Z,27,5,2020,0,0,Andorra,AD,AND,76177,Europe,51,763,57
2020-05-28T00:00:00Z,28,5,2020,0,0,Andorra,AD,AND,76177,Europe,51,763,58
2020-05-29T00:00:00Z,29,5,2020,0,0,Andorra,AD,AND,76177,Europe,51,763,59
2020-05-30T00:00:00Z,30,5,2020,1,0,Andorra,AD,AND,76177,Europe,51,764,60
2020-05-31T00:00:00Z,31,5,2020,0,0,Andorra,AD,AND,76177,Europe,51,764,61
2020-06-01T00:00:00Z,1,6,2020,0,0,Andorra,AD,AND,76177,Europe,51,764,62
2020-06-02T00:00:00Z,2,6,2020,1,0,Andorra,AD,AND,76177,Europe,51,765,63
2020-06-03T00:00:00Z,3,6,2020,79,0,Andorra,AD,AND,76177,Europe,51,844,64
2020-06-04T00:00:00Z,4,6,2020,7,0,Andorra,AD,AND,76177,Europe,51,851,65
2020-06-05T00:00:00Z,5,6,2020,1,0,Andorra,AD,AND,76177,Europe,51,852,66
2020-06-06T00:00:00Z,6,6,2020,0,0,Andorra,AD,AND,76177,Europe,51,852,67
2020-06-07T00:00:00Z,7,6,2020,0,0,Andorra,AD,AND,76177,Europe,51,852,68
2020-06-08T00:00:00Z,8,6,2020,0,0,Andorra,AD,AND,76177,Europe,51,852,69
2020-06-09T00:00:00Z,9,6,2020,0,0,Andorra,AD,AND,76177,Europe,51,852,70
2020-06-10T00:00:00Z,10,6,2020,0,0,Andorra,AD,AND,76177,Europe,51,852,71
2020-06-11T00:00:00Z,11,6,2020,0,0,Andorra,AD,AND,76177,Europe,51,852,72
2020-06-12T00:00:00Z,12,6,2020,0,0,Andorra,AD,AND,76177,Europe,51,852,73
2020-06-13T00:00:00Z,13,6,2020,1,0,Andorra,AD,AND,76177,Europe,51,853,74
2020-06-14T00:00:00Z,14,6,2020,0,0,Andorra,AD,AND,76177,Europe,51,853,75
2020-06-15T00:00:00Z,15,6,2020,0,0,Andorra,AD,AND,76177,Europe,51,853,76
2020-06-16T00:00:00Z,16,6,2020,0,0,Andorra,AD,AND,76177,Europe,51,853,77
2020-06-17T00:00:00Z,17,6,2020,1,1,Andorra,AD,AND,76177,Europe,52,854,78
2020-06-18T00:00:00Z,18,6,2020,0,0,Andorra,AD,AND,76177,Europe,52,854,79
2020-06-19T00:00:00Z,19,6,2020,1,0,Andorra,AD,AND,76177,Europe,52,855,80
2020-06-20T00:00:00Z,20,6,2020,0,0,Andorra,AD,AND,76177,Europe,52,855,81
2020-06-21T00:00:00Z,21,6,2020,0,0,Andorra,AD,AND,76177,Europe,52,855,82
2020-06-22T00:00:00Z,22,6,2020,0,0,Andorra,AD,AND,76177,Europe,52,855,83
2020-06-23T00:00:00Z,23,6,2020,0,0,Andorra,AD,AND,76177,Europe,52,855,84
2020-06-24T00:00:00Z,24,6,2020,0,0,Andorra,AD,AND,76177,Europe,52,855,85
2020-06-25T00:00:00Z,25,6,2020,0,0,Andorra,AD,AND,76177,Europe,52,855,86
2020-06-24T00:00:00Z,24,6,2020,3,1,Angola,AO,AGO,31825299,Africa,10,186,1
2020-06-25T00:00:00Z,25,6,2020,3,0,Angola,AO,AGO,31825299,Africa,10,189,2
2020-03-27T00:00:00Z,27,3,2020,87,4,Argentina,AR,ARG,44780675,America,12,589,1
2020-03-28T00:00:00Z,28,3,2020,101,5,Argentina,AR,ARG,44780675,America,17,690,2
2020-03-29T00:00:00Z,29,3,2020,55,2,Argentina,AR,ARG,44780675,America,19,745,3
2020-03-30T00:00:00Z,30,3,2020,75,1,Argentina,AR,ARG,44780675,America,20,820,4
2020-03-31T00:00:00Z,31,3,2020,146,4,Argentina,AR,ARG,44780675,America,24,966,5
2020-04-01T00:00:00Z,1,4,2020,0,0,Argentina,AR,ARG,44780675,America,24,966,6
2020-04-02T00:00:00Z,2,4,2020,167,7,Argentina,AR,ARG,44780675,America,31,1133,7
2020-04-03T00:00:00Z,3,4,2020,0,3,Argentina,AR,ARG,44780675,America,34,1133,8
2020-04-04T00:00:00Z,4,4,2020,132,3,Argentina,AR,ARG,44780675,America,37,1265,9
2020-04-05T00:00:00Z,5,4,2020,186,6,Argentina,AR,ARG,44780675,America,43,1451,10
2020-04-06T00:00:00Z,6,4,2020,103,3,Argentina,AR,ARG,44780675,America,46,1554,11
2020-04-07T00:00:00Z,7,4,2020,74,7,Argentina,AR,ARG,44780675,America,53,1628,12
2020-04-08T00:00:00Z,8,4,2020,87,7,Argentina,AR,ARG,44780675,America,60,1715,13
2020-04-09T00:00:00Z,9,4,2020,80,5,Argentina,AR,ARG,44780675,America,65,1795,14
2020-04-10T00:00:00Z,10,4,2020,99,14,Argentina,AR,ARG,44780675,America,79,1894,15
2020-04-11T00:00:00Z,11,4,2020,81,3,Argentina,AR,ARG,44780675,America,82,1975,16
2020-04-12T00:00:00Z,12,4,2020,162,7,Argentina,AR,ARG,44780675,America,89,2137,17
2020-04-13T00:00:00Z,13,4,2020,66,6,Argentina,AR,ARG,44780675,America,95,2203,18
2020-04-14T00:00:00Z,14,4,2020,69,3,Argentina,AR,ARG,44780675,America,98,2272,19
2020-04-15T00:00:00Z,15,4,2020,160,7,Argentina,AR,ARG,44780675,America,105,2432,20
2020-04-16T00:00:00Z,16,4,2020,0,4,Argentina,AR,ARG,44780675,America,109,2432,21
2020-04-17T00:00:00Z,17,4,2020,128,6,Argentina,AR,ARG,44780675,America,115,2560,22
2020-04-18T00:00:00Z,18,4,2020,98,7,Argentina,AR,ARG,44780675,America,122,2658,23
2020-04-19T00:00:00Z,19,4,2020,170,10,Argentina,AR,ARG,44780675,America,132,2828,24
2020-04-20T00:00:00Z,20,4,2020,102,2,Argentina,AR,ARG,44780675,America,134,2930,25
2020-04-21T00:00:00Z,21,4,2020,90,8,Argentina,AR,ARG,44780675,America,142,3020,26
2020-04-22T00:00:00Z,22,4,2020,112,9,Argentina,AR,ARG,44780675,America,151,3132,27
2020-04-23T00:00:00Z,23,4,2020,144,8,Argentina,AR,ARG,44780675,America,159,3276,28
2020-04-24T00:00:00Z,24,4,2020,147,6,Argentina,AR,ARG,44780675,America,165,3423,29
2020-04-25T00:00:00Z,25,4,2020,0,2,Argentina,AR,ARG,44780675,America,167,3423,30
2020-04-26T00:00:00Z,26,4,2020,344,18,Argentina,AR,ARG,44780675,America,185,3767,31
2020-04-27T00:00:00Z,27,4,2020,0,1,Argentina,AR,ARG,44780675,America,186,3767,32
2020-04-28T00:00:00Z,28,4,2020,223,11,Argentina,AR,ARG,44780675,America,197,3990,33
2020-04-29T00:00:00Z,29,4,2020,124,10,Argentina,AR,ARG,44780675,America,207,4114,34
2020-04-30T00:00:00Z,30,4,2020,158,7,Argentina,AR,ARG,44780675,America,214,4272,35
2020-05-01T00:00:00Z,1,5,2020,143,4,Argentina,AR,ARG,44780675,America,218,4415,36
2020-05-02T00:00:00Z,2,5,2020,104,7,Argentina,AR,ARG,44780675,America,225,4519,37
2020-05-03T00:00:00Z,3,5,2020,149,12,Argentina,AR,ARG,44780675,America,237,4668,38
2020-05-04T00:00:00Z,4,5,2020,102,9,Argentina,AR,ARG,44780675,America,246,4770,39
2020-05-05T00:00:00Z,5,5,2020,104,14,Argentina,AR,ARG,44780675,America,260,4874,40
2020-05-06T00:00:00Z,6,5,2020,133,4,Argentina,AR,ARG,44780675,America,264,5007,41
2020-05-07T00:00:00Z,7,5,2020,188,9,Argentina,AR,ARG,44780675,America,273,5195,42
2020-05-08T00:00:00Z,8,5,2020,163,9,Argentina,AR,ARG,44780675,America,282,5358,43
2020-05-09T00:00:00Z,9,5,2020,240,11,Argentina,AR,ARG,44780675,America,293,5598,44
2020-05-10T00:00:00Z,10,5,2020,165,7,Argentina,AR,ARG,44780675,America,300,5763,45
2020-05-11T00:00:00Z,11,5,2020,13,0,Argentina,AR,ARG,44780675,America,300,5776,46
2020-05-12T00:00:00Z,12,5,2020,245,5,Argentina,AR,ARG,44780675,America,305,6021,47
2020-05-13T00:00:00Z,13,5,2020,529,14,Argentina,AR,ARG,44780675,America,319,6550,48
2020-05-14T00:00:00Z,14,5,2020,316,10,Argentina,AR,ARG,44780675,America,329,6866,49
2020-05-15T00:00:00Z,15,5,2020,255,24,Argentina,AR,ARG,44780675,America,353,7121,50
2020-05-16T00:00:00Z,16,5,2020,345,3,Argentina,AR,ARG,44780675,America,356,7466,51
2020-05-17T00:00:00Z,17,5,2020,326,7,Argentina,AR,ARG,44780675,America,363,7792,52
2020-05-18T00:00:00Z,18,5,2020,0,3,Argentina,AR,ARG,44780675,America,366,7792,53
2020-05-19T00:00:00Z,19,5,2020,566,16,Argentina,AR,ARG,44780675,America,382,8358,54
2020-05-20T00:00:00Z,20,5,2020,438,11,Argentina,AR,ARG,44780675,America,393,8796,55
2020-05-21T00:00:00Z,21,5,2020,474,10,Argentina,AR,ARG,44780675,America,403,9270,56
2020-05-22T00:00:00Z,22,5,2020,648,13,Argentina,AR,ARG,44780675,America,416,9918,57
2020-05-23T00:00:00Z,23,5,2020,718,17,Argentina,AR,ARG,44780675,America,433,10636,58
2020-05-24T00:00:00Z,24,5,2020,704,12,Argentina,AR,ARG,44780675,America,445,11340,59
2020-05-25T00:00:00Z,25,5,2020,723,7,Argentina,AR,ARG,44780675,America,452,12063,60
2020-05-26T00:00:00Z,26,5,2020,552,15,Argentina,AR,ARG,44780675,America,467,12615,61
2020-05-27T00:00:00Z,27,5,2020,600,17,Argentina,AR,ARG,44780675,America,484,13215,62
2020-05-28T00:00:00Z,28,5,2020,705,16,Argentina,AR,ARG,44780675,America,500,13920,63
2020-05-29T00:00:00Z,29,5,2020,769,8,Argentina,AR,ARG,44780675,America,508,14689,64
2020-05-30T00:00:00Z,30,5,2020,717,12,Argentina,AR,ARG,44780675,America,520,15406,65
2020-05-31T00:00:00Z,31,5,2020,795,8,Argentina,AR,ARG,44780675,America,528,16201,66
2020-06-01T00:00:00Z,1,6,2020,637,11,Argentina,AR,ARG,44780675,America,539,16838,67
2020-06-02T00:00:00Z,2,6,2020,564,17,Argentina,AR,ARG,44780675,America,556,17402,68
2020-06-03T00:00:00Z,3,6,2020,904,13,Argentina,AR,ARG,44780675,America,569,18306,69
2020-06-04T00:00:00Z,4,6,2020,949,14,Argentina,AR,ARG,44780675,America,583,19255,70
2020-06-05T00:00:00Z,5,6,2020,0,5,Argentina,AR,ARG,44780675,America,588,19255,71
2020-06-06T00:00:00Z,6,6,2020,1769,44,Argentina,AR,ARG,44780675,America,632,21024,72
2020-06-07T00:00:00Z,7,6,2020,983,16,Argentina,AR,ARG,44780675,America,648,22007,73
2020-06-08T00:00:00Z,8,6,2020,774,16,Argentina,AR,ARG,44780675,America,664,22781,74
2020-06-09T00:00:00Z,9,6,2020,826,29,Argentina,AR,ARG,44780675,America,693,23607,75
2020-06-10T00:00:00Z,10,6,2020,1141,24,Argentina,AR,ARG,44780675,America,717,24748,76
2020-06-11T00:00:00Z,11,6,2020,1239,18,Argentina,AR,ARG,44780675,America,735,25987,77
2020-06-12T00:00:00Z,12,6,2020,1373,30,Argentina,AR,ARG,44780675,America,765,27360,78
2020-06-13T00:00:00Z,13,6,2020,1391,20,Argentina,AR,ARG,44780675,America,785,28751,79
2020-06-14T00:00:00Z,14,6,2020,1531,30,Argentina,AR,ARG,44780675,America,815,30282,80
2020-06-15T00:00:00Z,15,6,2020,1282,18,Argentina,AR,ARG,44780675,America,833,31564,81
2020-06-16T00:00:00Z,16,6,2020,1208,21,Argentina,AR,ARG,44780675,America,854,32772,82
2020-06-17T00:00:00Z,17,6,2020,1374,24,Argentina,AR,ARG,44780675,America,878,34146,83
2020-06-18T00:00:00Z,18,6,2020,1393,35,Argentina,AR,ARG,44780675,America,913,35539,84
2020-06-19T00:00:00Z,19,6,2020,0,16,Argentina,AR,ARG,44780675,America,929,35539,85
2020-06-20T00:00:00Z,20,6,2020,4018,50,Argentina,AR,ARG,44780675,America,979,39557,86
2020-06-21T00:00:00Z,21,6,2020,1634,13,Argentina,AR,ARG,44780675,America,992,41191,87
2020-06-22T00:00:00Z,22,6,2020,1581,19,Argentina,AR,ARG,44780675,America,1011,42772,88
2020-06-23T00:00:00Z,23,6,2020,2146,32,Argentina,AR,ARG,44780675,America,1043,44918,89
2020-06-24T00:00:00Z,24,6,2020,0,6,Argentina,AR,ARG,44780675,America,1049,44918,90
2020-06-25T00:00:00Z,25,6,2020,4920,36,Argentina,AR,ARG,44780675,America,1085,49838,91
2020-04-10T00:00:00Z,10,4,2020,40,1,Armenia,AM,ARM,2957728,Europe,10,921,1
2020-04-11T00:00:00Z,11,4,2020,16,1,Armenia,AM,ARM,2957728,Europe,11,937,2
2020-04-12T00:00:00Z,12,4,2020,30,2,Armenia,AM,ARM,2957728,Europe,13,967,3
2020-04-13T00:00:00Z,13,4,2020,46,0,Armenia,AM,ARM,2957728,Europe,13,1013,4
2020-04-14T00:00:00Z,14,4,2020,26,1,Armenia,AM,ARM,2957728,Europe,14,1039,5
2020-04-15T00:00:00Z,15,4,2020,72,3,Armenia,AM,ARM,2957728,Europe,17,1111,6
2020-04-16T00:00:00Z,16,4,2020,48,1,Armenia,AM,ARM,2957728,Europe,18,1159,7
2020-04-17T00:00:00Z,17,4,2020,42,1,Armenia,AM,ARM,2957728,Europe,19,1201,8
2020-04-18T00:00:00Z,18,4,2020,47,1,Armenia,AM,ARM,2957728,Europe,20,1248,9
2020-04-19T00:00:00Z,19,4,2020,43,0,Armenia,AM,ARM,2957728,Europe,20,1291,10
2020-04-20T00:00:00Z,20,4,2020,48,2,Armenia,AM,ARM,2957728,Europe,22,1339,11
2020-04-21T00:00:00Z,21,4,2020,62,2,Armenia,AM,ARM,2957728,Europe,24,1401,12
2020-04-22T00:00:00Z,22,4,2020,72,0,Armenia,AM,ARM,2957728,Europe,24,1473,13
2020-04-23T00:00:00Z,23,4,2020,50,0,Armenia,AM,ARM,2957728,Europe,24,1523,14
2020-04-24T00:00:00Z,24,4,2020,73,3,Armenia,AM,ARM,2957728,Europe,27,1596,15
2020-04-25T00:00:00Z,25,4,2020,81,1,Armenia,AM,ARM,2957728,Europe,28,1677,16
2020-04-26T00:00:00Z,26,4,2020,69,0,Armenia,AM,ARM,2957728,Europe,28,1746,17
2020-04-27T00:00:00Z,27,4,2020,62,1,Armenia,AM,ARM,2957728,Europe,29,1808,18
2020-04-28T00:00:00Z,28,4,2020,59,1,Armenia,AM,ARM,2957728,Europe,30,1867,19
2020-04-29T00:00:00Z,29,4,2020,65,0,Armenia,AM,ARM,2957728,Europe,30,1932,20
2020-04-30T00:00:00Z,30,4,2020,0,0,Armenia,AM,ARM,2957728,Europe,30,1932,21
2020-05-01T00:00:00Z,1,5,2020,134,2,Armenia,AM,ARM,2957728,Europe,32,2066,22
2020-05-02T00:00:00Z,2,5,2020,82,1,Armenia,AM,ARM,2957728,Europe,33,2148,23
2020-05-03T00:00:00Z,3,5,2020,125,0,Armenia,AM,ARM,2957728,Europe,33,2273,24
2020-05-04T00:00:00Z,4,5,2020,113,2,Armenia,AM,ARM,2957728,Europe,35,2386,25
2020-05-05T00:00:00Z,5,5,2020,121,4,Armenia,AM,ARM,2957728,Europe,39,2507,26
2020-05-06T00:00:00Z,6,5,2020,112,1,Armenia,AM,ARM,2957728,Europe,40,2619,27
2020-05-07T00:00:00Z,7,5,2020,163,0,Armenia,AM,ARM,2957728,Europe,40,2782,28
2020-05-08T00:00:00Z,8,5,2020,102,2,Armenia,AM,ARM,2957728,Europe,42,2884,29
2020-05-09T00:00:00Z,9,5,2020,145,1,Armenia,AM,ARM,2957728,Europe,43,3029,30
2020-05-10T00:00:00Z,10,5,2020,146,1,Armenia,AM,ARM,2957728,Europe,44,3175,31
2020-05-11T00:00:00Z,11,5,2020,138,1,Armenia,AM,ARM,2957728,Europe,45,3313,32
2020-05-12T00:00:00Z,12,5,2020,79,1,Armenia,AM,ARM,2957728,Europe,46,3392,33
2020-05-13T00:00:00Z,13,5,2020,146,1,Armenia,AM,ARM,2957728,Europe,47,3538,34
2020-05-14T00:00:00Z,14,5,2020,180,1,Armenia,AM,ARM,2957728,Europe,48,3718,35
2020-05-15T00:00:00Z,15,5,2020,142,1,Armenia,AM,ARM,2957728,Europe,49,3860,36
2020-05-16T00:00:00Z,16,5,2020,184,3,Armenia,AM,ARM,2957728,Europe,52,4044,37
2020-05-17T00:00:00Z,17,5,2020,239,3,Armenia,AM,ARM,2957728,Europe,55,4283,38
2020-05-18T00:00:00Z,18,5,2020,189,5,Armenia,AM,ARM,2957728,Europe,60,4472,39
2020-05-19T00:00:00Z,19,5,2020,351,1,Armenia,AM,ARM,2957728,Europe,61,4823,40
2020-05-20T00:00:00Z,20,5,2020,218,3,Armenia,AM,ARM,2957728,Europe,64,5041,41
2020-05-21T00:00:00Z,21,5,2020,230,3,Armenia,AM,ARM,2957728,Europe,67,5271,42
2020-05-22T00:00:00Z,22,5,2020,335,3,Armenia,AM,ARM,2957728,Europe,70,5606,43
2020-05-23T00:00:00Z,23,5,2020,322,4,Armenia,AM,ARM,2957728,Europe,74,5928,44
2020-05-24T00:00:00Z,24,5,2020,374,3,Armenia,AM,ARM,2957728,Europe,77,6302,45
2020-05-25T00:00:00Z,25,5,2020,359,4,Armenia,AM,ARM,2957728,Europe,81,6661,46
2020-05-26T00:00:00Z,26,5,2020,452,6,Armenia,AM,ARM,2957728,Europe,87,7113,47
2020-05-27T00:00:00Z,27,5,2020,289,4,Armenia,AM,ARM,2957728,Europe,91,7402,48
2020-05-28T00:00:00Z,28,5,2020,372,7,Armenia,AM,ARM,2957728,Europe,98,7774,49
2020-05-29T00:00:00Z,29,5,2020,442,15,Armenia,AM,ARM,2957728,Europe,113,8216,50
2020-05-30T00:00:00Z,30,5,2020,460,7,Armenia,AM,ARM,2957728,Europe,120,8676,51
2020-05-31T00:00:00Z,31,5,2020,251,7,Armenia,AM,ARM,2957728,Europe,127,8927,52
2020-06-01T00:00:00Z,1,6,2020,355,4,Armenia,AM,ARM,2957728,Europe,131,9282,53
2020-06-02T00:00:00Z,2,6,2020,210,8,Armenia,AM,ARM,2957728,Europe,139,9492,54
2020-06-03T00:00:00Z,3,6,2020,517,19,Armenia,AM,ARM,2957728,Europe,158,10009,55
2020-06-04T00:00:00Z,4,6,2020,515,12,Armenia,AM,ARM,2957728,Europe,170,10524,56
2020-06-05T00:00:00Z,5,6,2020,697,6,Armenia,AM,ARM,2957728,Europe,176,11221,57
2020-06-06T00:00:00Z,6,6,2020,596,7,Armenia,AM,ARM,2957728,Europe,183,11817,58
2020-06-07T00:00:00Z,7,6,2020,547,7,Armenia,AM,ARM,2957728,Europe,190,12364,59
2020-06-08T00:00:00Z,8,6,2020,766,10,Armenia,AM,ARM,2957728,Europe,200,13130,60
2020-06-09T00:00:00Z,9,6,2020,195,11,Armenia,AM,ARM,2957728,Europe,211,13325,61
2020-06-10T00:00:00Z,10,6,2020,350,6,Armenia,AM,ARM,2957728,Europe,217,13675,62
2020-06-11T00:00:00Z,11,6,2020,428,10,Armenia,AM,ARM,2957728,Europe,227,14103,63
2020-06-12T00:00:00Z,12,6,2020,566,18,Armenia,AM,ARM,2957728,Europe,245,14669,64
2020-06-13T00:00:00Z,13,6,2020,612,13,Armenia,AM,ARM,2957728,Europe,258,15281,65
2020-06-14T00:00:00Z,14,6,2020,723,6,Armenia,AM,ARM,2957728,Europe,264,16004,66
2020-06-15T00:00:00Z,15,6,2020,663,5,Armenia,AM,ARM,2957728,Europe,269,16667,67
2020-06-16T00:00:00Z,16,6,2020,397,16,Armenia,AM,ARM,2957728,Europe,285,17064,68
2020-06-17T00:00:00Z,17,6,2020,425,8,Armenia,AM,ARM,2957728,Europe,293,17489,69
2020-06-18T00:00:00Z,18,6,2020,544,9,Armenia,AM,ARM,2957728,Europe,302,18033,70
2020-06-19T00:00:00Z,19,6,2020,665,7,Armenia,AM,ARM,2957728,Europe,309,18698,71
2020-06-20T00:00:00Z,20,6,2020,459,10,Armenia,AM,ARM,2957728,Europe,319,19157,72
2020-06-21T00:00:00Z,21,6,2020,551,13,Armenia,AM,ARM,2957728,Europe,332,19708,73
2020-06-22T00:00:00Z,22,6,2020,880,28,Armenia,AM,ARM,2957728,Europe,360,20588,74
2020-06-23T00:00:00Z,23,6,2020,0,0,Armenia,AM,ARM,2957728,Europe,360,20588,75
2020-06-24T00:00:00Z,24,6,2020,1129,26,Armenia,AM,ARM,2957728,Europe,386,21717,76
2020-06-25T00:00:00Z,25,6,2020,0,0,Armenia,AM,ARM,2957728,Europe,386,21717,77
2020-03-26T00:00:00Z,26,3,2020,376,3,Australia,AU,AUS,25203200,Oceania,11,2799,1
2020-03-27T00:00:00Z,27,3,2020,367,2,Australia,AU,AUS,25203200,Oceania,13,3166,2
2020-03-28T00:00:00Z,28,3,2020,212,0,Australia,AU,AUS,25203200,Oceania,13,3378,3
2020-03-29T00:00:00Z,29,3,2020,431,1,Australia,AU,AUS,25203200,Oceania,14,3809,4
2020-03-30T00:00:00Z,30,3,2020,284,2,Australia,AU,AUS,25203200,Oceania,16,4093,5
2020-03-31T00:00:00Z,31,3,2020,464,3,Australia,AU,AUS,25203200,Oceania,19,4557,6
2020-04-01T00:00:00Z,1,4,2020,150,1,Australia,AU,AUS,25203200,Oceania,20,4707,7
2020-04-02T00:00:00Z,2,4,2020,269,1,Australia,AU,AUS,25203200,Oceania,21,4976,8
2020-04-03T00:00:00Z,3,4,2020,248,2,Australia,AU,AUS,25203200,Oceania,23,5224,9
2020-04-04T00:00:00Z,4,4,2020,324,7,Australia,AU,AUS,25203200,Oceania,30,5548,10
2020-04-05T00:00:00Z,5,4,2020,139,4,Australia,AU,AUS,25203200,Oceania,34,5687,11
2020-04-06T00:00:00Z,6,4,2020,57,2,Australia,AU,AUS,25203200,Oceania,36,5744,12
2020-04-07T00:00:00Z,7,4,2020,100,6,Australia,AU,AUS,25203200,Oceania,42,5844,13
2020-04-08T00:00:00Z,8,4,2020,112,3,Australia,AU,AUS,25203200,Oceania,45,5956,14
2020-04-09T00:00:00Z,9,4,2020,96,5,Australia,AU,AUS,25203200,Oceania,50,6052,15
2020-04-10T00:00:00Z,10,4,2020,100,2,Australia,AU,AUS,25203200,Oceania,52,6152,16
2020-04-11T00:00:00Z,11,4,2020,86,2,Australia,AU,AUS,25203200,Oceania,54,6238,17
2020-04-12T00:00:00Z,12,4,2020,51,3,Australia,AU,AUS,25203200,Oceania,57,6289,18
2020-04-13T00:00:00Z,13,4,2020,33,4,Australia,AU,AUS,25203200,Oceania,61,6322,19
2020-04-14T00:00:00Z,14,4,2020,44,0,Australia,AU,AUS,25203200,Oceania,61,6366,20
2020-04-15T00:00:00Z,15,4,2020,50,0,Australia,AU,AUS,25203200,Oceania,61,6416,21
2020-04-16T00:00:00Z,16,4,2020,42,2,Australia,AU,AUS,25203200,Oceania,63,6458,22
2020-04-17T00:00:00Z,17,4,2020,39,0,Australia,AU,AUS,25203200,Oceania,63,6497,23
2020-04-18T00:00:00Z,18,4,2020,36,4,Australia,AU,AUS,25203200,Oceania,67,6533,24
2020-04-19T00:00:00Z,19,4,2020,53,2,Australia,AU,AUS,25203200,Oceania,69,6586,25
2020-04-20T00:00:00Z,20,4,2020,26,1,Australia,AU,AUS,25203200,Oceania,70,6612,26
2020-04-21T00:00:00Z,21,4,2020,13,1,Australia,AU,AUS,25203200,Oceania,71,6625,27
2020-04-22T00:00:00Z,22,4,2020,22,3,Australia,AU,AUS,25203200,Oceania,74,6647,28
2020-04-23T00:00:00Z,23,4,2020,7,0,Australia,AU,AUS,25203200,Oceania,74,6654,29
2020-04-24T00:00:00Z,24,4,2020,13,1,Australia,AU,AUS,25203200,Oceania,75,6667,30
2020-04-25T00:00:00Z,25,4,2020,20,4,Australia,AU,AUS,25203200,Oceania,79,6687,31
2020-04-26T00:00:00Z,26,4,2020,16,2,Australia,AU,AUS,25203200,Oceania,81,6703,32
2020-04-27T00:00:00Z,27,4,2020,10,2,Australia,AU,AUS,25203200,Oceania,83,6713,33
2020-04-28T00:00:00Z,28,4,2020,12,1,Australia,AU,AUS,25203200,Oceania,84,6725,34
2020-04-29T00:00:00Z,29,4,2020,13,4,Australia,AU,AUS,25203200,Oceania,88,6738,35
2020-04-30T00:00:00Z,30,4,2020,8,2,Australia,AU,AUS,25203200,Oceania,90,6746,36
2020-05-01T00:00:00Z,1,5,2020,16,2,Australia,AU,AUS,25203200,Oceania,92,6762,37
2020-05-02T00:00:00Z,2,5,2020,5,1,Australia,AU,AUS,25203200,Oceania,93,6767,38
2020-05-03T00:00:00Z,3,5,2020,16,0,Australia,AU,AUS,25203200,Oceania,93,6783,39
2020-05-04T00:00:00Z,4,5,2020,18,2,Australia,AU,AUS,25203200,Oceania,95,6801,40
2020-05-05T00:00:00Z,5,5,2020,24,0,Australia,AU,AUS,25203200,Oceania,95,6825,41
2020-05-06T00:00:00Z,6,5,2020,24,1,Australia,AU,AUS,25203200,Oceania,96,6849,42
2020-05-07T00:00:00Z,7,5,2020,26,1,Australia,AU,AUS,25203200,Oceania,97,6875,43
2020-05-08T00:00:00Z,8,5,2020,21,0,Australia,AU,AUS,25203200,Oceania,97,6896,44
2020-05-09T00:00:00Z,9,5,2020,18,0,Australia,AU,AUS,25203200,Oceania,97,6914,45
2020-05-10T00:00:00Z,10,5,2020,15,0,Australia,AU,AUS,25203200,Oceania,97,6929,46
2020-05-11T00:00:00Z,11,5,2020,12,0,Australia,AU,AUS,25203200,Oceania,97,6941,47
2020-05-12T00:00:00Z,12,5,2020,7,0,Australia,AU,AUS,25203200,Oceania,97,6948,48
2020-05-13T00:00:00Z,13,5,2020,16,0,Australia,AU,AUS,25203200,Oceania,97,6964,49
2020-05-14T00:00:00Z,14,5,2020,11,1,Australia,AU,AUS,25203200,Oceania,98,6975,50
2020-05-15T00:00:00Z,15,5,2020,14,0,Australia,AU,AUS,25203200,Oceania,98,6989,51
2020-05-16T00:00:00Z,16,5,2020,30,0,Australia,AU,AUS,25203200,Oceania,98,7019,52
2020-05-17T00:00:00Z,17,5,2020,17,0,Australia,AU,AUS,25203200,Oceania,98,7036,53
2020-05-18T00:00:00Z,18,5,2020,9,0,Australia,AU,AUS,25203200,Oceania,98,7045,54
2020-05-19T00:00:00Z,19,5,2020,15,1,Australia,AU,AUS,25203200,Oceania,99,7060,55
2020-05-20T00:00:00Z,20,5,2020,8,0,Australia,AU,AUS,25203200,Oceania,99,7068,56
2020-05-21T00:00:00Z,21,5,2020,11,1,Australia,AU,AUS,25203200,Oceania,100,7079,57
2020-05-22T00:00:00Z,22,5,2020,2,0,Australia,AU,AUS,25203200,Oceania,100,7081,58
2020-05-23T00:00:00Z,23,5,2020,14,1,Australia,AU,AUS,25203200,Oceania,101,7095,59
2020-05-24T00:00:00Z,24,5,2020,11,1,Australia,AU,AUS,25203200,Oceania,102,7106,60
2020-05-25T00:00:00Z,25,5,2020,3,0,Australia,AU,AUS,25203200,Oceania,102,7109,61
2020-05-26T00:00:00Z,26,5,2020,9,0,Australia,AU,AUS,25203200,Oceania,102,7118,62
2020-05-27T00:00:00Z,27,5,2020,15,0,Australia,AU,AUS,25203200,Oceania,102,7133,63
2020-05-28T00:00:00Z,28,5,2020,6,0,Australia,AU,AUS,25203200,Oceania,102,7139,64
2020-05-29T00:00:00Z,29,5,2020,11,0,Australia,AU,AUS,25203200,Oceania,102,7150,65
2020-05-30T00:00:00Z,30,5,2020,23,0,Australia,AU,AUS,25203200,Oceania,102,7173,66
2020-05-31T00:00:00Z,31,5,2020,12,0,Australia,AU,AUS,25203200,Oceania,102,7185,67
2020-06-01T00:00:00Z,1,6,2020,10,0,Australia,AU,AUS,25203200,Oceania,102,7195,68
2020-06-02T00:00:00Z,2,6,2020,9,0,Australia,AU,AUS,25203200,Oceania,102,7204,69
2020-06-03T00:00:00Z,3,6,2020,17,0,Australia,AU,AUS,25203200,Oceania,102,7221,70
2020-06-04T00:00:00Z,4,6,2020,8,0,Australia,AU,AUS,25203200,Oceania,102,7229,71
2020-06-05T00:00:00Z,5,6,2020,11,0,Australia,AU,AUS,25203200,Oceania,102,7240,72
2020-06-06T00:00:00Z,6,6,2020,11,0,Australia,AU,AUS,25203200,Oceania,102,7251,73
2020-06-07T00:00:00Z,7,6,2020,4,0,Australia,AU,AUS,25203200,Oceania,102,7255,74
2020-06-08T00:00:00Z,8,6,2020,5,0,Australia,AU,AUS,25203200,Oceania,102,7260,75
2020-06-09T00:00:00Z,9,6,2020,5,0,Australia,AU,AUS,25203200,Oceania,102,7265,76
2020-06-10T00:00:00Z,10,6,2020,2,0,Australia,AU,AUS,25203200,Oceania,102,7267,77
2020-06-11T00:00:00Z,11,6,2020,9,0,Australia,AU,AUS,25203200,Oceania,102,7276,78
2020-06-12T00:00:00Z,12,6,2020,9,0,Australia,AU,AUS,25203200,Oceania,102,7285,79
2020-06-13T00:00:00Z,13,6,2020,5,0,Australia,AU,AUS,25203200,Oceania,102,7290,80
2020-06-14T00:00:00Z,14,6,2020,12,0,Australia,AU,AUS,25203200,Oceania,102,7302,81
2020-06-15T00:00:00Z,15,6,2020,18,0,Australia,AU,AUS,25203200,Oceania,102,7320,82
2020-06-16T00:00:00Z,16,6,2020,15,0,Australia,AU,AUS,25203200,Oceania,102,7335,83
2020-06-17T00:00:00Z,17,6,2020,12,0,Australia,AU,AUS,25203200,Oceania,102,7347,84
2020-06-18T00:00:00Z,18,6,2020,23,0,Australia,AU,AUS,25203200,Oceania,102,7370,85
2020-06-19T00:00:00Z,19,6,2020,21,0,Australia,AU,AUS,25203200,Oceania,102,7391,86
2020-06-20T00:00:00Z,20,6,2020,18,0,Australia,AU,AUS,25203200,Oceania,102,7409,87
2020-06-21T00:00:00Z,21,6,2020,27,0,Australia,AU,AUS,25203200,Oceania,102,7436,88
2020-06-22T00:00:00Z,22,6,2020,25,0,Australia,AU,AUS,25203200,Oceania,102,7461,89
2020-06-23T00:00:00Z,23,6,2020,13,0,Australia,AU,AUS,25203200,Oceania,102,7474,90
2020-06-24T00:00:00Z,24,6,2020,18,0,Australia,AU,AUS,25203200,Oceania,102,7492,91
2020-06-25T00:00:00Z,25,6,2020,29,1,Australia,AU,AUS,25203200,Oceania,103,7521,92
2020-03-23T00:00:00Z,23,3,2020,607,8,Austria,AT,AUT,8858775,Europe,16,3631,1
2020-03-24T00:00:00Z,24,3,2020,855,9,Austria,AT,AUT,8858775,Europe,25,4486,2
2020-03-25T00:00:00Z,25,3,2020,796,5,Austria,AT,AUT,8858775,Europe,30,5282,3
2020-03-26T00:00:00Z,26,3,2020,606,4,Austria,AT,AUT,8858775,Europe,34,5888,4
2020-03-27T00:00:00Z,27,3,2020,1141,18,Austria,AT,AUT,8858775,Europe,52,7029,5
2020-03-28T00:00:00Z,28,3,2020,668,16,Austria,AT,AUT,8858775,Europe,68,7697,6
2020-03-29T00:00:00Z,29,3,2020,594,0,Austria,AT,AUT,8858775,Europe,68,8291,7
2020-03-30T00:00:00Z,30,3,2020,522,18,Austria,AT,AUT,8858775,Europe,86,8813,8
2020-03-31T00:00:00Z,31,3,2020,805,22,Austria,AT,AUT,8858775,Europe,108,9618,9
2020-04-01T00:00:00Z,1,4,2020,564,20,Austria,AT,AUT,8858775,Europe,128,10182,10
2020-04-02T00:00:00Z,2,4,2020,529,18,Austria,AT,AUT,8858775,Europe,146,10711,11
2020-04-03T00:00:00Z,3,4,2020,418,12,Austria,AT,AUT,8858775,Europe,158,11129,12
2020-04-04T00:00:00Z,4,4,2020,396,10,Austria,AT,AUT,8858775,Europe,168,11525,13
2020-04-05T00:00:00Z,5,4,2020,241,18,Austria,AT,AUT,8858775,Europe,186,11766,14
2020-04-06T00:00:00Z,6,4,2020,217,18,Austria,AT,AUT,8858775,Europe,204,11983,15
2020-04-07T00:00:00Z,7,4,2020,314,16,Austria,AT,AUT,8858775,Europe,220,12297,16
2020-04-08T00:00:00Z,8,4,2020,343,23,Austria,AT,AUT,8858775,Europe,243,12640,17
2020-04-09T00:00:00Z,9,4,2020,329,30,Austria,AT,AUT,8858775,Europe,273,12969,18
2020-04-10T00:00:00Z,10,4,2020,279,22,Austria,AT,AUT,8858775,Europe,295,13248,19
2020-04-11T00:00:00Z,11,4,2020,312,24,Austria,AT,AUT,8858775,Europe,319,13560,20
2020-04-12T00:00:00Z,12,4,2020,247,18,Austria,AT,AUT,8858775,Europe,337,13807,21
2020-04-13T00:00:00Z,13,4,2020,130,13,Austria,AT,AUT,8858775,Europe,350,13937,22
2020-04-14T00:00:00Z,14,4,2020,106,18,Austria,AT,AUT,8858775,Europe,368,14043,23
2020-04-15T00:00:00Z,15,4,2020,191,16,Austria,AT,AUT,8858775,Europe,384,14234,24
2020-04-16T00:00:00Z,16,4,2020,136,9,Austria,AT,AUT,8858775,Europe,393,14370,25
2020-04-17T00:00:00Z,17,4,2020,78,17,Austria,AT,AUT,8858775,Europe,410,14448,26
2020-04-18T00:00:00Z,18,4,2020,155,21,Austria,AT,AUT,8858775,Europe,431,14603,27
2020-04-19T00:00:00Z,19,4,2020,59,12,Austria,AT,AUT,8858775,Europe,443,14662,28
2020-04-20T00:00:00Z,20,4,2020,48,9,Austria,AT,AUT,8858775,Europe,452,14710,29
2020-04-21T00:00:00Z,21,4,2020,73,10,Austria,AT,AUT,8858775,Europe,462,14783,30
2020-04-22T00:00:00Z,22,4,2020,50,1,Austria,AT,AUT,8858775,Europe,463,14833,31
2020-04-23T00:00:00Z,23,4,2020,91,31,Austria,AT,AUT,8858775,Europe,494,14924,32
2020-04-24T00:00:00Z,24,4,2020,61,14,Austria,AT,AUT,8858775,Europe,508,14985,33
2020-04-25T00:00:00Z,25,4,2020,83,5,Austria,AT,AUT,8858775,Europe,513,15068,34
2020-04-26T00:00:00Z,26,4,2020,66,23,Austria,AT,AUT,8858775,Europe,536,15134,35
2020-04-27T00:00:00Z,27,4,2020,55,6,Austria,AT,AUT,8858775,Europe,542,15189,36
2020-04-28T00:00:00Z,28,4,2020,67,7,Austria,AT,AUT,8858775,Europe,549,15256,37
2020-04-29T00:00:00Z,29,4,2020,58,20,Austria,AT,AUT,8858775,Europe,569,15314,38
2020-04-30T00:00:00Z,30,4,2020,50,11,Austria,AT,AUT,8858775,Europe,580,15364,39
2020-05-01T00:00:00Z,1,5,2020,60,4,Austria,AT,AUT,8858775,Europe,584,15424,40
2020-05-02T00:00:00Z,2,5,2020,34,5,Austria,AT,AUT,8858775,Europe,589,15458,41
2020-05-03T00:00:00Z,3,5,2020,12,7,Austria,AT,AUT,8858775,Europe,596,15470,42
2020-05-04T00:00:00Z,4,5,2020,68,2,Austria,AT,AUT,8858775,Europe,598,15538,43
2020-05-05T00:00:00Z,5,5,2020,31,2,Austria,AT,AUT,8858775,Europe,600,15569,44
2020-05-06T00:00:00Z,6,5,2020,17,6,Austria,AT,AUT,8858775,Europe,606,15586,45
2020-05-07T00:00:00Z,7,5,2020,65,2,Austria,AT,AUT,8858775,Europe,608,15651,46
2020-05-08T00:00:00Z,8,5,2020,22,1,Austria,AT,AUT,8858775,Europe,609,15673,47
2020-05-09T00:00:00Z,9,5,2020,62,5,Austria,AT,AUT,8858775,Europe,614,15735,48
2020-05-10T00:00:00Z,10,5,2020,42,1,Austria,AT,AUT,8858775,Europe,615,15777,49
2020-05-11T00:00:00Z,11,5,2020,10,3,Austria,AT,AUT,8858775,Europe,618,15787,50
2020-05-12T00:00:00Z,12,5,2020,87,2,Austria,AT,AUT,8858775,Europe,620,15874,51
2020-05-13T00:00:00Z,13,5,2020,36,3,Austria,AT,AUT,8858775,Europe,623,15910,52
2020-05-14T00:00:00Z,14,5,2020,54,1,Austria,AT,AUT,8858775,Europe,624,15964,53
2020-05-15T00:00:00Z,15,5,2020,41,2,Austria,AT,AUT,8858775,Europe,626,16005,54
2020-05-16T00:00:00Z,16,5,2020,63,2,Austria,AT,AUT,8858775,Europe,628,16068,55
2020-05-17T00:00:00Z,17,5,2020,72,0,Austria,AT,AUT,8858775,Europe,628,16140,56
2020-05-18T00:00:00Z,18,5,2020,14,1,Austria,AT,AUT,8858775,Europe,629,16154,57
2020-05-19T00:00:00Z,19,5,2020,25,0,Austria,AT,AUT,8858775,Europe,629,16179,58
2020-05-20T00:00:00Z,20,5,2020,78,3,Austria,AT,AUT,8858775,Europe,632,16257,59
2020-05-21T00:00:00Z,21,5,2020,18,1,Austria,AT,AUT,8858775,Europe,633,16275,60
2020-05-22T00:00:00Z,22,5,2020,57,0,Austria,AT,AUT,8858775,Europe,633,16332,61
2020-05-23T00:00:00Z,23,5,2020,29,2,Austria,AT,AUT,8858775,Europe,635,16361,62
2020-05-24T00:00:00Z,24,5,2020,46,4,Austria,AT,AUT,8858775,Europe,639,16407,63
2020-05-25T00:00:00Z,25,5,2020,32,1,Austria,AT,AUT,8858775,Europe,640,16439,64
2020-05-26T00:00:00Z,26,5,2020,20,1,Austria,AT,AUT,8858775,Europe,641,16459,65
2020-05-27T00:00:00Z,27,5,2020,38,2,Austria,AT,AUT,8858775,Europe,643,16497,66
2020-05-28T00:00:00Z,28,5,2020,18,2,Austria,AT,AUT,8858775,Europe,645,16515,67
2020-05-29T00:00:00Z,29,5,2020,28,23,Austria,AT,AUT,8858775,Europe,668,16543,68
2020-05-30T00:00:00Z,30,5,2020,51,0,Austria,AT,AUT,8858775,Europe,668,16594,69
2020-05-31T00:00:00Z,31,5,2020,44,0,Austria,AT,AUT,8858775,Europe,668,16638,70
2020-06-01T00:00:00Z,1,6,2020,4,0,Austria,AT,AUT,8858775,Europe,668,16642,71
2020-06-02T00:00:00Z,2,6,2020,21,0,Austria,AT,AUT,8858775,Europe,668,16663,72
2020-06-03T00:00:00Z,3,6,2020,11,1,Austria,AT,AUT,8858775,Europe,669,16674,73
2020-06-04T00:00:00Z,4,6,2020,31,1,Austria,AT,AUT,8858775,Europe,670,16705,74
2020-06-05T00:00:00Z,5,6,2020,36,0,Austria,AT,AUT,8858775,Europe,670,16741,75
2020-06-06T00:00:00Z,6,6,2020,62,2,Austria,AT,AUT,8858775,Europe,672,16803,76
2020-06-07T00:00:00Z,7,6,2020,19,0,Austria,AT,AUT,8858775,Europe,672,16822,77
2020-06-08T00:00:00Z,8,6,2020,46,0,Austria,AT,AUT,8858775,Europe,672,16868,78
2020-06-09T00:00:00Z,9,6,2020,21,0,Austria,AT,AUT,8858775,Europe,672,16889,79
2020-06-10T00:00:00Z,10,6,2020,13,0,Austria,AT,AUT,8858775,Europe,672,16902,80
2020-06-11T00:00:00Z,11,6,2020,34,1,Austria,AT,AUT,8858775,Europe,673,16936,81
2020-06-12T00:00:00Z,12,6,2020,28,1,Austria,AT,AUT,8858775,Europe,674,16964,82
2020-06-13T00:00:00Z,13,6,2020,30,1,Austria,AT,AUT,8858775,Europe,675,16994,83
2020-06-14T00:00:00Z,14,6,2020,20,2,Austria,AT,AUT,8858775,Europe,677,17014,84
2020-06-15T00:00:00Z,15,6,2020,24,0,Austria,AT,AUT,8858775,Europe,677,17038,85
2020-06-16T00:00:00Z,16,6,2020,27,1,Austria,AT,AUT,8858775,Europe,678,17065,86
2020-06-17T00:00:00Z,17,6,2020,33,3,Austria,AT,AUT,8858775,Europe,681,17098,87
2020-06-18T00:00:00Z,18,6,2020,17,6,Austria,AT,AUT,8858775,Europe,687,17115,88
2020-06-19T00:00:00Z,19,6,2020,40,1,Austria,AT,AUT,8858775,Europe,688,17155,89
2020-06-20T00:00:00Z,20,6,2020,30,0,Austria,AT,AUT,8858775,Europe,688,17185,90
2020-06-21T00:00:00Z,21,6,2020,62,0,Austria,AT,AUT,8858775,Europe,688,17247,91
2020-06-22T00:00:00Z,22,6,2020,38,2,Austria,AT,AUT,8858775,Europe,690,17285,92
2020-06-23T00:00:00Z,23,6,2020,35,0,Austria,AT,AUT,8858775,Europe,690,17320,93
2020-06-24T00:00:00Z,24,6,2020,31,3,Austria,AT,AUT,8858775,Europe,693,17351,94
2020-06-25T00:00:00Z,25,6,2020,33,0,Austria,AT,AUT,8858775,Europe,693,17384,95
2020-04-11T00:00:00Z,11,4,2020,65,1,Azerbaijan,AZ,AZE,10047719,Europe,10,991,1
2020-04-12T00:00:00Z,12,4,2020,67,1,Azerbaijan,AZ,AZE,10047719,Europe,11,1058,2
2020-04-13T00:00:00Z,13,4,2020,40,0,Azerbaijan,AZ,AZE,10047719,Europe,11,1098,3
2020-04-14T00:00:00Z,14,4,2020,50,1,Azerbaijan,AZ,AZE,10047719,Europe,12,1148,4
2020-04-15T00:00:00Z,15,4,2020,49,1,Azerbaijan,AZ,AZE,10047719,Europe,13,1197,5
2020-04-16T00:00:00Z,16,4,2020,56,0,Azerbaijan,AZ,AZE,10047719,Europe,13,1253,6
2020-04-17T00:00:00Z,17,4,2020,30,2,Azerbaijan,AZ,AZE,10047719,Europe,15,1283,7
2020-04-18T00:00:00Z,18,4,2020,57,0,Azerbaijan,AZ,AZE,10047719,Europe,15,1340,8
2020-04-19T00:00:00Z,19,4,2020,33,3,Azerbaijan,AZ,AZE,10047719,Europe,18,1373,9
2020-04-20T00:00:00Z,20,4,2020,25,1,Azerbaijan,AZ,AZE,10047719,Europe,19,1398,10
2020-04-21T00:00:00Z,21,4,2020,38,0,Azerbaijan,AZ,AZE,10047719,Europe,19,1436,11
2020-04-22T00:00:00Z,22,4,2020,44,1,Azerbaijan,AZ,AZE,10047719,Europe,20,1480,12
2020-04-23T00:00:00Z,23,4,2020,38,0,Azerbaijan,AZ,AZE,10047719,Europe,20,1518,13
2020-04-24T00:00:00Z,24,4,2020,30,0,Azerbaijan,AZ,AZE,10047719,Europe,20,1548,14
2020-04-25T00:00:00Z,25,4,2020,44,1,Azerbaijan,AZ,AZE,10047719,Europe,21,1592,15
2020-04-26T00:00:00Z,26,4,2020,25,0,Azerbaijan,AZ,AZE,10047719,Europe,21,1617,16
2020-04-27T00:00:00Z,27,4,2020,28,0,Azerbaijan,AZ,AZE,10047719,Europe,21,1645,17
2020-04-28T00:00:00Z,28,4,2020,33,1,Azerbaijan,AZ,AZE,10047719,Europe,22,1678,18
2020-04-29T00:00:00Z,29,4,2020,39,0,Azerbaijan,AZ,AZE,10047719,Europe,22,1717,19
2020-04-30T00:00:00Z,30,4,2020,49,1,Azerbaijan,AZ,AZE,10047719,Europe,23,1766,20
2020-05-01T00:00:00Z,1,5,2020,38,1,Azerbaijan,AZ,AZE,10047719,Europe,24,1804,21
2020-05-02T00:00:00Z,2,5,2020,50,1,Azerbaijan,AZ,AZE,10047719,Europe,25,1854,22
2020-05-03T00:00:00Z,3,5,2020,40,0,Azerbaijan,AZ,AZE,10047719,Europe,25,1894,23
2020-05-04T00:00:00Z,4,5,2020,38,0,Azerbaijan,AZ,AZE,10047719,Europe,25,1932,24
2020-05-05T00:00:00Z,5,5,2020,52,1,Azerbaijan,AZ,AZE,10047719,Europe,26,1984,25
2020-05-06T00:00:00Z,6,5,2020,76,0,Azerbaijan,AZ,AZE,10047719,Europe,26,2060,26
2020-05-07T00:00:00Z,7,5,2020,67,2,Azerbaijan,AZ,AZE,10047719,Europe,28,2127,27
2020-05-08T00:00:00Z,8,5,2020,77,0,Azerbaijan,AZ,AZE,10047719,Europe,28,2204,28
2020-05-09T00:00:00Z,9,5,2020,75,0,Azerbaijan,AZ,AZE,10047719,Europe,28,2279,29
2020-05-10T00:00:00Z,10,5,2020,143,3,Azerbaijan,AZ,AZE,10047719,Europe,31,2422,30
2020-05-11T00:00:00Z,11,5,2020,97,1,Azerbaijan,AZ,AZE,10047719,Europe,32,2519,31
2020-05-12T00:00:00Z,12,5,2020,70,0,Azerbaijan,AZ,AZE,10047719,Europe,32,2589,32
2020-05-13T00:00:00Z,13,5,2020,104,1,Azerbaijan,AZ,AZE,10047719,Europe,33,2693,33
2020-05-14T00:00:00Z,14,5,2020,65,2,Azerbaijan,AZ,AZE,10047719,Europe,35,2758,34
2020-05-15T00:00:00Z,15,5,2020,121,0,Azerbaijan,AZ,AZE,10047719,Europe,35,2879,35
2020-05-16T00:00:00Z,16,5,2020,101,1,Azerbaijan,AZ,AZE,10047719,Europe,36,2980,36
2020-05-17T00:00:00Z,17,5,2020,158,0,Azerbaijan,AZ,AZE,10047719,Europe,36,3138,37
2020-05-18T00:00:00Z,18,5,2020,136,3,Azerbaijan,AZ,AZE,10047719,Europe,39,3274,38
2020-05-19T00:00:00Z,19,5,2020,13,1,Azerbaijan,AZ,AZE,10047719,Europe,40,3287,39
2020-05-20T00:00:00Z,20,5,2020,231,1,Azerbaijan,AZ,AZE,10047719,Europe,41,3518,40
2020-05-21T00:00:00Z,21,5,2020,113,2,Azerbaijan,AZ,AZE,10047719,Europe,43,3631,41
2020-05-22T00:00:00Z,22,5,2020,118,1,Azerbaijan,AZ,AZE,10047719,Europe,44,3749,42
2020-05-23T00:00:00Z,23,5,2020,106,2,Azerbaijan,AZ,AZE,10047719,Europe,46,3855,43
2020-05-24T00:00:00Z,24,5,2020,127,3,Azerbaijan,AZ,AZE,10047719,Europe,49,3982,44
2020-05-25T00:00:00Z,25,5,2020,140,0,Azerbaijan,AZ,AZE,10047719,Europe,49,4122,45
2020-05-26T00:00:00Z,26,5,2020,149,2,Azerbaijan,AZ,AZE,10047719,Europe,51,4271,46
2020-05-27T00:00:00Z,27,5,2020,132,1,Azerbaijan,AZ,AZE,10047719,Europe,52,4403,47
2020-05-28T00:00:00Z,28,5,2020,165,2,Azerbaijan,AZ,AZE,10047719,Europe,54,4568,48
2020-05-29T00:00:00Z,29,5,2020,191,2,Azerbaijan,AZ,AZE,10047719,Europe,56,4759,49
2020-05-30T00:00:00Z,30,5,2020,230,2,Azerbaijan,AZ,AZE,10047719,Europe,58,4989,50
2020-05-31T00:00:00Z,31,5,2020,257,3,Azerbaijan,AZ,AZE,10047719,Europe,61,5246,51
2020-06-01T00:00:00Z,1,6,2020,248,2,Azerbaijan,AZ,AZE,10047719,Europe,63,5494,52
2020-06-02T00:00:00Z,2,6,2020,168,5,Azerbaijan,AZ,AZE,10047719,Europe,68,5662,53
2020-06-03T00:00:00Z,3,6,2020,273,3,Azerbaijan,AZ,AZE,10047719,Europe,71,5935,54
2020-06-04T00:00:00Z,4,6,2020,325,5,Azerbaijan,AZ,AZE,10047719,Europe,76,6260,55
2020-06-05T00:00:00Z,5,6,2020,262,2,Azerbaijan,AZ,AZE,10047719,Europe,78,6522,56
2020-06-06T00:00:00Z,6,6,2020,338,4,Azerbaijan,AZ,AZE,10047719,Europe,82,6860,57
2020-06-07T00:00:00Z,7,6,2020,379,2,Azerbaijan,AZ,AZE,10047719,Europe,84,7239,58
2020-06-08T00:00:00Z,8,6,2020,314,4,Azerbaijan,AZ,AZE,10047719,Europe,88,7553,59
2020-06-09T00:00:00Z,9,6,2020,323,5,Azerbaijan,AZ,AZE,10047719,Europe,93,7876,60
2020-06-10T00:00:00Z,10,6,2020,315,5,Azerbaijan,AZ,AZE,10047719,Europe,98,8191,61
2020-06-11T00:00:00Z,11,6,2020,339,4,Azerbaijan,AZ,AZE,10047719,Europe,102,8530,62
2020-06-12T00:00:00Z,12,6,2020,352,6,Azerbaijan,AZ,AZE,10047719,Europe,108,8882,63
2020-06-13T00:00:00Z,13,6,2020,336,5,Azerbaijan,AZ,AZE,10047719,Europe,113,9218,64
2020-06-14T00:00:00Z,14,6,2020,352,2,Azerbaijan,AZ,AZE,10047719,Europe,115,9570,65
2020-06-15T00:00:00Z,15,6,2020,387,4,Azerbaijan,AZ,AZE,10047719,Europe,119,9957,66
2020-06-16T00:00:00Z,16,6,2020,367,3,Azerbaijan,AZ,AZE,10047719,Europe,122,10324,67
2020-06-17T00:00:00Z,17,6,2020,338,4,Azerbaijan,AZ,AZE,10047719,Europe,126,10662,68
2020-06-18T00:00:00Z,18,6,2020,329,7,Azerbaijan,AZ,AZE,10047719,Europe,133,10991,69
2020-06-19T00:00:00Z,19,6,2020,338,6,Azerbaijan,AZ,AZE,10047719,Europe,139,11329,70
2020-06-20T00:00:00Z,20,6,2020,0,0,Azerbaijan,AZ,AZE,10047719,Europe,139,11329,71
2020-06-21T00:00:00Z,21,6,2020,909,9,Azerbaijan,AZ,AZE,10047719,Europe,148,12238,72
2020-06-22T00:00:00Z,22,6,2020,491,6,Azerbaijan,AZ,AZE,10047719,Europe,154,12729,73
2020-06-23T00:00:00Z,23,6,2020,478,7,Azerbaijan,AZ,AZE,10047719,Europe,161,13207,74
2020-06-24T00:00:00Z,24,6,2020,508,6,Azerbaijan,AZ,AZE,10047719,Europe,167,13715,75
2020-06-25T00:00:00Z,25,6,2020,590,7,Azerbaijan,AZ,AZE,10047719,Europe,174,14305,76
2020-04-24T00:00:00Z,24,4,2020,2,2,Bahamas,BS,BHS,389486,America,11,72,1
2020-04-25T00:00:00Z,25,4,2020,1,0,Bahamas,BS,BHS,389486,America,11,73,2
2020-04-26T00:00:00Z,26,4,2020,5,0,Bahamas,BS,BHS,389486,America,11,78,3
2020-04-27T00:00:00Z,27,4,2020,2,0,Bahamas,BS,BHS,389486,America,11,80,4
2020-04-28T00:00:00Z,28,4,2020,0,0,Bahamas,BS,BHS,389486,America,11,80,5
2020-04-29T00:00:00Z,29,4,2020,0,0,Bahamas,BS,BHS,389486,America,11,80,6
2020-04-30T00:00:00Z,30,4,2020,0,0,Bahamas,BS,BHS,389486,America,11,80,7
2020-05-01T00:00:00Z,1,5,2020,1,0,Bahamas,BS,BHS,389486,America,11,81,8
2020-05-02T00:00:00Z,2,5,2020,1,0,Bahamas,BS,BHS,389486,America,11,82,9
2020-05-03T00:00:00Z,3,5,2020,1,0,Bahamas,BS,BHS,389486,America,11,83,10
2020-05-04T00:00:00Z,4,5,2020,0,0,Bahamas,BS,BHS,389486,America,11,83,11
2020-05-05T00:00:00Z,5,5,2020,0,0,Bahamas,BS,BHS,389486,America,11,83,12
2020-05-06T00:00:00Z,6,5,2020,6,0,Bahamas,BS,BHS,389486,America,11,89,13
2020-05-07T00:00:00Z,7,5,2020,3,0,Bahamas,BS,BHS,389486,America,11,92,14
2020-05-08T00:00:00Z,8,5,2020,0,0,Bahamas,BS,BHS,389486,America,11,92,15
2020-05-09T00:00:00Z,9,5,2020,0,0,Bahamas,BS,BHS,389486,America,11,92,16
2020-05-10T00:00:00Z,10,5,2020,0,0,Bahamas,BS,BHS,389486,America,11,92,17
2020-05-11T00:00:00Z,11,5,2020,0,0,Bahamas,BS,BHS,389486,America,11,92,18
2020-05-12T00:00:00Z,12,5,2020,1,0,Bahamas,BS,BHS,389486,America,11,93,19
2020-05-13T00:00:00Z,13,5,2020,0,0,Bahamas,BS,BHS,389486,America,11,93,20
2020-05-14T00:00:00Z,14,5,2020,1,0,Bahamas,BS,BHS,389486,America,11,94,21
2020-05-15T00:00:00Z,15,5,2020,2,0,Bahamas,BS,BHS,389486,America,11,96,22
2020-05-16T00:00:00Z,16,5,2020,0,0,Bahamas,BS,BHS,389486,America,11,96,23
2020-05-17T00:00:00Z,17,5,2020,0,0,Bahamas,BS,BHS,389486,America,11,96,24
2020-05-18T00:00:00Z,18,5,2020,0,0,Bahamas,BS,BHS,389486,America,11,96,25
2020-05-19T00:00:00Z,19,5,2020,0,0,Bahamas,BS,BHS,389486,America,11,96,26
2020-05-20T00:00:00Z,20,5,2020,0,0,Bahamas,BS,BHS,389486,America,11,96,27
2020-05-21T00:00:00Z,21,5,2020,1,0,Bahamas,BS,BHS,389486,America,11,97,28
2020-05-22T00:00:00Z,22,5,2020,0,0,Bahamas,BS,BHS,389486,America,11,97,29
2020-05-23T00:00:00Z,23,5,2020,0,0,Bahamas,BS,BHS,389486,America,11,97,30
2020-05-24T00:00:00Z,24,5,2020,3,0,Bahamas,BS,BHS,389486,America,11,100,31
2020-05-25T00:00:00Z,25,5,2020,0,0,Bahamas,BS,BHS,389486,America,11,100,32
2020-05-26T00:00:00Z,26,5,2020,0,0,Bahamas,BS,BHS,389486,America,11,100,33
2020-05-27T00:00:00Z,27,5,2020,0,0,Bahamas,BS,BHS,389486,America,11,100,34
2020-05-28T00:00:00Z,28,5,2020,0,0,Bahamas,BS,BHS,389486,America,11,100,35
2020-05-29T00:00:00Z,29,5,2020,1,0,Bahamas,BS,BHS,389486,America,11,101,36
2020-05-30T00:00:00Z,30,5,2020,1,0,Bahamas,BS,BHS,389486,America,11,102,37
2020-05-31T00:00:00Z,31,5,2020,0,0,Bahamas,BS,BHS,389486,America,11,102,38
2020-06-01T00:00:00Z,1,6,2020,0,0,Bahamas,BS,BHS,389486,America,11,102,39
2020-06-02T00:00:00Z,2,6,2020,0,0,Bahamas,BS,BHS,389486,America,11,102,40
2020-06-03T00:00:00Z,3,6,2020,0,0,Bahamas,BS,BHS,389486,America,11,102,41
2020-06-04T00:00:00Z,4,6,2020,0,0,Bahamas,BS,BHS,389486,America,11,102,42
2020-06-05T00:00:00Z,5,6,2020,0,0,Bahamas,BS,BHS,389486,America,11,102,43
2020-06-06T00:00:00Z,6,6,2020,0,0,Bahamas,BS,BHS,389486,America,11,102,44
2020-06-07T00:00:00Z,7,6,2020,1,0,Bahamas,BS,BHS,389486,America,11,103,45
2020-06-08T00:00:00Z,8,6,2020,0,0,Bahamas,BS,BHS,389486,America,11,103,46
2020-06-09T00:00:00Z,9,6,2020,0,0,Bahamas,BS,BHS,389486,America,11,103,47
2020-06-10T00:00:00Z,10,6,2020,0,0,Bahamas,BS,BHS,389486,America,11,103,48
2020-06-11T00:00:00Z,11,6,2020,0,0,Bahamas,BS,BHS,389486,America,11,103,49
2020-06-12T00:00:00Z,12,6,2020,0,0,Bahamas,BS,BHS,389486,America,11,103,50
2020-06-13T00:00:00Z,13,6,2020,0,0,Bahamas,BS,BHS,389486,America,11,103,51
2020-06-14T00:00:00Z,14,6,2020,0,0,Bahamas,BS,BHS,389486,America,11,103,52
2020-06-15T00:00:00Z,15,6,2020,0,0,Bahamas,BS,BHS,389486,America,11,103,53
2020-06-16T00:00:00Z,16,6,2020,1,0,Bahamas,BS,BHS,389486,America,11,104,54
2020-06-17T00:00:00Z,17,6,2020,0,0,Bahamas,BS,BHS,389486,America,11,104,55
2020-06-18T00:00:00Z,18,6,2020,0,0,Bahamas,BS,BHS,389486,America,11,104,56
2020-06-19T00:00:00Z,19,6,2020,0,0,Bahamas,BS,BHS,389486,America,11,104,57
2020-06-20T00:00:00Z,20,6,2020,0,0,Bahamas,BS,BHS,389486,America,11,104,58
2020-06-21T00:00:00Z,21,6,2020,0,0,Bahamas,BS,BHS,389486,America,11,104,59
2020-06-22T00:00:00Z,22,6,2020,0,0,Bahamas,BS,BHS,389486,America,11,104,60
2020-06-23T00:00:00Z,23,6,2020,0,0,Bahamas,BS,BHS,389486,America,11,104,61
2020-06-24T00:00:00Z,24,6,2020,0,0,Bahamas,BS,BHS,389486,America,11,104,62
2020-06-25T00:00:00Z,25,6,2020,0,0,Bahamas,BS,BHS,389486,America,11,104,63
2020-05-14T00:00:00Z,14,5,2020,285,1,Bahrain,BH,BHR,1641164,Asia,10,5816,1
2020-05-15T00:00:00Z,15,5,2020,382,0,Bahrain,BH,BHR,1641164,Asia,10,6198,2
2020-05-16T00:00:00Z,16,5,2020,385,2,Bahrain,BH,BHR,1641164,Asia,12,6583,3
2020-05-17T00:00:00Z,17,5,2020,164,0,Bahrain,BH,BHR,1641164,Asia,12,6747,4
2020-05-18T00:00:00Z,18,5,2020,209,0,Bahrain,BH,BHR,1641164,Asia,12,6956,5
2020-05-19T00:00:00Z,19,5,2020,228,0,Bahrain,BH,BHR,1641164,Asia,12,7184,6
2020-05-20T00:00:00Z,20,5,2020,348,0,Bahrain,BH,BHR,1641164,Asia,12,7532,7
2020-05-21T00:00:00Z,21,5,2020,356,0,Bahrain,BH,BHR,1641164,Asia,12,7888,8
2020-05-22T00:00:00Z,22,5,2020,286,0,Bahrain,BH,BHR,1641164,Asia,12,8174,9
2020-05-23T00:00:00Z,23,5,2020,240,0,Bahrain,BH,BHR,1641164,Asia,12,8414,10
2020-05-24T00:00:00Z,24,5,2020,388,1,Bahrain,BH,BHR,1641164,Asia,13,8802,11
2020-05-25T00:00:00Z,25,5,2020,336,1,Bahrain,BH,BHR,1641164,Asia,14,9138,12
2020-05-26T00:00:00Z,26,5,2020,33,0,Bahrain,BH,BHR,1641164,Asia,14,9171,13
2020-05-27T00:00:00Z,27,5,2020,195,0,Bahrain,BH,BHR,1641164,Asia,14,9366,14
2020-05-28T00:00:00Z,28,5,2020,267,1,Bahrain,BH,BHR,1641164,Asia,15,9633,15
2020-05-29T00:00:00Z,29,5,2020,419,0,Bahrain,BH,BHR,1641164,Asia,15,10052,16
2020-05-30T00:00:00Z,30,5,2020,397,0,Bahrain,BH,BHR,1641164,Asia,15,10449,17
2020-05-31T00:00:00Z,31,5,2020,344,2,Bahrain,BH,BHR,1641164,Asia,17,10793,18
2020-06-01T00:00:00Z,1,6,2020,605,2,Bahrain,BH,BHR,1641164,Asia,19,11398,19
2020-06-02T00:00:00Z,2,6,2020,406,0,Bahrain,BH,BHR,1641164,Asia,19,11804,20
2020-06-03T00:00:00Z,3,6,2020,507,0,Bahrain,BH,BHR,1641164,Asia,19,12311,21
2020-06-04T00:00:00Z,4,6,2020,504,1,Bahrain,BH,BHR,1641164,Asia,20,12815,22
2020-06-05T00:00:00Z,5,6,2020,481,1,Bahrain,BH,BHR,1641164,Asia,21,13296,23
2020-06-06T00:00:00Z,6,6,2020,539,2,Bahrain,BH,BHR,1641164,Asia,23,13835,24
2020-06-07T00:00:00Z,7,6,2020,548,1,Bahrain,BH,BHR,1641164,Asia,24,14383,25
2020-06-08T00:00:00Z,8,6,2020,380,2,Bahrain,BH,BHR,1641164,Asia,26,14763,26
2020-06-09T00:00:00Z,9,6,2020,654,0,Bahrain,BH,BHR,1641164,Asia,26,15417,27
2020-06-10T00:00:00Z,10,6,2020,783,3,Bahrain,BH,BHR,1641164,Asia,29,16200,28
2020-06-11T00:00:00Z,11,6,2020,0,2,Bahrain,BH,BHR,1641164,Asia,31,16200,29
2020-06-12T00:00:00Z,12,6,2020,1069,5,Bahrain,BH,BHR,1641164,Asia,36,17269,30
2020-06-13T00:00:00Z,13,6,2020,444,0,Bahrain,BH,BHR,1641164,Asia,36,17713,31
2020-06-14T00:00:00Z,14,6,2020,514,3,Bahrain,BH,BHR,1641164,Asia,39,18227,32
2020-06-15T00:00:00Z,15,6,2020,0,4,Bahrain,BH,BHR,1641164,Asia,43,18227,33
2020-06-16T00:00:00Z,16,6,2020,786,3,Bahrain,BH,BHR,1641164,Asia,46,19013,34
2020-06-17T00:00:00Z,17,6,2020,540,1,Bahrain,BH,BHR,1641164,Asia,47,19553,35
2020-06-18T00:00:00Z,18,6,2020,408,2,Bahrain,BH,BHR,1641164,Asia,49,19961,36
2020-06-19T00:00:00Z,19,6,2020,469,6,Bahrain,BH,BHR,1641164,Asia,55,20430,37
2020-06-20T00:00:00Z,20,6,2020,486,2,Bahrain,BH,BHR,1641164,Asia,57,20916,38
2020-06-21T00:00:00Z,21,6,2020,415,3,Bahrain,BH,BHR,1641164,Asia,60,21331,39
2020-06-22T00:00:00Z,22,6,2020,433,3,Bahrain,BH,BHR,1641164,Asia,63,21764,40
2020-06-23T00:00:00Z,23,6,2020,643,2,Bahrain,BH,BHR,1641164,Asia,65,22407,41
2020-06-24T00:00:00Z,24,6,2020,655,2,Bahrain,BH,BHR,1641164,Asia,67,23062,42
2020-06-25T00:00:00Z,25,6,2020,508,2,Bahrain,BH,BHR,1641164,Asia,69,23570,43
2020-04-07T00:00:00Z,7,4,2020,35,3,Bangladesh,BD,BGD,163046173,Asia,12,123,1
2020-04-08T00:00:00Z,8,4,2020,41,5,Bangladesh,BD,BGD,163046173,Asia,17,164,2
2020-04-09T00:00:00Z,9,4,2020,54,3,Bangladesh,BD,BGD,163046173,Asia,20,218,3
2020-04-10T00:00:00Z,10,4,2020,112,1,Bangladesh,BD,BGD,163046173,Asia,21,330,4
2020-04-11T00:00:00Z,11,4,2020,94,6,Bangladesh,BD,BGD,163046173,Asia,27,424,5
2020-04-12T00:00:00Z,12,4,2020,58,3,Bangladesh,BD,BGD,163046173,Asia,30,482,6
2020-04-13T00:00:00Z,13,4,2020,139,4,Bangladesh,BD,BGD,163046173,Asia,34,621,7
2020-04-14T00:00:00Z,14,4,2020,182,5,Bangladesh,BD,BGD,163046173,Asia,39,803,8
2020-04-15T00:00:00Z,15,4,2020,209,7,Bangladesh,BD,BGD,163046173,Asia,46,1012,9
2020-04-16T00:00:00Z,16,4,2020,219,4,Bangladesh,BD,BGD,163046173,Asia,50,1231,10
2020-04-17T00:00:00Z,17,4,2020,341,10,Bangladesh,BD,BGD,163046173,Asia,60,1572,11
2020-04-18T00:00:00Z,18,4,2020,266,15,Bangladesh,BD,BGD,163046173,Asia,75,1838,12
2020-04-19T00:00:00Z,19,4,2020,306,9,Bangladesh,BD,BGD,163046173,Asia,84,2144,13
2020-04-20T00:00:00Z,20,4,2020,312,7,Bangladesh,BD,BGD,163046173,Asia,91,2456,14
2020-04-21T00:00:00Z,21,4,2020,492,10,Bangladesh,BD,BGD,163046173,Asia,101,2948,15
2020-04-22T00:00:00Z,22,4,2020,434,9,Bangladesh,BD,BGD,163046173,Asia,110,3382,16
2020-04-23T00:00:00Z,23,4,2020,390,10,Bangladesh,BD,BGD,163046173,Asia,120,3772,17
2020-04-24T00:00:00Z,24,4,2020,414,7,Bangladesh,BD,BGD,163046173,Asia,127,4186,18
2020-04-25T00:00:00Z,25,4,2020,503,4,Bangladesh,BD,BGD,163046173,Asia,131,4689,19
2020-04-26T00:00:00Z,26,4,2020,309,9,Bangladesh,BD,BGD,163046173,Asia,140,4998,20
2020-04-27T00:00:00Z,27,4,2020,418,5,Bangladesh,BD,BGD,163046173,Asia,145,5416,21
2020-04-28T00:00:00Z,28,4,2020,497,7,Bangladesh,BD,BGD,163046173,Asia,152,5913,22
2020-04-29T00:00:00Z,29,4,2020,549,3,Bangladesh,BD,BGD,163046173,Asia,155,6462,23
2020-04-30T00:00:00Z,30,4,2020,641,8,Bangladesh,BD,BGD,163046173,Asia,163,7103,24
2020-05-01T00:00:00Z,1,5,2020,564,5,Bangladesh,BD,BGD,163046173,Asia,168,7667,25
2020-05-02T00:00:00Z,2,5,2020,571,2,Bangladesh,BD,BGD,163046173,Asia,170,8238,26
2020-05-03T00:00:00Z,3,5,2020,552,5,Bangladesh,BD,BGD,163046173,Asia,175,8790,27
2020-05-04T00:00:00Z,4,5,2020,665,2,Bangladesh,BD,BGD,163046173,Asia,177,9455,28
2020-05-05T00:00:00Z,5,5,2020,688,5,Bangladesh,BD,BGD,163046173,Asia,182,10143,29
2020-05-06T00:00:00Z,6,5,2020,786,1,Bangladesh,BD,BGD,163046173,Asia,183,10929,30
2020-05-07T00:00:00Z,7,5,2020,790,3,Bangladesh,BD,BGD,163046173,Asia,186,11719,31
2020-05-08T00:00:00Z,8,5,2020,706,13,Bangladesh,BD,BGD,163046173,Asia,199,12425,32
2020-05-09T00:00:00Z,9,5,2020,709,7,Bangladesh,BD,BGD,163046173,Asia,206,13134,33
2020-05-10T00:00:00Z,10,5,2020,636,8,Bangladesh,BD,BGD,163046173,Asia,214,13770,34
2020-05-11T00:00:00Z,11,5,2020,887,14,Bangladesh,BD,BGD,163046173,Asia,228,14657,35
2020-05-12T00:00:00Z,12,5,2020,1034,11,Bangladesh,BD,BGD,163046173,Asia,239,15691,36
2020-05-13T00:00:00Z,13,5,2020,969,11,Bangladesh,BD,BGD,163046173,Asia,250,16660,37
2020-05-14T00:00:00Z,14,5,2020,1162,19,Bangladesh,BD,BGD,163046173,Asia,269,17822,38
2020-05-15T00:00:00Z,15,5,2020,1041,14,Bangladesh,BD,BGD,163046173,Asia,283,18863,39
2020-05-16T00:00:00Z,16,5,2020,1202,15,Bangladesh,BD,BGD,163046173,Asia,298,20065,40
2020-05-17T00:00:00Z,17,5,2020,930,16,Bangladesh,BD,BGD,163046173,Asia,314,20995,41
2020-05-18T00:00:00Z,18,5,2020,1273,14,Bangladesh,BD,BGD,163046173,Asia,328,22268,42
2020-05-19T00:00:00Z,19,5,2020,1602,21,Bangladesh,BD,BGD,163046173,Asia,349,23870,43
2020-05-20T00:00:00Z,20,5,2020,1251,21,Bangladesh,BD,BGD,163046173,Asia,370,25121,44
2020-05-21T00:00:00Z,21,5,2020,1617,16,Bangladesh,BD,BGD,163046173,Asia,386,26738,45
2020-05-22T00:00:00Z,22,5,2020,1773,22,Bangladesh,BD,BGD,163046173,Asia,408,28511,46
2020-05-23T00:00:00Z,23,5,2020,1694,24,Bangladesh,BD,BGD,163046173,Asia,432,30205,47
2020-05-24T00:00:00Z,24,5,2020,1873,20,Bangladesh,BD,BGD,163046173,Asia,452,32078,48
2020-05-25T00:00:00Z,25,5,2020,1532,28,Bangladesh,BD,BGD,163046173,Asia,480,33610,49
2020-05-26T00:00:00Z,26,5,2020,1975,21,Bangladesh,BD,BGD,163046173,Asia,501,35585,50
2020-05-27T00:00:00Z,27,5,2020,1166,21,Bangladesh,BD,BGD,163046173,Asia,522,36751,51
2020-05-28T00:00:00Z,28,5,2020,1541,22,Bangladesh,BD,BGD,163046173,Asia,544,38292,52
2020-05-29T00:00:00Z,29,5,2020,2029,15,Bangladesh,BD,BGD,163046173,Asia,559,40321,53
2020-05-30T00:00:00Z,30,5,2020,2523,23,Bangladesh,BD,BGD,163046173,Asia,582,42844,54
2020-05-31T00:00:00Z,31,5,2020,1764,28,Bangladesh,BD,BGD,163046173,Asia,610,44608,55
2020-06-01T00:00:00Z,1,6,2020,2545,40,Bangladesh,BD,BGD,163046173,Asia,650,47153,56
2020-06-02T00:00:00Z,2,6,2020,2381,22,Bangladesh,BD,BGD,163046173,Asia,672,49534,57
2020-06-03T00:00:00Z,3,6,2020,2911,37,Bangladesh,BD,BGD,163046173,Asia,709,52445,58
2020-06-04T00:00:00Z,4,6,2020,2695,37,Bangladesh,BD,BGD,163046173,Asia,746,55140,59
2020-06-05T00:00:00Z,5,6,2020,2423,35,Bangladesh,BD,BGD,163046173,Asia,781,57563,60
2020-06-06T00:00:00Z,6,6,2020,2828,30,Bangladesh,BD,BGD,163046173,Asia,811,60391,61
2020-06-07T00:00:00Z,7,6,2020,2635,35,Bangladesh,BD,BGD,163046173,Asia,846,63026,62
2020-06-08T00:00:00Z,8,6,2020,2743,42,Bangladesh,BD,BGD,163046173,Asia,888,65769,63
2020-06-09T00:00:00Z,9,6,2020,2735,42,Bangladesh,BD,BGD,163046173,Asia,930,68504,64
2020-06-10T00:00:00Z,10,6,2020,3171,45,Bangladesh,BD,BGD,163046173,Asia,975,71675,65
2020-06-11T00:00:00Z,11,6,2020,3190,37,Bangladesh,BD,BGD,163046173,Asia,1012,74865,66
2020-06-12T00:00:00Z,12,6,2020,3187,37,Bangladesh,BD,BGD,163046173,Asia,1049,78052,67
2020-06-13T00:00:00Z,13,6,2020,3471,46,Bangladesh,BD,BGD,163046173,Asia,1095,81523,68
2020-06-14T00:00:00Z,14,6,2020,2856,44,Bangladesh,BD,BGD,163046173,Asia,1139,84379,69
2020-06-15T00:00:00Z,15,6,2020,3141,32,Bangladesh,BD,BGD,163046173,Asia,1171,87520,70
2020-06-16T00:00:00Z,16,6,2020,3099,38,Bangladesh,BD,BGD,163046173,Asia,1209,90619,71
2020-06-17T00:00:00Z,17,6,2020,3862,53,Bangladesh,BD,BGD,163046173,Asia,1262,94481,72
2020-06-18T00:00:00Z,18,6,2020,4008,43,Bangladesh,BD,BGD,163046173,Asia,1305,98489,73
2020-06-19T00:00:00Z,19,6,2020,3803,38,Bangladesh,BD,BGD,163046173,Asia,1343,102292,74
2020-06-20T00:00:00Z,20,6,2020,3243,45,Bangladesh,BD,BGD,163046173,Asia,1388,105535,75
2020-06-21T00:00:00Z,21,6,2020,3240,37,Bangladesh,BD,BGD,163046173,Asia,1425,108775,76
2020-06-22T00:00:00Z,22,6,2020,3531,39,Bangladesh,BD,BGD,163046173,Asia,1464,112306,77
2020-06-23T00:00:00Z,23,6,2020,3480,38,Bangladesh,BD,BGD,163046173,Asia,1502,115786,78
2020-06-24T00:00:00Z,24,6,2020,3412,43,Bangladesh,BD,BGD,163046173,Asia,1545,119198,79
2020-06-25T00:00:00Z,25,6,2020,3462,37,Bangladesh,BD,BGD,163046173,Asia,1582,122660,80
2020-04-07T00:00:00Z,7,4,2020,136,5,Belarus,BY,BLR,9452409,Europe,13,700,1
2020-04-08T00:00:00Z,8,4,2020,161,0,Belarus,BY,BLR,9452409,Europe,13,861,2
2020-04-09T00:00:00Z,9,4,2020,205,0,Belarus,BY,BLR,9452409,Europe,13,1066,3
2020-04-10T00:00:00Z,10,4,2020,420,3,Belarus,BY,BLR,9452409,Europe,16,1486,4
2020-04-11T00:00:00Z,11,4,2020,495,3,Belarus,BY,BLR,9452409,Europe,19,1981,5
2020-04-12T00:00:00Z,12,4,2020,245,4,Belarus,BY,BLR,9452409,Europe,23,2226,6
2020-04-13T00:00:00Z,13,4,2020,352,3,Belarus,BY,BLR,9452409,Europe,26,2578,7
2020-04-14T00:00:00Z,14,4,2020,341,3,Belarus,BY,BLR,9452409,Europe,29,2919,8
2020-04-15T00:00:00Z,15,4,2020,362,4,Belarus,BY,BLR,9452409,Europe,33,3281,9
2020-04-16T00:00:00Z,16,4,2020,447,3,Belarus,BY,BLR,9452409,Europe,36,3728,10
2020-04-17T00:00:00Z,17,4,2020,476,4,Belarus,BY,BLR,9452409,Europe,40,4204,11
2020-04-18T00:00:00Z,18,4,2020,575,2,Belarus,BY,BLR,9452409,Europe,42,4779,12
2020-04-19T00:00:00Z,19,4,2020,0,3,Belarus,BY,BLR,9452409,Europe,45,4779,13
2020-04-20T00:00:00Z,20,4,2020,0,2,Belarus,BY,BLR,9452409,Europe,47,4779,14
2020-04-21T00:00:00Z,21,4,2020,1485,4,Belarus,BY,BLR,9452409,Europe,51,6264,15
2020-04-22T00:00:00Z,22,4,2020,459,4,Belarus,BY,BLR,9452409,Europe,55,6723,16
2020-04-23T00:00:00Z,23,4,2020,558,3,Belarus,BY,BLR,9452409,Europe,58,7281,17
2020-04-24T00:00:00Z,24,4,2020,741,2,Belarus,BY,BLR,9452409,Europe,60,8022,18
2020-04-25T00:00:00Z,25,4,2020,751,3,Belarus,BY,BLR,9452409,Europe,63,8773,19
2020-04-26T00:00:00Z,26,4,2020,817,4,Belarus,BY,BLR,9452409,Europe,67,9590,20
2020-04-27T00:00:00Z,27,4,2020,873,5,Belarus,BY,BLR,9452409,Europe,72,10463,21
2020-04-28T00:00:00Z,28,4,2020,826,3,Belarus,BY,BLR,9452409,Europe,75,11289,22
2020-04-29T00:00:00Z,29,4,2020,919,4,Belarus,BY,BLR,9452409,Europe,79,12208,23
2020-04-30T00:00:00Z,30,4,2020,973,5,Belarus,BY,BLR,9452409,Europe,84,13181,24
2020-05-01T00:00:00Z,1,5,2020,846,5,Belarus,BY,BLR,9452409,Europe,89,14027,25
2020-05-02T00:00:00Z,2,5,2020,890,4,Belarus,BY,BLR,9452409,Europe,93,14917,26
2020-05-03T00:00:00Z,3,5,2020,911,4,Belarus,BY,BLR,9452409,Europe,97,15828,27
2020-05-04T00:00:00Z,4,5,2020,877,2,Belarus,BY,BLR,9452409,Europe,99,16705,28
2020-05-05T00:00:00Z,5,5,2020,784,4,Belarus,BY,BLR,9452409,Europe,103,17489,29
2020-05-06T00:00:00Z,6,5,2020,861,4,Belarus,BY,BLR,9452409,Europe,107,18350,30
2020-05-07T00:00:00Z,7,5,2020,905,5,Belarus,BY,BLR,9452409,Europe,112,19255,31
2020-05-08T00:00:00Z,8,5,2020,913,4,Belarus,BY,BLR,9452409,Europe,116,20168,32
2020-05-09T00:00:00Z,9,5,2020,933,5,Belarus,BY,BLR,9452409,Europe,121,21101,33
2020-05-10T00:00:00Z,10,5,2020,951,5,Belarus,BY,BLR,9452409,Europe,126,22052,34
2020-05-11T00:00:00Z,11,5,2020,921,5,Belarus,BY,BLR,9452409,Europe,131,22973,35
2020-05-12T00:00:00Z,12,5,2020,933,4,Belarus,BY,BLR,9452409,Europe,135,23906,36
2020-05-13T00:00:00Z,13,5,2020,967,7,Belarus,BY,BLR,9452409,Europe,142,24873,37
2020-05-14T00:00:00Z,14,5,2020,952,4,Belarus,BY,BLR,9452409,Europe,146,25825,38
2020-05-15T00:00:00Z,15,5,2020,947,5,Belarus,BY,BLR,9452409,Europe,151,26772,39
2020-05-16T00:00:00Z,16,5,2020,958,5,Belarus,BY,BLR,9452409,Europe,156,27730,40
2020-05-17T00:00:00Z,17,5,2020,951,4,Belarus,BY,BLR,9452409,Europe,160,28681,41
2020-05-18T00:00:00Z,18,5,2020,969,5,Belarus,BY,BLR,9452409,Europe,165,29650,42
2020-05-19T00:00:00Z,19,5,2020,922,6,Belarus,BY,BLR,9452409,Europe,171,30572,43
2020-05-20T00:00:00Z,20,5,2020,936,4,Belarus,BY,BLR,9452409,Europe,175,31508,44
2020-05-21T00:00:00Z,21,5,2020,918,4,Belarus,BY,BLR,9452409,Europe,179,32426,45
2020-05-22T00:00:00Z,22,5,2020,945,6,Belarus,BY,BLR,9452409,Europe,185,33371,46
2020-05-23T00:00:00Z,23,5,2020,932,5,Belarus,BY,BLR,9452409,Europe,190,34303,47
2020-05-24T00:00:00Z,24,5,2020,941,4,Belarus,BY,BLR,9452409,Europe,194,35244,48
2020-05-25T00:00:00Z,25,5,2020,954,5,Belarus,BY,BLR,9452409,Europe,199,36198,49
2020-05-26T00:00:00Z,26,5,2020,946,5,Belarus,BY,BLR,9452409,Europe,204,37144,50
2020-05-27T00:00:00Z,27,5,2020,915,4,Belarus,BY,BLR,9452409,Europe,208,38059,51
2020-05-28T00:00:00Z,28,5,2020,897,6,Belarus,BY,BLR,9452409,Europe,214,38956,52
2020-05-29T00:00:00Z,29,5,2020,902,5,Belarus,BY,BLR,9452409,Europe,219,39858,53
2020-05-30T00:00:00Z,30,5,2020,906,5,Belarus,BY,BLR,9452409,Europe,224,40764,54
2020-05-31T00:00:00Z,31,5,2020,894,5,Belarus,BY,BLR,9452409,Europe,229,41658,55
2020-06-01T00:00:00Z,1,6,2020,898,6,Belarus,BY,BLR,9452409,Europe,235,42556,56
2020-06-02T00:00:00Z,2,6,2020,847,5,Belarus,BY,BLR,9452409,Europe,240,43403,57
2020-06-03T00:00:00Z,3,6,2020,852,3,Belarus,BY,BLR,9452409,Europe,243,44255,58
2020-06-04T00:00:00Z,4,6,2020,861,5,Belarus,BY,BLR,9452409,Europe,248,45116,59
2020-06-05T00:00:00Z,5,6,2020,865,5,Belarus,BY,BLR,9452409,Europe,253,45981,60
2020-06-06T00:00:00Z,6,6,2020,887,6,Belarus,BY,BLR,9452409,Europe,259,46868,61
2020-06-07T00:00:00Z,7,6,2020,883,4,Belarus,BY,BLR,9452409,Europe,263,47751,62
2020-06-08T00:00:00Z,8,6,2020,879,6,Belarus,BY,BLR,9452409,Europe,269,48630,63
2020-06-09T00:00:00Z,9,6,2020,823,7,Belarus,BY,BLR,9452409,Europe,276,49453,64
2020-06-10T00:00:00Z,10,6,2020,812,6,Belarus,BY,BLR,9452409,Europe,282,50265,65
2020-06-11T00:00:00Z,11,6,2020,801,6,Belarus,BY,BLR,9452409,Europe,288,51066,66
2020-06-12T00:00:00Z,12,6,2020,750,5,Belarus,BY,BLR,9452409,Europe,293,51816,67
2020-06-13T00:00:00Z,13,6,2020,704,5,Belarus,BY,BLR,9452409,Europe,298,52520,68
2020-06-14T00:00:00Z,14,6,2020,721,5,Belarus,BY,BLR,9452409,Europe,303,53241,69
2020-06-15T00:00:00Z,15,6,2020,732,5,Belarus,BY,BLR,9452409,Europe,308,53973,70
2020-06-16T00:00:00Z,16,6,2020,707,4,Belarus,BY,BLR,9452409,Europe,312,54680,71
2020-06-17T00:00:00Z,17,6,2020,689,6,Belarus,BY,BLR,9452409,Europe,318,55369,72
2020-06-18T00:00:00Z,18,6,2020,663,6,Belarus,BY,BLR,9452409,Europe,324,56032,73
2020-06-19T00:00:00Z,19,6,2020,625,7,Belarus,BY,BLR,9452409,Europe,331,56657,74
2020-06-20T00:00:00Z,20,6,2020,676,2,Belarus,BY,BLR,9452409,Europe,333,57333,75
2020-06-21T00:00:00Z,21,6,2020,603,10,Belarus,BY,BLR,9452409,Europe,343,57936,76
2020-06-22T00:00:00Z,22,6,2020,569,3,Belarus,BY,BLR,9452409,Europe,346,58505,77
2020-06-23T00:00:00Z,23,6,2020,518,5,Belarus,BY,BLR,9452409,Europe,351,59023,78
2020-06-24T00:00:00Z,24,6,2020,464,6,Belarus,BY,BLR,9452409,Europe,357,59487,79
2020-06-25T00:00:00Z,25,6,2020,458,5,Belarus,BY,BLR,9452409,Europe,362,59945,80
2020-03-19T00:00:00Z,19,3,2020,243,9,Belgium,BE,BEL,11455519,Europe,14,1486,1
2020-03-20T00:00:00Z,20,3,2020,309,7,Belgium,BE,BEL,11455519,Europe,21,1795,2
2020-03-21T00:00:00Z,21,3,2020,462,16,Belgium,BE,BEL,11455519,Europe,37,2257,3
2020-03-22T00:00:00Z,22,3,2020,558,30,Belgium,BE,BEL,11455519,Europe,67,2815,4
2020-03-23T00:00:00Z,23,3,2020,586,8,Belgium,BE,BEL,11455519,Europe,75,3401,5
2020-03-24T00:00:00Z,24,3,2020,342,13,Belgium,BE,BEL,11455519,Europe,88,3743,6
2020-03-25T00:00:00Z,25,3,2020,526,34,Belgium,BE,BEL,11455519,Europe,122,4269,7
2020-03-26T00:00:00Z,26,3,2020,668,56,Belgium,BE,BEL,11455519,Europe,178,4937,8
2020-03-27T00:00:00Z,27,3,2020,1298,42,Belgium,BE,BEL,11455519,Europe,220,6235,9
2020-03-28T00:00:00Z,28,3,2020,1049,69,Belgium,BE,BEL,11455519,Europe,289,7284,10
2020-03-29T00:00:00Z,29,3,2020,1850,64,Belgium,BE,BEL,11455519,Europe,353,9134,11
2020-03-30T00:00:00Z,30,3,2020,1702,78,Belgium,BE,BEL,11455519,Europe,431,10836,12
2020-03-31T00:00:00Z,31,3,2020,1063,82,Belgium,BE,BEL,11455519,Europe,513,11899,13
2020-04-01T00:00:00Z,1,4,2020,876,192,Belgium,BE,BEL,11455519,Europe,705,12775,14
2020-04-02T00:00:00Z,2,4,2020,1189,123,Belgium,BE,BEL,11455519,Europe,828,13964,15
2020-04-03T00:00:00Z,3,4,2020,1384,183,Belgium,BE,BEL,11455519,Europe,1011,15348,16
2020-04-04T00:00:00Z,4,4,2020,1422,132,Belgium,BE,BEL,11455519,Europe,1143,16770,17
2020-04-05T00:00:00Z,5,4,2020,1661,140,Belgium,BE,BEL,11455519,Europe,1283,18431,18
2020-04-06T00:00:00Z,6,4,2020,1260,164,Belgium,BE,BEL,11455519,Europe,1447,19691,19
2020-04-07T00:00:00Z,7,4,2020,1123,185,Belgium,BE,BEL,11455519,Europe,1632,20814,20
2020-04-08T00:00:00Z,8,4,2020,1380,403,Belgium,BE,BEL,11455519,Europe,2035,22194,21
2020-04-09T00:00:00Z,9,4,2020,1209,205,Belgium,BE,BEL,11455519,Europe,2240,23403,22
2020-04-10T00:00:00Z,10,4,2020,1580,283,Belgium,BE,BEL,11455519,Europe,2523,24983,23
2020-04-11T00:00:00Z,11,4,2020,1684,496,Belgium,BE,BEL,11455519,Europe,3019,26667,24
2020-04-12T00:00:00Z,12,4,2020,1351,327,Belgium,BE,BEL,11455519,Europe,3346,28018,25
2020-04-13T00:00:00Z,13,4,2020,1629,254,Belgium,BE,BEL,11455519,Europe,3600,29647,26
2020-04-14T00:00:00Z,14,4,2020,942,303,Belgium,BE,BEL,11455519,Europe,3903,30589,27
2020-04-15T00:00:00Z,15,4,2020,530,254,Belgium,BE,BEL,11455519,Europe,4157,31119,28
2020-04-16T00:00:00Z,16,4,2020,2454,283,Belgium,BE,BEL,11455519,Europe,4440,33573,29
2020-04-17T00:00:00Z,17,4,2020,1236,417,Belgium,BE,BEL,11455519,Europe,4857,34809,30
2020-04-18T00:00:00Z,18,4,2020,1329,306,Belgium,BE,BEL,11455519,Europe,5163,36138,31
2020-04-19T00:00:00Z,19,4,2020,1045,290,Belgium,BE,BEL,11455519,Europe,5453,37183,32
2020-04-20T00:00:00Z,20,4,2020,1313,230,Belgium,BE,BEL,11455519,Europe,5683,38496,33
2020-04-21T00:00:00Z,21,4,2020,1487,145,Belgium,BE,BEL,11455519,Europe,5828,39983,34
2020-04-22T00:00:00Z,22,4,2020,973,170,Belgium,BE,BEL,11455519,Europe,5998,40956,35
2020-04-23T00:00:00Z,23,4,2020,933,264,Belgium,BE,BEL,11455519,Europe,6262,41889,36
2020-04-24T00:00:00Z,24,4,2020,908,228,Belgium,BE,BEL,11455519,Europe,6490,42797,37
2020-04-25T00:00:00Z,25,4,2020,1496,189,Belgium,BE,BEL,11455519,Europe,6679,44293,38
2020-04-26T00:00:00Z,26,4,2020,1032,238,Belgium,BE,BEL,11455519,Europe,6917,45325,39
2020-04-27T00:00:00Z,27,4,2020,809,177,Belgium,BE,BEL,11455519,Europe,7094,46134,40
2020-04-28T00:00:00Z,28,4,2020,553,113,Belgium,BE,BEL,11455519,Europe,7207,46687,41
2020-04-29T00:00:00Z,29,4,2020,647,124,Belgium,BE,BEL,11455519,Europe,7331,47334,42
2020-04-30T00:00:00Z,30,4,2020,525,170,Belgium,BE,BEL,11455519,Europe,7501,47859,43
2020-05-01T00:00:00Z,1,5,2020,660,93,Belgium,BE,BEL,11455519,Europe,7594,48519,44
2020-05-02T00:00:00Z,2,5,2020,513,109,Belgium,BE,BEL,11455519,Europe,7703,49032,45
2020-05-03T00:00:00Z,3,5,2020,485,62,Belgium,BE,BEL,11455519,Europe,7765,49517,46
2020-05-04T00:00:00Z,4,5,2020,389,79,Belgium,BE,BEL,11455519,Europe,7844,49906,47
2020-05-05T00:00:00Z,5,5,2020,361,80,Belgium,BE,BEL,11455519,Europe,7924,50267,48
2020-05-06T00:00:00Z,6,5,2020,242,92,Belgium,BE,BEL,11455519,Europe,8016,50509,49
2020-05-07T00:00:00Z,7,5,2020,272,323,Belgium,BE,BEL,11455519,Europe,8339,50781,50
2020-05-08T00:00:00Z,8,5,2020,639,76,Belgium,BE,BEL,11455519,Europe,8415,51420,51
2020-05-09T00:00:00Z,9,5,2020,591,106,Belgium,BE,BEL,11455519,Europe,8521,52011,52
2020-05-10T00:00:00Z,10,5,2020,585,60,Belgium,BE,BEL,11455519,Europe,8581,52596,53
2020-05-11T00:00:00Z,11,5,2020,485,75,Belgium,BE,BEL,11455519,Europe,8656,53081,54
2020-05-12T00:00:00Z,12,5,2020,368,51,Belgium,BE,BEL,11455519,Europe,8707,53449,55
2020-05-13T00:00:00Z,13,5,2020,330,54,Belgium,BE,BEL,11455519,Europe,8761,53779,56
2020-05-14T00:00:00Z,14,5,2020,202,82,Belgium,BE,BEL,11455519,Europe,8843,53981,57
2020-05-15T00:00:00Z,15,5,2020,307,60,Belgium,BE,BEL,11455519,Europe,8903,54288,58
2020-05-16T00:00:00Z,16,5,2020,356,56,Belgium,BE,BEL,11455519,Europe,8959,54644,59
2020-05-17T00:00:00Z,17,5,2020,345,46,Belgium,BE,BEL,11455519,Europe,9005,54989,60
2020-05-18T00:00:00Z,18,5,2020,291,47,Belgium,BE,BEL,11455519,Europe,9052,55280,61
2020-05-19T00:00:00Z,19,5,2020,279,28,Belgium,BE,BEL,11455519,Europe,9080,55559,62
2020-05-20T00:00:00Z,20,5,2020,232,28,Belgium,BE,BEL,11455519,Europe,9108,55791,63
2020-05-21T00:00:00Z,21,5,2020,192,42,Belgium,BE,BEL,11455519,Europe,9150,55983,64
2020-05-22T00:00:00Z,22,5,2020,252,36,Belgium,BE,BEL,11455519,Europe,9186,56235,65
2020-05-23T00:00:00Z,23,5,2020,276,26,Belgium,BE,BEL,11455519,Europe,9212,56511,66
2020-05-24T00:00:00Z,24,5,2020,299,25,Belgium,BE,BEL,11455519,Europe,9237,56810,67
2020-05-25T00:00:00Z,25,5,2020,282,43,Belgium,BE,BEL,11455519,Europe,9280,57092,68
2020-05-26T00:00:00Z,26,5,2020,250,32,Belgium,BE,BEL,11455519,Europe,9312,57342,69
2020-05-27T00:00:00Z,27,5,2020,113,22,Belgium,BE,BEL,11455519,Europe,9334,57455,70
2020-05-28T00:00:00Z,28,5,2020,137,30,Belgium,BE,BEL,11455519,Europe,9364,57592,71
2020-05-29T00:00:00Z,29,5,2020,257,24,Belgium,BE,BEL,11455519,Europe,9388,57849,72
2020-05-30T00:00:00Z,30,5,2020,212,55,Belgium,BE,BEL,11455519,Europe,9443,58061,73
2020-05-31T00:00:00Z,31,5,2020,125,10,Belgium,BE,BEL,11455519,Europe,9453,58186,74
2020-06-01T00:00:00Z,1,6,2020,195,14,Belgium,BE,BEL,11455519,Europe,9467,58381,75
2020-06-02T00:00:00Z,2,6,2020,136,19,Belgium,BE,BEL,11455519,Europe,9486,58517,76
2020-06-03T00:00:00Z,3,6,2020,98,19,Belgium,BE,BEL,11455519,Europe,9505,58615,77
2020-06-04T00:00:00Z,4,6,2020,70,17,Belgium,BE,BEL,11455519,Europe,9522,58685,78
2020-06-05T00:00:00Z,5,6,2020,82,26,Belgium,BE,BEL,11455519,Europe,9548,58767,79
2020-06-06T00:00:00Z,6,6,2020,140,18,Belgium,BE,BEL,11455519,Europe,9566,58907,80
2020-06-07T00:00:00Z,7,6,2020,165,14,Belgium,BE,BEL,11455519,Europe,9580,59072,81
2020-06-08T00:00:00Z,8,6,2020,154,15,Belgium,BE,BEL,11455519,Europe,9595,59226,82
2020-06-09T00:00:00Z,9,6,2020,122,14,Belgium,BE,BEL,11455519,Europe,9609,59348,83
2020-06-10T00:00:00Z,10,6,2020,89,10,Belgium,BE,BEL,11455519,Europe,9619,59437,84
2020-06-11T00:00:00Z,11,6,2020,132,10,Belgium,BE,BEL,11455519,Europe,9629,59569,85
2020-06-12T00:00:00Z,12,6,2020,142,7,Belgium,BE,BEL,11455519,Europe,9636,59711,86
2020-06-13T00:00:00Z,13,6,2020,108,10,Belgium,BE,BEL,11455519,Europe,9646,59819,87
2020-06-14T00:00:00Z,14,6,2020,99,4,Belgium,BE,BEL,11455519,Europe,9650,59918,88
2020-06-15T00:00:00Z,15,6,2020,111,5,Belgium,BE,BEL,11455519,Europe,9655,60029,89
2020-06-16T00:00:00Z,16,6,2020,71,6,Belgium,BE,BEL,11455519,Europe,9661,60100,90
2020-06-17T00:00:00Z,17,6,2020,55,2,Belgium,BE,BEL,11455519,Europe,9663,60155,91
2020-06-18T00:00:00Z,18,6,2020,89,12,Belgium,BE,BEL,11455519,Europe,9675,60244,92
2020-06-19T00:00:00Z,19,6,2020,104,8,Belgium,BE,BEL,11455519,Europe,9683,60348,93
2020-06-20T00:00:00Z,20,6,2020,128,12,Belgium,BE,BEL,11455519,Europe,9695,60476,94
2020-06-21T00:00:00Z,21,6,2020,74,1,Belgium,BE,BEL,11455519,Europe,9696,60550,95
2020-06-22T00:00:00Z,22,6,2020,0,0,Belgium,BE,BEL,11455519,Europe,9696,60550,96
2020-06-23T00:00:00Z,23,6,2020,0,0,Belgium,BE,BEL,11455519,Europe,9696,60550,97
2020-06-24T00:00:00Z,24,6,2020,260,17,Belgium,BE,BEL,11455519,Europe,9713,60810,98
2020-06-25T00:00:00Z,25,6,2020,88,9,Belgium,BE,BEL,11455519,Europe,9722,60898,99
2020-06-19T00:00:00Z,19,6,2020,25,2,Benin,BJ,BEN,11801151,Africa,11,597,1
2020-06-20T00:00:00Z,20,6,2020,53,0,Benin,BJ,BEN,11801151,Africa,11,650,2
2020-06-21T00:00:00Z,21,6,2020,0,0,Benin,BJ,BEN,11801151,Africa,11,650,3
2020-06-22T00:00:00Z,22,6,2020,115,2,Benin,BJ,BEN,11801151,Africa,13,765,4
2020-06-23T00:00:00Z,23,6,2020,42,0,Benin,BJ,BEN,11801151,Africa,13,807,5
2020-06-24T00:00:00Z,24,6,2020,43,0,Benin,BJ,BEN,11801151,Africa,13,850,6
2020-06-25T00:00:00Z,25,6,2020,52,0,Benin,BJ,BEN,11801151,Africa,13,902,7
2020-04-04T00:00:00Z,4,4,2020,7,1,Bolivia,BO,BOL,11513102,America,10,139,1
2020-04-05T00:00:00Z,5,4,2020,18,0,Bolivia,BO,BOL,11513102,America,10,157,2
2020-04-06T00:00:00Z,6,4,2020,26,1,Bolivia,BO,BOL,11513102,America,11,183,3
2020-04-07T00:00:00Z,7,4,2020,11,3,Bolivia,BO,BOL,11513102,America,14,194,4
2020-04-08T00:00:00Z,8,4,2020,16,1,Bolivia,BO,BOL,11513102,America,15,210,5
2020-04-09T00:00:00Z,9,4,2020,54,3,Bolivia,BO,BOL,11513102,America,18,264,6
2020-04-10T00:00:00Z,10,4,2020,4,1,Bolivia,BO,BOL,11513102,America,19,268,7
2020-04-11T00:00:00Z,11,4,2020,8,1,Bolivia,BO,BOL,11513102,America,20,276,8
2020-04-12T00:00:00Z,12,4,2020,24,4,Bolivia,BO,BOL,11513102,America,24,300,9
2020-04-13T00:00:00Z,13,4,2020,30,3,Bolivia,BO,BOL,11513102,America,27,330,10
2020-04-14T00:00:00Z,14,4,2020,24,1,Bolivia,BO,BOL,11513102,America,28,354,11
2020-04-15T00:00:00Z,15,4,2020,43,0,Bolivia,BO,BOL,11513102,America,28,397,12
2020-04-16T00:00:00Z,16,4,2020,44,1,Bolivia,BO,BOL,11513102,America,29,441,13
2020-04-17T00:00:00Z,17,4,2020,24,2,Bolivia,BO,BOL,11513102,America,31,465,14
2020-04-18T00:00:00Z,18,4,2020,28,0,Bolivia,BO,BOL,11513102,America,31,493,15
2020-04-19T00:00:00Z,19,4,2020,27,1,Bolivia,BO,BOL,11513102,America,32,520,16
2020-04-20T00:00:00Z,20,4,2020,44,1,Bolivia,BO,BOL,11513102,America,33,564,17
2020-04-21T00:00:00Z,21,4,2020,34,1,Bolivia,BO,BOL,11513102,America,34,598,18
2020-04-22T00:00:00Z,22,4,2020,11,3,Bolivia,BO,BOL,11513102,America,37,609,19
2020-04-23T00:00:00Z,23,4,2020,63,3,Bolivia,BO,BOL,11513102,America,40,672,20
2020-04-24T00:00:00Z,24,4,2020,31,3,Bolivia,BO,BOL,11513102,America,43,703,21
2020-04-25T00:00:00Z,25,4,2020,104,1,Bolivia,BO,BOL,11513102,America,44,807,22
2020-04-26T00:00:00Z,26,4,2020,59,2,Bolivia,BO,BOL,11513102,America,46,866,23
2020-04-27T00:00:00Z,27,4,2020,84,4,Bolivia,BO,BOL,11513102,America,50,950,24
2020-04-28T00:00:00Z,28,4,2020,64,3,Bolivia,BO,BOL,11513102,America,53,1014,25
2020-04-29T00:00:00Z,29,4,2020,39,2,Bolivia,BO,BOL,11513102,America,55,1053,26
2020-04-30T00:00:00Z,30,4,2020,57,4,Bolivia,BO,BOL,11513102,America,59,1110,27
2020-05-01T00:00:00Z,1,5,2020,57,3,Bolivia,BO,BOL,11513102,America,62,1167,28
2020-05-02T00:00:00Z,2,5,2020,62,4,Bolivia,BO,BOL,11513102,America,66,1229,29
2020-05-03T00:00:00Z,3,5,2020,241,5,Bolivia,BO,BOL,11513102,America,71,1470,30
2020-05-04T00:00:00Z,4,5,2020,124,5,Bolivia,BO,BOL,11513102,America,76,1594,31
2020-05-05T00:00:00Z,5,5,2020,87,6,Bolivia,BO,BOL,11513102,America,82,1681,32
2020-05-06T00:00:00Z,6,5,2020,121,4,Bolivia,BO,BOL,11513102,America,86,1802,33
2020-05-07T00:00:00Z,7,5,2020,84,5,Bolivia,BO,BOL,11513102,America,91,1886,34
2020-05-08T00:00:00Z,8,5,2020,195,11,Bolivia,BO,BOL,11513102,America,102,2081,35
2020-05-09T00:00:00Z,9,5,2020,185,4,Bolivia,BO,BOL,11513102,America,106,2266,36
2020-05-10T00:00:00Z,10,5,2020,171,8,Bolivia,BO,BOL,11513102,America,114,2437,37
2020-05-11T00:00:00Z,11,5,2020,119,4,Bolivia,BO,BOL,11513102,America,118,2556,38
2020-05-12T00:00:00Z,12,5,2020,275,4,Bolivia,BO,BOL,11513102,America,122,2831,39
2020-05-13T00:00:00Z,13,5,2020,133,6,Bolivia,BO,BOL,11513102,America,128,2964,40
2020-05-14T00:00:00Z,14,5,2020,184,14,Bolivia,BO,BOL,11513102,America,142,3148,41
2020-05-15T00:00:00Z,15,5,2020,224,10,Bolivia,BO,BOL,11513102,America,152,3372,42
2020-05-16T00:00:00Z,16,5,2020,205,12,Bolivia,BO,BOL,11513102,America,164,3577,43
2020-05-17T00:00:00Z,17,5,2020,249,1,Bolivia,BO,BOL,11513102,America,165,3826,44
2020-05-18T00:00:00Z,18,5,2020,262,4,Bolivia,BO,BOL,11513102,America,169,4088,45
2020-05-19T00:00:00Z,19,5,2020,175,5,Bolivia,BO,BOL,11513102,America,174,4263,46
2020-05-20T00:00:00Z,20,5,2020,218,15,Bolivia,BO,BOL,11513102,America,189,4481,47
2020-05-21T00:00:00Z,21,5,2020,438,10,Bolivia,BO,BOL,11513102,America,199,4919,48
2020-05-22T00:00:00Z,22,5,2020,268,16,Bolivia,BO,BOL,11513102,America,215,5187,49
2020-05-23T00:00:00Z,23,5,2020,392,15,Bolivia,BO,BOL,11513102,America,230,5579,50
2020-05-24T00:00:00Z,24,5,2020,336,10,Bolivia,BO,BOL,11513102,America,240,5915,51
2020-05-25T00:00:00Z,25,5,2020,348,10,Bolivia,BO,BOL,11513102,America,250,6263,52
2020-05-26T00:00:00Z,26,5,2020,397,11,Bolivia,BO,BOL,11513102,America,261,6660,53
2020-05-27T00:00:00Z,27,5,2020,476,13,Bolivia,BO,BOL,11513102,America,274,7136,54
2020-05-28T00:00:00Z,28,5,2020,632,6,Bolivia,BO,BOL,11513102,America,280,7768,55
2020-05-29T00:00:00Z,29,5,2020,619,13,Bolivia,BO,BOL,11513102,America,293,8387,56
2020-05-30T00:00:00Z,30,5,2020,344,7,Bolivia,BO,BOL,11513102,America,300,8731,57
2020-05-31T00:00:00Z,31,5,2020,861,10,Bolivia,BO,BOL,11513102,America,310,9592,58
2020-06-01T00:00:00Z,1,6,2020,390,3,Bolivia,BO,BOL,11513102,America,313,9982,59
2020-06-02T00:00:00Z,2,6,2020,549,30,Bolivia,BO,BOL,11513102,America,343,10531,60
2020-06-03T00:00:00Z,3,6,2020,460,33,Bolivia,BO,BOL,11513102,America,376,10991,61
2020-06-04T00:00:00Z,4,6,2020,647,24,Bolivia,BO,BOL,11513102,America,400,11638,62
2020-06-05T00:00:00Z,5,6,2020,607,15,Bolivia,BO,BOL,11513102,America,415,12245,63
2020-06-06T00:00:00Z,6,6,2020,483,12,Bolivia,BO,BOL,11513102,America,427,12728,64
2020-06-07T00:00:00Z,7,6,2020,630,27,Bolivia,BO,BOL,11513102,America,454,13358,65
2020-06-08T00:00:00Z,8,6,2020,285,11,Bolivia,BO,BOL,11513102,America,465,13643,66
2020-06-09T00:00:00Z,9,6,2020,306,10,Bolivia,BO,BOL,11513102,America,475,13949,67
2020-06-10T00:00:00Z,10,6,2020,695,12,Bolivia,BO,BOL,11513102,America,487,14644,68
2020-06-11T00:00:00Z,11,6,2020,637,25,Bolivia,BO,BOL,11513102,America,512,15281,69
2020-06-12T00:00:00Z,12,6,2020,884,21,Bolivia,BO,BOL,11513102,America,533,16165,70
2020-06-13T00:00:00Z,13,6,2020,764,26,Bolivia,BO,BOL,11513102,America,559,16929,71
2020-06-14T00:00:00Z,14,6,2020,913,26,Bolivia,BO,BOL,11513102,America,585,17842,72
2020-06-15T00:00:00Z,15,6,2020,617,26,Bolivia,BO,BOL,11513102,America,611,18459,73
2020-06-16T00:00:00Z,16,6,2020,614,21,Bolivia,BO,BOL,11513102,America,632,19073,74
2020-06-17T00:00:00Z,17,6,2020,810,27,Bolivia,BO,BOL,11513102,America,659,19883,75
2020-06-18T00:00:00Z,18,6,2020,802,20,Bolivia,BO,BOL,11513102,America,679,20685,76
2020-06-19T00:00:00Z,19,6,2020,814,18,Bolivia,BO,BOL,11513102,America,697,21499,77
2020-06-20T00:00:00Z,20,6,2020,977,18,Bolivia,BO,BOL,11513102,America,715,22476,78
2020-06-21T00:00:00Z,21,6,2020,1036,25,Bolivia,BO,BOL,11513102,America,740,23512,79
2020-06-22T00:00:00Z,22,6,2020,876,33,Bolivia,BO,BOL,11513102,America,773,24388,80
2020-06-23T00:00:00Z,23,6,2020,1105,47,Bolivia,BO,BOL,11513102,America,820,25493,81
2020-06-24T00:00:00Z,24,6,2020,896,26,Bolivia,BO,BOL,11513102,America,846,26389,82
2020-06-25T00:00:00Z,25,6,2020,1098,30,Bolivia,BO,BOL,11513102,America,876,27487,83
2020-04-01T00:00:00Z,1,4,2020,60,4,Bosnia_and_Herzegovina,BA,BIH,3300998,Europe,12,413,1
2020-04-02T00:00:00Z,2,4,2020,51,1,Bosnia_and_Herzegovina,BA,BIH,3300998,Europe,13,464,2
2020-04-03T00:00:00Z,3,4,2020,68,4,Bosnia_and_Herzegovina,BA,BIH,3300998,Europe,17,532,3
2020-04-04T00:00:00Z,4,4,2020,54,1,Bosnia_and_Herzegovina,BA,BIH,3300998,Europe,18,586,4
2020-04-05T00:00:00Z,5,4,2020,46,3,Bosnia_and_Herzegovina,BA,BIH,3300998,Europe,21,632,5
2020-04-06T00:00:00Z,6,4,2020,31,3,Bosnia_and_Herzegovina,BA,BIH,3300998,Europe,24,663,6
2020-04-07T00:00:00Z,7,4,2020,32,4,Bosnia_and_Herzegovina,BA,BIH,3300998,Europe,28,695,7
2020-04-08T00:00:00Z,8,4,2020,86,4,Bosnia_and_Herzegovina,BA,BIH,3300998,Europe,32,781,8
2020-04-09T00:00:00Z,9,4,2020,35,3,Bosnia_and_Herzegovina,BA,BIH,3300998,Europe,35,816,9
2020-04-10T00:00:00Z,10,4,2020,59,1,Bosnia_and_Herzegovina,BA,BIH,3300998,Europe,36,875,10
2020-04-11T00:00:00Z,11,4,2020,26,1,Bosnia_and_Herzegovina,BA,BIH,3300998,Europe,37,901,11
2020-04-12T00:00:00Z,12,4,2020,47,0,Bosnia_and_Herzegovina,BA,BIH,3300998,Europe,37,948,12
2020-04-13T00:00:00Z,13,4,2020,59,1,Bosnia_and_Herzegovina,BA,BIH,3300998,Europe,38,1007,13
2020-04-14T00:00:00Z,14,4,2020,21,0,Bosnia_and_Herzegovina,BA,BIH,3300998,Europe,38,1028,14
2020-04-15T00:00:00Z,15,4,2020,45,1,Bosnia_and_Herzegovina,BA,BIH,3300998,Europe,39,1073,15
2020-04-16T00:00:00Z,16,4,2020,27,1,Bosnia_and_Herzegovina,BA,BIH,3300998,Europe,40,1100,16
2020-04-17T00:00:00Z,17,4,2020,52,1,Bosnia_and_Herzegovina,BA,BIH,3300998,Europe,41,1152,17
2020-04-18T00:00:00Z,18,4,2020,58,3,Bosnia_and_Herzegovina,BA,BIH,3300998,Europe,44,1210,18
2020-04-19T00:00:00Z,19,4,2020,44,1,Bosnia_and_Herzegovina,BA,BIH,3300998,Europe,45,1254,19
2020-04-20T00:00:00Z,20,4,2020,15,1,Bosnia_and_Herzegovina,BA,BIH,3300998,Europe,46,1269,20
2020-04-21T00:00:00Z,21,4,2020,31,2,Bosnia_and_Herzegovina,BA,BIH,3300998,Europe,48,1300,21
2020-04-22T00:00:00Z,22,4,2020,40,2,Bosnia_and_Herzegovina,BA,BIH,3300998,Europe,50,1340,22
2020-04-23T00:00:00Z,23,4,2020,27,2,Bosnia_and_Herzegovina,BA,BIH,3300998,Europe,52,1367,23
2020-04-24T00:00:00Z,24,4,2020,46,1,Bosnia_and_Herzegovina,BA,BIH,3300998,Europe,53,1413,24
2020-04-25T00:00:00Z,25,4,2020,7,1,Bosnia_and_Herzegovina,BA,BIH,3300998,Europe,54,1420,25
2020-04-26T00:00:00Z,26,4,2020,65,2,Bosnia_and_Herzegovina,BA,BIH,3300998,Europe,56,1485,26
2020-04-27T00:00:00Z,27,4,2020,31,2,Bosnia_and_Herzegovina,BA,BIH,3300998,Europe,58,1516,27
2020-04-28T00:00:00Z,28,4,2020,48,2,Bosnia_and_Herzegovina,BA,BIH,3300998,Europe,60,1564,28
2020-04-29T00:00:00Z,29,4,2020,24,2,Bosnia_and_Herzegovina,BA,BIH,3300998,Europe,62,1588,29
2020-04-30T00:00:00Z,30,4,2020,0,0,Bosnia_and_Herzegovina,BA,BIH,3300998,Europe,62,1588,30
2020-05-01T00:00:00Z,1,5,2020,101,2,Bosnia_and_Herzegovina,BA,BIH,3300998,Europe,64,1689,31
2020-05-02T00:00:00Z,2,5,2020,92,6,Bosnia_and_Herzegovina,BA,BIH,3300998,Europe,70,1781,32
2020-05-03T00:00:00Z,3,5,2020,58,2,Bosnia_and_Herzegovina,BA,BIH,3300998,Europe,72,1839,33
2020-05-04T00:00:00Z,4,5,2020,18,5,Bosnia_and_Herzegovina,BA,BIH,3300998,Europe,77,1857,34
2020-05-05T00:00:00Z,5,5,2020,69,1,Bosnia_and_Herzegovina,BA,BIH,3300998,Europe,78,1926,35
2020-05-06T00:00:00Z,6,5,2020,20,1,Bosnia_and_Herzegovina,BA,BIH,3300998,Europe,79,1946,36
2020-05-07T00:00:00Z,7,5,2020,41,7,Bosnia_and_Herzegovina,BA,BIH,3300998,Europe,86,1987,37
2020-05-08T00:00:00Z,8,5,2020,40,4,Bosnia_and_Herzegovina,BA,BIH,3300998,Europe,90,2027,38
2020-05-09T00:00:00Z,9,5,2020,43,8,Bosnia_and_Herzegovina,BA,BIH,3300998,Europe,98,2070,39
2020-05-10T00:00:00Z,10,5,2020,0,0,Bosnia_and_Herzegovina,BA,BIH,3300998,Europe,98,2070,40
2020-05-11T00:00:00Z,11,5,2020,20,4,Bosnia_and_Herzegovina,BA,BIH,3300998,Europe,102,2090,41
2020-05-12T00:00:00Z,12,5,2020,52,10,Bosnia_and_Herzegovina,BA,BIH,3300998,Europe,112,2142,42
2020-05-13T00:00:00Z,13,5,2020,16,5,Bosnia_and_Herzegovina,BA,BIH,3300998,Europe,117,2158,43
2020-05-14T00:00:00Z,14,5,2020,23,3,Bosnia_and_Herzegovina,BA,BIH,3300998,Europe,120,2181,44
2020-05-15T00:00:00Z,15,5,2020,35,3,Bosnia_and_Herzegovina,BA,BIH,3300998,Europe,123,2216,45
2020-05-16T00:00:00Z,16,5,2020,21,4,Bosnia_and_Herzegovina,BA,BIH,3300998,Europe,127,2237,46
2020-05-17T00:00:00Z,17,5,2020,30,2,Bosnia_and_Herzegovina,BA,BIH,3300998,Europe,129,2267,47
2020-05-18T00:00:00Z,18,5,2020,22,3,Bosnia_and_Herzegovina,BA,BIH,3300998,Europe,132,2289,48
2020-05-19T00:00:00Z,19,5,2020,14,0,Bosnia_and_Herzegovina,BA,BIH,3300998,Europe,132,2303,49
2020-05-20T00:00:00Z,20,5,2020,16,1,Bosnia_and_Herzegovina,BA,BIH,3300998,Europe,133,2319,50
2020-05-21T00:00:00Z,21,5,2020,15,2,Bosnia_and_Herzegovina,BA,BIH,3300998,Europe,135,2334,51
2020-05-22T00:00:00Z,22,5,2020,18,4,Bosnia_and_Herzegovina,BA,BIH,3300998,Europe,139,2352,52
2020-05-23T00:00:00Z,23,5,2020,20,2,Bosnia_and_Herzegovina,BA,BIH,3300998,Europe,141,2372,53
2020-05-24T00:00:00Z,24,5,2020,19,0,Bosnia_and_Herzegovina,BA,BIH,3300998,Europe,141,2391,54
2020-05-25T00:00:00Z,25,5,2020,10,3,Bosnia_and_Herzegovina,BA,BIH,3300998,Europe,144,2401,55
2020-05-26T00:00:00Z,26,5,2020,5,2,Bosnia_and_Herzegovina,BA,BIH,3300998,Europe,146,2406,56
2020-05-27T00:00:00Z,27,5,2020,10,3,Bosnia_and_Herzegovina,BA,BIH,3300998,Europe,149,2416,57
2020-05-28T00:00:00Z,28,5,2020,19,2,Bosnia_and_Herzegovina,BA,BIH,3300998,Europe,151,2435,58
2020-05-29T00:00:00Z,29,5,2020,27,2,Bosnia_and_Herzegovina,BA,BIH,3300998,Europe,153,2462,59
2020-05-30T00:00:00Z,30,5,2020,23,0,Bosnia_and_Herzegovina,BA,BIH,3300998,Europe,153,2485,60
2020-05-31T00:00:00Z,31,5,2020,9,0,Bosnia_and_Herzegovina,BA,BIH,3300998,Europe,153,2494,61
2020-06-01T00:00:00Z,1,6,2020,15,0,Bosnia_and_Herzegovina,BA,BIH,3300998,Europe,153,2509,62
2020-06-02T00:00:00Z,2,6,2020,14,0,Bosnia_and_Herzegovina,BA,BIH,3300998,Europe,153,2523,63
2020-06-03T00:00:00Z,3,6,2020,11,3,Bosnia_and_Herzegovina,BA,BIH,3300998,Europe,156,2534,64
2020-06-04T00:00:00Z,4,6,2020,16,0,Bosnia_and_Herzegovina,BA,BIH,3300998,Europe,156,2550,65
2020-06-05T00:00:00Z,5,6,2020,43,2,Bosnia_and_Herzegovina,BA,BIH,3300998,Europe,158,2593,66
2020-06-06T00:00:00Z,6,6,2020,12,0,Bosnia_and_Herzegovina,BA,BIH,3300998,Europe,158,2605,67
2020-06-07T00:00:00Z,7,6,2020,0,0,Bosnia_and_Herzegovina,BA,BIH,3300998,Europe,158,2605,68
2020-06-08T00:00:00Z,8,6,2020,0,0,Bosnia_and_Herzegovina,BA,BIH,3300998,Europe,158,2605,69
2020-06-09T00:00:00Z,9,6,2020,98,1,Bosnia_and_Herzegovina,BA,BIH,3300998,Europe,159,2703,70
2020-06-10T00:00:00Z,10,6,2020,24,0,Bosnia_and_Herzegovina,BA,BIH,3300998,Europe,159,2727,71
2020-06-11T00:00:00Z,11,6,2020,49,1,Bosnia_and_Herzegovina,BA,BIH,3300998,Europe,160,2776,72
2020-06-12T00:00:00Z,12,6,2020,55,0,Bosnia_and_Herzegovina,BA,BIH,3300998,Europe,160,2831,73
2020-06-13T00:00:00Z,13,6,2020,61,2,Bosnia_and_Herzegovina,BA,BIH,3300998,Europe,162,2892,74
2020-06-14T00:00:00Z,14,6,2020,48,1,Bosnia_and_Herzegovina,BA,BIH,3300998,Europe,163,2940,75
2020-06-15T00:00:00Z,15,6,2020,61,0,Bosnia_and_Herzegovina,BA,BIH,3300998,Europe,163,3001,76
2020-06-16T00:00:00Z,16,6,2020,38,1,Bosnia_and_Herzegovina,BA,BIH,3300998,Europe,164,3039,77
2020-06-17T00:00:00Z,17,6,2020,45,3,Bosnia_and_Herzegovina,BA,BIH,3300998,Europe,167,3084,78
2020-06-18T00:00:00Z,18,6,2020,60,0,Bosnia_and_Herzegovina,BA,BIH,3300998,Europe,167,3144,79
2020-06-19T00:00:00Z,19,6,2020,58,0,Bosnia_and_Herzegovina,BA,BIH,3300998,Europe,167,3202,80
2020-06-20T00:00:00Z,20,6,2020,86,1,Bosnia_and_Herzegovina,BA,BIH,3300998,Europe,168,3288,81
2020-06-21T00:00:00Z,21,6,2020,66,1,Bosnia_and_Herzegovina,BA,BIH,3300998,Europe,169,3354,82
2020-06-22T00:00:00Z,22,6,2020,0,0,Bosnia_and_Herzegovina,BA,BIH,3300998,Europe,169,3354,83
2020-06-23T00:00:00Z,23,6,2020,170,1,Bosnia_and_Herzegovina,BA,BIH,3300998,Europe,170,3524,84
2020-06-24T00:00:00Z,24,6,2020,63,1,Bosnia_and_Herzegovina,BA,BIH,3300998,Europe,171,3587,85
2020-06-25T00:00:00Z,25,6,2020,88,1,Bosnia_and_Herzegovina,BA,BIH,3300998,Europe,172,3675,86
2020-03-21T00:00:00Z,21,3,2020,283,5,Brazil,BR,BRA,211049519,America,11,904,1
2020-03-22T00:00:00Z,22,3,2020,224,7,Brazil,BR,BRA,211049519,America,18,1128,2
2020-03-23T00:00:00Z,23,3,2020,418,7,Brazil,BR,BRA,211049519,America,25,1546,3
2020-03-24T00:00:00Z,24,3,2020,345,9,Brazil,BR,BRA,211049519,America,34,1891,4
2020-03-25T00:00:00Z,25,3,2020,310,12,Brazil,BR,BRA,211049519,America,46,2201,5
2020-03-26T00:00:00Z,26,3,2020,232,11,Brazil,BR,BRA,211049519,America,57,2433,6
2020-03-27T00:00:00Z,27,3,2020,482,20,Brazil,BR,BRA,211049519,America,77,2915,7
2020-03-28T00:00:00Z,28,3,2020,502,15,Brazil,BR,BRA,211049519,America,92,3417,8
2020-03-29T00:00:00Z,29,3,2020,487,22,Brazil,BR,BRA,211049519,America,114,3904,9
2020-03-30T00:00:00Z,30,3,2020,352,22,Brazil,BR,BRA,211049519,America,136,4256,10
2020-03-31T00:00:00Z,31,3,2020,323,23,Brazil,BR,BRA,211049519,America,159,4579,11
2020-04-01T00:00:00Z,1,4,2020,1138,42,Brazil,BR,BRA,211049519,America,201,5717,12
2020-04-02T00:00:00Z,2,4,2020,1119,40,Brazil,BR,BRA,211049519,America,241,6836,13
2020-04-03T00:00:00Z,3,4,2020,1074,58,Brazil,BR,BRA,211049519,America,299,7910,14
2020-04-04T00:00:00Z,4,4,2020,1146,60,Brazil,BR,BRA,211049519,America,359,9056,15
2020-04-05T00:00:00Z,5,4,2020,1222,73,Brazil,BR,BRA,211049519,America,432,10278,16
2020-04-06T00:00:00Z,6,4,2020,852,54,Brazil,BR,BRA,211049519,America,486,11130,17
2020-04-07T00:00:00Z,7,4,2020,926,67,Brazil,BR,BRA,211049519,America,553,12056,18
2020-04-08T00:00:00Z,8,4,2020,1661,114,Brazil,BR,BRA,211049519,America,667,13717,19
2020-04-09T00:00:00Z,9,4,2020,2210,133,Brazil,BR,BRA,211049519,America,800,15927,20
2020-04-10T00:00:00Z,10,4,2020,1930,141,Brazil,BR,BRA,211049519,America,941,17857,21
2020-04-11T00:00:00Z,11,4,2020,1781,115,Brazil,BR,BRA,211049519,America,1056,19638,22
2020-04-12T00:00:00Z,12,4,2020,1089,68,Brazil,BR,BRA,211049519,America,1124,20727,23
2020-04-13T00:00:00Z,13,4,2020,1442,99,Brazil,BR,BRA,211049519,America,1223,22169,24
2020-04-14T00:00:00Z,14,4,2020,1261,105,Brazil,BR,BRA,211049519,America,1328,23430,25
2020-04-15T00:00:00Z,15,4,2020,1832,204,Brazil,BR,BRA,211049519,America,1532,25262,26
2020-04-16T00:00:00Z,16,4,2020,3058,204,Brazil,BR,BRA,211049519,America,1736,28320,27
2020-04-17T00:00:00Z,17,4,2020,2105,188,Brazil,BR,BRA,211049519,America,1924,30425,28
2020-04-18T00:00:00Z,18,4,2020,3257,217,Brazil,BR,BRA,211049519,America,2141,33682,29
2020-04-19T00:00:00Z,19,4,2020,2917,206,Brazil,BR,BRA,211049519,America,2347,36599,30
2020-04-20T00:00:00Z,20,4,2020,2055,115,Brazil,BR,BRA,211049519,America,2462,38654,31
2020-04-21T00:00:00Z,21,4,2020,1927,113,Brazil,BR,BRA,211049519,America,2575,40581,32
2020-04-22T00:00:00Z,22,4,2020,2498,166,Brazil,BR,BRA,211049519,America,2741,43079,33
2020-04-23T00:00:00Z,23,4,2020,2678,165,Brazil,BR,BRA,211049519,America,2906,45757,34
2020-04-24T00:00:00Z,24,4,2020,3735,407,Brazil,BR,BRA,211049519,America,3313,49492,35
2020-04-25T00:00:00Z,25,4,2020,3503,357,Brazil,BR,BRA,211049519,America,3670,52995,36
2020-04-26T00:00:00Z,26,4,2020,5514,346,Brazil,BR,BRA,211049519,America,4016,58509,37
2020-04-27T00:00:00Z,27,4,2020,3379,189,Brazil,BR,BRA,211049519,America,4205,61888,38
2020-04-28T00:00:00Z,28,4,2020,4613,338,Brazil,BR,BRA,211049519,America,4543,66501,39
2020-04-29T00:00:00Z,29,4,2020,5385,474,Brazil,BR,BRA,211049519,America,5017,71886,40
2020-04-30T00:00:00Z,30,4,2020,6276,449,Brazil,BR,BRA,211049519,America,5466,78162,41
2020-05-01T00:00:00Z,1,5,2020,7218,435,Brazil,BR,BRA,211049519,America,5901,85380,42
2020-05-02T00:00:00Z,2,5,2020,6209,428,Brazil,BR,BRA,211049519,America,6329,91589,43
2020-05-03T00:00:00Z,3,5,2020,4970,421,Brazil,BR,BRA,211049519,America,6750,96559,44
2020-05-04T00:00:00Z,4,5,2020,4588,275,Brazil,BR,BRA,211049519,America,7025,101147,45
2020-05-05T00:00:00Z,5,5,2020,6633,296,Brazil,BR,BRA,211049519,America,7321,107780,46
2020-05-06T00:00:00Z,6,5,2020,6935,600,Brazil,BR,BRA,211049519,America,7921,114715,47
2020-05-07T00:00:00Z,7,5,2020,10503,615,Brazil,BR,BRA,211049519,America,8536,125218,48
2020-05-08T00:00:00Z,8,5,2020,9888,610,Brazil,BR,BRA,211049519,America,9146,135106,49
2020-05-09T00:00:00Z,9,5,2020,10222,751,Brazil,BR,BRA,211049519,America,9897,145328,50
2020-05-10T00:00:00Z,10,5,2020,10611,730,Brazil,BR,BRA,211049519,America,10627,155939,51
2020-05-11T00:00:00Z,11,5,2020,6760,496,Brazil,BR,BRA,211049519,America,11123,162699,52
2020-05-12T00:00:00Z,12,5,2020,5632,396,Brazil,BR,BRA,211049519,America,11519,168331,53
2020-05-13T00:00:00Z,13,5,2020,9258,881,Brazil,BR,BRA,211049519,America,12400,177589,54
2020-05-14T00:00:00Z,14,5,2020,11385,749,Brazil,BR,BRA,211049519,America,13149,188974,55
2020-05-15T00:00:00Z,15,5,2020,13944,844,Brazil,BR,BRA,211049519,America,13993,202918,56
2020-05-16T00:00:00Z,16,5,2020,15305,824,Brazil,BR,BRA,211049519,America,14817,218223,57
2020-05-17T00:00:00Z,17,5,2020,14919,816,Brazil,BR,BRA,211049519,America,15633,233142,58
2020-05-18T00:00:00Z,18,5,2020,7938,485,Brazil,BR,BRA,211049519,America,16118,241080,59
2020-05-19T00:00:00Z,19,5,2020,13140,674,Brazil,BR,BRA,211049519,America,16792,254220,60
2020-05-20T00:00:00Z,20,5,2020,17408,1179,Brazil,BR,BRA,211049519,America,17971,271628,61
2020-05-21T00:00:00Z,21,5,2020,19951,888,Brazil,BR,BRA,211049519,America,18859,291579,62
2020-05-22T00:00:00Z,22,5,2020,18508,1188,Brazil,BR,BRA,211049519,America,20047,310087,63
2020-05-23T00:00:00Z,23,5,2020,20803,1001,Brazil,BR,BRA,211049519,America,21048,330890,64
2020-05-24T00:00:00Z,24,5,2020,16508,965,Brazil,BR,BRA,211049519,America,22013,347398,65
2020-05-25T00:00:00Z,25,5,2020,15813,653,Brazil,BR,BRA,211049519,America,22666,363211,66
2020-05-26T00:00:00Z,26,5,2020,11687,807,Brazil,BR,BRA,211049519,America,23473,374898,67
2020-05-27T00:00:00Z,27,5,2020,16324,1039,Brazil,BR,BRA,211049519,America,24512,391222,68
2020-05-28T00:00:00Z,28,5,2020,20599,1086,Brazil,BR,BRA,211049519,America,25598,411821,69
2020-05-29T00:00:00Z,29,5,2020,26417,1156,Brazil,BR,BRA,211049519,America,26754,438238,70
2020-05-30T00:00:00Z,30,5,2020,26928,1124,Brazil,BR,BRA,211049519,America,27878,465166,71
2020-05-31T00:00:00Z,31,5,2020,33274,956,Brazil,BR,BRA,211049519,America,28834,498440,72
2020-06-01T00:00:00Z,1,6,2020,16409,480,Brazil,BR,BRA,211049519,America,29314,514849,73
2020-06-02T00:00:00Z,2,6,2020,11598,623,Brazil,BR,BRA,211049519,America,29937,526447,74
2020-06-03T00:00:00Z,3,6,2020,28936,1262,Brazil,BR,BRA,211049519,America,31199,555383,75
2020-06-04T00:00:00Z,4,6,2020,28633,1349,Brazil,BR,BRA,211049519,America,32548,584016,76
2020-06-05T00:00:00Z,5,6,2020,30916,1473,Brazil,BR,BRA,211049519,America,34021,614932,77
2020-06-06T00:00:00Z,6,6,2020,30830,1005,Brazil,BR,BRA,211049519,America,35026,645762,78
2020-06-07T00:00:00Z,7,6,2020,27075,904,Brazil,BR,BRA,211049519,America,35930,672837,79
2020-06-08T00:00:00Z,8,6,2020,18921,525,Brazil,BR,BRA,211049519,America,36455,691758,80
2020-06-09T00:00:00Z,9,6,2020,15654,679,Brazil,BR,BRA,211049519,America,37134,707412,81
2020-06-10T00:00:00Z,10,6,2020,32091,1272,Brazil,BR,BRA,211049519,America,38406,739503,82
2020-06-11T00:00:00Z,11,6,2020,32913,1274,Brazil,BR,BRA,211049519,America,39680,772416,83
2020-06-12T00:00:00Z,12,6,2020,30412,1239,Brazil,BR,BRA,211049519,America,40919,802828,84
2020-06-13T00:00:00Z,13,6,2020,25982,909,Brazil,BR,BRA,211049519,America,41828,828810,85
2020-06-14T00:00:00Z,14,6,2020,21704,892,Brazil,BR,BRA,211049519,America,42720,850514,86
2020-06-15T00:00:00Z,15,6,2020,17110,612,Brazil,BR,BRA,211049519,America,43332,867624,87
2020-06-16T00:00:00Z,16,6,2020,20647,627,Brazil,BR,BRA,211049519,America,43959,888271,88
2020-06-17T00:00:00Z,17,6,2020,34918,1282,Brazil,BR,BRA,211049519,America,45241,923189,89
2020-06-18T00:00:00Z,18,6,2020,32188,1269,Brazil,BR,BRA,211049519,America,46510,955377,90
2020-06-19T00:00:00Z,19,6,2020,22765,1238,Brazil,BR,BRA,211049519,America,47748,978142,91
2020-06-20T00:00:00Z,20,6,2020,54771,1206,Brazil,BR,BRA,211049519,America,48954,1032913,92
2020-06-21T00:00:00Z,21,6,2020,34666,1022,Brazil,BR,BRA,211049519,America,49976,1067579,93
2020-06-22T00:00:00Z,22,6,2020,17459,641,Brazil,BR,BRA,211049519,America,50617,1085038,94
2020-06-23T00:00:00Z,23,6,2020,21432,654,Brazil,BR,BRA,211049519,America,51271,1106470,95
2020-06-24T00:00:00Z,24,6,2020,39436,1374,Brazil,BR,BRA,211049519,America,52645,1145906,96
2020-06-25T00:00:00Z,25,6,2020,42725,1185,Brazil,BR,BRA,211049519,America,53830,1188631,97
2020-04-02T00:00:00Z,2,4,2020,23,2,Bulgaria,BG,BGR,7000039,Europe,10,422,1
2020-04-03T00:00:00Z,3,4,2020,35,0,Bulgaria,BG,BGR,7000039,Europe,10,457,2
2020-04-04T00:00:00Z,4,4,2020,28,4,Bulgaria,BG,BGR,7000039,Europe,14,485,3
2020-04-05T00:00:00Z,5,4,2020,18,3,Bulgaria,BG,BGR,7000039,Europe,17,503,4
2020-04-06T00:00:00Z,6,4,2020,28,3,Bulgaria,BG,BGR,7000039,Europe,20,531,5
2020-04-07T00:00:00Z,7,4,2020,18,2,Bulgaria,BG,BGR,7000039,Europe,22,549,6
2020-04-08T00:00:00Z,8,4,2020,28,1,Bulgaria,BG,BGR,7000039,Europe,23,577,7
2020-04-09T00:00:00Z,9,4,2020,16,1,Bulgaria,BG,BGR,7000039,Europe,24,593,8
2020-04-10T00:00:00Z,10,4,2020,31,0,Bulgaria,BG,BGR,7000039,Europe,24,624,9
2020-04-11T00:00:00Z,11,4,2020,11,1,Bulgaria,BG,BGR,7000039,Europe,25,635,10
2020-04-12T00:00:00Z,12,4,2020,26,3,Bulgaria,BG,BGR,7000039,Europe,28,661,11
2020-04-13T00:00:00Z,13,4,2020,14,1,Bulgaria,BG,BGR,7000039,Europe,29,675,12
2020-04-14T00:00:00Z,14,4,2020,10,3,Bulgaria,BG,BGR,7000039,Europe,32,685,13
2020-04-15T00:00:00Z,15,4,2020,28,3,Bulgaria,BG,BGR,7000039,Europe,35,713,14
2020-04-16T00:00:00Z,16,4,2020,34,1,Bulgaria,BG,BGR,7000039,Europe,36,747,15
2020-04-17T00:00:00Z,17,4,2020,53,2,Bulgaria,BG,BGR,7000039,Europe,38,800,16
2020-04-18T00:00:00Z,18,4,2020,46,3,Bulgaria,BG,BGR,7000039,Europe,41,846,17
2020-04-19T00:00:00Z,19,4,2020,32,0,Bulgaria,BG,BGR,7000039,Europe,41,878,18
2020-04-20T00:00:00Z,20,4,2020,37,2,Bulgaria,BG,BGR,7000039,Europe,43,915,19
2020-04-21T00:00:00Z,21,4,2020,14,0,Bulgaria,BG,BGR,7000039,Europe,43,929,20
2020-04-22T00:00:00Z,22,4,2020,46,2,Bulgaria,BG,BGR,7000039,Europe,45,975,21
2020-04-23T00:00:00Z,23,4,2020,49,4,Bulgaria,BG,BGR,7000039,Europe,49,1024,22
2020-04-24T00:00:00Z,24,4,2020,73,3,Bulgaria,BG,BGR,7000039,Europe,52,1097,23
2020-04-25T00:00:00Z,25,4,2020,91,2,Bulgaria,BG,BGR,7000039,Europe,54,1188,24
2020-04-26T00:00:00Z,26,4,2020,59,1,Bulgaria,BG,BGR,7000039,Europe,55,1247,25
2020-04-27T00:00:00Z,27,4,2020,53,1,Bulgaria,BG,BGR,7000039,Europe,56,1300,26
2020-04-28T00:00:00Z,28,4,2020,63,2,Bulgaria,BG,BGR,7000039,Europe,58,1363,27
2020-04-29T00:00:00Z,29,4,2020,36,0,Bulgaria,BG,BGR,7000039,Europe,58,1399,28
2020-04-30T00:00:00Z,30,4,2020,48,6,Bulgaria,BG,BGR,7000039,Europe,64,1447,29
2020-05-01T00:00:00Z,1,5,2020,59,2,Bulgaria,BG,BGR,7000039,Europe,66,1506,30
2020-05-02T00:00:00Z,2,5,2020,82,3,Bulgaria,BG,BGR,7000039,Europe,69,1588,31
2020-05-03T00:00:00Z,3,5,2020,6,3,Bulgaria,BG,BGR,7000039,Europe,72,1594,32
2020-05-04T00:00:00Z,4,5,2020,24,1,Bulgaria,BG,BGR,7000039,Europe,73,1618,33
2020-05-05T00:00:00Z,5,5,2020,34,5,Bulgaria,BG,BGR,7000039,Europe,78,1652,34
2020-05-06T00:00:00Z,6,5,2020,37,0,Bulgaria,BG,BGR,7000039,Europe,78,1689,35
2020-05-07T00:00:00Z,7,5,2020,89,6,Bulgaria,BG,BGR,7000039,Europe,84,1778,36
2020-05-08T00:00:00Z,8,5,2020,51,0,Bulgaria,BG,BGR,7000039,Europe,84,1829,37
2020-05-09T00:00:00Z,9,5,2020,82,4,Bulgaria,BG,BGR,7000039,Europe,88,1911,38
2020-05-10T00:00:00Z,10,5,2020,44,2,Bulgaria,BG,BGR,7000039,Europe,90,1955,39
2020-05-11T00:00:00Z,11,5,2020,10,1,Bulgaria,BG,BGR,7000039,Europe,91,1965,40
2020-05-12T00:00:00Z,12,5,2020,25,2,Bulgaria,BG,BGR,7000039,Europe,93,1990,41
2020-05-13T00:00:00Z,13,5,2020,33,2,Bulgaria,BG,BGR,7000039,Europe,95,2023,42
2020-05-14T00:00:00Z,14,5,2020,46,1,Bulgaria,BG,BGR,7000039,Europe,96,2069,43
2020-05-15T00:00:00Z,15,5,2020,31,3,Bulgaria,BG,BGR,7000039,Europe,99,2100,44
2020-05-16T00:00:00Z,16,5,2020,38,3,Bulgaria,BG,BGR,7000039,Europe,102,2138,45
2020-05-17T00:00:00Z,17,5,2020,73,6,Bulgaria,BG,BGR,7000039,Europe,108,2211,46
2020-05-18T00:00:00Z,18,5,2020,24,2,Bulgaria,BG,BGR,7000039,Europe,110,2235,47
2020-05-19T00:00:00Z,19,5,2020,24,2,Bulgaria,BG,BGR,7000039,Europe,112,2259,48
2020-05-20T00:00:00Z,20,5,2020,33,4,Bulgaria,BG,BGR,7000039,Europe,116,2292,49
2020-05-21T00:00:00Z,21,5,2020,39,4,Bulgaria,BG,BGR,7000039,Europe,120,2331,50
2020-05-22T00:00:00Z,22,5,2020,41,5,Bulgaria,BG,BGR,7000039,Europe,125,2372,51
2020-05-23T00:00:00Z,23,5,2020,36,1,Bulgaria,BG,BGR,7000039,Europe,126,2408,52
2020-05-24T00:00:00Z,24,5,2020,0,0,Bulgaria,BG,BGR,7000039,Europe,126,2408,53
2020-05-25T00:00:00Z,25,5,2020,25,4,Bulgaria,BG,BGR,7000039,Europe,130,2433,54
2020-05-26T00:00:00Z,26,5,2020,0,0,Bulgaria,BG,BGR,7000039,Europe,130,2433,55
2020-05-27T00:00:00Z,27,5,2020,27,3,Bulgaria,BG,BGR,7000039,Europe,133,2460,56
2020-05-28T00:00:00Z,28,5,2020,0,0,Bulgaria,BG,BGR,7000039,Europe,133,2460,57
2020-05-29T00:00:00Z,29,5,2020,25,3,Bulgaria,BG,BGR,7000039,Europe,136,2485,58
2020-05-30T00:00:00Z,30,5,2020,14,3,Bulgaria,BG,BGR,7000039,Europe,139,2499,59
2020-05-31T00:00:00Z,31,5,2020,14,1,Bulgaria,BG,BGR,7000039,Europe,140,2513,60
2020-06-01T00:00:00Z,1,6,2020,0,0,Bulgaria,BG,BGR,7000039,Europe,140,2513,61
2020-06-02T00:00:00Z,2,6,2020,0,4,Bulgaria,BG,BGR,7000039,Europe,144,2513,62
2020-06-03T00:00:00Z,3,6,2020,25,0,Bulgaria,BG,BGR,7000039,Europe,144,2538,63
2020-06-04T00:00:00Z,4,6,2020,47,3,Bulgaria,BG,BGR,7000039,Europe,147,2585,64
2020-06-05T00:00:00Z,5,6,2020,0,0,Bulgaria,BG,BGR,7000039,Europe,147,2585,65
2020-06-06T00:00:00Z,6,6,2020,83,13,Bulgaria,BG,BGR,7000039,Europe,160,2668,66
2020-06-07T00:00:00Z,7,6,2020,43,0,Bulgaria,BG,BGR,7000039,Europe,160,2711,67
2020-06-08T00:00:00Z,8,6,2020,16,0,Bulgaria,BG,BGR,7000039,Europe,160,2727,68
2020-06-09T00:00:00Z,9,6,2020,83,4,Bulgaria,BG,BGR,7000039,Europe,164,2810,69
2020-06-10T00:00:00Z,10,6,2020,79,3,Bulgaria,BG,BGR,7000039,Europe,167,2889,70
2020-06-11T00:00:00Z,11,6,2020,0,0,Bulgaria,BG,BGR,7000039,Europe,167,2889,71
2020-06-12T00:00:00Z,12,6,2020,197,1,Bulgaria,BG,BGR,7000039,Europe,168,3086,72
2020-06-13T00:00:00Z,13,6,2020,105,4,Bulgaria,BG,BGR,7000039,Europe,172,3191,73
2020-06-14T00:00:00Z,14,6,2020,75,0,Bulgaria,BG,BGR,7000039,Europe,172,3266,74
2020-06-15T00:00:00Z,15,6,2020,24,2,Bulgaria,BG,BGR,7000039,Europe,174,3290,75
2020-06-16T00:00:00Z,16,6,2020,51,2,Bulgaria,BG,BGR,7000039,Europe,176,3341,76
2020-06-17T00:00:00Z,17,6,2020,112,5,Bulgaria,BG,BGR,7000039,Europe,181,3453,77
2020-06-18T00:00:00Z,18,6,2020,89,3,Bulgaria,BG,BGR,7000039,Europe,184,3542,78
2020-06-19T00:00:00Z,19,6,2020,132,6,Bulgaria,BG,BGR,7000039,Europe,190,3674,79
2020-06-20T00:00:00Z,20,6,2020,81,3,Bulgaria,BG,BGR,7000039,Europe,193,3755,80
2020-06-21T00:00:00Z,21,6,2020,117,6,Bulgaria,BG,BGR,7000039,Europe,199,3872,81
2020-06-22T00:00:00Z,22,6,2020,33,0,Bulgaria,BG,BGR,7000039,Europe,199,3905,82
2020-06-23T00:00:00Z,23,6,2020,79,8,Bulgaria,BG,BGR,7000039,Europe,207,3984,83
2020-06-24T00:00:00Z,24,6,2020,130,1,Bulgaria,BG,BGR,7000039,Europe,208,4114,84
2020-06-25T00:00:00Z,25,6,2020,128,1,Bulgaria,BG,BGR,7000039,Europe,209,4242,85
2020-03-31T00:00:00Z,31,3,2020,42,3,Burkina_Faso,BF,BFA,20321383,Africa,12,222,1
2020-04-01T00:00:00Z,1,4,2020,24,0,Burkina_Faso,BF,BFA,20321383,Africa,12,246,2
2020-04-02T00:00:00Z,2,4,2020,15,2,Burkina_Faso,BF,BFA,20321383,Africa,14,261,3
2020-04-03T00:00:00Z,3,4,2020,27,2,Burkina_Faso,BF,BFA,20321383,Africa,16,288,4
2020-04-04T00:00:00Z,4,4,2020,0,0,Burkina_Faso,BF,BFA,20321383,Africa,16,288,5
2020-04-05T00:00:00Z,5,4,2020,14,0,Burkina_Faso,BF,BFA,20321383,Africa,16,302,6
2020-04-06T00:00:00Z,6,4,2020,43,1,Burkina_Faso,BF,BFA,20321383,Africa,17,345,7
2020-04-07T00:00:00Z,7,4,2020,19,0,Burkina_Faso,BF,BFA,20321383,Africa,17,364,8
2020-04-08T00:00:00Z,8,4,2020,20,2,Burkina_Faso,BF,BFA,20321383,Africa,19,384,9
2020-04-09T00:00:00Z,9,4,2020,30,4,Burkina_Faso,BF,BFA,20321383,Africa,23,414,10
2020-04-10T00:00:00Z,10,4,2020,29,1,Burkina_Faso,BF,BFA,20321383,Africa,24,443,11
2020-04-11T00:00:00Z,11,4,2020,5,2,Burkina_Faso,BF,BFA,20321383,Africa,26,448,12
2020-04-12T00:00:00Z,12,4,2020,36,1,Burkina_Faso,BF,BFA,20321383,Africa,27,484,13
2020-04-13T00:00:00Z,13,4,2020,13,0,Burkina_Faso,BF,BFA,20321383,Africa,27,497,14
2020-04-14T00:00:00Z,14,4,2020,18,1,Burkina_Faso,BF,BFA,20321383,Africa,28,515,15
2020-04-15T00:00:00Z,15,4,2020,13,2,Burkina_Faso,BF,BFA,20321383,Africa,30,528,16
2020-04-16T00:00:00Z,16,4,2020,14,2,Burkina_Faso,BF,BFA,20321383,Africa,32,542,17
2020-04-17T00:00:00Z,17,4,2020,1,0,Burkina_Faso,BF,BFA,20321383,Africa,32,543,18
2020-04-18T00:00:00Z,18,4,2020,14,3,Burkina_Faso,BF,BFA,20321383,Africa,35,557,19
2020-04-19T00:00:00Z,19,4,2020,8,1,Burkina_Faso,BF,BFA,20321383,Africa,36,565,20
2020-04-20T00:00:00Z,20,4,2020,11,0,Burkina_Faso,BF,BFA,20321383,Africa,36,576,21
2020-04-21T00:00:00Z,21,4,2020,5,2,Burkina_Faso,BF,BFA,20321383,Africa,38,581,22
2020-04-22T00:00:00Z,22,4,2020,19,0,Burkina_Faso,BF,BFA,20321383,Africa,38,600,23
2020-04-23T00:00:00Z,23,4,2020,9,1,Burkina_Faso,BF,BFA,20321383,Africa,39,609,24
2020-04-24T00:00:00Z,24,4,2020,7,2,Burkina_Faso,BF,BFA,20321383,Africa,41,616,25
2020-04-25T00:00:00Z,25,4,2020,10,0,Burkina_Faso,BF,BFA,20321383,Africa,41,626,26
2020-04-26T00:00:00Z,26,4,2020,3,0,Burkina_Faso,BF,BFA,20321383,Africa,41,629,27
2020-04-27T00:00:00Z,27,4,2020,3,1,Burkina_Faso,BF,BFA,20321383,Africa,42,632,28
2020-04-28T00:00:00Z,28,4,2020,3,0,Burkina_Faso,BF,BFA,20321383,Africa,42,635,29
2020-04-29T00:00:00Z,29,4,2020,3,0,Burkina_Faso,BF,BFA,20321383,Africa,42,638,30
2020-04-30T00:00:00Z,30,4,2020,3,1,Burkina_Faso,BF,BFA,20321383,Africa,43,641,31
2020-05-01T00:00:00Z,1,5,2020,4,0,Burkina_Faso,BF,BFA,20321383,Africa,43,645,32
2020-05-02T00:00:00Z,2,5,2020,4,1,Burkina_Faso,BF,BFA,20321383,Africa,44,649,33
2020-05-03T00:00:00Z,3,5,2020,3,0,Burkina_Faso,BF,BFA,20321383,Africa,44,652,34
2020-05-04T00:00:00Z,4,5,2020,10,1,Burkina_Faso,BF,BFA,20321383,Africa,45,662,35
2020-05-05T00:00:00Z,5,5,2020,10,1,Burkina_Faso,BF,BFA,20321383,Africa,46,672,36
2020-05-06T00:00:00Z,6,5,2020,16,2,Burkina_Faso,BF,BFA,20321383,Africa,48,688,37
2020-05-07T00:00:00Z,7,5,2020,41,0,Burkina_Faso,BF,BFA,20321383,Africa,48,729,38
2020-05-08T00:00:00Z,8,5,2020,7,0,Burkina_Faso,BF,BFA,20321383,Africa,48,736,39
2020-05-09T00:00:00Z,9,5,2020,8,0,Burkina_Faso,BF,BFA,20321383,Africa,48,744,40
2020-05-10T00:00:00Z,10,5,2020,4,0,Burkina_Faso,BF,BFA,20321383,Africa,48,748,41
2020-05-11T00:00:00Z,11,5,2020,3,1,Burkina_Faso,BF,BFA,20321383,Africa,49,751,42
2020-05-12T00:00:00Z,12,5,2020,9,1,Burkina_Faso,BF,BFA,20321383,Africa,50,760,43
2020-05-13T00:00:00Z,13,5,2020,6,1,Burkina_Faso,BF,BFA,20321383,Africa,51,766,44
2020-05-14T00:00:00Z,14,5,2020,7,0,Burkina_Faso,BF,BFA,20321383,Africa,51,773,45
2020-05-15T00:00:00Z,15,5,2020,0,0,Burkina_Faso,BF,BFA,20321383,Africa,51,773,46
2020-05-16T00:00:00Z,16,5,2020,9,0,Burkina_Faso,BF,BFA,20321383,Africa,51,782,47
2020-05-17T00:00:00Z,17,5,2020,0,0,Burkina_Faso,BF,BFA,20321383,Africa,51,782,48
2020-05-18T00:00:00Z,18,5,2020,14,0,Burkina_Faso,BF,BFA,20321383,Africa,51,796,49
2020-05-19T00:00:00Z,19,5,2020,0,0,Burkina_Faso,BF,BFA,20321383,Africa,51,796,50
2020-05-20T00:00:00Z,20,5,2020,10,1,Burkina_Faso,BF,BFA,20321383,Africa,52,806,51
2020-05-21T00:00:00Z,21,5,2020,3,0,Burkina_Faso,BF,BFA,20321383,Africa,52,809,52
2020-05-22T00:00:00Z,22,5,2020,3,0,Burkina_Faso,BF,BFA,20321383,Africa,52,812,53
2020-05-23T00:00:00Z,23,5,2020,2,0,Burkina_Faso,BF,BFA,20321383,Africa,52,814,54
2020-05-24T00:00:00Z,24,5,2020,0,0,Burkina_Faso,BF,BFA,20321383,Africa,52,814,55
2020-05-25T00:00:00Z,25,5,2020,18,0,Burkina_Faso,BF,BFA,20321383,Africa,52,832,56
2020-05-26T00:00:00Z,26,5,2020,9,0,Burkina_Faso,BF,BFA,20321383,Africa,52,841,57
2020-05-27T00:00:00Z,27,5,2020,4,1,Burkina_Faso,BF,BFA,20321383,Africa,53,845,58
2020-05-28T00:00:00Z,28,5,2020,0,0,Burkina_Faso,BF,BFA,20321383,Africa,53,845,59
2020-05-29T00:00:00Z,29,5,2020,2,0,Burkina_Faso,BF,BFA,20321383,Africa,53,847,60
2020-05-30T00:00:00Z,30,5,2020,0,0,Burkina_Faso,BF,BFA,20321383,Africa,53,847,61
2020-05-31T00:00:00Z,31,5,2020,6,0,Burkina_Faso,BF,BFA,20321383,Africa,53,853,62
2020-06-01T00:00:00Z,1,6,2020,28,0,Burkina_Faso,BF,BFA,20321383,Africa,53,881,63
2020-06-02T00:00:00Z,2,6,2020,0,0,Burkina_Faso,BF,BFA,20321383,Africa,53,881,64
2020-06-03T00:00:00Z,3,6,2020,2,0,Burkina_Faso,BF,BFA,20321383,Africa,53,883,65
2020-06-04T00:00:00Z,4,6,2020,1,0,Burkina_Faso,BF,BFA,20321383,Africa,53,884,66
2020-06-05T00:00:00Z,5,6,2020,1,0,Burkina_Faso,BF,BFA,20321383,Africa,53,885,67
2020-06-06T00:00:00Z,6,6,2020,3,0,Burkina_Faso,BF,BFA,20321383,Africa,53,888,68
2020-06-07T00:00:00Z,7,6,2020,0,0,Burkina_Faso,BF,BFA,20321383,Africa,53,888,69
2020-06-08T00:00:00Z,8,6,2020,1,0,Burkina_Faso,BF,BFA,20321383,Africa,53,889,70
2020-06-09T00:00:00Z,9,6,2020,1,0,Burkina_Faso,BF,BFA,20321383,Africa,53,890,71
2020-06-10T00:00:00Z,10,6,2020,1,0,Burkina_Faso,BF,BFA,20321383,Africa,53,891,72
2020-06-11T00:00:00Z,11,6,2020,0,0,Burkina_Faso,BF,BFA,20321383,Africa,53,891,73
2020-06-12T00:00:00Z,12,6,2020,1,0,Burkina_Faso,BF,BFA,20321383,Africa,53,892,74
2020-06-13T00:00:00Z,13,6,2020,0,0,Burkina_Faso,BF,BFA,20321383,Africa,53,892,75
2020-06-14T00:00:00Z,14,6,2020,2,0,Burkina_Faso,BF,BFA,20321383,Africa,53,894,76
2020-06-15T00:00:00Z,15,6,2020,0,0,Burkina_Faso,BF,BFA,20321383,Africa,53,894,77
2020-06-16T00:00:00Z,16,6,2020,0,0,Burkina_Faso,BF,BFA,20321383,Africa,53,894,78
2020-06-17T00:00:00Z,17,6,2020,1,0,Burkina_Faso,BF,BFA,20321383,Africa,53,895,79
2020-06-18T00:00:00Z,18,6,2020,4,0,Burkina_Faso,BF,BFA,20321383,Africa,53,899,80
2020-06-19T00:00:00Z,19,6,2020,0,0,Burkina_Faso,BF,BFA,20321383,Africa,53,899,81
2020-06-20T00:00:00Z,20,6,2020,1,0,Burkina_Faso,BF,BFA,20321383,Africa,53,900,82
2020-06-21T00:00:00Z,21,6,2020,2,0,Burkina_Faso,BF,BFA,20321383,Africa,53,902,83
2020-06-22T00:00:00Z,22,6,2020,1,0,Burkina_Faso,BF,BFA,20321383,Africa,53,903,84
2020-06-23T00:00:00Z,23,6,2020,4,0,Burkina_Faso,BF,BFA,20321383,Africa,53,907,85
2020-06-24T00:00:00Z,24,6,2020,12,0,Burkina_Faso,BF,BFA,20321383,Africa,53,919,86
2020-06-25T00:00:00Z,25,6,2020,15,0,Burkina_Faso,BF,BFA,20321383,Africa,53,934,87
2020-04-09T00:00:00Z,9,4,2020,45,1,Cameroon,CM,CMR,25876387,Africa,10,730,1
2020-04-10T00:00:00Z,10,4,2020,0,0,Cameroon,CM,CMR,25876387,Africa,10,730,2
2020-04-11T00:00:00Z,11,4,2020,73,0,Cameroon,CM,CMR,25876387,Africa,10,803,3
2020-04-12T00:00:00Z,12,4,2020,17,1,Cameroon,CM,CMR,25876387,Africa,11,820,4
2020-04-13T00:00:00Z,13,4,2020,0,1,Cameroon,CM,CMR,25876387,Africa,12,820,5
2020-04-14T00:00:00Z,14,4,2020,0,0,Cameroon,CM,CMR,25876387,Africa,12,820,6
2020-04-15T00:00:00Z,15,4,2020,35,5,Cameroon,CM,CMR,25876387,Africa,17,855,7
2020-04-16T00:00:00Z,16,4,2020,0,0,Cameroon,CM,CMR,25876387,Africa,17,855,8
2020-04-17T00:00:00Z,17,4,2020,0,4,Cameroon,CM,CMR,25876387,Africa,21,855,9
2020-04-18T00:00:00Z,18,4,2020,161,0,Cameroon,CM,CMR,25876387,Africa,21,1016,10
2020-04-19T00:00:00Z,19,4,2020,0,0,Cameroon,CM,CMR,25876387,Africa,21,1016,11
2020-04-20T00:00:00Z,20,4,2020,0,21,Cameroon,CM,CMR,25876387,Africa,42,1016,12
2020-04-21T00:00:00Z,21,4,2020,1,0,Cameroon,CM,CMR,25876387,Africa,42,1017,13
2020-04-22T00:00:00Z,22,4,2020,146,0,Cameroon,CM,CMR,25876387,Africa,42,1163,14
2020-04-23T00:00:00Z,23,4,2020,0,1,Cameroon,CM,CMR,25876387,Africa,43,1163,15
2020-04-24T00:00:00Z,24,4,2020,238,6,Cameroon,CM,CMR,25876387,Africa,49,1401,16
2020-04-25T00:00:00Z,25,4,2020,2,0,Cameroon,CM,CMR,25876387,Africa,49,1403,17
2020-04-26T00:00:00Z,26,4,2020,115,4,Cameroon,CM,CMR,25876387,Africa,53,1518,18
2020-04-27T00:00:00Z,27,4,2020,103,3,Cameroon,CM,CMR,25876387,Africa,56,1621,19
2020-04-28T00:00:00Z,28,4,2020,0,2,Cameroon,CM,CMR,25876387,Africa,58,1621,20
2020-04-29T00:00:00Z,29,4,2020,185,1,Cameroon,CM,CMR,25876387,Africa,59,1806,21
2020-04-30T00:00:00Z,30,4,2020,26,2,Cameroon,CM,CMR,25876387,Africa,61,1832,22
2020-05-01T00:00:00Z,1,5,2020,0,0,Cameroon,CM,CMR,25876387,Africa,61,1832,23
2020-05-02T00:00:00Z,2,5,2020,237,0,Cameroon,CM,CMR,25876387,Africa,61,2069,24
2020-05-03T00:00:00Z,3,5,2020,8,3,Cameroon,CM,CMR,25876387,Africa,64,2077,25
2020-05-04T00:00:00Z,4,5,2020,0,0,Cameroon,CM,CMR,25876387,Africa,64,2077,26
2020-05-05T00:00:00Z,5,5,2020,27,0,Cameroon,CM,CMR,25876387,Africa,64,2104,27
2020-05-06T00:00:00Z,6,5,2020,0,0,Cameroon,CM,CMR,25876387,Africa,64,2104,28
2020-05-07T00:00:00Z,7,5,2020,161,44,Cameroon,CM,CMR,25876387,Africa,108,2265,29
2020-05-08T00:00:00Z,8,5,2020,0,0,Cameroon,CM,CMR,25876387,Africa,108,2265,30
2020-05-09T00:00:00Z,9,5,2020,0,0,Cameroon,CM,CMR,25876387,Africa,108,2265,31
2020-05-10T00:00:00Z,10,5,2020,9,0,Cameroon,CM,CMR,25876387,Africa,108,2274,32
2020-05-11T00:00:00Z,11,5,2020,305,6,Cameroon,CM,CMR,25876387,Africa,114,2579,33
2020-05-12T00:00:00Z,12,5,2020,110,11,Cameroon,CM,CMR,25876387,Africa,125,2689,34
2020-05-13T00:00:00Z,13,5,2020,0,0,Cameroon,CM,CMR,25876387,Africa,125,2689,35
2020-05-14T00:00:00Z,14,5,2020,111,11,Cameroon,CM,CMR,25876387,Africa,136,2800,36
2020-05-15T00:00:00Z,15,5,2020,154,3,Cameroon,CM,CMR,25876387,Africa,139,2954,37
2020-05-16T00:00:00Z,16,5,2020,151,1,Cameroon,CM,CMR,25876387,Africa,140,3105,38
2020-05-17T00:00:00Z,17,5,2020,187,0,Cameroon,CM,CMR,25876387,Africa,140,3292,39
2020-05-18T00:00:00Z,18,5,2020,0,0,Cameroon,CM,CMR,25876387,Africa,140,3292,40
2020-05-19T00:00:00Z,19,5,2020,0,0,Cameroon,CM,CMR,25876387,Africa,140,3292,41
2020-05-20T00:00:00Z,20,5,2020,237,0,Cameroon,CM,CMR,25876387,Africa,140,3529,42
2020-05-21T00:00:00Z,21,5,2020,204,6,Cameroon,CM,CMR,25876387,Africa,146,3733,43
2020-05-22T00:00:00Z,22,5,2020,555,10,Cameroon,CM,CMR,25876387,Africa,156,4288,44
2020-05-23T00:00:00Z,23,5,2020,112,3,Cameroon,CM,CMR,25876387,Africa,159,4400,45
2020-05-24T00:00:00Z,24,5,2020,197,0,Cameroon,CM,CMR,25876387,Africa,159,4597,46
2020-05-25T00:00:00Z,25,5,2020,293,6,Cameroon,CM,CMR,25876387,Africa,165,4890,47
2020-05-26T00:00:00Z,26,5,2020,154,6,Cameroon,CM,CMR,25876387,Africa,171,5044,48
2020-05-27T00:00:00Z,27,5,2020,312,4,Cameroon,CM,CMR,25876387,Africa,175,5356,49
2020-05-28T00:00:00Z,28,5,2020,0,2,Cameroon,CM,CMR,25876387,Africa,177,5356,50
2020-05-29T00:00:00Z,29,5,2020,0,0,Cameroon,CM,CMR,25876387,Africa,177,5356,51
2020-05-30T00:00:00Z,30,5,2020,80,0,Cameroon,CM,CMR,25876387,Africa,177,5436,52
2020-05-31T00:00:00Z,31,5,2020,468,14,Cameroon,CM,CMR,25876387,Africa,191,5904,53
2020-06-01T00:00:00Z,1,6,2020,0,0,Cameroon,CM,CMR,25876387,Africa,191,5904,54
2020-06-02T00:00:00Z,2,6,2020,493,8,Cameroon,CM,CMR,25876387,Africa,199,6397,55
2020-06-03T00:00:00Z,3,6,2020,188,1,Cameroon,CM,CMR,25876387,Africa,200,6585,56
2020-06-04T00:00:00Z,4,6,2020,167,0,Cameroon,CM,CMR,25876387,Africa,200,6752,57
2020-06-05T00:00:00Z,5,6,2020,37,3,Cameroon,CM,CMR,25876387,Africa,203,6789,58
2020-06-06T00:00:00Z,6,6,2020,810,0,Cameroon,CM,CMR,25876387,Africa,203,7599,59
2020-06-07T00:00:00Z,7,6,2020,0,0,Cameroon,CM,CMR,25876387,Africa,203,7599,60
2020-06-08T00:00:00Z,8,6,2020,309,0,Cameroon,CM,CMR,25876387,Africa,203,7908,61
2020-06-09T00:00:00Z,9,6,2020,404,5,Cameroon,CM,CMR,25876387,Africa,208,8312,62
2020-06-10T00:00:00Z,10,6,2020,369,0,Cameroon,CM,CMR,25876387,Africa,208,8681,63
2020-06-11T00:00:00Z,11,6,2020,248,6,Cameroon,CM,CMR,25876387,Africa,214,8929,64
2020-06-12T00:00:00Z,12,6,2020,0,0,Cameroon,CM,CMR,25876387,Africa,214,8929,65
2020-06-13T00:00:00Z,13,6,2020,267,59,Cameroon,CM,CMR,25876387,Africa,273,9196,66
2020-06-14T00:00:00Z,14,6,2020,376,2,Cameroon,CM,CMR,25876387,Africa,275,9572,67
2020-06-15T00:00:00Z,15,6,2020,292,1,Cameroon,CM,CMR,25876387,Africa,276,9864,68
2020-06-16T00:00:00Z,16,6,2020,0,0,Cameroon,CM,CMR,25876387,Africa,276,9864,69
2020-06-17T00:00:00Z,17,6,2020,0,0,Cameroon,CM,CMR,25876387,Africa,276,9864,70
2020-06-18T00:00:00Z,18,6,2020,0,0,Cameroon,CM,CMR,25876387,Africa,276,9864,71
2020-06-19T00:00:00Z,19,6,2020,774,6,Cameroon,CM,CMR,25876387,Africa,282,10638,72
2020-06-20T00:00:00Z,20,6,2020,643,18,Cameroon,CM,CMR,25876387,Africa,300,11281,73
2020-06-21T00:00:00Z,21,6,2020,0,0,Cameroon,CM,CMR,25876387,Africa,300,11281,74
2020-06-22T00:00:00Z,22,6,2020,329,1,Cameroon,CM,CMR,25876387,Africa,301,11610,75
2020-06-23T00:00:00Z,23,6,2020,282,2,Cameroon,CM,CMR,25876387,Africa,303,11892,76
2020-06-24T00:00:00Z,24,6,2020,149,5,Cameroon,CM,CMR,25876387,Africa,308,12041,77
2020-06-25T00:00:00Z,25,6,2020,229,5,Cameroon,CM,CMR,25876387,Africa,313,12270,78
2020-03-20T00:00:00Z,20,3,2020,156,1,Canada,CA,CAN,37411038,America,10,846,1
2020-03-21T00:00:00Z,21,3,2020,125,2,Canada,CA,CAN,37411038,America,12,971,2
2020-03-22T00:00:00Z,22,3,2020,331,6,Canada,CA,CAN,37411038,America,18,1302,3
2020-03-23T00:00:00Z,23,3,2020,128,2,Canada,CA,CAN,37411038,America,20,1430,4
2020-03-24T00:00:00Z,24,3,2020,216,4,Canada,CA,CAN,37411038,America,24,1646,5
2020-03-25T00:00:00Z,25,3,2020,313,3,Canada,CA,CAN,37411038,America,27,1959,6
2020-03-26T00:00:00Z,26,3,2020,1426,8,Canada,CA,CAN,37411038,America,35,3385,7
2020-03-27T00:00:00Z,27,3,2020,633,4,Canada,CA,CAN,37411038,America,39,4018,8
2020-03-28T00:00:00Z,28,3,2020,657,14,Canada,CA,CAN,37411038,America,53,4675,9
2020-03-29T00:00:00Z,29,3,2020,711,7,Canada,CA,CAN,37411038,America,60,5386,10
2020-03-30T00:00:00Z,30,3,2020,869,1,Canada,CA,CAN,37411038,America,61,6255,11
2020-03-31T00:00:00Z,31,3,2020,1169,28,Canada,CA,CAN,37411038,America,89,7424,12
2020-04-01T00:00:00Z,1,4,2020,1112,7,Canada,CA,CAN,37411038,America,96,8536,13
2020-04-02T00:00:00Z,2,4,2020,1059,13,Canada,CA,CAN,37411038,America,109,9595,14
2020-04-03T00:00:00Z,3,4,2020,1673,29,Canada,CA,CAN,37411038,America,138,11268,15
2020-04-04T00:00:00Z,4,4,2020,1251,49,Canada,CA,CAN,37411038,America,187,12519,16
2020-04-05T00:00:00Z,5,4,2020,1363,44,Canada,CA,CAN,37411038,America,231,13882,17
2020-04-06T00:00:00Z,6,4,2020,1614,49,Canada,CA,CAN,37411038,America,280,15496,18
2020-04-07T00:00:00Z,7,4,2020,1157,43,Canada,CA,CAN,37411038,America,323,16653,19
2020-04-08T00:00:00Z,8,4,2020,1230,57,Canada,CA,CAN,37411038,America,380,17883,20
2020-04-09T00:00:00Z,9,4,2020,1391,55,Canada,CA,CAN,37411038,America,435,19274,21
2020-04-10T00:00:00Z,10,4,2020,1474,74,Canada,CA,CAN,37411038,America,509,20748,22
2020-04-11T00:00:00Z,11,4,2020,1385,60,Canada,CA,CAN,37411038,America,569,22133,23
2020-04-12T00:00:00Z,12,4,2020,1168,84,Canada,CA,CAN,37411038,America,653,23301,24
2020-04-13T00:00:00Z,13,4,2020,1064,64,Canada,CA,CAN,37411038,America,717,24365,25
2020-04-14T00:00:00Z,14,4,2020,1298,63,Canada,CA,CAN,37411038,America,780,25663,26
2020-04-15T00:00:00Z,15,4,2020,1383,123,Canada,CA,CAN,37411038,America,903,27046,27
2020-04-16T00:00:00Z,16,4,2020,1318,107,Canada,CA,CAN,37411038,America,1010,28364,28
2020-04-17T00:00:00Z,17,4,2020,1717,183,Canada,CA,CAN,37411038,America,1193,30081,29
2020-04-18T00:00:00Z,18,4,2020,1791,116,Canada,CA,CAN,37411038,America,1309,31872,30
2020-04-19T00:00:00Z,19,4,2020,1469,158,Canada,CA,CAN,37411038,America,1467,33341,31
2020-04-20T00:00:00Z,20,4,2020,1436,113,Canada,CA,CAN,37411038,America,1580,34777,32
2020-04-21T00:00:00Z,21,4,2020,2046,110,Canada,CA,CAN,37411038,America,1690,36823,33
2020-04-22T00:00:00Z,22,4,2020,1590,144,Canada,CA,CAN,37411038,America,1834,38413,34
2020-04-23T00:00:00Z,23,4,2020,1766,140,Canada,CA,CAN,37411038,America,1974,40179,35
2020-04-24T00:00:00Z,24,4,2020,1920,172,Canada,CA,CAN,37411038,America,2146,42099,36
2020-04-25T00:00:00Z,25,4,2020,1778,156,Canada,CA,CAN,37411038,America,2302,43877,37
2020-04-26T00:00:00Z,26,4,2020,1464,163,Canada,CA,CAN,37411038,America,2465,45341,38
2020-04-27T00:00:00Z,27,4,2020,1543,95,Canada,CA,CAN,37411038,America,2560,46884,39
2020-04-28T00:00:00Z,28,4,2020,1605,147,Canada,CA,CAN,37411038,America,2707,48489,40
2020-04-29T00:00:00Z,29,4,2020,1526,152,Canada,CA,CAN,37411038,America,2859,50015,41
2020-04-30T00:00:00Z,30,4,2020,1572,137,Canada,CA,CAN,37411038,America,2996,51587,42
2020-05-01T00:00:00Z,1,5,2020,1649,188,Canada,CA,CAN,37411038,America,3184,53236,43
2020-05-02T00:00:00Z,2,5,2020,1825,207,Canada,CA,CAN,37411038,America,3391,55061,44
2020-05-03T00:00:00Z,3,5,2020,1653,175,Canada,CA,CAN,37411038,America,3566,56714,45
2020-05-04T00:00:00Z,4,5,2020,2760,116,Canada,CA,CAN,37411038,America,3682,59474,46
2020-05-05T00:00:00Z,5,5,2020,1298,172,Canada,CA,CAN,37411038,America,3854,60772,47
2020-05-06T00:00:00Z,6,5,2020,1274,189,Canada,CA,CAN,37411038,America,4043,62046,48
2020-05-07T00:00:00Z,7,5,2020,1450,189,Canada,CA,CAN,37411038,America,4232,63496,49
2020-05-08T00:00:00Z,8,5,2020,1426,176,Canada,CA,CAN,37411038,America,4408,64922,50
2020-05-09T00:00:00Z,9,5,2020,1512,161,Canada,CA,CAN,37411038,America,4569,66434,51
2020-05-10T00:00:00Z,10,5,2020,1268,124,Canada,CA,CAN,37411038,America,4693,67702,52
2020-05-11T00:00:00Z,11,5,2020,1146,178,Canada,CA,CAN,37411038,America,4871,68848,53
2020-05-12T00:00:00Z,12,5,2020,1133,122,Canada,CA,CAN,37411038,America,4993,69981,54
2020-05-13T00:00:00Z,13,5,2020,1176,176,Canada,CA,CAN,37411038,America,5169,71157,55
2020-05-14T00:00:00Z,14,5,2020,1121,135,Canada,CA,CAN,37411038,America,5304,72278,56
2020-05-15T00:00:00Z,15,5,2020,1123,168,Canada,CA,CAN,37411038,America,5472,73401,57
2020-05-16T00:00:00Z,16,5,2020,1201,90,Canada,CA,CAN,37411038,America,5562,74602,58
2020-05-17T00:00:00Z,17,5,2020,1251,117,Canada,CA,CAN,37411038,America,5679,75853,59
2020-05-18T00:00:00Z,18,5,2020,1138,103,Canada,CA,CAN,37411038,America,5782,76991,60
2020-05-19T00:00:00Z,19,5,2020,1070,60,Canada,CA,CAN,37411038,America,5842,78061,61
2020-05-20T00:00:00Z,20,5,2020,1040,70,Canada,CA,CAN,37411038,America,5912,79101,62
2020-05-21T00:00:00Z,21,5,2020,990,118,Canada,CA,CAN,37411038,America,6030,80091,63
2020-05-22T00:00:00Z,22,5,2020,1222,122,Canada,CA,CAN,37411038,America,6152,81313,64
2020-05-23T00:00:00Z,23,5,2020,1156,98,Canada,CA,CAN,37411038,America,6250,82469,65
2020-05-24T00:00:00Z,24,5,2020,1141,105,Canada,CA,CAN,37411038,America,6355,83610,66
2020-05-25T00:00:00Z,25,5,2020,1078,69,Canada,CA,CAN,37411038,America,6424,84688,67
2020-05-26T00:00:00Z,26,5,2020,1012,121,Canada,CA,CAN,37411038,America,6545,85700,68
2020-05-27T00:00:00Z,27,5,2020,936,94,Canada,CA,CAN,37411038,America,6639,86636,69
2020-05-28T00:00:00Z,28,5,2020,872,126,Canada,CA,CAN,37411038,America,6765,87508,70
2020-05-29T00:00:00Z,29,5,2020,993,112,Canada,CA,CAN,37411038,America,6877,88501,71
2020-05-30T00:00:00Z,30,5,2020,906,102,Canada,CA,CAN,37411038,America,6979,89407,72
2020-05-31T00:00:00Z,31,5,2020,772,94,Canada,CA,CAN,37411038,America,7073,90179,73
2020-06-01T00:00:00Z,1,6,2020,757,222,Canada,CA,CAN,37411038,America,7295,90936,74
2020-06-02T00:00:00Z,2,6,2020,758,31,Canada,CA,CAN,37411038,America,7326,91694,75
2020-06-03T00:00:00Z,3,6,2020,705,69,Canada,CA,CAN,37411038,America,7395,92399,76
2020-06-04T00:00:00Z,4,6,2020,675,103,Canada,CA,CAN,37411038,America,7498,93074,77
2020-06-05T00:00:00Z,5,6,2020,641,139,Canada,CA,CAN,37411038,America,7637,93715,78
2020-06-06T00:00:00Z,6,6,2020,609,66,Canada,CA,CAN,37411038,America,7703,94324,79
2020-06-07T00:00:00Z,7,6,2020,722,70,Canada,CA,CAN,37411038,America,7773,95046,80
2020-06-08T00:00:00Z,8,6,2020,642,27,Canada,CA,CAN,37411038,America,7800,95688,81
2020-06-09T00:00:00Z,9,6,2020,545,35,Canada,CA,CAN,37411038,America,7835,96233,82
2020-06-10T00:00:00Z,10,6,2020,409,62,Canada,CA,CAN,37411038,America,7897,96642,83
2020-06-11T00:00:00Z,11,6,2020,472,63,Canada,CA,CAN,37411038,America,7960,97114,84
2020-06-12T00:00:00Z,12,6,2020,405,34,Canada,CA,CAN,37411038,America,7994,97519,85
2020-06-13T00:00:00Z,13,6,2020,413,55,Canada,CA,CAN,37411038,America,8049,97932,86
2020-06-14T00:00:00Z,14,6,2020,467,58,Canada,CA,CAN,37411038,America,8107,98399,87
2020-06-15T00:00:00Z,15,6,2020,377,39,Canada,CA,CAN,37411038,America,8146,98776,88
2020-06-16T00:00:00Z,16,6,2020,360,29,Canada,CA,CAN,37411038,America,8175,99136,89
2020-06-17T00:00:00Z,17,6,2020,320,38,Canada,CA,CAN,37411038,America,8213,99456,90
2020-06-18T00:00:00Z,18,6,2020,386,41,Canada,CA,CAN,37411038,America,8254,99842,91
2020-06-19T00:00:00Z,19,6,2020,367,46,Canada,CA,CAN,37411038,America,8300,100209,92
2020-06-20T00:00:00Z,20,6,2020,409,46,Canada,CA,CAN,37411038,America,8346,100618,93
2020-06-21T00:00:00Z,21,6,2020,390,64,Canada,CA,CAN,37411038,America,8410,101008,94
2020-06-22T00:00:00Z,22,6,2020,318,20,Canada,CA,CAN,37411038,America,8430,101326,95
2020-06-23T00:00:00Z,23,6,2020,311,6,Canada,CA,CAN,37411038,America,8436,101637,96
2020-06-24T00:00:00Z,24,6,2020,326,18,Canada,CA,CAN,37411038,America,8454,101963,97
2020-06-25T00:00:00Z,25,6,2020,279,30,Canada,CA,CAN,37411038,America,8484,102242,98
2020-06-16T00:00:00Z,16,6,2020,67,3,Central_African_Republic,CF,CAF,4745179,Africa,10,2289,1
2020-06-17T00:00:00Z,17,6,2020,121,4,Central_African_Republic,CF,CAF,4745179,Africa,14,2410,2
2020-06-18T00:00:00Z,18,6,2020,154,4,Central_African_Republic,CF,CAF,4745179,Africa,18,2564,3
2020-06-19T00:00:00Z,19,6,2020,41,1,Central_African_Republic,CF,CAF,4745179,Africa,19,2605,4
2020-06-20T00:00:00Z,20,6,2020,0,0,Central_African_Republic,CF,CAF,4745179,Africa,19,2605,5
2020-06-21T00:00:00Z,21,6,2020,203,4,Central_African_Republic,CF,CAF,4745179,Africa,23,2808,6
2020-06-22T00:00:00Z,22,6,2020,0,0,Central_African_Republic,CF,CAF,4745179,Africa,23,2808,7
2020-06-23T00:00:00Z,23,6,2020,155,7,Central_African_Republic,CF,CAF,4745179,Africa,30,2963,8
2020-06-24T00:00:00Z,24,6,2020,88,7,Central_African_Republic,CF,CAF,4745179,Africa,37,3051,9
2020-06-25T00:00:00Z,25,6,2020,48,1,Central_African_Republic,CF,CAF,4745179,Africa,38,3099,10
2020-05-03T00:00:00Z,3,5,2020,44,5,Chad,TD,TCD,15946882,Africa,10,117,1
2020-05-04T00:00:00Z,4,5,2020,0,0,Chad,TD,TCD,15946882,Africa,10,117,2
2020-05-05T00:00:00Z,5,5,2020,0,0,Chad,TD,TCD,15946882,Africa,10,117,3
2020-05-06T00:00:00Z,6,5,2020,53,7,Chad,TD,TCD,15946882,Africa,17,170,4
2020-05-07T00:00:00Z,7,5,2020,0,0,Chad,TD,TCD,15946882,Africa,17,170,5
2020-05-08T00:00:00Z,8,5,2020,83,10,Chad,TD,TCD,15946882,Africa,27,253,6
2020-05-09T00:00:00Z,9,5,2020,7,1,Chad,TD,TCD,15946882,Africa,28,260,7
2020-05-10T00:00:00Z,10,5,2020,62,3,Chad,TD,TCD,15946882,Africa,31,322,8
2020-05-11T00:00:00Z,11,5,2020,0,0,Chad,TD,TCD,15946882,Africa,31,322,9
2020-05-12T00:00:00Z,12,5,2020,0,0,Chad,TD,TCD,15946882,Africa,31,322,10
2020-05-13T00:00:00Z,13,5,2020,35,9,Chad,TD,TCD,15946882,Africa,40,357,11
2020-05-14T00:00:00Z,14,5,2020,15,2,Chad,TD,TCD,15946882,Africa,42,372,12
2020-05-15T00:00:00Z,15,5,2020,27,4,Chad,TD,TCD,15946882,Africa,46,399,13
2020-05-16T00:00:00Z,16,5,2020,29,2,Chad,TD,TCD,15946882,Africa,48,428,14
2020-05-17T00:00:00Z,17,5,2020,46,2,Chad,TD,TCD,15946882,Africa,50,474,15
2020-05-18T00:00:00Z,18,5,2020,29,3,Chad,TD,TCD,15946882,Africa,53,503,16
2020-05-19T00:00:00Z,19,5,2020,16,0,Chad,TD,TCD,15946882,Africa,53,519,17
2020-05-20T00:00:00Z,20,5,2020,26,3,Chad,TD,TCD,15946882,Africa,56,545,18
2020-05-21T00:00:00Z,21,5,2020,20,1,Chad,TD,TCD,15946882,Africa,57,565,19
2020-05-22T00:00:00Z,22,5,2020,23,1,Chad,TD,TCD,15946882,Africa,58,588,20
2020-05-23T00:00:00Z,23,5,2020,23,1,Chad,TD,TCD,15946882,Africa,59,611,21
2020-05-24T00:00:00Z,24,5,2020,37,1,Chad,TD,TCD,15946882,Africa,60,648,22
2020-05-25T00:00:00Z,25,5,2020,27,0,Chad,TD,TCD,15946882,Africa,60,675,23
2020-05-26T00:00:00Z,26,5,2020,12,1,Chad,TD,TCD,15946882,Africa,61,687,24
2020-05-27T00:00:00Z,27,5,2020,13,1,Chad,TD,TCD,15946882,Africa,62,700,25
2020-05-28T00:00:00Z,28,5,2020,15,2,Chad,TD,TCD,15946882,Africa,64,715,26
2020-05-29T00:00:00Z,29,5,2020,11,1,Chad,TD,TCD,15946882,Africa,65,726,27
2020-05-30T00:00:00Z,30,5,2020,33,0,Chad,TD,TCD,15946882,Africa,65,759,28
2020-05-31T00:00:00Z,31,5,2020,0,0,Chad,TD,TCD,15946882,Africa,65,759,29
2020-06-01T00:00:00Z,1,6,2020,19,0,Chad,TD,TCD,15946882,Africa,65,778,30
2020-06-02T00:00:00Z,2,6,2020,12,1,Chad,TD,TCD,15946882,Africa,66,790,31
2020-06-03T00:00:00Z,3,6,2020,13,0,Chad,TD,TCD,15946882,Africa,66,803,32
2020-06-04T00:00:00Z,4,6,2020,17,0,Chad,TD,TCD,15946882,Africa,66,820,33
2020-06-05T00:00:00Z,5,6,2020,8,0,Chad,TD,TCD,15946882,Africa,66,828,34
2020-06-06T00:00:00Z,6,6,2020,8,2,Chad,TD,TCD,15946882,Africa,68,836,35
2020-06-07T00:00:00Z,7,6,2020,0,1,Chad,TD,TCD,15946882,Africa,69,836,36
2020-06-08T00:00:00Z,8,6,2020,1,0,Chad,TD,TCD,15946882,Africa,69,837,37
2020-06-09T00:00:00Z,9,6,2020,2,1,Chad,TD,TCD,15946882,Africa,70,839,38
2020-06-10T00:00:00Z,10,6,2020,5,1,Chad,TD,TCD,15946882,Africa,71,844,39
2020-06-11T00:00:00Z,11,6,2020,2,1,Chad,TD,TCD,15946882,Africa,72,846,40
2020-06-12T00:00:00Z,12,6,2020,2,0,Chad,TD,TCD,15946882,Africa,72,848,41
2020-06-13T00:00:00Z,13,6,2020,0,0,Chad,TD,TCD,15946882,Africa,72,848,42
2020-06-14T00:00:00Z,14,6,2020,0,0,Chad,TD,TCD,15946882,Africa,72,848,43
2020-06-15T00:00:00Z,15,6,2020,2,1,Chad,TD,TCD,15946882,Africa,73,850,44
2020-06-16T00:00:00Z,16,6,2020,0,0,Chad,TD,TCD,15946882,Africa,73,850,45
2020-06-17T00:00:00Z,17,6,2020,3,1,Chad,TD,TCD,15946882,Africa,74,853,46
2020-06-18T00:00:00Z,18,6,2020,1,0,Chad,TD,TCD,15946882,Africa,74,854,47
2020-06-19T00:00:00Z,19,6,2020,0,0,Chad,TD,TCD,15946882,Africa,74,854,48
2020-06-20T00:00:00Z,20,6,2020,4,0,Chad,TD,TCD,15946882,Africa,74,858,49
2020-06-21T00:00:00Z,21,6,2020,0,0,Chad,TD,TCD,15946882,Africa,74,858,50
2020-06-22T00:00:00Z,22,6,2020,0,0,Chad,TD,TCD,15946882,Africa,74,858,51
2020-06-23T00:00:00Z,23,6,2020,0,0,Chad,TD,TCD,15946882,Africa,74,858,52
2020-06-24T00:00:00Z,24,6,2020,2,0,Chad,TD,TCD,15946882,Africa,74,860,53
2020-06-25T00:00:00Z,25,6,2020,0,0,Chad,TD,TCD,15946882,Africa,74,860,54
2020-04-01T00:00:00Z,1,4,2020,289,4,Chile,CL,CHL,18952035,America,12,2738,1
2020-04-02T00:00:00Z,2,4,2020,293,4,Chile,CL,CHL,18952035,America,16,3031,2
2020-04-03T00:00:00Z,3,4,2020,373,2,Chile,CL,CHL,18952035,America,18,3404,3
2020-04-04T00:00:00Z,4,4,2020,333,4,Chile,CL,CHL,18952035,America,22,3737,4
2020-04-05T00:00:00Z,5,4,2020,424,5,Chile,CL,CHL,18952035,America,27,4161,5
2020-04-06T00:00:00Z,6,4,2020,310,7,Chile,CL,CHL,18952035,America,34,4471,6
2020-04-07T00:00:00Z,7,4,2020,344,3,Chile,CL,CHL,18952035,America,37,4815,7
2020-04-08T00:00:00Z,8,4,2020,301,6,Chile,CL,CHL,18952035,America,43,5116,8
2020-04-09T00:00:00Z,9,4,2020,430,5,Chile,CL,CHL,18952035,America,48,5546,9
2020-04-10T00:00:00Z,10,4,2020,426,9,Chile,CL,CHL,18952035,America,57,5972,10
2020-04-11T00:00:00Z,11,4,2020,529,8,Chile,CL,CHL,18952035,America,65,6501,11
2020-04-12T00:00:00Z,12,4,2020,426,8,Chile,CL,CHL,18952035,America,73,6927,12
2020-04-13T00:00:00Z,13,4,2020,286,7,Chile,CL,CHL,18952035,America,80,7213,13
2020-04-14T00:00:00Z,14,4,2020,312,2,Chile,CL,CHL,18952035,America,82,7525,14
2020-04-15T00:00:00Z,15,4,2020,392,10,Chile,CL,CHL,18952035,America,92,7917,15
2020-04-16T00:00:00Z,16,4,2020,356,2,Chile,CL,CHL,18952035,America,94,8273,16
2020-04-17T00:00:00Z,17,4,2020,534,11,Chile,CL,CHL,18952035,America,105,8807,17
2020-04-18T00:00:00Z,18,4,2020,445,11,Chile,CL,CHL,18952035,America,116,9252,18
2020-04-19T00:00:00Z,19,4,2020,478,10,Chile,CL,CHL,18952035,America,126,9730,19
2020-04-20T00:00:00Z,20,4,2020,358,7,Chile,CL,CHL,18952035,America,133,10088,20
2020-04-21T00:00:00Z,21,4,2020,419,6,Chile,CL,CHL,18952035,America,139,10507,21
2020-04-22T00:00:00Z,22,4,2020,325,8,Chile,CL,CHL,18952035,America,147,10832,22
2020-04-23T00:00:00Z,23,4,2020,464,13,Chile,CL,CHL,18952035,America,160,11296,23
2020-04-24T00:00:00Z,24,4,2020,516,8,Chile,CL,CHL,18952035,America,168,11812,24
2020-04-25T00:00:00Z,25,4,2020,494,6,Chile,CL,CHL,18952035,America,174,12306,25
2020-04-26T00:00:00Z,26,4,2020,552,7,Chile,CL,CHL,18952035,America,181,12858,26
2020-04-27T00:00:00Z,27,4,2020,473,8,Chile,CL,CHL,18952035,America,189,13331,27
2020-04-28T00:00:00Z,28,4,2020,482,9,Chile,CL,CHL,18952035,America,198,13813,28
2020-04-29T00:00:00Z,29,4,2020,552,9,Chile,CL,CHL,18952035,America,207,14365,29
2020-04-30T00:00:00Z,30,4,2020,520,9,Chile,CL,CHL,18952035,America,216,14885,30
2020-05-01T00:00:00Z,1,5,2020,1138,11,Chile,CL,CHL,18952035,America,227,16023,31
2020-05-02T00:00:00Z,2,5,2020,985,7,Chile,CL,CHL,18952035,America,234,17008,32
2020-05-03T00:00:00Z,3,5,2020,1427,13,Chile,CL,CHL,18952035,America,247,18435,33
2020-05-04T00:00:00Z,4,5,2020,1228,13,Chile,CL,CHL,18952035,America,260,19663,34
2020-05-05T00:00:00Z,5,5,2020,980,10,Chile,CL,CHL,18952035,America,270,20643,35
2020-05-06T00:00:00Z,6,5,2020,1373,5,Chile,CL,CHL,18952035,America,275,22016,36
2020-05-07T00:00:00Z,7,5,2020,1032,6,Chile,CL,CHL,18952035,America,281,23048,37
2020-05-08T00:00:00Z,8,5,2020,1533,4,Chile,CL,CHL,18952035,America,285,24581,38
2020-05-09T00:00:00Z,9,5,2020,1391,9,Chile,CL,CHL,18952035,America,294,25972,39
2020-05-10T00:00:00Z,10,5,2020,1247,10,Chile,CL,CHL,18952035,America,304,27219,40
2020-05-11T00:00:00Z,11,5,2020,1647,8,Chile,CL,CHL,18952035,America,312,28866,41
2020-05-12T00:00:00Z,12,5,2020,1197,11,Chile,CL,CHL,18952035,America,323,30063,42
2020-05-13T00:00:00Z,13,5,2020,1658,12,Chile,CL,CHL,18952035,America,335,31721,43
2020-05-14T00:00:00Z,14,5,2020,2660,11,Chile,CL,CHL,18952035,America,346,34381,44
2020-05-15T00:00:00Z,15,5,2020,2659,12,Chile,CL,CHL,18952035,America,358,37040,45
2020-05-16T00:00:00Z,16,5,2020,2502,36,Chile,CL,CHL,18952035,America,394,39542,46
2020-05-17T00:00:00Z,17,5,2020,1886,27,Chile,CL,CHL,18952035,America,421,41428,47
2020-05-18T00:00:00Z,18,5,2020,2353,29,Chile,CL,CHL,18952035,America,450,43781,48
2020-05-19T00:00:00Z,19,5,2020,2278,28,Chile,CL,CHL,18952035,America,478,46059,49
2020-05-20T00:00:00Z,20,5,2020,3520,31,Chile,CL,CHL,18952035,America,509,49579,50
2020-05-21T00:00:00Z,21,5,2020,4038,35,Chile,CL,CHL,18952035,America,544,53617,51
2020-05-22T00:00:00Z,22,5,2020,3964,45,Chile,CL,CHL,18952035,America,589,57581,52
2020-05-23T00:00:00Z,23,5,2020,4276,41,Chile,CL,CHL,18952035,America,630,61857,53
2020-05-24T00:00:00Z,24,5,2020,3536,43,Chile,CL,CHL,18952035,America,673,65393,54
2020-05-25T00:00:00Z,25,5,2020,3709,45,Chile,CL,CHL,18952035,America,718,69102,55
2020-05-26T00:00:00Z,26,5,2020,4895,43,Chile,CL,CHL,18952035,America,761,73997,56
2020-05-27T00:00:00Z,27,5,2020,3964,45,Chile,CL,CHL,18952035,America,806,77961,57
2020-05-28T00:00:00Z,28,5,2020,4328,35,Chile,CL,CHL,18952035,America,841,82289,58
2020-05-29T00:00:00Z,29,5,2020,4654,49,Chile,CL,CHL,18952035,America,890,86943,59
2020-05-30T00:00:00Z,30,5,2020,3695,54,Chile,CL,CHL,18952035,America,944,90638,60
2020-05-31T00:00:00Z,31,5,2020,4220,53,Chile,CL,CHL,18952035,America,997,94858,61
2020-06-01T00:00:00Z,1,6,2020,4830,57,Chile,CL,CHL,18952035,America,1054,99688,62
2020-06-02T00:00:00Z,2,6,2020,5471,59,Chile,CL,CHL,18952035,America,1113,105159,63
2020-06-03T00:00:00Z,3,6,2020,3527,75,Chile,CL,CHL,18952035,America,1188,108686,64
2020-06-04T00:00:00Z,4,6,2020,4942,87,Chile,CL,CHL,18952035,America,1275,113628,65
2020-06-05T00:00:00Z,5,6,2020,4664,81,Chile,CL,CHL,18952035,America,1356,118292,66
2020-06-06T00:00:00Z,6,6,2020,4207,92,Chile,CL,CHL,18952035,America,1448,122499,67
2020-06-07T00:00:00Z,7,6,2020,5246,93,Chile,CL,CHL,18952035,America,1541,127745,68
2020-06-08T00:00:00Z,8,6,2020,6405,649,Chile,CL,CHL,18952035,America,2190,134150,69
2020-06-09T00:00:00Z,9,6,2020,4696,74,Chile,CL,CHL,18952035,America,2264,138846,70
2020-06-10T00:00:00Z,10,6,2020,3913,19,Chile,CL,CHL,18952035,America,2283,142759,71
2020-06-11T00:00:00Z,11,6,2020,5737,192,Chile,CL,CHL,18952035,America,2475,148496,72
2020-06-12T00:00:00Z,12,6,2020,5596,173,Chile,CL,CHL,18952035,America,2648,154092,73
2020-06-13T00:00:00Z,13,6,2020,6754,222,Chile,CL,CHL,18952035,America,2870,160846,74
2020-06-14T00:00:00Z,14,6,2020,6509,231,Chile,CL,CHL,18952035,America,3101,167355,75
2020-06-15T00:00:00Z,15,6,2020,6938,222,Chile,CL,CHL,18952035,America,3323,174293,76
2020-06-16T00:00:00Z,16,6,2020,5143,39,Chile,CL,CHL,18952035,America,3362,179436,77
2020-06-17T00:00:00Z,17,6,2020,5013,21,Chile,CL,CHL,18952035,America,3383,184449,78
2020-06-18T00:00:00Z,18,6,2020,36179,232,Chile,CL,CHL,18952035,America,3615,220628,79
2020-06-19T00:00:00Z,19,6,2020,4475,226,Chile,CL,CHL,18952035,America,3841,225103,80
2020-06-20T00:00:00Z,20,6,2020,6290,252,Chile,CL,CHL,18952035,America,4093,231393,81
2020-06-21T00:00:00Z,21,6,2020,5355,202,Chile,CL,CHL,18952035,America,4295,236748,82
2020-06-22T00:00:00Z,22,6,2020,5607,184,Chile,CL,CHL,18952035,America,4479,242355,83
2020-06-23T00:00:00Z,23,6,2020,4608,23,Chile,CL,CHL,18952035,America,4502,246963,84
2020-06-24T00:00:00Z,24,6,2020,3804,3,Chile,CL,CHL,18952035,America,4505,250767,85
2020-06-25T00:00:00Z,25,6,2020,3649,226,Chile,CL,CHL,18952035,America,4731,254416,86
2020-01-22T00:00:00Z,22,1,2020,140,11,China,CN,CHN,1433783692,Asia,17,526,1
2020-01-23T00:00:00Z,23,1,2020,97,0,China,CN,CHN,1433783692,Asia,17,623,2
2020-01-24T00:00:00Z,24,1,2020,259,9,China,CN,CHN,1433783692,Asia,26,882,3
2020-01-25T00:00:00Z,25,1,2020,441,15,China,CN,CHN,1433783692,Asia,41,1323,4
2020-01-26T00:00:00Z,26,1,2020,665,15,China,CN,CHN,1433783692,Asia,56,1988,5
2020-01-27T00:00:00Z,27,1,2020,787,25,China,CN,CHN,1433783692,Asia,81,2775,6
2020-01-28T00:00:00Z,28,1,2020,1753,25,China,CN,CHN,1433783692,Asia,106,4528,7
2020-01-29T00:00:00Z,29,1,2020,1466,26,China,CN,CHN,1433783692,Asia,132,5994,8
2020-01-30T00:00:00Z,30,1,2020,1740,38,China,CN,CHN,1433783692,Asia,170,7734,9
2020-01-31T00:00:00Z,31,1,2020,1980,43,China,CN,CHN,1433783692,Asia,213,9714,10
2020-02-01T00:00:00Z,1,2,2020,2095,46,China,CN,CHN,1433783692,Asia,259,11809,11
2020-02-02T00:00:00Z,2,2,2020,2590,45,China,CN,CHN,1433783692,Asia,304,14399,12
2020-02-03T00:00:00Z,3,2,2020,2812,57,China,CN,CHN,1433783692,Asia,361,17211,13
2020-02-04T00:00:00Z,4,2,2020,3237,65,China,CN,CHN,1433783692,Asia,426,20448,14
2020-02-05T00:00:00Z,5,2,2020,3872,66,China,CN,CHN,1433783692,Asia,492,24320,15
2020-02-06T00:00:00Z,6,2,2020,3727,72,China,CN,CHN,1433783692,Asia,564,28047,16
2020-02-07T00:00:00Z,7,2,2020,3160,73,China,CN,CHN,1433783692,Asia,637,31207,17
2020-02-08T00:00:00Z,8,2,2020,3418,86,China,CN,CHN,1433783692,Asia,723,34625,18
2020-02-09T00:00:00Z,9,2,2020,2607,89,China,CN,CHN,1433783692,Asia,812,37232,19
2020-02-10T00:00:00Z,10,2,2020,2974,97,China,CN,CHN,1433783692,Asia,909,40206,20
2020-02-11T00:00:00Z,11,2,2020,2490,108,China,CN,CHN,1433783692,Asia,1017,42696,21
2020-02-12T00:00:00Z,12,2,2020,2028,97,China,CN,CHN,1433783692,Asia,1114,44724,22
2020-02-13T00:00:00Z,13,2,2020,15141,254,China,CN,CHN,1433783692,Asia,1368,59865,23
2020-02-14T00:00:00Z,14,2,2020,4156,13,China,CN,CHN,1433783692,Asia,1381,64021,24
2020-02-15T00:00:00Z,15,2,2020,2538,143,China,CN,CHN,1433783692,Asia,1524,66559,25
2020-02-16T00:00:00Z,16,2,2020,2007,142,China,CN,CHN,1433783692,Asia,1666,68566,26
2020-02-17T00:00:00Z,17,2,2020,2052,105,China,CN,CHN,1433783692,Asia,1771,70618,27
2020-02-18T00:00:00Z,18,2,2020,1890,98,China,CN,CHN,1433783692,Asia,1869,72508,28
2020-02-19T00:00:00Z,19,2,2020,1750,139,China,CN,CHN,1433783692,Asia,2008,74258,29
2020-02-20T00:00:00Z,20,2,2020,394,112,China,CN,CHN,1433783692,Asia,2120,74652,30
2020-02-21T00:00:00Z,21,2,2020,891,118,China,CN,CHN,1433783692,Asia,2238,75543,31
2020-02-22T00:00:00Z,22,2,2020,826,109,China,CN,CHN,1433783692,Asia,2347,76369,32
2020-02-23T00:00:00Z,23,2,2020,647,98,China,CN,CHN,1433783692,Asia,2445,77016,33
2020-02-24T00:00:00Z,24,2,2020,218,150,China,CN,CHN,1433783692,Asia,2595,77234,34
2020-02-25T00:00:00Z,25,2,2020,515,70,China,CN,CHN,1433783692,Asia,2665,77749,35
2020-02-26T00:00:00Z,26,2,2020,410,52,China,CN,CHN,1433783692,Asia,2717,78159,36
2020-02-27T00:00:00Z,27,2,2020,439,29,China,CN,CHN,1433783692,Asia,2746,78598,37
2020-02-28T00:00:00Z,28,2,2020,329,44,China,CN,CHN,1433783692,Asia,2790,78927,38
2020-02-29T00:00:00Z,29,2,2020,428,47,China,CN,CHN,1433783692,Asia,2837,79355,39
2020-03-01T00:00:00Z,1,3,2020,574,35,China,CN,CHN,1433783692,Asia,2872,79929,40
2020-03-02T00:00:00Z,2,3,2020,205,42,China,CN,CHN,1433783692,Asia,2914,80134,41
2020-03-03T00:00:00Z,3,3,2020,127,32,China,CN,CHN,1433783692,Asia,2946,80261,42
2020-03-04T00:00:00Z,4,3,2020,119,37,China,CN,CHN,1433783692,Asia,2983,80380,43
2020-03-05T00:00:00Z,5,3,2020,117,31,China,CN,CHN,1433783692,Asia,3014,80497,44
2020-03-06T00:00:00Z,6,3,2020,170,30,China,CN,CHN,1433783692,Asia,3044,80667,45
2020-03-07T00:00:00Z,7,3,2020,101,28,China,CN,CHN,1433783692,Asia,3072,80768,46
2020-03-08T00:00:00Z,8,3,2020,46,27,China,CN,CHN,1433783692,Asia,3099,80814,47
2020-03-09T00:00:00Z,9,3,2020,45,23,China,CN,CHN,1433783692,Asia,3122,80859,48
2020-03-10T00:00:00Z,10,3,2020,20,17,China,CN,CHN,1433783692,Asia,3139,80879,49
2020-03-11T00:00:00Z,11,3,2020,29,22,China,CN,CHN,1433783692,Asia,3161,80908,50
2020-03-12T00:00:00Z,12,3,2020,24,11,China,CN,CHN,1433783692,Asia,3172,80932,51
2020-03-13T00:00:00Z,13,3,2020,22,7,China,CN,CHN,1433783692,Asia,3179,80954,52
2020-03-14T00:00:00Z,14,3,2020,19,15,China,CN,CHN,1433783692,Asia,3194,80973,53
2020-03-15T00:00:00Z,15,3,2020,22,9,China,CN,CHN,1433783692,Asia,3203,80995,54
2020-03-16T00:00:00Z,16,3,2020,25,13,China,CN,CHN,1433783692,Asia,3216,81020,55
2020-03-17T00:00:00Z,17,3,2020,43,9,China,CN,CHN,1433783692,Asia,3225,81063,56
2020-03-18T00:00:00Z,18,3,2020,23,16,China,CN,CHN,1433783692,Asia,3241,81086,57
2020-03-19T00:00:00Z,19,3,2020,44,8,China,CN,CHN,1433783692,Asia,3249,81130,58
2020-03-20T00:00:00Z,20,3,2020,99,4,China,CN,CHN,1433783692,Asia,3253,81229,59
2020-03-21T00:00:00Z,21,3,2020,52,6,China,CN,CHN,1433783692,Asia,3259,81281,60
2020-03-22T00:00:00Z,22,3,2020,65,6,China,CN,CHN,1433783692,Asia,3265,81346,61
2020-03-23T00:00:00Z,23,3,2020,138,9,China,CN,CHN,1433783692,Asia,3274,81484,62
2020-03-24T00:00:00Z,24,3,2020,69,7,China,CN,CHN,1433783692,Asia,3281,81553,63
2020-03-25T00:00:00Z,25,3,2020,78,4,China,CN,CHN,1433783692,Asia,3285,81631,64
2020-03-26T00:00:00Z,26,3,2020,102,6,China,CN,CHN,1433783692,Asia,3291,81733,65
2020-03-27T00:00:00Z,27,3,2020,94,5,China,CN,CHN,1433783692,Asia,3296,81827,66
2020-03-28T00:00:00Z,28,3,2020,119,3,China,CN,CHN,1433783692,Asia,3299,81946,67
2020-03-29T00:00:00Z,29,3,2020,113,5,China,CN,CHN,1433783692,Asia,3304,82059,68
2020-03-30T00:00:00Z,30,3,2020,98,2,China,CN,CHN,1433783692,Asia,3306,82157,69
2020-03-31T00:00:00Z,31,3,2020,84,3,China,CN,CHN,1433783692,Asia,3309,82241,70
2020-04-01T00:00:00Z,1,4,2020,54,1,China,CN,CHN,1433783692,Asia,3310,82295,71
2020-04-02T00:00:00Z,2,4,2020,100,6,China,CN,CHN,1433783692,Asia,3316,82395,72
2020-04-03T00:00:00Z,3,4,2020,70,10,China,CN,CHN,1433783692,Asia,3326,82465,73
2020-04-04T00:00:00Z,4,4,2020,62,4,China,CN,CHN,1433783692,Asia,3330,82527,74
2020-04-05T00:00:00Z,5,4,2020,48,3,China,CN,CHN,1433783692,Asia,3333,82575,75
2020-04-06T00:00:00Z,6,4,2020,67,2,China,CN,CHN,1433783692,Asia,3335,82642,76
2020-04-07T00:00:00Z,7,4,2020,56,0,China,CN,CHN,1433783692,Asia,3335,82698,77
2020-04-08T00:00:00Z,8,4,2020,86,2,China,CN,CHN,1433783692,Asia,3337,82784,78
2020-04-09T00:00:00Z,9,4,2020,86,2,China,CN,CHN,1433783692,Asia,3339,82870,79
2020-04-10T00:00:00Z,10,4,2020,55,1,China,CN,CHN,1433783692,Asia,3340,82925,80
2020-04-11T00:00:00Z,11,4,2020,79,3,China,CN,CHN,1433783692,Asia,3343,83004,81
2020-04-12T00:00:00Z,12,4,2020,93,0,China,CN,CHN,1433783692,Asia,3343,83097,82
2020-04-13T00:00:00Z,13,4,2020,112,2,China,CN,CHN,1433783692,Asia,3345,83209,83
2020-04-14T00:00:00Z,14,4,2020,94,0,China,CN,CHN,1433783692,Asia,3345,83303,84
2020-04-15T00:00:00Z,15,4,2020,49,1,China,CN,CHN,1433783692,Asia,3346,83352,85
2020-04-16T00:00:00Z,16,4,2020,50,0,China,CN,CHN,1433783692,Asia,3346,83402,86
2020-04-17T00:00:00Z,17,4,2020,352,1290,China,CN,CHN,1433783692,Asia,4636,83754,87
2020-04-18T00:00:00Z,18,4,2020,31,0,China,CN,CHN,1433783692,Asia,4636,83785,88
2020-04-19T00:00:00Z,19,4,2020,18,0,China,CN,CHN,1433783692,Asia,4636,83803,89
2020-04-20T00:00:00Z,20,4,2020,14,0,China,CN,CHN,1433783692,Asia,4636,83817,90
2020-04-21T00:00:00Z,21,4,2020,32,0,China,CN,CHN,1433783692,Asia,4636,83849,91
2020-04-22T00:00:00Z,22,4,2020,15,0,China,CN,CHN,1433783692,Asia,4636,83864,92
2020-04-23T00:00:00Z,23,4,2020,12,0,China,CN,CHN,1433783692,Asia,4636,83876,93
2020-04-24T00:00:00Z,24,4,2020,8,0,China,CN,CHN,1433783692,Asia,4636,83884,94
2020-04-25T00:00:00Z,25,4,2020,15,0,China,CN,CHN,1433783692,Asia,4636,83899,95
2020-04-26T00:00:00Z,26,4,2020,10,0,China,CN,CHN,1433783692,Asia,4636,83909,96
2020-04-27T00:00:00Z,27,4,2020,3,1,China,CN,CHN,1433783692,Asia,4637,83912,97
2020-04-28T00:00:00Z,28,4,2020,26,0,China,CN,CHN,1433783692,Asia,4637,83938,98
2020-04-29T00:00:00Z,29,4,2020,2,0,China,CN,CHN,1433783692,Asia,4637,83940,99
2020-04-30T00:00:00Z,30,4,2020,4,0,China,CN,CHN,1433783692,Asia,4637,83944,100
2020-05-01T00:00:00Z,1,5,2020,12,0,China,CN,CHN,1433783692,Asia,4637,83956,101
2020-05-02T00:00:00Z,2,5,2020,3,0,China,CN,CHN,1433783692,Asia,4637,83959,102
2020-05-03T00:00:00Z,3,5,2020,2,0,China,CN,CHN,1433783692,Asia,4637,83961,103
2020-05-04T00:00:00Z,4,5,2020,3,0,China,CN,CHN,1433783692,Asia,4637,83964,104
2020-05-05T00:00:00Z,5,5,2020,2,0,China,CN,CHN,1433783692,Asia,4637,83966,105
2020-05-06T00:00:00Z,6,5,2020,2,0,China,CN,CHN,1433783692,Asia,4637,83968,106
2020-05-07T00:00:00Z,7,5,2020,2,0,China,CN,CHN,1433783692,Asia,4637,83970,107
2020-05-08T00:00:00Z,8,5,2020,6,0,China,CN,CHN,1433783692,Asia,4637,83976,108
2020-05-09T00:00:00Z,9,5,2020,0,0,China,CN,CHN,1433783692,Asia,4637,83976,109
2020-05-10T00:00:00Z,10,5,2020,15,0,China,CN,CHN,1433783692,Asia,4637,83991,110
2020-05-11T00:00:00Z,11,5,2020,19,0,China,CN,CHN,1433783692,Asia,4637,84010,111
2020-05-12T00:00:00Z,12,5,2020,1,0,China,CN,CHN,1433783692,Asia,4637,84011,112
2020-05-13T00:00:00Z,13,5,2020,7,0,China,CN,CHN,1433783692,Asia,4637,84018,113
2020-05-14T00:00:00Z,14,5,2020,6,0,China,CN,CHN,1433783692,Asia,4637,84024,114
2020-05-15T00:00:00Z,15,5,2020,5,0,China,CN,CHN,1433783692,Asia,4637,84029,115
2020-05-16T00:00:00Z,16,5,2020,9,0,China,CN,CHN,1433783692,Asia,4637,84038,116
2020-05-17T00:00:00Z,17,5,2020,6,1,China,CN,CHN,1433783692,Asia,4638,84044,117
2020-05-18T00:00:00Z,18,5,2020,10,0,China,CN,CHN,1433783692,Asia,4638,84054,118
2020-05-19T00:00:00Z,19,5,2020,9,0,China,CN,CHN,1433783692,Asia,4638,84063,119
2020-05-20T00:00:00Z,20,5,2020,2,0,China,CN,CHN,1433783692,Asia,4638,84065,120
2020-05-21T00:00:00Z,21,5,2020,2,0,China,CN,CHN,1433783692,Asia,4638,84067,121
2020-05-22T00:00:00Z,22,5,2020,12,0,China,CN,CHN,1433783692,Asia,4638,84079,122
2020-05-23T00:00:00Z,23,5,2020,2,0,China,CN,CHN,1433783692,Asia,4638,84081,123
2020-05-24T00:00:00Z,24,5,2020,3,0,China,CN,CHN,1433783692,Asia,4638,84084,124
2020-05-25T00:00:00Z,25,5,2020,11,0,China,CN,CHN,1433783692,Asia,4638,84095,125
2020-05-26T00:00:00Z,26,5,2020,7,0,China,CN,CHN,1433783692,Asia,4638,84102,126
2020-05-27T00:00:00Z,27,5,2020,1,0,China,CN,CHN,1433783692,Asia,4638,84103,127
2020-05-28T00:00:00Z,28,5,2020,3,0,China,CN,CHN,1433783692,Asia,4638,84106,128
2020-05-29T00:00:00Z,29,5,2020,0,0,China,CN,CHN,1433783692,Asia,4638,84106,129
2020-05-30T00:00:00Z,30,5,2020,17,0,China,CN,CHN,1433783692,Asia,4638,84123,130
2020-05-31T00:00:00Z,31,5,2020,5,0,China,CN,CHN,1433783692,Asia,4638,84128,131
2020-06-01T00:00:00Z,1,6,2020,19,0,China,CN,CHN,1433783692,Asia,4638,84147,132
2020-06-02T00:00:00Z,2,6,2020,7,0,China,CN,CHN,1433783692,Asia,4638,84154,133
2020-06-03T00:00:00Z,3,6,2020,5,0,China,CN,CHN,1433783692,Asia,4638,84159,134
2020-06-04T00:00:00Z,4,6,2020,1,0,China,CN,CHN,1433783692,Asia,4638,84160,135
2020-06-05T00:00:00Z,5,6,2020,11,0,China,CN,CHN,1433783692,Asia,4638,84171,136
2020-06-06T00:00:00Z,6,6,2020,6,0,China,CN,CHN,1433783692,Asia,4638,84177,137
2020-06-07T00:00:00Z,7,6,2020,9,0,China,CN,CHN,1433783692,Asia,4638,84186,138
2020-06-08T00:00:00Z,8,6,2020,5,0,China,CN,CHN,1433783692,Asia,4638,84191,139
2020-06-09T00:00:00Z,9,6,2020,3,0,China,CN,CHN,1433783692,Asia,4638,84194,140
2020-06-10T00:00:00Z,10,6,2020,4,0,China,CN,CHN,1433783692,Asia,4638,84198,141
2020-06-11T00:00:00Z,11,6,2020,11,0,China,CN,CHN,1433783692,Asia,4638,84209,142
2020-06-12T00:00:00Z,12,6,2020,7,0,China,CN,CHN,1433783692,Asia,4638,84216,143
2020-06-13T00:00:00Z,13,6,2020,12,0,China,CN,CHN,1433783692,Asia,4638,84228,144
2020-06-14T00:00:00Z,14,6,2020,60,0,China,CN,CHN,1433783692,Asia,4638,84288,145
2020-06-15T00:00:00Z,15,6,2020,47,0,China,CN,CHN,1433783692,Asia,4638,84335,146
2020-06-16T00:00:00Z,16,6,2020,43,0,China,CN,CHN,1433783692,Asia,4638,84378,147
2020-06-17T00:00:00Z,17,6,2020,44,0,China,CN,CHN,1433783692,Asia,4638,84422,148
2020-06-18T00:00:00Z,18,6,2020,36,0,China,CN,CHN,1433783692,Asia,4638,84458,149
2020-06-19T00:00:00Z,19,6,2020,36,0,China,CN,CHN,1433783692,Asia,4638,84494,150
2020-06-20T00:00:00Z,20,6,2020,30,0,China,CN,CHN,1433783692,Asia,4638,84524,151
2020-06-21T00:00:00Z,21,6,2020,29,1,China,CN,CHN,1433783692,Asia,4639,84553,152
2020-06-22T00:00:00Z,22,6,2020,19,0,China,CN,CHN,1433783692,Asia,4639,84572,153
2020-06-23T00:00:00Z,23,6,2020,52,0,China,CN,CHN,1433783692,Asia,4639,84624,154
2020-06-24T00:00:00Z,24,6,2020,29,1,China,CN,CHN,1433783692,Asia,4640,84653,155
2020-06-25T00:00:00Z,25,6,2020,20,0,China,CN,CHN,1433783692,Asia,4640,84673,156
2020-03-30T00:00:00Z,30,3,2020,94,4,Colombia,CO,COL,50339443,America,10,702,1
2020-03-31T00:00:00Z,31,3,2020,96,4,Colombia,CO,COL,50339443,America,14,798,2
2020-04-01T00:00:00Z,1,4,2020,108,2,Colombia,CO,COL,50339443,America,16,906,3
2020-04-02T00:00:00Z,2,4,2020,159,1,Colombia,CO,COL,50339443,America,17,1065,4
2020-04-03T00:00:00Z,3,4,2020,96,2,Colombia,CO,COL,50339443,America,19,1161,5
2020-04-04T00:00:00Z,4,4,2020,106,6,Colombia,CO,COL,50339443,America,25,1267,6
2020-04-05T00:00:00Z,5,4,2020,139,7,Colombia,CO,COL,50339443,America,32,1406,7
2020-04-06T00:00:00Z,6,4,2020,79,3,Colombia,CO,COL,50339443,America,35,1485,8
2020-04-07T00:00:00Z,7,4,2020,94,11,Colombia,CO,COL,50339443,America,46,1579,9
2020-04-08T00:00:00Z,8,4,2020,201,4,Colombia,CO,COL,50339443,America,50,1780,10
2020-04-09T00:00:00Z,9,4,2020,274,5,Colombia,CO,COL,50339443,America,55,2054,11
2020-04-10T00:00:00Z,10,4,2020,169,14,Colombia,CO,COL,50339443,America,69,2223,12
2020-04-11T00:00:00Z,11,4,2020,250,11,Colombia,CO,COL,50339443,America,80,2473,13
2020-04-12T00:00:00Z,12,4,2020,236,20,Colombia,CO,COL,50339443,America,100,2709,14
2020-04-13T00:00:00Z,13,4,2020,67,9,Colombia,CO,COL,50339443,America,109,2776,15
2020-04-14T00:00:00Z,14,4,2020,76,3,Colombia,CO,COL,50339443,America,112,2852,16
2020-04-15T00:00:00Z,15,4,2020,127,15,Colombia,CO,COL,50339443,America,127,2979,17
2020-04-16T00:00:00Z,16,4,2020,126,4,Colombia,CO,COL,50339443,America,131,3105,18
2020-04-17T00:00:00Z,17,4,2020,128,13,Colombia,CO,COL,50339443,America,144,3233,19
2020-04-18T00:00:00Z,18,4,2020,206,9,Colombia,CO,COL,50339443,America,153,3439,20
2020-04-19T00:00:00Z,19,4,2020,182,13,Colombia,CO,COL,50339443,America,166,3621,21
2020-04-20T00:00:00Z,20,4,2020,171,13,Colombia,CO,COL,50339443,America,179,3792,22
2020-04-21T00:00:00Z,21,4,2020,185,10,Colombia,CO,COL,50339443,America,189,3977,23
2020-04-22T00:00:00Z,22,4,2020,172,7,Colombia,CO,COL,50339443,America,196,4149,24
2020-04-23T00:00:00Z,23,4,2020,207,10,Colombia,CO,COL,50339443,America,206,4356,25
2020-04-24T00:00:00Z,24,4,2020,205,9,Colombia,CO,COL,50339443,America,215,4561,26
2020-04-25T00:00:00Z,25,4,2020,320,10,Colombia,CO,COL,50339443,America,225,4881,27
2020-04-26T00:00:00Z,26,4,2020,261,8,Colombia,CO,COL,50339443,America,233,5142,28
2020-04-27T00:00:00Z,27,4,2020,237,10,Colombia,CO,COL,50339443,America,243,5379,29
2020-04-28T00:00:00Z,28,4,2020,218,10,Colombia,CO,COL,50339443,America,253,5597,30
2020-04-29T00:00:00Z,29,4,2020,352,16,Colombia,CO,COL,50339443,America,269,5949,31
2020-04-30T00:00:00Z,30,4,2020,262,9,Colombia,CO,COL,50339443,America,278,6211,32
2020-05-01T00:00:00Z,1,5,2020,296,15,Colombia,CO,COL,50339443,America,293,6507,33
2020-05-02T00:00:00Z,2,5,2020,499,21,Colombia,CO,COL,50339443,America,314,7006,34
2020-05-03T00:00:00Z,3,5,2020,279,10,Colombia,CO,COL,50339443,America,324,7285,35
2020-05-04T00:00:00Z,4,5,2020,383,16,Colombia,CO,COL,50339443,America,340,7668,36
2020-05-05T00:00:00Z,5,5,2020,305,18,Colombia,CO,COL,50339443,America,358,7973,37
2020-05-06T00:00:00Z,6,5,2020,640,20,Colombia,CO,COL,50339443,America,378,8613,38
2020-05-07T00:00:00Z,7,5,2020,346,19,Colombia,CO,COL,50339443,America,397,8959,39
2020-05-08T00:00:00Z,8,5,2020,497,10,Colombia,CO,COL,50339443,America,407,9456,40
2020-05-09T00:00:00Z,9,5,2020,595,21,Colombia,CO,COL,50339443,America,428,10051,41
2020-05-10T00:00:00Z,10,5,2020,444,17,Colombia,CO,COL,50339443,America,445,10495,42
2020-05-11T00:00:00Z,11,5,2020,568,18,Colombia,CO,COL,50339443,America,463,11063,43
2020-05-12T00:00:00Z,12,5,2020,550,16,Colombia,CO,COL,50339443,America,479,11613,44
2020-05-13T00:00:00Z,13,5,2020,659,14,Colombia,CO,COL,50339443,America,493,12272,45
2020-05-14T00:00:00Z,14,5,2020,658,16,Colombia,CO,COL,50339443,America,509,12930,46
2020-05-15T00:00:00Z,15,5,2020,680,16,Colombia,CO,COL,50339443,America,525,13610,47
2020-05-16T00:00:00Z,16,5,2020,606,21,Colombia,CO,COL,50339443,America,546,14216,48
2020-05-17T00:00:00Z,17,5,2020,723,16,Colombia,CO,COL,50339443,America,562,14939,49
2020-05-18T00:00:00Z,18,5,2020,635,12,Colombia,CO,COL,50339443,America,574,15574,50
2020-05-19T00:00:00Z,19,5,2020,721,18,Colombia,CO,COL,50339443,America,592,16295,51
2020-05-20T00:00:00Z,20,5,2020,640,21,Colombia,CO,COL,50339443,America,613,16935,52
2020-05-21T00:00:00Z,21,5,2020,752,17,Colombia,CO,COL,50339443,America,630,17687,53
2020-05-22T00:00:00Z,22,5,2020,643,22,Colombia,CO,COL,50339443,America,652,18330,54
2020-05-23T00:00:00Z,23,5,2020,801,30,Colombia,CO,COL,50339443,America,682,19131,55
2020-05-24T00:00:00Z,24,5,2020,1046,23,Colombia,CO,COL,50339443,America,705,20177,56
2020-05-25T00:00:00Z,25,5,2020,998,22,Colombia,CO,COL,50339443,America,727,21175,57
2020-05-26T00:00:00Z,26,5,2020,806,23,Colombia,CO,COL,50339443,America,750,21981,58
2020-05-27T00:00:00Z,27,5,2020,1022,26,Colombia,CO,COL,50339443,America,776,23003,59
2020-05-28T00:00:00Z,28,5,2020,1101,27,Colombia,CO,COL,50339443,America,803,24104,60
2020-05-29T00:00:00Z,29,5,2020,1262,19,Colombia,CO,COL,50339443,America,822,25366,61
2020-05-30T00:00:00Z,30,5,2020,1322,31,Colombia,CO,COL,50339443,America,853,26688,62
2020-05-31T00:00:00Z,31,5,2020,1548,37,Colombia,CO,COL,50339443,America,890,28236,63
2020-06-01T00:00:00Z,1,6,2020,1147,49,Colombia,CO,COL,50339443,America,939,29383,64
2020-06-02T00:00:00Z,2,6,2020,1110,30,Colombia,CO,COL,50339443,America,969,30493,65
2020-06-03T00:00:00Z,3,6,2020,1340,40,Colombia,CO,COL,50339443,America,1009,31833,66
2020-06-04T00:00:00Z,4,6,2020,1521,36,Colombia,CO,COL,50339443,America,1045,33354,67
2020-06-05T00:00:00Z,5,6,2020,1766,42,Colombia,CO,COL,50339443,America,1087,35120,68
2020-06-06T00:00:00Z,6,6,2020,1515,58,Colombia,CO,COL,50339443,America,1145,36635,69
2020-06-07T00:00:00Z,7,6,2020,1392,60,Colombia,CO,COL,50339443,America,1205,38027,70
2020-06-08T00:00:00Z,8,6,2020,1209,54,Colombia,CO,COL,50339443,America,1259,39236,71
2020-06-09T00:00:00Z,9,6,2020,1483,49,Colombia,CO,COL,50339443,America,1308,40719,72
2020-06-10T00:00:00Z,10,6,2020,1359,64,Colombia,CO,COL,50339443,America,1372,42078,73
2020-06-11T00:00:00Z,11,6,2020,1604,61,Colombia,CO,COL,50339443,America,1433,43682,74
2020-06-12T00:00:00Z,12,6,2020,0,0,Colombia,CO,COL,50339443,America,1433,43682,75
2020-06-13T00:00:00Z,13,6,2020,3176,112,Colombia,CO,COL,50339443,America,1545,46858,76
2020-06-14T00:00:00Z,14,6,2020,1888,47,Colombia,CO,COL,50339443,America,1592,48746,77
2020-06-15T00:00:00Z,15,6,2020,2193,75,Colombia,CO,COL,50339443,America,1667,50939,78
2020-06-16T00:00:00Z,16,6,2020,2124,59,Colombia,CO,COL,50339443,America,1726,53063,79
2020-06-17T00:00:00Z,17,6,2020,1868,75,Colombia,CO,COL,50339443,America,1801,54931,80
2020-06-18T00:00:00Z,18,6,2020,2115,63,Colombia,CO,COL,50339443,America,1864,57046,81
2020-06-19T00:00:00Z,19,6,2020,3171,86,Colombia,CO,COL,50339443,America,1950,60217,82
2020-06-20T00:00:00Z,20,6,2020,3059,95,Colombia,CO,COL,50339443,America,2045,63276,83
2020-06-21T00:00:00Z,21,6,2020,2357,81,Colombia,CO,COL,50339443,America,2126,65633,84
2020-06-22T00:00:00Z,22,6,2020,3019,111,Colombia,CO,COL,50339443,America,2237,68652,85
2020-06-23T00:00:00Z,23,6,2020,2531,73,Colombia,CO,COL,50339443,America,2310,71183,86
2020-06-24T00:00:00Z,24,6,2020,2389,94,Colombia,CO,COL,50339443,America,2404,73572,87
2020-06-25T00:00:00Z,25,6,2020,3541,87,Colombia,CO,COL,50339443,America,2491,77113,88
2020-05-02T00:00:00Z,2,5,2020,9,1,Congo,CG,COG,5380504,Africa,10,229,1
2020-05-03T00:00:00Z,3,5,2020,0,0,Congo,CG,COG,5380504,Africa,10,229,2
2020-05-04T00:00:00Z,4,5,2020,0,0,Congo,CG,COG,5380504,Africa,10,229,3
2020-05-05T00:00:00Z,5,5,2020,7,0,Congo,CG,COG,5380504,Africa,10,236,4
2020-05-06T00:00:00Z,6,5,2020,0,0,Congo,CG,COG,5380504,Africa,10,236,5
2020-05-07T00:00:00Z,7,5,2020,28,0,Congo,CG,COG,5380504,Africa,10,264,6
2020-05-08T00:00:00Z,8,5,2020,10,0,Congo,CG,COG,5380504,Africa,10,274,7
2020-05-09T00:00:00Z,9,5,2020,13,0,Congo,CG,COG,5380504,Africa,10,287,8
2020-05-10T00:00:00Z,10,5,2020,0,0,Congo,CG,COG,5380504,Africa,10,287,9
2020-05-11T00:00:00Z,11,5,2020,0,0,Congo,CG,COG,5380504,Africa,10,287,10
2020-05-12T00:00:00Z,12,5,2020,46,1,Congo,CG,COG,5380504,Africa,11,333,11
2020-05-13T00:00:00Z,13,5,2020,0,0,Congo,CG,COG,5380504,Africa,11,333,12
2020-05-14T00:00:00Z,14,5,2020,8,0,Congo,CG,COG,5380504,Africa,11,341,13
2020-05-15T00:00:00Z,15,5,2020,50,4,Congo,CG,COG,5380504,Africa,15,391,14
2020-05-16T00:00:00Z,16,5,2020,0,0,Congo,CG,COG,5380504,Africa,15,391,15
2020-05-17T00:00:00Z,17,5,2020,21,0,Congo,CG,COG,5380504,Africa,15,412,16
2020-05-18T00:00:00Z,18,5,2020,0,0,Congo,CG,COG,5380504,Africa,15,412,17
2020-05-19T00:00:00Z,19,5,2020,0,0,Congo,CG,COG,5380504,Africa,15,412,18
2020-05-20T00:00:00Z,20,5,2020,8,0,Congo,CG,COG,5380504,Africa,15,420,19
2020-05-21T00:00:00Z,21,5,2020,0,0,Congo,CG,COG,5380504,Africa,15,420,20
2020-05-22T00:00:00Z,22,5,2020,49,1,Congo,CG,COG,5380504,Africa,16,469,21
2020-05-23T00:00:00Z,23,5,2020,0,0,Congo,CG,COG,5380504,Africa,16,469,22
2020-05-24T00:00:00Z,24,5,2020,18,0,Congo,CG,COG,5380504,Africa,16,487,23
2020-05-25T00:00:00Z,25,5,2020,0,0,Congo,CG,COG,5380504,Africa,16,487,24
2020-05-26T00:00:00Z,26,5,2020,44,1,Congo,CG,COG,5380504,Africa,17,531,25
2020-05-27T00:00:00Z,27,5,2020,38,2,Congo,CG,COG,5380504,Africa,19,569,26
2020-05-28T00:00:00Z,28,5,2020,2,0,Congo,CG,COG,5380504,Africa,19,571,27
2020-05-29T00:00:00Z,29,5,2020,0,0,Congo,CG,COG,5380504,Africa,19,571,28
2020-05-30T00:00:00Z,30,5,2020,16,0,Congo,CG,COG,5380504,Africa,19,587,29
2020-05-31T00:00:00Z,31,5,2020,0,0,Congo,CG,COG,5380504,Africa,19,587,30
2020-06-01T00:00:00Z,1,6,2020,24,1,Congo,CG,COG,5380504,Africa,20,611,31
2020-06-02T00:00:00Z,2,6,2020,0,0,Congo,CG,COG,5380504,Africa,20,611,32
2020-06-03T00:00:00Z,3,6,2020,0,0,Congo,CG,COG,5380504,Africa,20,611,33
2020-06-04T00:00:00Z,4,6,2020,7,0,Congo,CG,COG,5380504,Africa,20,618,34
2020-06-05T00:00:00Z,5,6,2020,17,0,Congo,CG,COG,5380504,Africa,20,635,35
2020-06-06T00:00:00Z,6,6,2020,4,0,Congo,CG,COG,5380504,Africa,20,639,36
2020-06-07T00:00:00Z,7,6,2020,44,2,Congo,CG,COG,5380504,Africa,22,683,37
2020-06-08T00:00:00Z,8,6,2020,0,0,Congo,CG,COG,5380504,Africa,22,683,38
2020-06-09T00:00:00Z,9,6,2020,0,0,Congo,CG,COG,5380504,Africa,22,683,39
2020-06-10T00:00:00Z,10,6,2020,45,2,Congo,CG,COG,5380504,Africa,24,728,40
2020-06-11T00:00:00Z,11,6,2020,17,1,Congo,CG,COG,5380504,Africa,25,745,41
2020-06-12T00:00:00Z,12,6,2020,0,0,Congo,CG,COG,5380504,Africa,25,745,42
2020-06-13T00:00:00Z,13,6,2020,0,0,Congo,CG,COG,5380504,Africa,25,745,43
2020-06-14T00:00:00Z,14,6,2020,34,0,Congo,CG,COG,5380504,Africa,25,779,44
2020-06-15T00:00:00Z,15,6,2020,0,0,Congo,CG,COG,5380504,Africa,25,779,45
2020-06-16T00:00:00Z,16,6,2020,104,2,Congo,CG,COG,5380504,Africa,27,883,46
2020-06-17T00:00:00Z,17,6,2020,0,0,Congo,CG,COG,5380504,Africa,27,883,47
2020-06-18T00:00:00Z,18,6,2020,0,0,Congo,CG,COG,5380504,Africa,27,883,48
2020-06-19T00:00:00Z,19,6,2020,0,0,Congo,CG,COG,5380504,Africa,27,883,49
2020-06-20T00:00:00Z,20,6,2020,0,0,Congo,CG,COG,5380504,Africa,27,883,50
2020-06-21T00:00:00Z,21,6,2020,130,1,Congo,CG,COG,5380504,Africa,28,1013,51
2020-06-22T00:00:00Z,22,6,2020,0,0,Congo,CG,COG,5380504,Africa,28,1013,52
2020-06-23T00:00:00Z,23,6,2020,74,9,Congo,CG,COG,5380504,Africa,37,1087,53
2020-06-24T00:00:00Z,24,6,2020,0,0,Congo,CG,COG,5380504,Africa,37,1087,54
2020-06-25T00:00:00Z,25,6,2020,0,0,Congo,CG,COG,5380504,Africa,37,1087,55
2020-05-17T00:00:00Z,17,5,2020,10,2,Costa_Rica,CR,CRI,5047561,America,10,853,1
2020-05-18T00:00:00Z,18,5,2020,10,0,Costa_Rica,CR,CRI,5047561,America,10,863,2
2020-05-19T00:00:00Z,19,5,2020,3,0,Costa_Rica,CR,CRI,5047561,America,10,866,3
2020-05-20T00:00:00Z,20,5,2020,16,0,Costa_Rica,CR,CRI,5047561,America,10,882,4
2020-05-21T00:00:00Z,21,5,2020,15,0,Costa_Rica,CR,CRI,5047561,America,10,897,5
2020-05-22T00:00:00Z,22,5,2020,6,0,Costa_Rica,CR,CRI,5047561,America,10,903,6
2020-05-23T00:00:00Z,23,5,2020,8,0,Costa_Rica,CR,CRI,5047561,America,10,911,7
2020-05-24T00:00:00Z,24,5,2020,7,0,Costa_Rica,CR,CRI,5047561,America,10,918,8
2020-05-25T00:00:00Z,25,5,2020,12,0,Costa_Rica,CR,CRI,5047561,America,10,930,9
2020-05-26T00:00:00Z,26,5,2020,21,0,Costa_Rica,CR,CRI,5047561,America,10,951,10
2020-05-27T00:00:00Z,27,5,2020,5,0,Costa_Rica,CR,CRI,5047561,America,10,956,11
2020-05-28T00:00:00Z,28,5,2020,28,0,Costa_Rica,CR,CRI,5047561,America,10,984,12
2020-05-29T00:00:00Z,29,5,2020,16,0,Costa_Rica,CR,CRI,5047561,America,10,1000,13
2020-05-30T00:00:00Z,30,5,2020,22,0,Costa_Rica,CR,CRI,5047561,America,10,1022,14
2020-05-31T00:00:00Z,31,5,2020,25,0,Costa_Rica,CR,CRI,5047561,America,10,1047,15
2020-06-01T00:00:00Z,1,6,2020,9,0,Costa_Rica,CR,CRI,5047561,America,10,1056,16
2020-06-02T00:00:00Z,2,6,2020,28,0,Costa_Rica,CR,CRI,5047561,America,10,1084,17
2020-06-03T00:00:00Z,3,6,2020,21,0,Costa_Rica,CR,CRI,5047561,America,10,1105,18
2020-06-04T00:00:00Z,4,6,2020,52,0,Costa_Rica,CR,CRI,5047561,America,10,1157,19
2020-06-05T00:00:00Z,5,6,2020,37,0,Costa_Rica,CR,CRI,5047561,America,10,1194,20
2020-06-06T00:00:00Z,6,6,2020,34,0,Costa_Rica,CR,CRI,5047561,America,10,1228,21
2020-06-07T00:00:00Z,7,6,2020,35,0,Costa_Rica,CR,CRI,5047561,America,10,1263,22
2020-06-08T00:00:00Z,8,6,2020,55,0,Costa_Rica,CR,CRI,5047561,America,10,1318,23
2020-06-09T00:00:00Z,9,6,2020,24,0,Costa_Rica,CR,CRI,5047561,America,10,1342,24
2020-06-10T00:00:00Z,10,6,2020,33,1,Costa_Rica,CR,CRI,5047561,America,11,1375,25
2020-06-11T00:00:00Z,11,6,2020,86,1,Costa_Rica,CR,CRI,5047561,America,12,1461,26
2020-06-12T00:00:00Z,12,6,2020,77,0,Costa_Rica,CR,CRI,5047561,America,12,1538,27
2020-06-13T00:00:00Z,13,6,2020,74,0,Costa_Rica,CR,CRI,5047561,America,12,1612,28
2020-06-14T00:00:00Z,14,6,2020,50,0,Costa_Rica,CR,CRI,5047561,America,12,1662,29
2020-06-15T00:00:00Z,15,6,2020,53,0,Costa_Rica,CR,CRI,5047561,America,12,1715,30
2020-06-16T00:00:00Z,16,6,2020,29,0,Costa_Rica,CR,CRI,5047561,America,12,1744,31
2020-06-17T00:00:00Z,17,6,2020,25,0,Costa_Rica,CR,CRI,5047561,America,12,1769,32
2020-06-18T00:00:00Z,18,6,2020,102,0,Costa_Rica,CR,CRI,5047561,America,12,1871,33
2020-06-19T00:00:00Z,19,6,2020,0,0,Costa_Rica,CR,CRI,5047561,America,12,1871,34
2020-06-20T00:00:00Z,20,6,2020,187,0,Costa_Rica,CR,CRI,5047561,America,12,2058,35
2020-06-21T00:00:00Z,21,6,2020,69,0,Costa_Rica,CR,CRI,5047561,America,12,2127,36
2020-06-22T00:00:00Z,22,6,2020,86,0,Costa_Rica,CR,CRI,5047561,America,12,2213,37
2020-06-23T00:00:00Z,23,6,2020,64,0,Costa_Rica,CR,CRI,5047561,America,12,2277,38
2020-06-24T00:00:00Z,24,6,2020,91,0,Costa_Rica,CR,CRI,5047561,America,12,2368,39
2020-06-25T00:00:00Z,25,6,2020,147,0,Costa_Rica,CR,CRI,5047561,America,12,2515,40
2020-04-21T00:00:00Z,21,4,2020,32,1,Cote_dIvoire,CI,CIV,25716554,Africa,10,879,1
2020-04-22T00:00:00Z,22,4,2020,37,3,Cote_dIvoire,CI,CIV,25716554,Africa,13,916,2
2020-04-23T00:00:00Z,23,4,2020,36,1,Cote_dIvoire,CI,CIV,25716554,Africa,14,952,3
2020-04-24T00:00:00Z,24,4,2020,52,0,Cote_dIvoire,CI,CIV,25716554,Africa,14,1004,4
2020-04-25T00:00:00Z,25,4,2020,73,0,Cote_dIvoire,CI,CIV,25716554,Africa,14,1077,5
2020-04-26T00:00:00Z,26,4,2020,34,0,Cote_dIvoire,CI,CIV,25716554,Africa,14,1111,6
2020-04-27T00:00:00Z,27,4,2020,39,0,Cote_dIvoire,CI,CIV,25716554,Africa,14,1150,7
2020-04-28T00:00:00Z,28,4,2020,14,0,Cote_dIvoire,CI,CIV,25716554,Africa,14,1164,8
2020-04-29T00:00:00Z,29,4,2020,19,0,Cote_dIvoire,CI,CIV,25716554,Africa,14,1183,9
2020-04-30T00:00:00Z,30,4,2020,55,0,Cote_dIvoire,CI,CIV,25716554,Africa,14,1238,10
2020-05-01T00:00:00Z,1,5,2020,37,0,Cote_dIvoire,CI,CIV,25716554,Africa,14,1275,11
2020-05-02T00:00:00Z,2,5,2020,58,1,Cote_dIvoire,CI,CIV,25716554,Africa,15,1333,12
2020-05-03T00:00:00Z,3,5,2020,29,0,Cote_dIvoire,CI,CIV,25716554,Africa,15,1362,13
2020-05-04T00:00:00Z,4,5,2020,36,2,Cote_dIvoire,CI,CIV,25716554,Africa,17,1398,14
2020-05-05T00:00:00Z,5,5,2020,34,0,Cote_dIvoire,CI,CIV,25716554,Africa,17,1432,15
2020-05-06T00:00:00Z,6,5,2020,32,1,Cote_dIvoire,CI,CIV,25716554,Africa,18,1464,16
2020-05-07T00:00:00Z,7,5,2020,52,0,Cote_dIvoire,CI,CIV,25716554,Africa,18,1516,17
2020-05-08T00:00:00Z,8,5,2020,55,2,Cote_dIvoire,CI,CIV,25716554,Africa,20,1571,18
2020-05-09T00:00:00Z,9,5,2020,31,0,Cote_dIvoire,CI,CIV,25716554,Africa,20,1602,19
2020-05-10T00:00:00Z,10,5,2020,65,1,Cote_dIvoire,CI,CIV,25716554,Africa,21,1667,20
2020-05-11T00:00:00Z,11,5,2020,33,0,Cote_dIvoire,CI,CIV,25716554,Africa,21,1700,21
2020-05-12T00:00:00Z,12,5,2020,30,0,Cote_dIvoire,CI,CIV,25716554,Africa,21,1730,22
2020-05-13T00:00:00Z,13,5,2020,127,0,Cote_dIvoire,CI,CIV,25716554,Africa,21,1857,23
2020-05-14T00:00:00Z,14,5,2020,55,3,Cote_dIvoire,CI,CIV,25716554,Africa,24,1912,24
2020-05-15T00:00:00Z,15,5,2020,59,0,Cote_dIvoire,CI,CIV,25716554,Africa,24,1971,25
2020-05-16T00:00:00Z,16,5,2020,46,0,Cote_dIvoire,CI,CIV,25716554,Africa,24,2017,26
2020-05-17T00:00:00Z,17,5,2020,44,1,Cote_dIvoire,CI,CIV,25716554,Africa,25,2061,27
2020-05-18T00:00:00Z,18,5,2020,48,2,Cote_dIvoire,CI,CIV,25716554,Africa,27,2109,28
2020-05-19T00:00:00Z,19,5,2020,10,1,Cote_dIvoire,CI,CIV,25716554,Africa,28,2119,29
2020-05-20T00:00:00Z,20,5,2020,34,0,Cote_dIvoire,CI,CIV,25716554,Africa,28,2153,30
2020-05-21T00:00:00Z,21,5,2020,78,1,Cote_dIvoire,CI,CIV,25716554,Africa,29,2231,31
2020-05-22T00:00:00Z,22,5,2020,0,0,Cote_dIvoire,CI,CIV,25716554,Africa,29,2231,32
2020-05-23T00:00:00Z,23,5,2020,70,0,Cote_dIvoire,CI,CIV,25716554,Africa,29,2301,33
2020-05-24T00:00:00Z,24,5,2020,65,1,Cote_dIvoire,CI,CIV,25716554,Africa,30,2366,34
2020-05-25T00:00:00Z,25,5,2020,10,0,Cote_dIvoire,CI,CIV,25716554,Africa,30,2376,35
2020-05-26T00:00:00Z,26,5,2020,47,0,Cote_dIvoire,CI,CIV,25716554,Africa,30,2423,36
2020-05-27T00:00:00Z,27,5,2020,54,0,Cote_dIvoire,CI,CIV,25716554,Africa,30,2477,37
2020-05-28T00:00:00Z,28,5,2020,79,1,Cote_dIvoire,CI,CIV,25716554,Africa,31,2556,38
2020-05-29T00:00:00Z,29,5,2020,85,1,Cote_dIvoire,CI,CIV,25716554,Africa,32,2641,39
2020-05-30T00:00:00Z,30,5,2020,109,0,Cote_dIvoire,CI,CIV,25716554,Africa,32,2750,40
2020-05-31T00:00:00Z,31,5,2020,49,1,Cote_dIvoire,CI,CIV,25716554,Africa,33,2799,41
2020-06-01T00:00:00Z,1,6,2020,34,0,Cote_dIvoire,CI,CIV,25716554,Africa,33,2833,42
2020-06-02T00:00:00Z,2,6,2020,118,0,Cote_dIvoire,CI,CIV,25716554,Africa,33,2951,43
2020-06-03T00:00:00Z,3,6,2020,73,0,Cote_dIvoire,CI,CIV,25716554,Africa,33,3024,44
2020-06-04T00:00:00Z,4,6,2020,0,0,Cote_dIvoire,CI,CIV,25716554,Africa,33,3024,45
2020-06-05T00:00:00Z,5,6,2020,238,2,Cote_dIvoire,CI,CIV,25716554,Africa,35,3262,46
2020-06-06T00:00:00Z,6,6,2020,169,1,Cote_dIvoire,CI,CIV,25716554,Africa,36,3431,47
2020-06-07T00:00:00Z,7,6,2020,126,0,Cote_dIvoire,CI,CIV,25716554,Africa,36,3557,48
2020-06-08T00:00:00Z,8,6,2020,182,0,Cote_dIvoire,CI,CIV,25716554,Africa,36,3739,49
2020-06-09T00:00:00Z,9,6,2020,142,2,Cote_dIvoire,CI,CIV,25716554,Africa,38,3881,50
2020-06-10T00:00:00Z,10,6,2020,114,0,Cote_dIvoire,CI,CIV,25716554,Africa,38,3995,51
2020-06-11T00:00:00Z,11,6,2020,186,3,Cote_dIvoire,CI,CIV,25716554,Africa,41,4181,52
2020-06-12T00:00:00Z,12,6,2020,223,0,Cote_dIvoire,CI,CIV,25716554,Africa,41,4404,53
2020-06-13T00:00:00Z,13,6,2020,280,4,Cote_dIvoire,CI,CIV,25716554,Africa,45,4684,54
2020-06-14T00:00:00Z,14,6,2020,164,0,Cote_dIvoire,CI,CIV,25716554,Africa,45,4848,55
2020-06-15T00:00:00Z,15,6,2020,236,0,Cote_dIvoire,CI,CIV,25716554,Africa,45,5084,56
2020-06-16T00:00:00Z,16,6,2020,355,1,Cote_dIvoire,CI,CIV,25716554,Africa,46,5439,57
2020-06-17T00:00:00Z,17,6,2020,240,0,Cote_dIvoire,CI,CIV,25716554,Africa,46,5679,58
2020-06-18T00:00:00Z,18,6,2020,384,2,Cote_dIvoire,CI,CIV,25716554,Africa,48,6063,59
2020-06-19T00:00:00Z,19,6,2020,0,0,Cote_dIvoire,CI,CIV,25716554,Africa,48,6063,60
2020-06-20T00:00:00Z,20,6,2020,381,1,Cote_dIvoire,CI,CIV,25716554,Africa,49,6444,61
2020-06-21T00:00:00Z,21,6,2020,430,0,Cote_dIvoire,CI,CIV,25716554,Africa,49,6874,62
2020-06-22T00:00:00Z,22,6,2020,618,2,Cote_dIvoire,CI,CIV,25716554,Africa,51,7492,63
2020-06-23T00:00:00Z,23,6,2020,0,3,Cote_dIvoire,CI,CIV,25716554,Africa,54,7492,64
2020-06-24T00:00:00Z,24,6,2020,412,4,Cote_dIvoire,CI,CIV,25716554,Africa,58,7904,65
2020-06-25T00:00:00Z,25,6,2020,0,0,Cote_dIvoire,CI,CIV,25716554,Africa,58,7904,66
2020-04-05T00:00:00Z,5,4,2020,47,4,Croatia,HR,HRV,4076246,Europe,12,1126,1
2020-04-06T00:00:00Z,6,4,2020,56,3,Croatia,HR,HRV,4076246,Europe,15,1182,2
2020-04-07T00:00:00Z,7,4,2020,40,1,Croatia,HR,HRV,4076246,Europe,16,1222,3
2020-04-08T00:00:00Z,8,4,2020,60,2,Croatia,HR,HRV,4076246,Europe,18,1282,4
2020-04-09T00:00:00Z,9,4,2020,61,1,Croatia,HR,HRV,4076246,Europe,19,1343,5
2020-04-10T00:00:00Z,10,4,2020,64,1,Croatia,HR,HRV,4076246,Europe,20,1407,6
2020-04-11T00:00:00Z,11,4,2020,88,1,Croatia,HR,HRV,4076246,Europe,21,1495,7
2020-04-12T00:00:00Z,12,4,2020,39,0,Croatia,HR,HRV,4076246,Europe,21,1534,8
2020-04-13T00:00:00Z,13,4,2020,66,2,Croatia,HR,HRV,4076246,Europe,23,1600,9
2020-04-14T00:00:00Z,14,4,2020,50,2,Croatia,HR,HRV,4076246,Europe,25,1650,10
2020-04-15T00:00:00Z,15,4,2020,54,6,Croatia,HR,HRV,4076246,Europe,31,1704,11
2020-04-16T00:00:00Z,16,4,2020,37,3,Croatia,HR,HRV,4076246,Europe,34,1741,12
2020-04-17T00:00:00Z,17,4,2020,50,1,Croatia,HR,HRV,4076246,Europe,35,1791,13
2020-04-18T00:00:00Z,18,4,2020,23,1,Croatia,HR,HRV,4076246,Europe,36,1814,14
2020-04-19T00:00:00Z,19,4,2020,18,3,Croatia,HR,HRV,4076246,Europe,39,1832,15
2020-04-20T00:00:00Z,20,4,2020,39,8,Croatia,HR,HRV,4076246,Europe,47,1871,16
2020-04-21T00:00:00Z,21,4,2020,10,0,Croatia,HR,HRV,4076246,Europe,47,1881,17
2020-04-22T00:00:00Z,22,4,2020,27,1,Croatia,HR,HRV,4076246,Europe,48,1908,18
2020-04-23T00:00:00Z,23,4,2020,42,0,Croatia,HR,HRV,4076246,Europe,48,1950,19
2020-04-24T00:00:00Z,24,4,2020,31,2,Croatia,HR,HRV,4076246,Europe,50,1981,20
2020-04-25T00:00:00Z,25,4,2020,28,1,Croatia,HR,HRV,4076246,Europe,51,2009,21
2020-04-26T00:00:00Z,26,4,2020,7,3,Croatia,HR,HRV,4076246,Europe,54,2016,22
2020-04-27T00:00:00Z,27,4,2020,14,1,Croatia,HR,HRV,4076246,Europe,55,2030,23
2020-04-28T00:00:00Z,28,4,2020,9,4,Croatia,HR,HRV,4076246,Europe,59,2039,24
2020-04-29T00:00:00Z,29,4,2020,8,4,Croatia,HR,HRV,4076246,Europe,63,2047,25
2020-04-30T00:00:00Z,30,4,2020,15,4,Croatia,HR,HRV,4076246,Europe,67,2062,26
2020-05-01T00:00:00Z,1,5,2020,14,2,Croatia,HR,HRV,4076246,Europe,69,2076,27
2020-05-02T00:00:00Z,2,5,2020,9,6,Croatia,HR,HRV,4076246,Europe,75,2085,28
2020-05-03T00:00:00Z,3,5,2020,3,2,Croatia,HR,HRV,4076246,Europe,77,2088,29
2020-05-04T00:00:00Z,4,5,2020,8,2,Croatia,HR,HRV,4076246,Europe,79,2096,30
2020-05-05T00:00:00Z,5,5,2020,5,1,Croatia,HR,HRV,4076246,Europe,80,2101,31
2020-05-06T00:00:00Z,6,5,2020,11,3,Croatia,HR,HRV,4076246,Europe,83,2112,32
2020-05-07T00:00:00Z,7,5,2020,7,2,Croatia,HR,HRV,4076246,Europe,85,2119,33
2020-05-08T00:00:00Z,8,5,2020,6,1,Croatia,HR,HRV,4076246,Europe,86,2125,34
2020-05-09T00:00:00Z,9,5,2020,36,0,Croatia,HR,HRV,4076246,Europe,86,2161,35
2020-05-10T00:00:00Z,10,5,2020,15,1,Croatia,HR,HRV,4076246,Europe,87,2176,36
2020-05-11T00:00:00Z,11,5,2020,11,3,Croatia,HR,HRV,4076246,Europe,90,2187,37
2020-05-12T00:00:00Z,12,5,2020,9,1,Croatia,HR,HRV,4076246,Europe,91,2196,38
2020-05-13T00:00:00Z,13,5,2020,11,0,Croatia,HR,HRV,4076246,Europe,91,2207,39
2020-05-14T00:00:00Z,14,5,2020,6,3,Croatia,HR,HRV,4076246,Europe,94,2213,40
2020-05-15T00:00:00Z,15,5,2020,8,0,Croatia,HR,HRV,4076246,Europe,94,2221,41
2020-05-16T00:00:00Z,16,5,2020,1,1,Croatia,HR,HRV,4076246,Europe,95,2222,42
2020-05-17T00:00:00Z,17,5,2020,2,0,Croatia,HR,HRV,4076246,Europe,95,2224,43
2020-05-18T00:00:00Z,18,5,2020,2,0,Croatia,HR,HRV,4076246,Europe,95,2226,44
2020-05-19T00:00:00Z,19,5,2020,2,0,Croatia,HR,HRV,4076246,Europe,95,2228,45
2020-05-20T00:00:00Z,20,5,2020,4,1,Croatia,HR,HRV,4076246,Europe,96,2232,46
2020-05-21T00:00:00Z,21,5,2020,2,0,Croatia,HR,HRV,4076246,Europe,96,2234,47
2020-05-22T00:00:00Z,22,5,2020,3,1,Croatia,HR,HRV,4076246,Europe,97,2237,48
2020-05-23T00:00:00Z,23,5,2020,6,2,Croatia,HR,HRV,4076246,Europe,99,2243,49
2020-05-24T00:00:00Z,24,5,2020,0,0,Croatia,HR,HRV,4076246,Europe,99,2243,50
2020-05-25T00:00:00Z,25,5,2020,1,0,Croatia,HR,HRV,4076246,Europe,99,2244,51
2020-05-26T00:00:00Z,26,5,2020,0,1,Croatia,HR,HRV,4076246,Europe,100,2244,52
2020-05-27T00:00:00Z,27,5,2020,0,1,Croatia,HR,HRV,4076246,Europe,101,2244,53
2020-05-28T00:00:00Z,28,5,2020,0,0,Croatia,HR,HRV,4076246,Europe,101,2244,54
2020-05-29T00:00:00Z,29,5,2020,1,1,Croatia,HR,HRV,4076246,Europe,102,2245,55
2020-05-30T00:00:00Z,30,5,2020,0,1,Croatia,HR,HRV,4076246,Europe,103,2245,56
2020-05-31T00:00:00Z,31,5,2020,1,0,Croatia,HR,HRV,4076246,Europe,103,2246,57
2020-06-01T00:00:00Z,1,6,2020,0,0,Croatia,HR,HRV,4076246,Europe,103,2246,58
2020-06-02T00:00:00Z,2,6,2020,0,0,Croatia,HR,HRV,4076246,Europe,103,2246,59
2020-06-03T00:00:00Z,3,6,2020,0,0,Croatia,HR,HRV,4076246,Europe,103,2246,60
2020-06-04T00:00:00Z,4,6,2020,0,0,Croatia,HR,HRV,4076246,Europe,103,2246,61
2020-06-05T00:00:00Z,5,6,2020,1,0,Croatia,HR,HRV,4076246,Europe,103,2247,62
2020-06-06T00:00:00Z,6,6,2020,0,0,Croatia,HR,HRV,4076246,Europe,103,2247,63
2020-06-07T00:00:00Z,7,6,2020,0,1,Croatia,HR,HRV,4076246,Europe,104,2247,64
2020-06-08T00:00:00Z,8,6,2020,0,0,Croatia,HR,HRV,4076246,Europe,104,2247,65
2020-06-09T00:00:00Z,9,6,2020,0,0,Croatia,HR,HRV,4076246,Europe,104,2247,66
2020-06-10T00:00:00Z,10,6,2020,0,2,Croatia,HR,HRV,4076246,Europe,106,2247,67
2020-06-11T00:00:00Z,11,6,2020,2,0,Croatia,HR,HRV,4076246,Europe,106,2249,68
2020-06-12T00:00:00Z,12,6,2020,0,0,Croatia,HR,HRV,4076246,Europe,106,2249,69
2020-06-13T00:00:00Z,13,6,2020,0,1,Croatia,HR,HRV,4076246,Europe,107,2249,70
2020-06-14T00:00:00Z,14,6,2020,2,0,Croatia,HR,HRV,4076246,Europe,107,2251,71
2020-06-15T00:00:00Z,15,6,2020,1,0,Croatia,HR,HRV,4076246,Europe,107,2252,72
2020-06-16T00:00:00Z,16,6,2020,2,0,Croatia,HR,HRV,4076246,Europe,107,2254,73
2020-06-17T00:00:00Z,17,6,2020,1,0,Croatia,HR,HRV,4076246,Europe,107,2255,74
2020-06-18T00:00:00Z,18,6,2020,3,0,Croatia,HR,HRV,4076246,Europe,107,2258,75
2020-06-19T00:00:00Z,19,6,2020,11,0,Croatia,HR,HRV,4076246,Europe,107,2269,76
2020-06-20T00:00:00Z,20,6,2020,11,0,Croatia,HR,HRV,4076246,Europe,107,2280,77
2020-06-21T00:00:00Z,21,6,2020,19,0,Croatia,HR,HRV,4076246,Europe,107,2299,78
2020-06-22T00:00:00Z,22,6,2020,18,0,Croatia,HR,HRV,4076246,Europe,107,2317,79
2020-06-23T00:00:00Z,23,6,2020,19,0,Croatia,HR,HRV,4076246,Europe,107,2336,80
2020-06-24T00:00:00Z,24,6,2020,30,0,Croatia,HR,HRV,4076246,Europe,107,2366,81
2020-06-25T00:00:00Z,25,6,2020,22,0,Croatia,HR,HRV,4076246,Europe,107,2388,82
2020-04-08T00:00:00Z,8,4,2020,46,2,Cuba,CU,CUB,11333484,America,11,396,1
2020-04-09T00:00:00Z,9,4,2020,61,1,Cuba,CU,CUB,11333484,America,12,457,2
2020-04-10T00:00:00Z,10,4,2020,58,3,Cuba,CU,CUB,11333484,America,15,515,3
2020-04-11T00:00:00Z,11,4,2020,49,0,Cuba,CU,CUB,11333484,America,15,564,4
2020-04-12T00:00:00Z,12,4,2020,56,1,Cuba,CU,CUB,11333484,America,16,620,5
2020-04-13T00:00:00Z,13,4,2020,49,2,Cuba,CU,CUB,11333484,America,18,669,6
2020-04-14T00:00:00Z,14,4,2020,57,3,Cuba,CU,CUB,11333484,America,21,726,7
2020-04-15T00:00:00Z,15,4,2020,40,0,Cuba,CU,CUB,11333484,America,21,766,8
2020-04-16T00:00:00Z,16,4,2020,48,3,Cuba,CU,CUB,11333484,America,24,814,9
2020-04-17T00:00:00Z,17,4,2020,48,3,Cuba,CU,CUB,11333484,America,27,862,10
2020-04-18T00:00:00Z,18,4,2020,61,4,Cuba,CU,CUB,11333484,America,31,923,11
2020-04-19T00:00:00Z,19,4,2020,63,1,Cuba,CU,CUB,11333484,America,32,986,12
2020-04-20T00:00:00Z,20,4,2020,49,2,Cuba,CU,CUB,11333484,America,34,1035,13
2020-04-21T00:00:00Z,21,4,2020,52,2,Cuba,CU,CUB,11333484,America,36,1087,14
2020-04-22T00:00:00Z,22,4,2020,50,2,Cuba,CU,CUB,11333484,America,38,1137,15
2020-04-23T00:00:00Z,23,4,2020,52,2,Cuba,CU,CUB,11333484,America,40,1189,16
2020-04-24T00:00:00Z,24,4,2020,46,3,Cuba,CU,CUB,11333484,America,43,1235,17
2020-04-25T00:00:00Z,25,4,2020,50,6,Cuba,CU,CUB,11333484,America,49,1285,18
2020-04-26T00:00:00Z,26,4,2020,52,2,Cuba,CU,CUB,11333484,America,51,1337,19
2020-04-27T00:00:00Z,27,4,2020,32,3,Cuba,CU,CUB,11333484,America,54,1369,20
2020-04-28T00:00:00Z,28,4,2020,20,2,Cuba,CU,CUB,11333484,America,56,1389,21
2020-04-29T00:00:00Z,29,4,2020,48,2,Cuba,CU,CUB,11333484,America,58,1437,22
2020-04-30T00:00:00Z,30,4,2020,30,0,Cuba,CU,CUB,11333484,America,58,1467,23
2020-05-01T00:00:00Z,1,5,2020,34,3,Cuba,CU,CUB,11333484,America,61,1501,24
2020-05-02T00:00:00Z,2,5,2020,36,3,Cuba,CU,CUB,11333484,America,64,1537,25
2020-05-03T00:00:00Z,3,5,2020,74,2,Cuba,CU,CUB,11333484,America,66,1611,26
2020-05-04T00:00:00Z,4,5,2020,38,1,Cuba,CU,CUB,11333484,America,67,1649,27
2020-05-05T00:00:00Z,5,5,2020,19,2,Cuba,CU,CUB,11333484,America,69,1668,28
2020-05-06T00:00:00Z,6,5,2020,17,0,Cuba,CU,CUB,11333484,America,69,1685,29
2020-05-07T00:00:00Z,7,5,2020,18,0,Cuba,CU,CUB,11333484,America,69,1703,30
2020-05-08T00:00:00Z,8,5,2020,26,4,Cuba,CU,CUB,11333484,America,73,1729,31
2020-05-09T00:00:00Z,9,5,2020,12,1,Cuba,CU,CUB,11333484,America,74,1741,32
2020-05-10T00:00:00Z,10,5,2020,13,0,Cuba,CU,CUB,11333484,America,74,1754,33
2020-05-11T00:00:00Z,11,5,2020,12,3,Cuba,CU,CUB,11333484,America,77,1766,34
2020-05-12T00:00:00Z,12,5,2020,17,0,Cuba,CU,CUB,11333484,America,77,1783,35
2020-05-13T00:00:00Z,13,5,2020,21,1,Cuba,CU,CUB,11333484,America,78,1804,36
2020-05-14T00:00:00Z,14,5,2020,6,1,Cuba,CU,CUB,11333484,America,79,1810,37
2020-05-15T00:00:00Z,15,5,2020,20,0,Cuba,CU,CUB,11333484,America,79,1830,38
2020-05-16T00:00:00Z,16,5,2020,10,0,Cuba,CU,CUB,11333484,America,79,1840,39
2020-05-17T00:00:00Z,17,5,2020,22,0,Cuba,CU,CUB,11333484,America,79,1862,40
2020-05-18T00:00:00Z,18,5,2020,10,0,Cuba,CU,CUB,11333484,America,79,1872,41
2020-05-19T00:00:00Z,19,5,2020,9,0,Cuba,CU,CUB,11333484,America,79,1881,42
2020-05-20T00:00:00Z,20,5,2020,6,0,Cuba,CU,CUB,11333484,America,79,1887,43
2020-05-21T00:00:00Z,21,5,2020,13,0,Cuba,CU,CUB,11333484,America,79,1900,44
2020-05-22T00:00:00Z,22,5,2020,8,1,Cuba,CU,CUB,11333484,America,80,1908,45
2020-05-23T00:00:00Z,23,5,2020,8,1,Cuba,CU,CUB,11333484,America,81,1916,46
2020-05-24T00:00:00Z,24,5,2020,15,0,Cuba,CU,CUB,11333484,America,81,1931,47
2020-05-25T00:00:00Z,25,5,2020,10,1,Cuba,CU,CUB,11333484,America,82,1941,48
2020-05-26T00:00:00Z,26,5,2020,6,0,Cuba,CU,CUB,11333484,America,82,1947,49
2020-05-27T00:00:00Z,27,5,2020,16,0,Cuba,CU,CUB,11333484,America,82,1963,50
2020-05-28T00:00:00Z,28,5,2020,11,0,Cuba,CU,CUB,11333484,America,82,1974,51
2020-05-29T00:00:00Z,29,5,2020,9,0,Cuba,CU,CUB,11333484,America,82,1983,52
2020-05-30T00:00:00Z,30,5,2020,22,0,Cuba,CU,CUB,11333484,America,82,2005,53
2020-05-31T00:00:00Z,31,5,2020,20,1,Cuba,CU,CUB,11333484,America,83,2025,54
2020-06-01T00:00:00Z,1,6,2020,20,0,Cuba,CU,CUB,11333484,America,83,2045,55
2020-06-02T00:00:00Z,2,6,2020,38,0,Cuba,CU,CUB,11333484,America,83,2083,56
2020-06-03T00:00:00Z,3,6,2020,9,0,Cuba,CU,CUB,11333484,America,83,2092,57
2020-06-04T00:00:00Z,4,6,2020,15,0,Cuba,CU,CUB,11333484,America,83,2107,58
2020-06-05T00:00:00Z,5,6,2020,12,0,Cuba,CU,CUB,11333484,America,83,2119,59
2020-06-06T00:00:00Z,6,6,2020,14,0,Cuba,CU,CUB,11333484,America,83,2133,60
2020-06-07T00:00:00Z,7,6,2020,40,0,Cuba,CU,CUB,11333484,America,83,2173,61
2020-06-08T00:00:00Z,8,6,2020,18,0,Cuba,CU,CUB,11333484,America,83,2191,62
2020-06-09T00:00:00Z,9,6,2020,9,0,Cuba,CU,CUB,11333484,America,83,2200,63
2020-06-10T00:00:00Z,10,6,2020,5,0,Cuba,CU,CUB,11333484,America,83,2205,64
2020-06-11T00:00:00Z,11,6,2020,6,0,Cuba,CU,CUB,11333484,America,83,2211,65
2020-06-12T00:00:00Z,12,6,2020,8,1,Cuba,CU,CUB,11333484,America,84,2219,66
2020-06-13T00:00:00Z,13,6,2020,14,0,Cuba,CU,CUB,11333484,America,84,2233,67
2020-06-14T00:00:00Z,14,6,2020,5,0,Cuba,CU,CUB,11333484,America,84,2238,68
2020-06-15T00:00:00Z,15,6,2020,10,0,Cuba,CU,CUB,11333484,America,84,2248,69
2020-06-16T00:00:00Z,16,6,2020,14,0,Cuba,CU,CUB,11333484,America,84,2262,70
2020-06-17T00:00:00Z,17,6,2020,11,0,Cuba,CU,CUB,11333484,America,84,2273,71
2020-06-18T00:00:00Z,18,6,2020,7,0,Cuba,CU,CUB,11333484,America,84,2280,72
2020-06-19T00:00:00Z,19,6,2020,15,1,Cuba,CU,CUB,11333484,America,85,2295,73
2020-06-20T00:00:00Z,20,6,2020,10,0,Cuba,CU,CUB,11333484,America,85,2305,74
2020-06-21T00:00:00Z,21,6,2020,4,0,Cuba,CU,CUB,11333484,America,85,2309,75
2020-06-22T00:00:00Z,22,6,2020,3,0,Cuba,CU,CUB,11333484,America,85,2312,76
2020-06-23T00:00:00Z,23,6,2020,3,0,Cuba,CU,CUB,11333484,America,85,2315,77
2020-06-24T00:00:00Z,24,6,2020,3,0,Cuba,CU,CUB,11333484,America,85,2318,78
2020-06-25T00:00:00Z,25,6,2020,1,0,Cuba,CU,CUB,11333484,America,85,2319,79
2020-04-10T00:00:00Z,10,4,2020,38,1,Cyprus,CY,CYP,875899,Europe,10,564,1
2020-04-11T00:00:00Z,11,4,2020,31,0,Cyprus,CY,CYP,875899,Europe,10,595,2
2020-04-12T00:00:00Z,12,4,2020,21,0,Cyprus,CY,CYP,875899,Europe,10,616,3
2020-04-13T00:00:00Z,13,4,2020,17,1,Cyprus,CY,CYP,875899,Europe,11,633,4
2020-04-14T00:00:00Z,14,4,2020,29,1,Cyprus,CY,CYP,875899,Europe,12,662,5
2020-04-15T00:00:00Z,15,4,2020,33,0,Cyprus,CY,CYP,875899,Europe,12,695,6
2020-04-16T00:00:00Z,16,4,2020,20,0,Cyprus,CY,CYP,875899,Europe,12,715,7
2020-04-17T00:00:00Z,17,4,2020,20,0,Cyprus,CY,CYP,875899,Europe,12,735,8
2020-04-18T00:00:00Z,18,4,2020,0,0,Cyprus,CY,CYP,875899,Europe,12,735,9
2020-04-19T00:00:00Z,19,4,2020,26,0,Cyprus,CY,CYP,875899,Europe,12,761,10
2020-04-20T00:00:00Z,20,4,2020,6,0,Cyprus,CY,CYP,875899,Europe,12,767,11
2020-04-21T00:00:00Z,21,4,2020,5,0,Cyprus,CY,CYP,875899,Europe,12,772,12
2020-04-22T00:00:00Z,22,4,2020,12,0,Cyprus,CY,CYP,875899,Europe,12,784,13
2020-04-23T00:00:00Z,23,4,2020,6,2,Cyprus,CY,CYP,875899,Europe,14,790,14
2020-04-24T00:00:00Z,24,4,2020,5,0,Cyprus,CY,CYP,875899,Europe,14,795,15
2020-04-25T00:00:00Z,25,4,2020,9,0,Cyprus,CY,CYP,875899,Europe,14,804,16
2020-04-26T00:00:00Z,26,4,2020,6,0,Cyprus,CY,CYP,875899,Europe,14,810,17
2020-04-27T00:00:00Z,27,4,2020,7,0,Cyprus,CY,CYP,875899,Europe,14,817,18
2020-04-28T00:00:00Z,28,4,2020,5,1,Cyprus,CY,CYP,875899,Europe,15,822,19
2020-04-29T00:00:00Z,29,4,2020,15,0,Cyprus,CY,CYP,875899,Europe,15,837,20
2020-04-30T00:00:00Z,30,4,2020,6,0,Cyprus,CY,CYP,875899,Europe,15,843,21
2020-05-01T00:00:00Z,1,5,2020,7,0,Cyprus,CY,CYP,875899,Europe,15,850,22
2020-05-02T00:00:00Z,2,5,2020,7,0,Cyprus,CY,CYP,875899,Europe,15,857,23
2020-05-03T00:00:00Z,3,5,2020,7,0,Cyprus,CY,CYP,875899,Europe,15,864,24
2020-05-04T00:00:00Z,4,5,2020,8,0,Cyprus,CY,CYP,875899,Europe,15,872,25
2020-05-05T00:00:00Z,5,5,2020,2,0,Cyprus,CY,CYP,875899,Europe,15,874,26
2020-05-06T00:00:00Z,6,5,2020,4,0,Cyprus,CY,CYP,875899,Europe,15,878,27
2020-05-07T00:00:00Z,7,5,2020,5,0,Cyprus,CY,CYP,875899,Europe,15,883,28
2020-05-08T00:00:00Z,8,5,2020,6,0,Cyprus,CY,CYP,875899,Europe,15,889,29
2020-05-09T00:00:00Z,9,5,2020,2,0,Cyprus,CY,CYP,875899,Europe,15,891,30
2020-05-10T00:00:00Z,10,5,2020,1,0,Cyprus,CY,CYP,875899,Europe,15,892,31
2020-05-11T00:00:00Z,11,5,2020,6,1,Cyprus,CY,CYP,875899,Europe,16,898,32
2020-05-12T00:00:00Z,12,5,2020,3,0,Cyprus,CY,CYP,875899,Europe,16,901,33
2020-05-13T00:00:00Z,13,5,2020,2,0,Cyprus,CY,CYP,875899,Europe,16,903,34
2020-05-14T00:00:00Z,14,5,2020,2,1,Cyprus,CY,CYP,875899,Europe,17,905,35
2020-05-15T00:00:00Z,15,5,2020,2,0,Cyprus,CY,CYP,875899,Europe,17,907,36
2020-05-16T00:00:00Z,16,5,2020,3,0,Cyprus,CY,CYP,875899,Europe,17,910,37
2020-05-17T00:00:00Z,17,5,2020,4,0,Cyprus,CY,CYP,875899,Europe,17,914,38
2020-05-18T00:00:00Z,18,5,2020,2,0,Cyprus,CY,CYP,875899,Europe,17,916,39
2020-05-19T00:00:00Z,19,5,2020,1,0,Cyprus,CY,CYP,875899,Europe,17,917,40
2020-05-20T00:00:00Z,20,5,2020,1,0,Cyprus,CY,CYP,875899,Europe,17,918,41
2020-05-21T00:00:00Z,21,5,2020,4,0,Cyprus,CY,CYP,875899,Europe,17,922,42
2020-05-22T00:00:00Z,22,5,2020,1,0,Cyprus,CY,CYP,875899,Europe,17,923,43
2020-05-23T00:00:00Z,23,5,2020,4,0,Cyprus,CY,CYP,875899,Europe,17,927,44
2020-05-24T00:00:00Z,24,5,2020,0,0,Cyprus,CY,CYP,875899,Europe,17,927,45
2020-05-25T00:00:00Z,25,5,2020,8,0,Cyprus,CY,CYP,875899,Europe,17,935,46
2020-05-26T00:00:00Z,26,5,2020,2,0,Cyprus,CY,CYP,875899,Europe,17,937,47
2020-05-27T00:00:00Z,27,5,2020,2,0,Cyprus,CY,CYP,875899,Europe,17,939,48
2020-05-28T00:00:00Z,28,5,2020,0,0,Cyprus,CY,CYP,875899,Europe,17,939,49
2020-05-29T00:00:00Z,29,5,2020,2,0,Cyprus,CY,CYP,875899,Europe,17,941,50
2020-05-30T00:00:00Z,30,5,2020,0,0,Cyprus,CY,CYP,875899,Europe,17,941,51
2020-05-31T00:00:00Z,31,5,2020,2,0,Cyprus,CY,CYP,875899,Europe,17,943,52
2020-06-01T00:00:00Z,1,6,2020,1,0,Cyprus,CY,CYP,875899,Europe,17,944,53
2020-06-02T00:00:00Z,2,6,2020,5,0,Cyprus,CY,CYP,875899,Europe,17,949,54
2020-06-03T00:00:00Z,3,6,2020,3,0,Cyprus,CY,CYP,875899,Europe,17,952,55
2020-06-04T00:00:00Z,4,6,2020,6,0,Cyprus,CY,CYP,875899,Europe,17,958,56
2020-06-05T00:00:00Z,5,6,2020,0,0,Cyprus,CY,CYP,875899,Europe,17,958,57
2020-06-06T00:00:00Z,6,6,2020,2,0,Cyprus,CY,CYP,875899,Europe,17,960,58
2020-06-07T00:00:00Z,7,6,2020,0,1,Cyprus,CY,CYP,875899,Europe,18,960,59
2020-06-08T00:00:00Z,8,6,2020,4,0,Cyprus,CY,CYP,875899,Europe,18,964,60
2020-06-09T00:00:00Z,9,6,2020,6,0,Cyprus,CY,CYP,875899,Europe,18,970,61
2020-06-10T00:00:00Z,10,6,2020,2,0,Cyprus,CY,CYP,875899,Europe,18,972,62
2020-06-11T00:00:00Z,11,6,2020,2,0,Cyprus,CY,CYP,875899,Europe,18,974,63
2020-06-12T00:00:00Z,12,6,2020,1,0,Cyprus,CY,CYP,875899,Europe,18,975,64
2020-06-13T00:00:00Z,13,6,2020,5,0,Cyprus,CY,CYP,875899,Europe,18,980,65
2020-06-14T00:00:00Z,14,6,2020,0,0,Cyprus,CY,CYP,875899,Europe,18,980,66
2020-06-15T00:00:00Z,15,6,2020,3,0,Cyprus,CY,CYP,875899,Europe,18,983,67
2020-06-16T00:00:00Z,16,6,2020,2,0,Cyprus,CY,CYP,875899,Europe,18,985,68
2020-06-17T00:00:00Z,17,6,2020,0,0,Cyprus,CY,CYP,875899,Europe,18,985,69
2020-06-18T00:00:00Z,18,6,2020,0,0,Cyprus,CY,CYP,875899,Europe,18,985,70
2020-06-19T00:00:00Z,19,6,2020,0,1,Cyprus,CY,CYP,875899,Europe,19,985,71
2020-06-20T00:00:00Z,20,6,2020,0,0,Cyprus,CY,CYP,875899,Europe,19,985,72
2020-06-21T00:00:00Z,21,6,2020,0,0,Cyprus,CY,CYP,875899,Europe,19,985,73
2020-06-22T00:00:00Z,22,6,2020,1,0,Cyprus,CY,CYP,875899,Europe,19,986,74
2020-06-23T00:00:00Z,23,6,2020,2,0,Cyprus,CY,CYP,875899,Europe,19,988,75
2020-06-24T00:00:00Z,24,6,2020,2,0,Cyprus,CY,CYP,875899,Europe,19,990,76
2020-06-25T00:00:00Z,25,6,2020,1,0,Cyprus,CY,CYP,875899,Europe,19,991,77
2020-03-29T00:00:00Z,29,3,2020,384,2,Czechia,CZ,CZE,10649800,Europe,11,2663,1
2020-03-30T00:00:00Z,30,3,2020,166,5,Czechia,CZ,CZE,10649800,Europe,16,2829,2
2020-03-31T00:00:00Z,31,3,2020,173,8,Czechia,CZ,CZE,10649800,Europe,24,3002,3
2020-04-01T00:00:00Z,1,4,2020,306,7,Czechia,CZ,CZE,10649800,Europe,31,3308,4
2020-04-02T00:00:00Z,2,4,2020,281,8,Czechia,CZ,CZE,10649800,Europe,39,3589,5
2020-04-03T00:00:00Z,3,4,2020,269,5,Czechia,CZ,CZE,10649800,Europe,44,3858,6
2020-04-04T00:00:00Z,4,4,2020,332,9,Czechia,CZ,CZE,10649800,Europe,53,4190,7
2020-04-05T00:00:00Z,5,4,2020,282,6,Czechia,CZ,CZE,10649800,Europe,59,4472,8
2020-04-06T00:00:00Z,6,4,2020,115,8,Czechia,CZ,CZE,10649800,Europe,67,4587,9
2020-04-07T00:00:00Z,7,4,2020,235,11,Czechia,CZ,CZE,10649800,Europe,78,4822,10
2020-04-08T00:00:00Z,8,4,2020,195,10,Czechia,CZ,CZE,10649800,Europe,88,5017,11
2020-04-09T00:00:00Z,9,4,2020,295,11,Czechia,CZ,CZE,10649800,Europe,99,5312,12
2020-04-10T00:00:00Z,10,4,2020,257,13,Czechia,CZ,CZE,10649800,Europe,112,5569,13
2020-04-11T00:00:00Z,11,4,2020,163,7,Czechia,CZ,CZE,10649800,Europe,119,5732,14
2020-04-12T00:00:00Z,12,4,2020,170,10,Czechia,CZ,CZE,10649800,Europe,129,5902,15
2020-04-13T00:00:00Z,13,4,2020,89,9,Czechia,CZ,CZE,10649800,Europe,138,5991,16
2020-04-14T00:00:00Z,14,4,2020,68,5,Czechia,CZ,CZE,10649800,Europe,143,6059,17
2020-04-15T00:00:00Z,15,4,2020,82,18,Czechia,CZ,CZE,10649800,Europe,161,6141,18
2020-04-16T00:00:00Z,16,4,2020,162,5,Czechia,CZ,CZE,10649800,Europe,166,6303,19
2020-04-17T00:00:00Z,17,4,2020,130,3,Czechia,CZ,CZE,10649800,Europe,169,6433,20
2020-04-18T00:00:00Z,18,4,2020,116,4,Czechia,CZ,CZE,10649800,Europe,173,6549,21
2020-04-19T00:00:00Z,19,4,2020,105,8,Czechia,CZ,CZE,10649800,Europe,181,6654,22
2020-04-20T00:00:00Z,20,4,2020,133,7,Czechia,CZ,CZE,10649800,Europe,188,6787,23
2020-04-21T00:00:00Z,21,4,2020,127,8,Czechia,CZ,CZE,10649800,Europe,196,6914,24
2020-04-22T00:00:00Z,22,4,2020,127,5,Czechia,CZ,CZE,10649800,Europe,201,7041,25
2020-04-23T00:00:00Z,23,4,2020,95,9,Czechia,CZ,CZE,10649800,Europe,210,7136,26
2020-04-24T00:00:00Z,24,4,2020,52,3,Czechia,CZ,CZE,10649800,Europe,213,7188,27
2020-04-25T00:00:00Z,25,4,2020,85,2,Czechia,CZ,CZE,10649800,Europe,215,7273,28
2020-04-26T00:00:00Z,26,4,2020,79,3,Czechia,CZ,CZE,10649800,Europe,218,7352,29
2020-04-27T00:00:00Z,27,4,2020,52,3,Czechia,CZ,CZE,10649800,Europe,221,7404,30
2020-04-28T00:00:00Z,28,4,2020,45,2,Czechia,CZ,CZE,10649800,Europe,223,7449,31
2020-04-29T00:00:00Z,29,4,2020,55,4,Czechia,CZ,CZE,10649800,Europe,227,7504,32
2020-04-30T00:00:00Z,30,4,2020,75,0,Czechia,CZ,CZE,10649800,Europe,227,7579,33
2020-05-01T00:00:00Z,1,5,2020,103,9,Czechia,CZ,CZE,10649800,Europe,236,7682,34
2020-05-02T00:00:00Z,2,5,2020,55,4,Czechia,CZ,CZE,10649800,Europe,240,7737,35
2020-05-03T00:00:00Z,3,5,2020,18,5,Czechia,CZ,CZE,10649800,Europe,245,7755,36
2020-05-04T00:00:00Z,4,5,2020,26,3,Czechia,CZ,CZE,10649800,Europe,248,7781,37
2020-05-05T00:00:00Z,5,5,2020,38,4,Czechia,CZ,CZE,10649800,Europe,252,7819,38
2020-05-06T00:00:00Z,6,5,2020,77,5,Czechia,CZ,CZE,10649800,Europe,257,7896,39
2020-05-07T00:00:00Z,7,5,2020,78,5,Czechia,CZ,CZE,10649800,Europe,262,7974,40
2020-05-08T00:00:00Z,8,5,2020,57,8,Czechia,CZ,CZE,10649800,Europe,270,8031,41
2020-05-09T00:00:00Z,9,5,2020,46,3,Czechia,CZ,CZE,10649800,Europe,273,8077,42
2020-05-10T00:00:00Z,10,5,2020,18,3,Czechia,CZ,CZE,10649800,Europe,276,8095,43
2020-05-11T00:00:00Z,11,5,2020,28,4,Czechia,CZ,CZE,10649800,Europe,280,8123,44
2020-05-12T00:00:00Z,12,5,2020,53,2,Czechia,CZ,CZE,10649800,Europe,282,8176,45
2020-05-13T00:00:00Z,13,5,2020,45,1,Czechia,CZ,CZE,10649800,Europe,283,8221,46
2020-05-14T00:00:00Z,14,5,2020,48,7,Czechia,CZ,CZE,10649800,Europe,290,8269,47
2020-05-15T00:00:00Z,15,5,2020,82,3,Czechia,CZ,CZE,10649800,Europe,293,8351,48
2020-05-16T00:00:00Z,16,5,2020,55,2,Czechia,CZ,CZE,10649800,Europe,295,8406,49
2020-05-17T00:00:00Z,17,5,2020,49,1,Czechia,CZ,CZE,10649800,Europe,296,8455,50
2020-05-18T00:00:00Z,18,5,2020,20,1,Czechia,CZ,CZE,10649800,Europe,297,8475,51
2020-05-19T00:00:00Z,19,5,2020,111,0,Czechia,CZ,CZE,10649800,Europe,297,8586,52
2020-05-20T00:00:00Z,20,5,2020,61,5,Czechia,CZ,CZE,10649800,Europe,302,8647,53
2020-05-21T00:00:00Z,21,5,2020,74,2,Czechia,CZ,CZE,10649800,Europe,304,8721,54
2020-05-22T00:00:00Z,22,5,2020,33,2,Czechia,CZ,CZE,10649800,Europe,306,8754,55
2020-05-23T00:00:00Z,23,5,2020,59,6,Czechia,CZ,CZE,10649800,Europe,312,8813,56
2020-05-24T00:00:00Z,24,5,2020,77,2,Czechia,CZ,CZE,10649800,Europe,314,8890,57
2020-05-25T00:00:00Z,25,5,2020,67,1,Czechia,CZ,CZE,10649800,Europe,315,8957,58
2020-05-26T00:00:00Z,26,5,2020,47,2,Czechia,CZ,CZE,10649800,Europe,317,9004,59
2020-05-27T00:00:00Z,27,5,2020,46,0,Czechia,CZ,CZE,10649800,Europe,317,9050,60
2020-05-28T00:00:00Z,28,5,2020,36,0,Czechia,CZ,CZE,10649800,Europe,317,9086,61
2020-05-29T00:00:00Z,29,5,2020,54,2,Czechia,CZ,CZE,10649800,Europe,319,9140,62
2020-05-30T00:00:00Z,30,5,2020,56,0,Czechia,CZ,CZE,10649800,Europe,319,9196,63
2020-05-31T00:00:00Z,31,5,2020,34,0,Czechia,CZ,CZE,10649800,Europe,319,9230,64
2020-06-01T00:00:00Z,1,6,2020,43,1,Czechia,CZ,CZE,10649800,Europe,320,9273,65
2020-06-02T00:00:00Z,2,6,2020,29,1,Czechia,CZ,CZE,10649800,Europe,321,9302,66
2020-06-03T00:00:00Z,3,6,2020,62,2,Czechia,CZ,CZE,10649800,Europe,323,9364,67
2020-06-04T00:00:00Z,4,6,2020,74,1,Czechia,CZ,CZE,10649800,Europe,324,9438,68
2020-06-05T00:00:00Z,5,6,2020,56,2,Czechia,CZ,CZE,10649800,Europe,326,9494,69
2020-06-06T00:00:00Z,6,6,2020,35,1,Czechia,CZ,CZE,10649800,Europe,327,9529,70
2020-06-07T00:00:00Z,7,6,2020,38,0,Czechia,CZ,CZE,10649800,Europe,327,9567,71
2020-06-08T00:00:00Z,8,6,2020,61,0,Czechia,CZ,CZE,10649800,Europe,327,9628,72
2020-06-09T00:00:00Z,9,6,2020,69,1,Czechia,CZ,CZE,10649800,Europe,328,9697,73
2020-06-10T00:00:00Z,10,6,2020,54,0,Czechia,CZ,CZE,10649800,Europe,328,9751,74
2020-06-11T00:00:00Z,11,6,2020,73,0,Czechia,CZ,CZE,10649800,Europe,328,9824,75
2020-06-12T00:00:00Z,12,6,2020,62,1,Czechia,CZ,CZE,10649800,Europe,329,9886,76
2020-06-13T00:00:00Z,13,6,2020,52,0,Czechia,CZ,CZE,10649800,Europe,329,9938,77
2020-06-14T00:00:00Z,14,6,2020,53,0,Czechia,CZ,CZE,10649800,Europe,329,9991,78
2020-06-15T00:00:00Z,15,6,2020,33,0,Czechia,CZ,CZE,10649800,Europe,329,10024,79
2020-06-16T00:00:00Z,16,6,2020,40,1,Czechia,CZ,CZE,10649800,Europe,330,10064,80
2020-06-17T00:00:00Z,17,6,2020,47,1,Czechia,CZ,CZE,10649800,Europe,331,10111,81
2020-06-18T00:00:00Z,18,6,2020,51,2,Czechia,CZ,CZE,10649800,Europe,333,10162,82
2020-06-19T00:00:00Z,19,6,2020,68,1,Czechia,CZ,CZE,10649800,Europe,334,10230,83
2020-06-20T00:00:00Z,20,6,2020,176,1,Czechia,CZ,CZE,10649800,Europe,335,10406,84
2020-06-21T00:00:00Z,21,6,2020,42,1,Czechia,CZ,CZE,10649800,Europe,336,10448,85
2020-06-22T00:00:00Z,22,6,2020,50,0,Czechia,CZ,CZE,10649800,Europe,336,10498,86
2020-06-23T00:00:00Z,23,6,2020,63,0,Czechia,CZ,CZE,10649800,Europe,336,10561,87
2020-06-24T00:00:00Z,24,6,2020,89,3,Czechia,CZ,CZE,10649800,Europe,339,10650,88
2020-06-25T00:00:00Z,25,6,2020,127,4,Czechia,CZ,CZE,10649800,Europe,343,10777,89
2020-04-02T00:00:00Z,2,4,2020,25,3,Democratic_Republic_of_the_Congo,CD,COD,86790568,Africa,11,123,1
2020-04-03T00:00:00Z,3,4,2020,0,0,Democratic_Republic_of_the_Congo,CD,COD,86790568,Africa,11,123,2
2020-04-04T00:00:00Z,4,4,2020,11,2,Democratic_Republic_of_the_Congo,CD,COD,86790568,Africa,13,134,3
2020-04-05T00:00:00Z,5,4,2020,20,5,Democratic_Republic_of_the_Congo,CD,COD,86790568,Africa,18,154,4
2020-04-06T00:00:00Z,6,4,2020,0,0,Democratic_Republic_of_the_Congo,CD,COD,86790568,Africa,18,154,5
2020-04-07T00:00:00Z,7,4,2020,7,0,Democratic_Republic_of_the_Congo,CD,COD,86790568,Africa,18,161,6
2020-04-08T00:00:00Z,8,4,2020,19,0,Democratic_Republic_of_the_Congo,CD,COD,86790568,Africa,18,180,7
2020-04-09T00:00:00Z,9,4,2020,3,2,Democratic_Republic_of_the_Congo,CD,COD,86790568,Africa,20,183,8
2020-04-10T00:00:00Z,10,4,2020,32,0,Democratic_Republic_of_the_Congo,CD,COD,86790568,Africa,20,215,9
2020-04-11T00:00:00Z,11,4,2020,8,0,Democratic_Republic_of_the_Congo,CD,COD,86790568,Africa,20,223,10
2020-04-12T00:00:00Z,12,4,2020,11,0,Democratic_Republic_of_the_Congo,CD,COD,86790568,Africa,20,234,11
2020-04-13T00:00:00Z,13,4,2020,0,0,Democratic_Republic_of_the_Congo,CD,COD,86790568,Africa,20,234,12
2020-04-14T00:00:00Z,14,4,2020,1,0,Democratic_Republic_of_the_Congo,CD,COD,86790568,Africa,20,235,13
2020-04-15T00:00:00Z,15,4,2020,19,1,Democratic_Republic_of_the_Congo,CD,COD,86790568,Africa,21,254,14
2020-04-16T00:00:00Z,16,4,2020,13,1,Democratic_Republic_of_the_Congo,CD,COD,86790568,Africa,22,267,15
2020-04-17T00:00:00Z,17,4,2020,20,1,Democratic_Republic_of_the_Congo,CD,COD,86790568,Africa,23,287,16
2020-04-18T00:00:00Z,18,4,2020,20,2,Democratic_Republic_of_the_Congo,CD,COD,86790568,Africa,25,307,17
2020-04-19T00:00:00Z,19,4,2020,20,0,Democratic_Republic_of_the_Congo,CD,COD,86790568,Africa,25,327,18
2020-04-20T00:00:00Z,20,4,2020,5,0,Democratic_Republic_of_the_Congo,CD,COD,86790568,Africa,25,332,19
2020-04-21T00:00:00Z,21,4,2020,18,0,Democratic_Republic_of_the_Congo,CD,COD,86790568,Africa,25,350,20
2020-04-22T00:00:00Z,22,4,2020,9,0,Democratic_Republic_of_the_Congo,CD,COD,86790568,Africa,25,359,21
2020-04-23T00:00:00Z,23,4,2020,18,0,Democratic_Republic_of_the_Congo,CD,COD,86790568,Africa,25,377,22
2020-04-24T00:00:00Z,24,4,2020,17,0,Democratic_Republic_of_the_Congo,CD,COD,86790568,Africa,25,394,23
2020-04-25T00:00:00Z,25,4,2020,22,3,Democratic_Republic_of_the_Congo,CD,COD,86790568,Africa,28,416,24
2020-04-26T00:00:00Z,26,4,2020,26,0,Democratic_Republic_of_the_Congo,CD,COD,86790568,Africa,28,442,25
2020-04-27T00:00:00Z,27,4,2020,17,0,Democratic_Republic_of_the_Congo,CD,COD,86790568,Africa,28,459,26
2020-04-28T00:00:00Z,28,4,2020,12,2,Democratic_Republic_of_the_Congo,CD,COD,86790568,Africa,30,471,27
2020-04-29T00:00:00Z,29,4,2020,20,0,Democratic_Republic_of_the_Congo,CD,COD,86790568,Africa,30,491,28
2020-04-30T00:00:00Z,30,4,2020,9,1,Democratic_Republic_of_the_Congo,CD,COD,86790568,Africa,31,500,29
2020-05-01T00:00:00Z,1,5,2020,72,0,Democratic_Republic_of_the_Congo,CD,COD,86790568,Africa,31,572,30
2020-05-02T00:00:00Z,2,5,2020,32,1,Democratic_Republic_of_the_Congo,CD,COD,86790568,Africa,32,604,31
2020-05-03T00:00:00Z,3,5,2020,70,1,Democratic_Republic_of_the_Congo,CD,COD,86790568,Africa,33,674,32
2020-05-04T00:00:00Z,4,5,2020,10,1,Democratic_Republic_of_the_Congo,CD,COD,86790568,Africa,34,684,33
2020-05-05T00:00:00Z,5,5,2020,0,0,Democratic_Republic_of_the_Congo,CD,COD,86790568,Africa,34,684,34
2020-05-06T00:00:00Z,6,5,2020,21,0,Democratic_Republic_of_the_Congo,CD,COD,86790568,Africa,34,705,35
2020-05-07T00:00:00Z,7,5,2020,158,2,Democratic_Republic_of_the_Congo,CD,COD,86790568,Africa,36,863,36
2020-05-08T00:00:00Z,8,5,2020,34,0,Democratic_Republic_of_the_Congo,CD,COD,86790568,Africa,36,897,37
2020-05-09T00:00:00Z,9,5,2020,40,3,Democratic_Republic_of_the_Congo,CD,COD,86790568,Africa,39,937,38
2020-05-10T00:00:00Z,10,5,2020,54,2,Democratic_Republic_of_the_Congo,CD,COD,86790568,Africa,41,991,39
2020-05-11T00:00:00Z,11,5,2020,33,0,Democratic_Republic_of_the_Congo,CD,COD,86790568,Africa,41,1024,40
2020-05-12T00:00:00Z,12,5,2020,78,3,Democratic_Republic_of_the_Congo,CD,COD,86790568,Africa,44,1102,41
2020-05-13T00:00:00Z,13,5,2020,67,6,Democratic_Republic_of_the_Congo,CD,COD,86790568,Africa,50,1169,42
2020-05-14T00:00:00Z,14,5,2020,73,0,Democratic_Republic_of_the_Congo,CD,COD,86790568,Africa,50,1242,43
2020-05-15T00:00:00Z,15,5,2020,56,0,Democratic_Republic_of_the_Congo,CD,COD,86790568,Africa,50,1298,44
2020-05-16T00:00:00Z,16,5,2020,71,10,Democratic_Republic_of_the_Congo,CD,COD,86790568,Africa,60,1369,45
2020-05-17T00:00:00Z,17,5,2020,85,0,Democratic_Republic_of_the_Congo,CD,COD,86790568,Africa,60,1454,46
2020-05-18T00:00:00Z,18,5,2020,0,0,Democratic_Republic_of_the_Congo,CD,COD,86790568,Africa,60,1454,47
2020-05-19T00:00:00Z,19,5,2020,175,1,Democratic_Republic_of_the_Congo,CD,COD,86790568,Africa,61,1629,48
2020-05-20T00:00:00Z,20,5,2020,102,0,Democratic_Republic_of_the_Congo,CD,COD,86790568,Africa,61,1731,49
2020-05-21T00:00:00Z,21,5,2020,104,0,Democratic_Republic_of_the_Congo,CD,COD,86790568,Africa,61,1835,50
2020-05-22T00:00:00Z,22,5,2020,110,2,Democratic_Republic_of_the_Congo,CD,COD,86790568,Africa,63,1945,51
2020-05-23T00:00:00Z,23,5,2020,80,0,Democratic_Republic_of_the_Congo,CD,COD,86790568,Africa,63,2025,52
2020-05-24T00:00:00Z,24,5,2020,116,0,Democratic_Republic_of_the_Congo,CD,COD,86790568,Africa,63,2141,53
2020-05-25T00:00:00Z,25,5,2020,156,4,Democratic_Republic_of_the_Congo,CD,COD,86790568,Africa,67,2297,54
2020-05-26T00:00:00Z,26,5,2020,0,0,Democratic_Republic_of_the_Congo,CD,COD,86790568,Africa,67,2297,55
2020-05-27T00:00:00Z,27,5,2020,248,0,Democratic_Republic_of_the_Congo,CD,COD,86790568,Africa,67,2545,56
2020-05-28T00:00:00Z,28,5,2020,114,1,Democratic_Republic_of_the_Congo,CD,COD,86790568,Africa,68,2659,57
2020-05-29T00:00:00Z,29,5,2020,173,1,Democratic_Republic_of_the_Congo,CD,COD,86790568,Africa,69,2832,58
2020-05-30T00:00:00Z,30,5,2020,1,0,Democratic_Republic_of_the_Congo,CD,COD,86790568,Africa,69,2833,59
2020-05-31T00:00:00Z,31,5,2020,133,0,Democratic_Republic_of_the_Congo,CD,COD,86790568,Africa,69,2966,60
2020-06-01T00:00:00Z,1,6,2020,83,2,Democratic_Republic_of_the_Congo,CD,COD,86790568,Africa,71,3049,61
2020-06-02T00:00:00Z,2,6,2020,145,1,Democratic_Republic_of_the_Congo,CD,COD,86790568,Africa,72,3194,62
2020-06-03T00:00:00Z,3,6,2020,131,0,Democratic_Republic_of_the_Congo,CD,COD,86790568,Africa,72,3325,63
2020-06-04T00:00:00Z,4,6,2020,169,3,Democratic_Republic_of_the_Congo,CD,COD,86790568,Africa,75,3494,64
2020-06-05T00:00:00Z,5,6,2020,149,3,Democratic_Republic_of_the_Congo,CD,COD,86790568,Africa,78,3643,65
2020-06-06T00:00:00Z,6,6,2020,121,3,Democratic_Republic_of_the_Congo,CD,COD,86790568,Africa,81,3764,66
2020-06-07T00:00:00Z,7,6,2020,114,0,Democratic_Republic_of_the_Congo,CD,COD,86790568,Africa,81,3878,67
2020-06-08T00:00:00Z,8,6,2020,138,4,Democratic_Republic_of_the_Congo,CD,COD,86790568,Africa,85,4016,68
2020-06-09T00:00:00Z,9,6,2020,89,2,Democratic_Republic_of_the_Congo,CD,COD,86790568,Africa,87,4105,69
2020-06-10T00:00:00Z,10,6,2020,153,2,Democratic_Republic_of_the_Congo,CD,COD,86790568,Africa,89,4258,70
2020-06-11T00:00:00Z,11,6,2020,131,6,Democratic_Republic_of_the_Congo,CD,COD,86790568,Africa,95,4389,71
2020-06-12T00:00:00Z,12,6,2020,125,2,Democratic_Republic_of_the_Congo,CD,COD,86790568,Africa,97,4514,72
2020-06-13T00:00:00Z,13,6,2020,122,3,Democratic_Republic_of_the_Congo,CD,COD,86790568,Africa,100,4636,73
2020-06-14T00:00:00Z,14,6,2020,87,5,Democratic_Republic_of_the_Congo,CD,COD,86790568,Africa,105,4723,74
2020-06-15T00:00:00Z,15,6,2020,54,1,Democratic_Republic_of_the_Congo,CD,COD,86790568,Africa,106,4777,75
2020-06-16T00:00:00Z,16,6,2020,60,6,Democratic_Republic_of_the_Congo,CD,COD,86790568,Africa,112,4837,76
2020-06-17T00:00:00Z,17,6,2020,137,0,Democratic_Republic_of_the_Congo,CD,COD,86790568,Africa,112,4974,77
2020-06-18T00:00:00Z,18,6,2020,125,3,Democratic_Republic_of_the_Congo,CD,COD,86790568,Africa,115,5099,78
2020-06-19T00:00:00Z,19,6,2020,183,2,Democratic_Republic_of_the_Congo,CD,COD,86790568,Africa,117,5282,79
2020-06-20T00:00:00Z,20,6,2020,194,4,Democratic_Republic_of_the_Congo,CD,COD,86790568,Africa,121,5476,80
2020-06-21T00:00:00Z,21,6,2020,195,3,Democratic_Republic_of_the_Congo,CD,COD,86790568,Africa,124,5671,81
2020-06-22T00:00:00Z,22,6,2020,155,6,Democratic_Republic_of_the_Congo,CD,COD,86790568,Africa,130,5826,82
2020-06-23T00:00:00Z,23,6,2020,99,5,Democratic_Republic_of_the_Congo,CD,COD,86790568,Africa,135,5925,83
2020-06-24T00:00:00Z,24,6,2020,102,0,Democratic_Republic_of_the_Congo,CD,COD,86790568,Africa,135,6027,84
2020-06-25T00:00:00Z,25,6,2020,0,0,Democratic_Republic_of_the_Congo,CD,COD,86790568,Africa,135,6027,85
2020-03-22T00:00:00Z,22,3,2020,71,4,Denmark,DK,DNK,5806081,Europe,13,1326,1
2020-03-23T00:00:00Z,23,3,2020,69,0,Denmark,DK,DNK,5806081,Europe,13,1395,2
2020-03-24T00:00:00Z,24,3,2020,65,11,Denmark,DK,DNK,5806081,Europe,24,1460,3
2020-03-25T00:00:00Z,25,3,2020,131,8,Denmark,DK,DNK,5806081,Europe,32,1591,4
2020-03-26T00:00:00Z,26,3,2020,133,2,Denmark,DK,DNK,5806081,Europe,34,1724,5
2020-03-27T00:00:00Z,27,3,2020,153,7,Denmark,DK,DNK,5806081,Europe,41,1877,6
2020-03-28T00:00:00Z,28,3,2020,169,11,Denmark,DK,DNK,5806081,Europe,52,2046,7
2020-03-29T00:00:00Z,29,3,2020,155,13,Denmark,DK,DNK,5806081,Europe,65,2201,8
2020-03-30T00:00:00Z,30,3,2020,194,7,Denmark,DK,DNK,5806081,Europe,72,2395,9
2020-03-31T00:00:00Z,31,3,2020,182,5,Denmark,DK,DNK,5806081,Europe,77,2577,10
2020-04-01T00:00:00Z,1,4,2020,283,13,Denmark,DK,DNK,5806081,Europe,90,2860,11
2020-04-02T00:00:00Z,2,4,2020,247,14,Denmark,DK,DNK,5806081,Europe,104,3107,12
2020-04-03T00:00:00Z,3,4,2020,279,19,Denmark,DK,DNK,5806081,Europe,123,3386,13
2020-04-04T00:00:00Z,4,4,2020,371,16,Denmark,DK,DNK,5806081,Europe,139,3757,14
2020-04-05T00:00:00Z,5,4,2020,320,22,Denmark,DK,DNK,5806081,Europe,161,4077,15
2020-04-06T00:00:00Z,6,4,2020,292,18,Denmark,DK,DNK,5806081,Europe,179,4369,16
2020-04-07T00:00:00Z,7,4,2020,312,8,Denmark,DK,DNK,5806081,Europe,187,4681,17
2020-04-08T00:00:00Z,8,4,2020,390,16,Denmark,DK,DNK,5806081,Europe,203,5071,18
2020-04-09T00:00:00Z,9,4,2020,331,15,Denmark,DK,DNK,5806081,Europe,218,5402,19
2020-04-10T00:00:00Z,10,4,2020,233,19,Denmark,DK,DNK,5806081,Europe,237,5635,20
2020-04-11T00:00:00Z,11,4,2020,184,10,Denmark,DK,DNK,5806081,Europe,247,5819,21
2020-04-12T00:00:00Z,12,4,2020,177,13,Denmark,DK,DNK,5806081,Europe,260,5996,22
2020-04-13T00:00:00Z,13,4,2020,178,13,Denmark,DK,DNK,5806081,Europe,273,6174,23
2020-04-14T00:00:00Z,14,4,2020,144,12,Denmark,DK,DNK,5806081,Europe,285,6318,24
2020-04-15T00:00:00Z,15,4,2020,193,14,Denmark,DK,DNK,5806081,Europe,299,6511,25
2020-04-16T00:00:00Z,16,4,2020,170,10,Denmark,DK,DNK,5806081,Europe,309,6681,26
2020-04-17T00:00:00Z,17,4,2020,198,12,Denmark,DK,DNK,5806081,Europe,321,6879,27
2020-04-18T00:00:00Z,18,4,2020,194,15,Denmark,DK,DNK,5806081,Europe,336,7073,28
2020-04-19T00:00:00Z,19,4,2020,169,10,Denmark,DK,DNK,5806081,Europe,346,7242,29
2020-04-20T00:00:00Z,20,4,2020,142,9,Denmark,DK,DNK,5806081,Europe,355,7384,30
2020-04-21T00:00:00Z,21,4,2020,131,9,Denmark,DK,DNK,5806081,Europe,364,7515,31
2020-04-22T00:00:00Z,22,4,2020,180,6,Denmark,DK,DNK,5806081,Europe,370,7695,32
2020-04-23T00:00:00Z,23,4,2020,217,14,Denmark,DK,DNK,5806081,Europe,384,7912,33
2020-04-24T00:00:00Z,24,4,2020,161,10,Denmark,DK,DNK,5806081,Europe,394,8073,34
2020-04-25T00:00:00Z,25,4,2020,137,9,Denmark,DK,DNK,5806081,Europe,403,8210,35
2020-04-26T00:00:00Z,26,4,2020,235,15,Denmark,DK,DNK,5806081,Europe,418,8445,36
2020-04-27T00:00:00Z,27,4,2020,130,4,Denmark,DK,DNK,5806081,Europe,422,8575,37
2020-04-28T00:00:00Z,28,4,2020,123,5,Denmark,DK,DNK,5806081,Europe,427,8698,38
2020-04-29T00:00:00Z,29,4,2020,153,7,Denmark,DK,DNK,5806081,Europe,434,8851,39
2020-04-30T00:00:00Z,30,4,2020,157,9,Denmark,DK,DNK,5806081,Europe,443,9008,40
2020-05-01T00:00:00Z,1,5,2020,150,9,Denmark,DK,DNK,5806081,Europe,452,9158,41
2020-05-02T00:00:00Z,2,5,2020,153,10,Denmark,DK,DNK,5806081,Europe,462,9311,42
2020-05-03T00:00:00Z,3,5,2020,96,11,Denmark,DK,DNK,5806081,Europe,473,9407,43
2020-05-04T00:00:00Z,4,5,2020,116,8,Denmark,DK,DNK,5806081,Europe,481,9523,44
2020-05-05T00:00:00Z,5,5,2020,147,9,Denmark,DK,DNK,5806081,Europe,490,9670,45
2020-05-06T00:00:00Z,6,5,2020,151,7,Denmark,DK,DNK,5806081,Europe,497,9821,46
2020-05-07T00:00:00Z,7,5,2020,162,3,Denmark,DK,DNK,5806081,Europe,500,9983,47
2020-05-08T00:00:00Z,8,5,2020,100,6,Denmark,DK,DNK,5806081,Europe,506,10083,48
2020-05-09T00:00:00Z,9,5,2020,135,6,Denmark,DK,DNK,5806081,Europe,512,10218,49
2020-05-10T00:00:00Z,10,5,2020,101,4,Denmark,DK,DNK,5806081,Europe,516,10319,50
2020-05-11T00:00:00Z,11,5,2020,110,3,Denmark,DK,DNK,5806081,Europe,519,10429,51
2020-05-12T00:00:00Z,12,5,2020,84,5,Denmark,DK,DNK,5806081,Europe,524,10513,52
2020-05-13T00:00:00Z,13,5,2020,78,4,Denmark,DK,DNK,5806081,Europe,528,10591,53
2020-05-14T00:00:00Z,14,5,2020,76,6,Denmark,DK,DNK,5806081,Europe,534,10667,54
2020-05-15T00:00:00Z,15,5,2020,46,4,Denmark,DK,DNK,5806081,Europe,538,10713,55
2020-05-16T00:00:00Z,16,5,2020,78,0,Denmark,DK,DNK,5806081,Europe,538,10791,56
2020-05-17T00:00:00Z,17,5,2020,67,5,Denmark,DK,DNK,5806081,Europe,543,10858,57
2020-05-18T00:00:00Z,18,5,2020,69,4,Denmark,DK,DNK,5806081,Europe,547,10927,58
2020-05-19T00:00:00Z,19,5,2020,41,1,Denmark,DK,DNK,5806081,Europe,548,10968,59
2020-05-20T00:00:00Z,20,5,2020,76,3,Denmark,DK,DNK,5806081,Europe,551,11044,60
2020-05-21T00:00:00Z,21,5,2020,73,3,Denmark,DK,DNK,5806081,Europe,554,11117,61
2020-05-22T00:00:00Z,22,5,2020,65,7,Denmark,DK,DNK,5806081,Europe,561,11182,62
2020-05-23T00:00:00Z,23,5,2020,48,0,Denmark,DK,DNK,5806081,Europe,561,11230,63
2020-05-24T00:00:00Z,24,5,2020,59,0,Denmark,DK,DNK,5806081,Europe,561,11289,64
2020-05-25T00:00:00Z,25,5,2020,71,1,Denmark,DK,DNK,5806081,Europe,562,11360,65
2020-05-26T00:00:00Z,26,5,2020,27,1,Denmark,DK,DNK,5806081,Europe,563,11387,66
2020-05-27T00:00:00Z,27,5,2020,41,0,Denmark,DK,DNK,5806081,Europe,563,11428,67
2020-05-28T00:00:00Z,28,5,2020,52,2,Denmark,DK,DNK,5806081,Europe,565,11480,68
2020-05-29T00:00:00Z,29,5,2020,32,3,Denmark,DK,DNK,5806081,Europe,568,11512,69
2020-05-30T00:00:00Z,30,5,2020,81,0,Denmark,DK,DNK,5806081,Europe,568,11593,70
2020-05-31T00:00:00Z,31,5,2020,40,3,Denmark,DK,DNK,5806081,Europe,571,11633,71
2020-06-01T00:00:00Z,1,6,2020,36,3,Denmark,DK,DNK,5806081,Europe,574,11669,72
2020-06-02T00:00:00Z,2,6,2020,30,2,Denmark,DK,DNK,5806081,Europe,576,11699,73
2020-06-03T00:00:00Z,3,6,2020,35,4,Denmark,DK,DNK,5806081,Europe,580,11734,74
2020-06-04T00:00:00Z,4,6,2020,37,0,Denmark,DK,DNK,5806081,Europe,580,11771,75
2020-06-05T00:00:00Z,5,6,2020,40,2,Denmark,DK,DNK,5806081,Europe,582,11811,76
2020-06-06T00:00:00Z,6,6,2020,64,4,Denmark,DK,DNK,5806081,Europe,586,11875,77
2020-06-07T00:00:00Z,7,6,2020,49,1,Denmark,DK,DNK,5806081,Europe,587,11924,78
2020-06-08T00:00:00Z,8,6,2020,24,2,Denmark,DK,DNK,5806081,Europe,589,11948,79
2020-06-09T00:00:00Z,9,6,2020,14,4,Denmark,DK,DNK,5806081,Europe,593,11962,80
2020-06-10T00:00:00Z,10,6,2020,39,0,Denmark,DK,DNK,5806081,Europe,593,12001,81
2020-06-11T00:00:00Z,11,6,2020,15,0,Denmark,DK,DNK,5806081,Europe,593,12016,82
2020-06-12T00:00:00Z,12,6,2020,19,0,Denmark,DK,DNK,5806081,Europe,593,12035,83
2020-06-13T00:00:00Z,13,6,2020,64,1,Denmark,DK,DNK,5806081,Europe,594,12099,84
2020-06-14T00:00:00Z,14,6,2020,40,3,Denmark,DK,DNK,5806081,Europe,597,12139,85
2020-06-15T00:00:00Z,15,6,2020,54,0,Denmark,DK,DNK,5806081,Europe,597,12193,86
2020-06-16T00:00:00Z,16,6,2020,24,1,Denmark,DK,DNK,5806081,Europe,598,12217,87
2020-06-17T00:00:00Z,17,6,2020,33,0,Denmark,DK,DNK,5806081,Europe,598,12250,88
2020-06-18T00:00:00Z,18,6,2020,44,0,Denmark,DK,DNK,5806081,Europe,598,12294,89
2020-06-19T00:00:00Z,19,6,2020,50,2,Denmark,DK,DNK,5806081,Europe,600,12344,90
2020-06-20T00:00:00Z,20,6,2020,47,0,Denmark,DK,DNK,5806081,Europe,600,12391,91
2020-06-21T00:00:00Z,21,6,2020,0,0,Denmark,DK,DNK,5806081,Europe,600,12391,92
2020-06-22T00:00:00Z,22,6,2020,0,0,Denmark,DK,DNK,5806081,Europe,600,12391,93
2020-06-23T00:00:00Z,23,6,2020,136,2,Denmark,DK,DNK,5806081,Europe,602,12527,94
2020-06-24T00:00:00Z,24,6,2020,34,1,Denmark,DK,DNK,5806081,Europe,603,12561,95
2020-06-25T00:00:00Z,25,6,2020,54,0,Denmark,DK,DNK,5806081,Europe,603,12615,96
2020-05-22T00:00:00Z,22,5,2020,219,1,Djibouti,DJ,DJI,973557,Africa,10,2047,1
2020-05-23T00:00:00Z,23,5,2020,223,0,Djibouti,DJ,DJI,973557,Africa,10,2270,2
2020-05-24T00:00:00Z,24,5,2020,0,0,Djibouti,DJ,DJI,973557,Africa,10,2270,3
2020-05-25T00:00:00Z,25,5,2020,0,0,Djibouti,DJ,DJI,973557,Africa,10,2270,4
2020-05-26T00:00:00Z,26,5,2020,198,4,Djibouti,DJ,DJI,973557,Africa,14,2468,5
2020-05-27T00:00:00Z,27,5,2020,0,0,Djibouti,DJ,DJI,973557,Africa,14,2468,6
2020-05-28T00:00:00Z,28,5,2020,229,4,Djibouti,DJ,DJI,973557,Africa,18,2697,7
2020-05-29T00:00:00Z,29,5,2020,217,2,Djibouti,DJ,DJI,973557,Africa,20,2914,8
2020-05-30T00:00:00Z,30,5,2020,0,0,Djibouti,DJ,DJI,973557,Africa,20,2914,9
2020-05-31T00:00:00Z,31,5,2020,280,2,Djibouti,DJ,DJI,973557,Africa,22,3194,10
2020-06-01T00:00:00Z,1,6,2020,160,2,Djibouti,DJ,DJI,973557,Africa,24,3354,11
2020-06-02T00:00:00Z,2,6,2020,215,0,Djibouti,DJ,DJI,973557,Africa,24,3569,12
2020-06-03T00:00:00Z,3,6,2020,210,1,Djibouti,DJ,DJI,973557,Africa,25,3779,13
2020-06-04T00:00:00Z,4,6,2020,156,1,Djibouti,DJ,DJI,973557,Africa,26,3935,14
2020-06-05T00:00:00Z,5,6,2020,119,0,Djibouti,DJ,DJI,973557,Africa,26,4054,15
2020-06-06T00:00:00Z,6,6,2020,69,0,Djibouti,DJ,DJI,973557,Africa,26,4123,16
2020-06-07T00:00:00Z,7,6,2020,46,0,Djibouti,DJ,DJI,973557,Africa,26,4169,17
2020-06-08T00:00:00Z,8,6,2020,38,2,Djibouti,DJ,DJI,973557,Africa,28,4207,18
2020-06-09T00:00:00Z,9,6,2020,71,3,Djibouti,DJ,DJI,973557,Africa,31,4278,19
2020-06-10T00:00:00Z,10,6,2020,53,3,Djibouti,DJ,DJI,973557,Africa,34,4331,20
2020-06-11T00:00:00Z,11,6,2020,42,0,Djibouti,DJ,DJI,973557,Africa,34,4373,21
2020-06-12T00:00:00Z,12,6,2020,25,3,Djibouti,DJ,DJI,973557,Africa,37,4398,22
2020-06-13T00:00:00Z,13,6,2020,43,1,Djibouti,DJ,DJI,973557,Africa,38,4441,23
2020-06-14T00:00:00Z,14,6,2020,8,3,Djibouti,DJ,DJI,973557,Africa,41,4449,24
2020-06-15T00:00:00Z,15,6,2020,16,2,Djibouti,DJ,DJI,973557,Africa,43,4465,25
2020-06-16T00:00:00Z,16,6,2020,36,0,Djibouti,DJ,DJI,973557,Africa,43,4501,26
2020-06-17T00:00:00Z,17,6,2020,38,0,Djibouti,DJ,DJI,973557,Africa,43,4539,27
2020-06-18T00:00:00Z,18,6,2020,6,0,Djibouti,DJ,DJI,973557,Africa,43,4545,28
2020-06-19T00:00:00Z,19,6,2020,12,0,Djibouti,DJ,DJI,973557,Africa,43,4557,29
2020-06-20T00:00:00Z,20,6,2020,8,2,Djibouti,DJ,DJI,973557,Africa,45,4565,30
2020-06-21T00:00:00Z,21,6,2020,0,0,Djibouti,DJ,DJI,973557,Africa,45,4565,31
2020-06-22T00:00:00Z,22,6,2020,17,0,Djibouti,DJ,DJI,973557,Africa,45,4582,32
2020-06-23T00:00:00Z,23,6,2020,17,3,Djibouti,DJ,DJI,973557,Africa,48,4599,33
2020-06-24T00:00:00Z,24,6,2020,18,1,Djibouti,DJ,DJI,973557,Africa,49,4617,34
2020-06-25T00:00:00Z,25,6,2020,13,3,Djibouti,DJ,DJI,973557,Africa,52,4630,35
2020-03-26T00:00:00Z,26,3,2020,80,4,Dominican_Republic,DO,DOM,10738957,America,10,392,1
2020-03-27T00:00:00Z,27,3,2020,96,0,Dominican_Republic,DO,DOM,10738957,America,10,488,2
2020-03-28T00:00:00Z,28,3,2020,93,10,Dominican_Republic,DO,DOM,10738957,America,20,581,3
2020-03-29T00:00:00Z,29,3,2020,138,8,Dominican_Republic,DO,DOM,10738957,America,28,719,4
2020-03-30T00:00:00Z,30,3,2020,140,11,Dominican_Republic,DO,DOM,10738957,America,39,859,5
2020-03-31T00:00:00Z,31,3,2020,42,3,Dominican_Republic,DO,DOM,10738957,America,42,901,6
2020-04-01T00:00:00Z,1,4,2020,208,9,Dominican_Republic,DO,DOM,10738957,America,51,1109,7
2020-04-02T00:00:00Z,2,4,2020,175,6,Dominican_Republic,DO,DOM,10738957,America,57,1284,8
2020-04-03T00:00:00Z,3,4,2020,96,3,Dominican_Republic,DO,DOM,10738957,America,60,1380,9
2020-04-04T00:00:00Z,4,4,2020,108,8,Dominican_Republic,DO,DOM,10738957,America,68,1488,10
2020-04-05T00:00:00Z,5,4,2020,90,9,Dominican_Republic,DO,DOM,10738957,America,77,1578,11
2020-04-06T00:00:00Z,6,4,2020,167,5,Dominican_Republic,DO,DOM,10738957,America,82,1745,12
2020-04-07T00:00:00Z,7,4,2020,83,4,Dominican_Republic,DO,DOM,10738957,America,86,1828,13
2020-04-08T00:00:00Z,8,4,2020,128,12,Dominican_Republic,DO,DOM,10738957,America,98,1956,14
2020-04-09T00:00:00Z,9,4,2020,155,10,Dominican_Republic,DO,DOM,10738957,America,108,2111,15
2020-04-10T00:00:00Z,10,4,2020,238,10,Dominican_Republic,DO,DOM,10738957,America,118,2349,16
2020-04-11T00:00:00Z,11,4,2020,271,8,Dominican_Republic,DO,DOM,10738957,America,126,2620,17
2020-04-12T00:00:00Z,12,4,2020,139,9,Dominican_Republic,DO,DOM,10738957,America,135,2759,18
2020-04-13T00:00:00Z,13,4,2020,208,38,Dominican_Republic,DO,DOM,10738957,America,173,2967,19
2020-04-14T00:00:00Z,14,4,2020,200,4,Dominican_Republic,DO,DOM,10738957,America,177,3167,20
2020-04-15T00:00:00Z,15,4,2020,119,6,Dominican_Republic,DO,DOM,10738957,America,183,3286,21
2020-04-16T00:00:00Z,16,4,2020,328,6,Dominican_Republic,DO,DOM,10738957,America,189,3614,22
2020-04-17T00:00:00Z,17,4,2020,141,7,Dominican_Republic,DO,DOM,10738957,America,196,3755,23
2020-04-18T00:00:00Z,18,4,2020,371,4,Dominican_Republic,DO,DOM,10738957,America,200,4126,24
2020-04-19T00:00:00Z,19,4,2020,209,17,Dominican_Republic,DO,DOM,10738957,America,217,4335,25
2020-04-20T00:00:00Z,20,4,2020,345,9,Dominican_Republic,DO,DOM,10738957,America,226,4680,26
2020-04-21T00:00:00Z,21,4,2020,284,9,Dominican_Republic,DO,DOM,10738957,America,235,4964,27
2020-04-22T00:00:00Z,22,4,2020,80,10,Dominican_Republic,DO,DOM,10738957,America,245,5044,28
2020-04-23T00:00:00Z,23,4,2020,256,15,Dominican_Republic,DO,DOM,10738957,America,260,5300,29
2020-04-24T00:00:00Z,24,4,2020,243,5,Dominican_Republic,DO,DOM,10738957,America,265,5543,30
2020-04-25T00:00:00Z,25,4,2020,206,2,Dominican_Republic,DO,DOM,10738957,America,267,5749,31
2020-04-26T00:00:00Z,26,4,2020,177,6,Dominican_Republic,DO,DOM,10738957,America,273,5926,32
2020-04-27T00:00:00Z,27,4,2020,209,5,Dominican_Republic,DO,DOM,10738957,America,278,6135,33
2020-04-28T00:00:00Z,28,4,2020,0,0,Dominican_Republic,DO,DOM,10738957,America,278,6135,34
2020-04-29T00:00:00Z,29,4,2020,281,8,Dominican_Republic,DO,DOM,10738957,America,286,6416,35
2020-04-30T00:00:00Z,30,4,2020,236,7,Dominican_Republic,DO,DOM,10738957,America,293,6652,36
2020-05-01T00:00:00Z,1,5,2020,320,8,Dominican_Republic,DO,DOM,10738957,America,301,6972,37
2020-05-02T00:00:00Z,2,5,2020,316,12,Dominican_Republic,DO,DOM,10738957,America,313,7288,38
2020-05-03T00:00:00Z,3,5,2020,290,13,Dominican_Republic,DO,DOM,10738957,America,326,7578,39
2020-05-04T00:00:00Z,4,5,2020,376,7,Dominican_Republic,DO,DOM,10738957,America,333,7954,40
2020-05-05T00:00:00Z,5,5,2020,281,13,Dominican_Republic,DO,DOM,10738957,America,346,8235,41
2020-05-06T00:00:00Z,6,5,2020,245,8,Dominican_Republic,DO,DOM,10738957,America,354,8480,42
2020-05-07T00:00:00Z,7,5,2020,327,8,Dominican_Republic,DO,DOM,10738957,America,362,8807,43
2020-05-08T00:00:00Z,8,5,2020,288,11,Dominican_Republic,DO,DOM,10738957,America,373,9095,44
2020-05-09T00:00:00Z,9,5,2020,281,7,Dominican_Republic,DO,DOM,10738957,America,380,9376,45
2020-05-10T00:00:00Z,10,5,2020,506,5,Dominican_Republic,DO,DOM,10738957,America,385,9882,46
2020-05-11T00:00:00Z,11,5,2020,465,3,Dominican_Republic,DO,DOM,10738957,America,388,10347,47
2020-05-12T00:00:00Z,12,5,2020,287,5,Dominican_Republic,DO,DOM,10738957,America,393,10634,48
2020-05-13T00:00:00Z,13,5,2020,266,9,Dominican_Republic,DO,DOM,10738957,America,402,10900,49
2020-05-14T00:00:00Z,14,5,2020,296,7,Dominican_Republic,DO,DOM,10738957,America,409,11196,50
2020-05-15T00:00:00Z,15,5,2020,124,13,Dominican_Republic,DO,DOM,10738957,America,422,11320,51
2020-05-16T00:00:00Z,16,5,2020,419,2,Dominican_Republic,DO,DOM,10738957,America,424,11739,52
2020-05-17T00:00:00Z,17,5,2020,154,0,Dominican_Republic,DO,DOM,10738957,America,424,11893,53
2020-05-18T00:00:00Z,18,5,2020,421,4,Dominican_Republic,DO,DOM,10738957,America,428,12314,54
2020-05-19T00:00:00Z,19,5,2020,411,6,Dominican_Republic,DO,DOM,10738957,America,434,12725,55
2020-05-20T00:00:00Z,20,5,2020,498,7,Dominican_Republic,DO,DOM,10738957,America,441,13223,56
2020-05-21T00:00:00Z,21,5,2020,254,5,Dominican_Republic,DO,DOM,10738957,America,446,13477,57
2020-05-22T00:00:00Z,22,5,2020,180,2,Dominican_Republic,DO,DOM,10738957,America,448,13657,58
2020-05-23T00:00:00Z,23,5,2020,332,8,Dominican_Republic,DO,DOM,10738957,America,456,13989,59
2020-05-24T00:00:00Z,24,5,2020,433,2,Dominican_Republic,DO,DOM,10738957,America,458,14422,60
2020-05-25T00:00:00Z,25,5,2020,0,0,Dominican_Republic,DO,DOM,10738957,America,458,14422,61
2020-05-26T00:00:00Z,26,5,2020,651,2,Dominican_Republic,DO,DOM,10738957,America,460,15073,62
2020-05-27T00:00:00Z,27,5,2020,191,8,Dominican_Republic,DO,DOM,10738957,America,468,15264,63
2020-05-28T00:00:00Z,28,5,2020,459,6,Dominican_Republic,DO,DOM,10738957,America,474,15723,64
2020-05-29T00:00:00Z,29,5,2020,345,11,Dominican_Republic,DO,DOM,10738957,America,485,16068,65
2020-05-30T00:00:00Z,30,5,2020,463,3,Dominican_Republic,DO,DOM,10738957,America,488,16531,66
2020-05-31T00:00:00Z,31,5,2020,377,10,Dominican_Republic,DO,DOM,10738957,America,498,16908,67
2020-06-01T00:00:00Z,1,6,2020,377,4,Dominican_Republic,DO,DOM,10738957,America,502,17285,68
2020-06-02T00:00:00Z,2,6,2020,287,0,Dominican_Republic,DO,DOM,10738957,America,502,17572,69
2020-06-03T00:00:00Z,3,6,2020,180,13,Dominican_Republic,DO,DOM,10738957,America,515,17752,70
2020-06-04T00:00:00Z,4,6,2020,288,1,Dominican_Republic,DO,DOM,10738957,America,516,18040,71
2020-06-05T00:00:00Z,5,6,2020,279,4,Dominican_Republic,DO,DOM,10738957,America,520,18319,72
2020-06-06T00:00:00Z,6,6,2020,389,5,Dominican_Republic,DO,DOM,10738957,America,525,18708,73
2020-06-07T00:00:00Z,7,6,2020,487,11,Dominican_Republic,DO,DOM,10738957,America,536,19195,74
2020-06-08T00:00:00Z,8,6,2020,405,2,Dominican_Republic,DO,DOM,10738957,America,538,19600,75
2020-06-09T00:00:00Z,9,6,2020,526,1,Dominican_Republic,DO,DOM,10738957,America,539,20126,76
2020-06-10T00:00:00Z,10,6,2020,289,5,Dominican_Republic,DO,DOM,10738957,America,544,20415,77
2020-06-11T00:00:00Z,11,6,2020,393,6,Dominican_Republic,DO,DOM,10738957,America,550,20808,78
2020-06-12T00:00:00Z,12,6,2020,629,11,Dominican_Republic,DO,DOM,10738957,America,561,21437,79
2020-06-13T00:00:00Z,13,6,2020,571,7,Dominican_Republic,DO,DOM,10738957,America,568,22008,80
2020-06-14T00:00:00Z,14,6,2020,564,9,Dominican_Republic,DO,DOM,10738957,America,577,22572,81
2020-06-15T00:00:00Z,15,6,2020,390,15,Dominican_Republic,DO,DOM,10738957,America,592,22962,82
2020-06-16T00:00:00Z,16,6,2020,309,13,Dominican_Republic,DO,DOM,10738957,America,605,23271,83
2020-06-17T00:00:00Z,17,6,2020,415,10,Dominican_Republic,DO,DOM,10738957,America,615,23686,84
2020-06-18T00:00:00Z,18,6,2020,419,18,Dominican_Republic,DO,DOM,10738957,America,633,24105,85
2020-06-19T00:00:00Z,19,6,2020,540,2,Dominican_Republic,DO,DOM,10738957,America,635,24645,86
2020-06-20T00:00:00Z,20,6,2020,423,12,Dominican_Republic,DO,DOM,10738957,America,647,25068,87
2020-06-21T00:00:00Z,21,6,2020,710,8,Dominican_Republic,DO,DOM,10738957,America,655,25778,88
2020-06-22T00:00:00Z,22,6,2020,899,7,Dominican_Republic,DO,DOM,10738957,America,662,26677,89
2020-06-23T00:00:00Z,23,6,2020,693,7,Dominican_Republic,DO,DOM,10738957,America,669,27370,90
2020-06-24T00:00:00Z,24,6,2020,566,6,Dominican_Republic,DO,DOM,10738957,America,675,27936,91
2020-06-25T00:00:00Z,25,6,2020,695,16,Dominican_Republic,DO,DOM,10738957,America,691,28631,92
2020-03-23T00:00:00Z,23,3,2020,257,7,Ecuador,EC,ECU,17373657,America,14,789,1
2020-03-24T00:00:00Z,24,3,2020,192,4,Ecuador,EC,ECU,17373657,America,18,981,2
2020-03-25T00:00:00Z,25,3,2020,101,9,Ecuador,EC,ECU,17373657,America,27,1082,3
2020-03-26T00:00:00Z,26,3,2020,129,2,Ecuador,EC,ECU,17373657,America,29,1211,4
2020-03-27T00:00:00Z,27,3,2020,192,5,Ecuador,EC,ECU,17373657,America,34,1403,5
2020-03-28T00:00:00Z,28,3,2020,224,7,Ecuador,EC,ECU,17373657,America,41,1627,6
2020-03-29T00:00:00Z,29,3,2020,208,7,Ecuador,EC,ECU,17373657,America,48,1835,7
2020-03-30T00:00:00Z,30,3,2020,55,10,Ecuador,EC,ECU,17373657,America,58,1890,8
2020-03-31T00:00:00Z,31,3,2020,76,4,Ecuador,EC,ECU,17373657,America,62,1966,9
2020-04-01T00:00:00Z,1,4,2020,336,17,Ecuador,EC,ECU,17373657,America,79,2302,10
2020-04-02T00:00:00Z,2,4,2020,456,41,Ecuador,EC,ECU,17373657,America,120,2758,11
2020-04-03T00:00:00Z,3,4,2020,405,0,Ecuador,EC,ECU,17373657,America,120,3163,12
2020-04-04T00:00:00Z,4,4,2020,205,25,Ecuador,EC,ECU,17373657,America,145,3368,13
2020-04-05T00:00:00Z,5,4,2020,97,27,Ecuador,EC,ECU,17373657,America,172,3465,14
2020-04-06T00:00:00Z,6,4,2020,181,8,Ecuador,EC,ECU,17373657,America,180,3646,15
2020-04-07T00:00:00Z,7,4,2020,101,11,Ecuador,EC,ECU,17373657,America,191,3747,16
2020-04-08T00:00:00Z,8,4,2020,248,29,Ecuador,EC,ECU,17373657,America,220,3995,17
2020-04-09T00:00:00Z,9,4,2020,455,22,Ecuador,EC,ECU,17373657,America,242,4450,18
2020-04-10T00:00:00Z,10,4,2020,515,30,Ecuador,EC,ECU,17373657,America,272,4965,19
2020-04-11T00:00:00Z,11,4,2020,2196,25,Ecuador,EC,ECU,17373657,America,297,7161,20
2020-04-12T00:00:00Z,12,4,2020,96,18,Ecuador,EC,ECU,17373657,America,315,7257,21
2020-04-13T00:00:00Z,13,4,2020,209,18,Ecuador,EC,ECU,17373657,America,333,7466,22
2020-04-14T00:00:00Z,14,4,2020,63,22,Ecuador,EC,ECU,17373657,America,355,7529,23
2020-04-15T00:00:00Z,15,4,2020,74,0,Ecuador,EC,ECU,17373657,America,355,7603,24
2020-04-16T00:00:00Z,16,4,2020,255,33,Ecuador,EC,ECU,17373657,America,388,7858,25
2020-04-17T00:00:00Z,17,4,2020,367,15,Ecuador,EC,ECU,17373657,America,403,8225,26
2020-04-18T00:00:00Z,18,4,2020,225,18,Ecuador,EC,ECU,17373657,America,421,8450,27
2020-04-19T00:00:00Z,19,4,2020,572,35,Ecuador,EC,ECU,17373657,America,456,9022,28
2020-04-20T00:00:00Z,20,4,2020,446,18,Ecuador,EC,ECU,17373657,America,474,9468,29
2020-04-21T00:00:00Z,21,4,2020,660,33,Ecuador,EC,ECU,17373657,America,507,10128,30
2020-04-22T00:00:00Z,22,4,2020,270,13,Ecuador,EC,ECU,17373657,America,520,10398,31
2020-04-23T00:00:00Z,23,4,2020,452,17,Ecuador,EC,ECU,17373657,America,537,10850,32
2020-04-24T00:00:00Z,24,4,2020,333,23,Ecuador,EC,ECU,17373657,America,560,11183,33
2020-04-25T00:00:00Z,25,4,2020,0,16,Ecuador,EC,ECU,17373657,America,576,11183,34
2020-04-26T00:00:00Z,26,4,2020,0,0,Ecuador,EC,ECU,17373657,America,576,11183,35
2020-04-27T00:00:00Z,27,4,2020,11536,0,Ecuador,EC,ECU,17373657,America,576,22719,36
2020-04-28T00:00:00Z,28,4,2020,521,87,Ecuador,EC,ECU,17373657,America,663,23240,37
2020-04-29T00:00:00Z,29,4,2020,1018,208,Ecuador,EC,ECU,17373657,America,871,24258,38
2020-04-30T00:00:00Z,30,4,2020,417,12,Ecuador,EC,ECU,17373657,America,883,24675,39
2020-05-01T00:00:00Z,1,5,2020,259,17,Ecuador,EC,ECU,17373657,America,900,24934,40
2020-05-02T00:00:00Z,2,5,2020,1402,163,Ecuador,EC,ECU,17373657,America,1063,26336,41
2020-05-03T00:00:00Z,3,5,2020,1128,308,Ecuador,EC,ECU,17373657,America,1371,27464,42
2020-05-04T00:00:00Z,4,5,2020,2074,193,Ecuador,EC,ECU,17373657,America,1564,29538,43
2020-05-05T00:00:00Z,5,5,2020,2343,5,Ecuador,EC,ECU,17373657,America,1569,31881,44
2020-05-06T00:00:00Z,6,5,2020,0,0,Ecuador,EC,ECU,17373657,America,1569,31881,45
2020-05-07T00:00:00Z,7,5,2020,-2461,49,Ecuador,EC,ECU,17373657,America,1618,29420,46
2020-05-08T00:00:00Z,8,5,2020,878,36,Ecuador,EC,ECU,17373657,America,1654,30298,47
2020-05-09T00:00:00Z,9,5,2020,-1480,50,Ecuador,EC,ECU,17373657,America,1704,28818,48
2020-05-10T00:00:00Z,10,5,2020,253,13,Ecuador,EC,ECU,17373657,America,1717,29071,49
2020-05-11T00:00:00Z,11,5,2020,488,410,Ecuador,EC,ECU,17373657,America,2127,29559,50
2020-05-12T00:00:00Z,12,5,2020,-50,18,Ecuador,EC,ECU,17373657,America,2145,29509,51
2020-05-13T00:00:00Z,13,5,2020,910,182,Ecuador,EC,ECU,17373657,America,2327,30419,52
2020-05-14T00:00:00Z,14,5,2020,67,7,Ecuador,EC,ECU,17373657,America,2334,30486,53
2020-05-15T00:00:00Z,15,5,2020,16,4,Ecuador,EC,ECU,17373657,America,2338,30502,54
2020-05-16T00:00:00Z,16,5,2020,965,256,Ecuador,EC,ECU,17373657,America,2594,31467,55
2020-05-17T00:00:00Z,17,5,2020,1296,94,Ecuador,EC,ECU,17373657,America,2688,32763,56
2020-05-18T00:00:00Z,18,5,2020,419,48,Ecuador,EC,ECU,17373657,America,2736,33182,57
2020-05-19T00:00:00Z,19,5,2020,400,63,Ecuador,EC,ECU,17373657,America,2799,33582,58
2020-05-20T00:00:00Z,20,5,2020,569,40,Ecuador,EC,ECU,17373657,America,2839,34151,59
2020-05-21T00:00:00Z,21,5,2020,703,49,Ecuador,EC,ECU,17373657,America,2888,34854,60
2020-05-22T00:00:00Z,22,5,2020,452,51,Ecuador,EC,ECU,17373657,America,2939,35306,61
2020-05-23T00:00:00Z,23,5,2020,522,117,Ecuador,EC,ECU,17373657,America,3056,35828,62
2020-05-24T00:00:00Z,24,5,2020,430,40,Ecuador,EC,ECU,17373657,America,3096,36258,63
2020-05-25T00:00:00Z,25,5,2020,498,12,Ecuador,EC,ECU,17373657,America,3108,36756,64
2020-05-26T00:00:00Z,26,5,2020,599,95,Ecuador,EC,ECU,17373657,America,3203,37355,65
2020-05-27T00:00:00Z,27,5,2020,0,0,Ecuador,EC,ECU,17373657,America,3203,37355,66
2020-05-28T00:00:00Z,28,5,2020,748,72,Ecuador,EC,ECU,17373657,America,3275,38103,67
2020-05-29T00:00:00Z,29,5,2020,368,38,Ecuador,EC,ECU,17373657,America,3313,38471,68
2020-05-30T00:00:00Z,30,5,2020,100,21,Ecuador,EC,ECU,17373657,America,3334,38571,69
2020-05-31T00:00:00Z,31,5,2020,0,0,Ecuador,EC,ECU,17373657,America,3334,38571,70
2020-06-01T00:00:00Z,1,6,2020,527,24,Ecuador,EC,ECU,17373657,America,3358,39098,71
2020-06-02T00:00:00Z,2,6,2020,896,36,Ecuador,EC,ECU,17373657,America,3394,39994,72
2020-06-03T00:00:00Z,3,6,2020,420,44,Ecuador,EC,ECU,17373657,America,3438,40414,73
2020-06-04T00:00:00Z,4,6,2020,552,48,Ecuador,EC,ECU,17373657,America,3486,40966,74
2020-06-05T00:00:00Z,5,6,2020,0,0,Ecuador,EC,ECU,17373657,America,3486,40966,75
2020-06-06T00:00:00Z,6,6,2020,609,48,Ecuador,EC,ECU,17373657,America,3534,41575,76
2020-06-07T00:00:00Z,7,6,2020,1153,74,Ecuador,EC,ECU,17373657,America,3608,42728,77
2020-06-08T00:00:00Z,8,6,2020,392,13,Ecuador,EC,ECU,17373657,America,3621,43120,78
2020-06-09T00:00:00Z,9,6,2020,258,21,Ecuador,EC,ECU,17373657,America,3642,43378,79
2020-06-10T00:00:00Z,10,6,2020,539,48,Ecuador,EC,ECU,17373657,America,3690,43917,80
2020-06-11T00:00:00Z,11,6,2020,523,30,Ecuador,EC,ECU,17373657,America,3720,44440,81
2020-06-12T00:00:00Z,12,6,2020,0,0,Ecuador,EC,ECU,17373657,America,3720,44440,82
2020-06-13T00:00:00Z,13,6,2020,1338,108,Ecuador,EC,ECU,17373657,America,3828,45778,83
2020-06-14T00:00:00Z,14,6,2020,578,46,Ecuador,EC,ECU,17373657,America,3874,46356,84
2020-06-15T00:00:00Z,15,6,2020,395,22,Ecuador,EC,ECU,17373657,America,3896,46751,85
2020-06-16T00:00:00Z,16,6,2020,571,33,Ecuador,EC,ECU,17373657,America,3929,47322,86
2020-06-17T00:00:00Z,17,6,2020,621,41,Ecuador,EC,ECU,17373657,America,3970,47943,87
2020-06-18T00:00:00Z,18,6,2020,547,37,Ecuador,EC,ECU,17373657,America,4007,48490,88
2020-06-19T00:00:00Z,19,6,2020,607,80,Ecuador,EC,ECU,17373657,America,4087,49097,89
2020-06-20T00:00:00Z,20,6,2020,634,69,Ecuador,EC,ECU,17373657,America,4156,49731,90
2020-06-21T00:00:00Z,21,6,2020,452,43,Ecuador,EC,ECU,17373657,America,4199,50183,91
2020-06-22T00:00:00Z,22,6,2020,457,24,Ecuador,EC,ECU,17373657,America,4223,50640,92
2020-06-23T00:00:00Z,23,6,2020,0,0,Ecuador,EC,ECU,17373657,America,4223,50640,93
2020-06-24T00:00:00Z,24,6,2020,1003,51,Ecuador,EC,ECU,17373657,America,4274,51643,94
2020-06-25T00:00:00Z,25,6,2020,691,35,Ecuador,EC,ECU,17373657,America,4309,52334,95
2020-03-23T00:00:00Z,23,3,2020,9,2,Egypt,EG,EGY,100388076,Africa,10,294,1
2020-03-24T00:00:00Z,24,3,2020,33,4,Egypt,EG,EGY,100388076,Africa,14,327,2
2020-03-25T00:00:00Z,25,3,2020,39,5,Egypt,EG,EGY,100388076,Africa,19,366,3
2020-03-26T00:00:00Z,26,3,2020,76,2,Egypt,EG,EGY,100388076,Africa,21,442,4
2020-03-27T00:00:00Z,27,3,2020,14,0,Egypt,EG,EGY,100388076,Africa,21,456,5
2020-03-28T00:00:00Z,28,3,2020,39,3,Egypt,EG,EGY,100388076,Africa,24,495,6
2020-03-29T00:00:00Z,29,3,2020,41,6,Egypt,EG,EGY,100388076,Africa,30,536,7
2020-03-30T00:00:00Z,30,3,2020,40,6,Egypt,EG,EGY,100388076,Africa,36,576,8
2020-03-31T00:00:00Z,31,3,2020,33,4,Egypt,EG,EGY,100388076,Africa,40,609,9
2020-04-01T00:00:00Z,1,4,2020,47,1,Egypt,EG,EGY,100388076,Africa,41,656,10
2020-04-02T00:00:00Z,2,4,2020,54,5,Egypt,EG,EGY,100388076,Africa,46,710,11
2020-04-03T00:00:00Z,3,4,2020,69,6,Egypt,EG,EGY,100388076,Africa,52,779,12
2020-04-04T00:00:00Z,4,4,2020,0,0,Egypt,EG,EGY,100388076,Africa,52,779,13
2020-04-05T00:00:00Z,5,4,2020,206,14,Egypt,EG,EGY,100388076,Africa,66,985,14
2020-04-06T00:00:00Z,6,4,2020,85,5,Egypt,EG,EGY,100388076,Africa,71,1070,15
2020-04-07T00:00:00Z,7,4,2020,3,7,Egypt,EG,EGY,100388076,Africa,78,1073,16
2020-04-08T00:00:00Z,8,4,2020,249,7,Egypt,EG,EGY,100388076,Africa,85,1322,17
2020-04-09T00:00:00Z,9,4,2020,238,18,Egypt,EG,EGY,100388076,Africa,103,1560,18
2020-04-10T00:00:00Z,10,4,2020,139,15,Egypt,EG,EGY,100388076,Africa,118,1699,19
2020-04-11T00:00:00Z,11,4,2020,95,17,Egypt,EG,EGY,100388076,Africa,135,1794,20
2020-04-12T00:00:00Z,12,4,2020,145,11,Egypt,EG,EGY,100388076,Africa,146,1939,21
2020-04-13T00:00:00Z,13,4,2020,126,13,Egypt,EG,EGY,100388076,Africa,159,2065,22
2020-04-14T00:00:00Z,14,4,2020,125,5,Egypt,EG,EGY,100388076,Africa,164,2190,23
2020-04-15T00:00:00Z,15,4,2020,160,14,Egypt,EG,EGY,100388076,Africa,178,2350,24
2020-04-16T00:00:00Z,16,4,2020,155,5,Egypt,EG,EGY,100388076,Africa,183,2505,25
2020-04-17T00:00:00Z,17,4,2020,168,13,Egypt,EG,EGY,100388076,Africa,196,2673,26
2020-04-18T00:00:00Z,18,4,2020,171,9,Egypt,EG,EGY,100388076,Africa,205,2844,27
2020-04-19T00:00:00Z,19,4,2020,188,19,Egypt,EG,EGY,100388076,Africa,224,3032,28
2020-04-20T00:00:00Z,20,4,2020,112,15,Egypt,EG,EGY,100388076,Africa,239,3144,29
2020-04-21T00:00:00Z,21,4,2020,189,11,Egypt,EG,EGY,100388076,Africa,250,3333,30
2020-04-22T00:00:00Z,22,4,2020,157,14,Egypt,EG,EGY,100388076,Africa,264,3490,31
2020-04-23T00:00:00Z,23,4,2020,0,0,Egypt,EG,EGY,100388076,Africa,264,3490,32
2020-04-24T00:00:00Z,24,4,2020,169,12,Egypt,EG,EGY,100388076,Africa,276,3659,33
2020-04-25T00:00:00Z,25,4,2020,433,18,Egypt,EG,EGY,100388076,Africa,294,4092,34
2020-04-26T00:00:00Z,26,4,2020,227,13,Egypt,EG,EGY,100388076,Africa,307,4319,35
2020-04-27T00:00:00Z,27,4,2020,0,0,Egypt,EG,EGY,100388076,Africa,307,4319,36
2020-04-28T00:00:00Z,28,4,2020,463,30,Egypt,EG,EGY,100388076,Africa,337,4782,37
2020-04-29T00:00:00Z,29,4,2020,260,22,Egypt,EG,EGY,100388076,Africa,359,5042,38
2020-04-30T00:00:00Z,30,4,2020,226,21,Egypt,EG,EGY,100388076,Africa,380,5268,39
2020-05-01T00:00:00Z,1,5,2020,269,12,Egypt,EG,EGY,100388076,Africa,392,5537,40
2020-05-02T00:00:00Z,2,5,2020,358,14,Egypt,EG,EGY,100388076,Africa,406,5895,41
2020-05-03T00:00:00Z,3,5,2020,298,9,Egypt,EG,EGY,100388076,Africa,415,6193,42
2020-05-04T00:00:00Z,4,5,2020,272,14,Egypt,EG,EGY,100388076,Africa,429,6465,43
2020-05-05T00:00:00Z,5,5,2020,348,7,Egypt,EG,EGY,100388076,Africa,436,6813,44
2020-05-06T00:00:00Z,6,5,2020,388,16,Egypt,EG,EGY,100388076,Africa,452,7201,45
2020-05-07T00:00:00Z,7,5,2020,387,17,Egypt,EG,EGY,100388076,Africa,469,7588,46
2020-05-08T00:00:00Z,8,5,2020,393,13,Egypt,EG,EGY,100388076,Africa,482,7981,47
2020-05-09T00:00:00Z,9,5,2020,495,21,Egypt,EG,EGY,100388076,Africa,503,8476,48
2020-05-10T00:00:00Z,10,5,2020,488,11,Egypt,EG,EGY,100388076,Africa,514,8964,49
2020-05-11T00:00:00Z,11,5,2020,436,11,Egypt,EG,EGY,100388076,Africa,525,9400,50
2020-05-12T00:00:00Z,12,5,2020,346,8,Egypt,EG,EGY,100388076,Africa,533,9746,51
2020-05-13T00:00:00Z,13,5,2020,347,11,Egypt,EG,EGY,100388076,Africa,544,10093,52
2020-05-14T00:00:00Z,14,5,2020,338,12,Egypt,EG,EGY,100388076,Africa,556,10431,53
2020-05-15T00:00:00Z,15,5,2020,398,15,Egypt,EG,EGY,100388076,Africa,571,10829,54
2020-05-16T00:00:00Z,16,5,2020,399,21,Egypt,EG,EGY,100388076,Africa,592,11228,55
2020-05-17T00:00:00Z,17,5,2020,491,20,Egypt,EG,EGY,100388076,Africa,612,11719,56
2020-05-18T00:00:00Z,18,5,2020,510,18,Egypt,EG,EGY,100388076,Africa,630,12229,57
2020-05-19T00:00:00Z,19,5,2020,535,15,Egypt,EG,EGY,100388076,Africa,645,12764,58
2020-05-20T00:00:00Z,20,5,2020,720,14,Egypt,EG,EGY,100388076,Africa,659,13484,59
2020-05-21T00:00:00Z,21,5,2020,745,21,Egypt,EG,EGY,100388076,Africa,680,14229,60
2020-05-22T00:00:00Z,22,5,2020,774,16,Egypt,EG,EGY,100388076,Africa,696,15003,61
2020-05-23T00:00:00Z,23,5,2020,783,11,Egypt,EG,EGY,100388076,Africa,707,15786,62
2020-05-24T00:00:00Z,24,5,2020,827,28,Egypt,EG,EGY,100388076,Africa,735,16613,63
2020-05-25T00:00:00Z,25,5,2020,652,29,Egypt,EG,EGY,100388076,Africa,764,17265,64
2020-05-26T00:00:00Z,26,5,2020,702,19,Egypt,EG,EGY,100388076,Africa,783,17967,65
2020-05-27T00:00:00Z,27,5,2020,789,14,Egypt,EG,EGY,100388076,Africa,797,18756,66
2020-05-28T00:00:00Z,28,5,2020,910,19,Egypt,EG,EGY,100388076,Africa,816,19666,67
2020-05-29T00:00:00Z,29,5,2020,1127,29,Egypt,EG,EGY,100388076,Africa,845,20793,68
2020-05-30T00:00:00Z,30,5,2020,1289,34,Egypt,EG,EGY,100388076,Africa,879,22082,69
2020-05-31T00:00:00Z,31,5,2020,1367,34,Egypt,EG,EGY,100388076,Africa,913,23449,70
2020-06-01T00:00:00Z,1,6,2020,1536,46,Egypt,EG,EGY,100388076,Africa,959,24985,71
2020-06-02T00:00:00Z,2,6,2020,1399,46,Egypt,EG,EGY,100388076,Africa,1005,26384,72
2020-06-03T00:00:00Z,3,6,2020,1152,47,Egypt,EG,EGY,100388076,Africa,1052,27536,73
2020-06-04T00:00:00Z,4,6,2020,1079,36,Egypt,EG,EGY,100388076,Africa,1088,28615,74
2020-06-05T00:00:00Z,5,6,2020,1152,38,Egypt,EG,EGY,100388076,Africa,1126,29767,75
2020-06-06T00:00:00Z,6,6,2020,1348,40,Egypt,EG,EGY,100388076,Africa,1166,31115,76
2020-06-07T00:00:00Z,7,6,2020,1497,32,Egypt,EG,EGY,100388076,Africa,1198,32612,77
2020-06-08T00:00:00Z,8,6,2020,1467,39,Egypt,EG,EGY,100388076,Africa,1237,34079,78
2020-06-09T00:00:00Z,9,6,2020,1365,34,Egypt,EG,EGY,100388076,Africa,1271,35444,79
2020-06-10T00:00:00Z,10,6,2020,1385,35,Egypt,EG,EGY,100388076,Africa,1306,36829,80
2020-06-11T00:00:00Z,11,6,2020,1455,36,Egypt,EG,EGY,100388076,Africa,1342,38284,81
2020-06-12T00:00:00Z,12,6,2020,1442,35,Egypt,EG,EGY,100388076,Africa,1377,39726,82
2020-06-13T00:00:00Z,13,6,2020,1578,45,Egypt,EG,EGY,100388076,Africa,1422,41304,83
2020-06-14T00:00:00Z,14,6,2020,1676,62,Egypt,EG,EGY,100388076,Africa,1484,42980,84
2020-06-15T00:00:00Z,15,6,2020,1618,91,Egypt,EG,EGY,100388076,Africa,1575,44598,85
2020-06-16T00:00:00Z,16,6,2020,1691,97,Egypt,EG,EGY,100388076,Africa,1672,46289,86
2020-06-17T00:00:00Z,17,6,2020,1567,94,Egypt,EG,EGY,100388076,Africa,1766,47856,87
2020-06-18T00:00:00Z,18,6,2020,1363,84,Egypt,EG,EGY,100388076,Africa,1850,49219,88
2020-06-19T00:00:00Z,19,6,2020,1218,88,Egypt,EG,EGY,100388076,Africa,1938,50437,89
2020-06-20T00:00:00Z,20,6,2020,1774,79,Egypt,EG,EGY,100388076,Africa,2017,52211,90
2020-06-21T00:00:00Z,21,6,2020,1547,89,Egypt,EG,EGY,100388076,Africa,2106,53758,91
2020-06-22T00:00:00Z,22,6,2020,1475,87,Egypt,EG,EGY,100388076,Africa,2193,55233,92
2020-06-23T00:00:00Z,23,6,2020,1576,85,Egypt,EG,EGY,100388076,Africa,2278,56809,93
2020-06-24T00:00:00Z,24,6,2020,1332,87,Egypt,EG,EGY,100388076,Africa,2365,58141,94
2020-06-25T00:00:00Z,25,6,2020,0,0,Egypt,EG,EGY,100388076,Africa,2365,58141,95
2020-05-01T00:00:00Z,1,5,2020,47,1,El_Salvador,SV,SLV,6453550,America,10,424,1
2020-05-02T00:00:00Z,2,5,2020,22,0,El_Salvador,SV,SLV,6453550,America,10,446,2
2020-05-03T00:00:00Z,3,5,2020,0,1,El_Salvador,SV,SLV,6453550,America,11,446,3
2020-05-04T00:00:00Z,4,5,2020,109,1,El_Salvador,SV,SLV,6453550,America,12,555,4
2020-05-05T00:00:00Z,5,5,2020,32,1,El_Salvador,SV,SLV,6453550,America,13,587,5
2020-05-06T00:00:00Z,6,5,2020,0,1,El_Salvador,SV,SLV,6453550,America,14,587,6
2020-05-07T00:00:00Z,7,5,2020,108,1,El_Salvador,SV,SLV,6453550,America,15,695,7
2020-05-08T00:00:00Z,8,5,2020,0,0,El_Salvador,SV,SLV,6453550,America,15,695,8
2020-05-09T00:00:00Z,9,5,2020,89,1,El_Salvador,SV,SLV,6453550,America,16,784,9
2020-05-10T00:00:00Z,10,5,2020,105,1,El_Salvador,SV,SLV,6453550,America,17,889,10
2020-05-11T00:00:00Z,11,5,2020,69,0,El_Salvador,SV,SLV,6453550,America,17,958,11
2020-05-12T00:00:00Z,12,5,2020,40,1,El_Salvador,SV,SLV,6453550,America,18,998,12
2020-05-13T00:00:00Z,13,5,2020,39,2,El_Salvador,SV,SLV,6453550,America,20,1037,13
2020-05-14T00:00:00Z,14,5,2020,75,0,El_Salvador,SV,SLV,6453550,America,20,1112,14
2020-05-15T00:00:00Z,15,5,2020,98,3,El_Salvador,SV,SLV,6453550,America,23,1210,15
2020-05-16T00:00:00Z,16,5,2020,55,2,El_Salvador,SV,SLV,6453550,America,25,1265,16
2020-05-17T00:00:00Z,17,5,2020,0,1,El_Salvador,SV,SLV,6453550,America,26,1265,17
2020-05-18T00:00:00Z,18,5,2020,73,4,El_Salvador,SV,SLV,6453550,America,30,1338,18
2020-05-19T00:00:00Z,19,5,2020,75,0,El_Salvador,SV,SLV,6453550,America,30,1413,19
2020-05-20T00:00:00Z,20,5,2020,85,1,El_Salvador,SV,SLV,6453550,America,31,1498,20
2020-05-21T00:00:00Z,21,5,2020,73,1,El_Salvador,SV,SLV,6453550,America,32,1571,21
2020-05-22T00:00:00Z,22,5,2020,69,1,El_Salvador,SV,SLV,6453550,America,33,1640,22
2020-05-23T00:00:00Z,23,5,2020,85,0,El_Salvador,SV,SLV,6453550,America,33,1725,23
2020-05-24T00:00:00Z,24,5,2020,94,2,El_Salvador,SV,SLV,6453550,America,35,1819,24
2020-05-25T00:00:00Z,25,5,2020,96,0,El_Salvador,SV,SLV,6453550,America,35,1915,25
2020-05-26T00:00:00Z,26,5,2020,68,1,El_Salvador,SV,SLV,6453550,America,36,1983,26
2020-05-27T00:00:00Z,27,5,2020,59,0,El_Salvador,SV,SLV,6453550,America,36,2042,27
2020-05-28T00:00:00Z,28,5,2020,67,3,El_Salvador,SV,SLV,6453550,America,39,2109,28
2020-05-29T00:00:00Z,29,5,2020,85,0,El_Salvador,SV,SLV,6453550,America,39,2194,29
2020-05-30T00:00:00Z,30,5,2020,84,4,El_Salvador,SV,SLV,6453550,America,43,2278,30
2020-05-31T00:00:00Z,31,5,2020,239,3,El_Salvador,SV,SLV,6453550,America,46,2517,31
2020-06-01T00:00:00Z,1,6,2020,0,0,El_Salvador,SV,SLV,6453550,America,46,2517,32
2020-06-02T00:00:00Z,2,6,2020,65,0,El_Salvador,SV,SLV,6453550,America,46,2582,33
2020-06-03T00:00:00Z,3,6,2020,71,3,El_Salvador,SV,SLV,6453550,America,49,2653,34
2020-06-04T00:00:00Z,4,6,2020,52,2,El_Salvador,SV,SLV,6453550,America,51,2705,35
2020-06-05T00:00:00Z,5,6,2020,76,1,El_Salvador,SV,SLV,6453550,America,52,2781,36
2020-06-06T00:00:00Z,6,6,2020,68,1,El_Salvador,SV,SLV,6453550,America,53,2849,37
2020-06-07T00:00:00Z,7,6,2020,85,0,El_Salvador,SV,SLV,6453550,America,53,2934,38
2020-06-08T00:00:00Z,8,6,2020,81,2,El_Salvador,SV,SLV,6453550,America,55,3015,39
2020-06-09T00:00:00Z,9,6,2020,89,3,El_Salvador,SV,SLV,6453550,America,58,3104,40
2020-06-10T00:00:00Z,10,6,2020,87,2,El_Salvador,SV,SLV,6453550,America,60,3191,41
2020-06-11T00:00:00Z,11,6,2020,83,4,El_Salvador,SV,SLV,6453550,America,64,3274,42
2020-06-12T00:00:00Z,12,6,2020,207,4,El_Salvador,SV,SLV,6453550,America,68,3481,43
2020-06-13T00:00:00Z,13,6,2020,0,4,El_Salvador,SV,SLV,6453550,America,72,3481,44
2020-06-14T00:00:00Z,14,6,2020,122,0,El_Salvador,SV,SLV,6453550,America,72,3603,45
2020-06-15T00:00:00Z,15,6,2020,117,2,El_Salvador,SV,SLV,6453550,America,74,3720,46
2020-06-16T00:00:00Z,16,6,2020,106,2,El_Salvador,SV,SLV,6453550,America,76,3826,47
2020-06-17T00:00:00Z,17,6,2020,115,2,El_Salvador,SV,SLV,6453550,America,78,3941,48
2020-06-18T00:00:00Z,18,6,2020,125,4,El_Salvador,SV,SLV,6453550,America,82,4066,49
2020-06-19T00:00:00Z,19,6,2020,134,4,El_Salvador,SV,SLV,6453550,America,86,4200,50
2020-06-20T00:00:00Z,20,6,2020,129,7,El_Salvador,SV,SLV,6453550,America,93,4329,51
2020-06-21T00:00:00Z,21,6,2020,297,5,El_Salvador,SV,SLV,6453550,America,98,4626,52
2020-06-22T00:00:00Z,22,6,2020,0,9,El_Salvador,SV,SLV,6453550,America,107,4626,53
2020-06-23T00:00:00Z,23,6,2020,182,0,El_Salvador,SV,SLV,6453550,America,107,4808,54
2020-06-24T00:00:00Z,24,6,2020,165,6,El_Salvador,SV,SLV,6453550,America,113,4973,55
2020-06-25T00:00:00Z,25,6,2020,177,13,El_Salvador,SV,SLV,6453550,America,126,5150,56
2020-05-22T00:00:00Z,22,5,2020,13,3,Equatorial_Guinea,GQ,GNQ,1355982,Africa,10,903,1
2020-05-23T00:00:00Z,23,5,2020,0,0,Equatorial_Guinea,GQ,GNQ,1355982,Africa,10,903,2
2020-05-24T00:00:00Z,24,5,2020,140,2,Equatorial_Guinea,GQ,GNQ,1355982,Africa,12,1043,3
2020-05-25T00:00:00Z,25,5,2020,0,0,Equatorial_Guinea,GQ,GNQ,1355982,Africa,12,1043,4
2020-05-26T00:00:00Z,26,5,2020,0,0,Equatorial_Guinea,GQ,GNQ,1355982,Africa,12,1043,5
2020-05-27T00:00:00Z,27,5,2020,0,0,Equatorial_Guinea,GQ,GNQ,1355982,Africa,12,1043,6
2020-05-28T00:00:00Z,28,5,2020,0,0,Equatorial_Guinea,GQ,GNQ,1355982,Africa,12,1043,7
2020-05-29T00:00:00Z,29,5,2020,0,0,Equatorial_Guinea,GQ,GNQ,1355982,Africa,12,1043,8
2020-05-30T00:00:00Z,30,5,2020,0,0,Equatorial_Guinea,GQ,GNQ,1355982,Africa,12,1043,9
2020-05-31T00:00:00Z,31,5,2020,263,0,Equatorial_Guinea,GQ,GNQ,1355982,Africa,12,1306,10
2020-06-01T00:00:00Z,1,6,2020,0,0,Equatorial_Guinea,GQ,GNQ,1355982,Africa,12,1306,11
2020-06-02T00:00:00Z,2,6,2020,0,0,Equatorial_Guinea,GQ,GNQ,1355982,Africa,12,1306,12
2020-06-03T00:00:00Z,3,6,2020,0,0,Equatorial_Guinea,GQ,GNQ,1355982,Africa,12,1306,13
2020-06-04T00:00:00Z,4,6,2020,0,0,Equatorial_Guinea,GQ,GNQ,1355982,Africa,12,1306,14
2020-06-05T00:00:00Z,5,6,2020,0,0,Equatorial_Guinea,GQ,GNQ,1355982,Africa,12,1306,15
2020-06-06T00:00:00Z,6,6,2020,0,0,Equatorial_Guinea,GQ,GNQ,1355982,Africa,12,1306,16
2020-06-07T00:00:00Z,7,6,2020,0,0,Equatorial_Guinea,GQ,GNQ,1355982,Africa,12,1306,17
2020-06-08T00:00:00Z,8,6,2020,0,0,Equatorial_Guinea,GQ,GNQ,1355982,Africa,12,1306,18
2020-06-09T00:00:00Z,9,6,2020,0,0,Equatorial_Guinea,GQ,GNQ,1355982,Africa,12,1306,19
2020-06-10T00:00:00Z,10,6,2020,0,0,Equatorial_Guinea,GQ,GNQ,1355982,Africa,12,1306,20
2020-06-11T00:00:00Z,11,6,2020,0,0,Equatorial_Guinea,GQ,GNQ,1355982,Africa,12,1306,21
2020-06-12T00:00:00Z,12,6,2020,0,0,Equatorial_Guinea,GQ,GNQ,1355982,Africa,12,1306,22
2020-06-13T00:00:00Z,13,6,2020,0,0,Equatorial_Guinea,GQ,GNQ,1355982,Africa,12,1306,23
2020-06-14T00:00:00Z,14,6,2020,0,0,Equatorial_Guinea,GQ,GNQ,1355982,Africa,12,1306,24
2020-06-15T00:00:00Z,15,6,2020,0,0,Equatorial_Guinea,GQ,GNQ,1355982,Africa,12,1306,25
2020-06-16T00:00:00Z,16,6,2020,0,0,Equatorial_Guinea,GQ,GNQ,1355982,Africa,12,1306,26
2020-06-17T00:00:00Z,17,6,2020,0,0,Equatorial_Guinea,GQ,GNQ,1355982,Africa,12,1306,27
2020-06-18T00:00:00Z,18,6,2020,0,0,Equatorial_Guinea,GQ,GNQ,1355982,Africa,12,1306,28
2020-06-19T00:00:00Z,19,6,2020,0,0,Equatorial_Guinea,GQ,GNQ,1355982,Africa,12,1306,29
2020-06-20T00:00:00Z,20,6,2020,358,20,Equatorial_Guinea,GQ,GNQ,1355982,Africa,32,1664,30
2020-06-21T00:00:00Z,21,6,2020,0,0,Equatorial_Guinea,GQ,GNQ,1355982,Africa,32,1664,31
2020-06-22T00:00:00Z,22,6,2020,0,0,Equatorial_Guinea,GQ,GNQ,1355982,Africa,32,1664,32
2020-06-23T00:00:00Z,23,6,2020,337,0,Equatorial_Guinea,GQ,GNQ,1355982,Africa,32,2001,33
2020-06-24T00:00:00Z,24,6,2020,0,0,Equatorial_Guinea,GQ,GNQ,1355982,Africa,32,2001,34
2020-06-25T00:00:00Z,25,6,2020,0,0,Equatorial_Guinea,GQ,GNQ,1355982,Africa,32,2001,35
2020-04-03T00:00:00Z,3,4,2020,79,6,Estonia,EE,EST,1324820,Europe,11,858,1
2020-04-04T00:00:00Z,4,4,2020,103,1,Estonia,EE,EST,1324820,Europe,12,961,2
2020-04-05T00:00:00Z,5,4,2020,57,1,Estonia,EE,EST,1324820,Europe,13,1018,3
2020-04-06T00:00:00Z,6,4,2020,79,2,Estonia,EE,EST,1324820,Europe,15,1097,4
2020-04-07T00:00:00Z,7,4,2020,11,4,Estonia,EE,EST,1324820,Europe,19,1108,5
2020-04-08T00:00:00Z,8,4,2020,41,2,Estonia,EE,EST,1324820,Europe,21,1149,6
2020-04-09T00:00:00Z,9,4,2020,36,3,Estonia,EE,EST,1324820,Europe,24,1185,7
2020-04-10T00:00:00Z,10,4,2020,22,0,Estonia,EE,EST,1324820,Europe,24,1207,8
2020-04-11T00:00:00Z,11,4,2020,51,0,Estonia,EE,EST,1324820,Europe,24,1258,9
2020-04-12T00:00:00Z,12,4,2020,46,0,Estonia,EE,EST,1324820,Europe,24,1304,10
2020-04-13T00:00:00Z,13,4,2020,5,1,Estonia,EE,EST,1324820,Europe,25,1309,11
2020-04-14T00:00:00Z,14,4,2020,23,3,Estonia,EE,EST,1324820,Europe,28,1332,12
2020-04-15T00:00:00Z,15,4,2020,41,3,Estonia,EE,EST,1324820,Europe,31,1373,13
2020-04-16T00:00:00Z,16,4,2020,29,4,Estonia,EE,EST,1324820,Europe,35,1402,14
2020-04-17T00:00:00Z,17,4,2020,32,1,Estonia,EE,EST,1324820,Europe,36,1434,15
2020-04-18T00:00:00Z,18,4,2020,25,2,Estonia,EE,EST,1324820,Europe,38,1459,16
2020-04-19T00:00:00Z,19,4,2020,53,0,Estonia,EE,EST,1324820,Europe,38,1512,17
2020-04-20T00:00:00Z,20,4,2020,16,2,Estonia,EE,EST,1324820,Europe,40,1528,18
2020-04-21T00:00:00Z,21,4,2020,7,0,Estonia,EE,EST,1324820,Europe,40,1535,19
2020-04-22T00:00:00Z,22,4,2020,17,3,Estonia,EE,EST,1324820,Europe,43,1552,20
2020-04-23T00:00:00Z,23,4,2020,7,1,Estonia,EE,EST,1324820,Europe,44,1559,21
2020-04-24T00:00:00Z,24,4,2020,33,1,Estonia,EE,EST,1324820,Europe,45,1592,22
2020-04-25T00:00:00Z,25,4,2020,13,1,Estonia,EE,EST,1324820,Europe,46,1605,23
2020-04-26T00:00:00Z,26,4,2020,30,0,Estonia,EE,EST,1324820,Europe,46,1635,24
2020-04-27T00:00:00Z,27,4,2020,8,3,Estonia,EE,EST,1324820,Europe,49,1643,25
2020-04-28T00:00:00Z,28,4,2020,4,1,Estonia,EE,EST,1324820,Europe,50,1647,26
2020-04-29T00:00:00Z,29,4,2020,13,0,Estonia,EE,EST,1324820,Europe,50,1660,27
2020-04-30T00:00:00Z,30,4,2020,6,0,Estonia,EE,EST,1324820,Europe,50,1666,28
2020-05-01T00:00:00Z,1,5,2020,23,2,Estonia,EE,EST,1324820,Europe,52,1689,29
2020-05-02T00:00:00Z,2,5,2020,5,0,Estonia,EE,EST,1324820,Europe,52,1694,30
2020-05-03T00:00:00Z,3,5,2020,5,1,Estonia,EE,EST,1324820,Europe,53,1699,31
2020-05-04T00:00:00Z,4,5,2020,1,2,Estonia,EE,EST,1324820,Europe,55,1700,32
2020-05-05T00:00:00Z,5,5,2020,3,0,Estonia,EE,EST,1324820,Europe,55,1703,33
2020-05-06T00:00:00Z,6,5,2020,8,0,Estonia,EE,EST,1324820,Europe,55,1711,34
2020-05-07T00:00:00Z,7,5,2020,2,0,Estonia,EE,EST,1324820,Europe,55,1713,35
2020-05-08T00:00:00Z,8,5,2020,7,1,Estonia,EE,EST,1324820,Europe,56,1720,36
2020-05-09T00:00:00Z,9,5,2020,5,0,Estonia,EE,EST,1324820,Europe,56,1725,37
2020-05-10T00:00:00Z,10,5,2020,8,4,Estonia,EE,EST,1324820,Europe,60,1733,38
2020-05-11T00:00:00Z,11,5,2020,6,0,Estonia,EE,EST,1324820,Europe,60,1739,39
2020-05-12T00:00:00Z,12,5,2020,2,1,Estonia,EE,EST,1324820,Europe,61,1741,40
2020-05-13T00:00:00Z,13,5,2020,5,0,Estonia,EE,EST,1324820,Europe,61,1746,41
2020-05-14T00:00:00Z,14,5,2020,5,0,Estonia,EE,EST,1324820,Europe,61,1751,42
2020-05-15T00:00:00Z,15,5,2020,7,1,Estonia,EE,EST,1324820,Europe,62,1758,43
2020-05-16T00:00:00Z,16,5,2020,8,1,Estonia,EE,EST,1324820,Europe,63,1766,44
2020-05-17T00:00:00Z,17,5,2020,4,0,Estonia,EE,EST,1324820,Europe,63,1770,45
2020-05-18T00:00:00Z,18,5,2020,4,0,Estonia,EE,EST,1324820,Europe,63,1774,46
2020-05-19T00:00:00Z,19,5,2020,10,1,Estonia,EE,EST,1324820,Europe,64,1784,47
2020-05-20T00:00:00Z,20,5,2020,7,0,Estonia,EE,EST,1324820,Europe,64,1791,48
2020-05-21T00:00:00Z,21,5,2020,3,0,Estonia,EE,EST,1324820,Europe,64,1794,49
2020-05-22T00:00:00Z,22,5,2020,6,0,Estonia,EE,EST,1324820,Europe,64,1800,50
2020-05-23T00:00:00Z,23,5,2020,7,0,Estonia,EE,EST,1324820,Europe,64,1807,51
2020-05-24T00:00:00Z,24,5,2020,14,0,Estonia,EE,EST,1324820,Europe,64,1821,52
2020-05-25T00:00:00Z,25,5,2020,2,0,Estonia,EE,EST,1324820,Europe,64,1823,53
2020-05-26T00:00:00Z,26,5,2020,1,1,Estonia,EE,EST,1324820,Europe,65,1824,54
2020-05-27T00:00:00Z,27,5,2020,10,0,Estonia,EE,EST,1324820,Europe,65,1834,55
2020-05-28T00:00:00Z,28,5,2020,6,1,Estonia,EE,EST,1324820,Europe,66,1840,56
2020-05-29T00:00:00Z,29,5,2020,11,0,Estonia,EE,EST,1324820,Europe,66,1851,57
2020-05-30T00:00:00Z,30,5,2020,8,1,Estonia,EE,EST,1324820,Europe,67,1859,58
2020-05-31T00:00:00Z,31,5,2020,6,0,Estonia,EE,EST,1324820,Europe,67,1865,59
2020-06-01T00:00:00Z,1,6,2020,4,1,Estonia,EE,EST,1324820,Europe,68,1869,60
2020-06-02T00:00:00Z,2,6,2020,1,0,Estonia,EE,EST,1324820,Europe,68,1870,61
2020-06-03T00:00:00Z,3,6,2020,0,0,Estonia,EE,EST,1324820,Europe,68,1870,62
2020-06-04T00:00:00Z,4,6,2020,10,1,Estonia,EE,EST,1324820,Europe,69,1880,63
2020-06-05T00:00:00Z,5,6,2020,10,0,Estonia,EE,EST,1324820,Europe,69,1890,64
2020-06-06T00:00:00Z,6,6,2020,20,0,Estonia,EE,EST,1324820,Europe,69,1910,65
2020-06-07T00:00:00Z,7,6,2020,21,0,Estonia,EE,EST,1324820,Europe,69,1931,66
2020-06-08T00:00:00Z,8,6,2020,8,0,Estonia,EE,EST,1324820,Europe,69,1939,67
2020-06-09T00:00:00Z,9,6,2020,1,0,Estonia,EE,EST,1324820,Europe,69,1940,68
2020-06-10T00:00:00Z,10,6,2020,7,0,Estonia,EE,EST,1324820,Europe,69,1947,69
2020-06-11T00:00:00Z,11,6,2020,11,0,Estonia,EE,EST,1324820,Europe,69,1958,70
2020-06-12T00:00:00Z,12,6,2020,7,0,Estonia,EE,EST,1324820,Europe,69,1965,71
2020-06-13T00:00:00Z,13,6,2020,5,0,Estonia,EE,EST,1324820,Europe,69,1970,72
2020-06-14T00:00:00Z,14,6,2020,3,0,Estonia,EE,EST,1324820,Europe,69,1973,73
2020-06-15T00:00:00Z,15,6,2020,0,0,Estonia,EE,EST,1324820,Europe,69,1973,74
2020-06-16T00:00:00Z,16,6,2020,1,0,Estonia,EE,EST,1324820,Europe,69,1974,75
2020-06-17T00:00:00Z,17,6,2020,1,0,Estonia,EE,EST,1324820,Europe,69,1975,76
2020-06-18T00:00:00Z,18,6,2020,2,0,Estonia,EE,EST,1324820,Europe,69,1977,77
2020-06-19T00:00:00Z,19,6,2020,0,0,Estonia,EE,EST,1324820,Europe,69,1977,78
2020-06-20T00:00:00Z,20,6,2020,2,0,Estonia,EE,EST,1324820,Europe,69,1979,79
2020-06-21T00:00:00Z,21,6,2020,2,0,Estonia,EE,EST,1324820,Europe,69,1981,80
2020-06-22T00:00:00Z,22,6,2020,0,0,Estonia,EE,EST,1324820,Europe,69,1981,81
2020-06-23T00:00:00Z,23,6,2020,0,0,Estonia,EE,EST,1324820,Europe,69,1981,82
2020-06-24T00:00:00Z,24,6,2020,1,0,Estonia,EE,EST,1324820,Europe,69,1982,83
2020-06-25T00:00:00Z,25,6,2020,1,0,Estonia,EE,EST,1324820,Europe,69,1983,84
2020-06-01T00:00:00Z,1,6,2020,109,3,Ethiopia,ET,ETH,112078727,Africa,11,1172,1
2020-06-02T00:00:00Z,2,6,2020,85,1,Ethiopia,ET,ETH,112078727,Africa,12,1257,2
2020-06-03T00:00:00Z,3,6,2020,87,2,Ethiopia,ET,ETH,112078727,Africa,14,1344,3
2020-06-04T00:00:00Z,4,6,2020,142,3,Ethiopia,ET,ETH,112078727,Africa,17,1486,4
2020-06-05T00:00:00Z,5,6,2020,150,1,Ethiopia,ET,ETH,112078727,Africa,18,1636,5
2020-06-06T00:00:00Z,6,6,2020,169,1,Ethiopia,ET,ETH,112078727,Africa,19,1805,6
2020-06-07T00:00:00Z,7,6,2020,129,1,Ethiopia,ET,ETH,112078727,Africa,20,1934,7
2020-06-08T00:00:00Z,8,6,2020,86,7,Ethiopia,ET,ETH,112078727,Africa,27,2020,8
2020-06-09T00:00:00Z,9,6,2020,136,0,Ethiopia,ET,ETH,112078727,Africa,27,2156,9
2020-06-10T00:00:00Z,10,6,2020,180,5,Ethiopia,ET,ETH,112078727,Africa,32,2336,10
2020-06-11T00:00:00Z,11,6,2020,170,3,Ethiopia,ET,ETH,112078727,Africa,35,2506,11
2020-06-12T00:00:00Z,12,6,2020,164,5,Ethiopia,ET,ETH,112078727,Africa,40,2670,12
2020-06-13T00:00:00Z,13,6,2020,245,7,Ethiopia,ET,ETH,112078727,Africa,47,2915,13
2020-06-14T00:00:00Z,14,6,2020,251,8,Ethiopia,ET,ETH,112078727,Africa,55,3166,14
2020-06-15T00:00:00Z,15,6,2020,179,2,Ethiopia,ET,ETH,112078727,Africa,57,3345,15
2020-06-16T00:00:00Z,16,6,2020,176,3,Ethiopia,ET,ETH,112078727,Africa,60,3521,16
2020-06-17T00:00:00Z,17,6,2020,109,1,Ethiopia,ET,ETH,112078727,Africa,61,3630,17
2020-06-18T00:00:00Z,18,6,2020,129,2,Ethiopia,ET,ETH,112078727,Africa,63,3759,18
2020-06-19T00:00:00Z,19,6,2020,195,2,Ethiopia,ET,ETH,112078727,Africa,65,3954,19
2020-06-20T00:00:00Z,20,6,2020,116,7,Ethiopia,ET,ETH,112078727,Africa,72,4070,20
2020-06-21T00:00:00Z,21,6,2020,399,0,Ethiopia,ET,ETH,112078727,Africa,72,4469,21
2020-06-22T00:00:00Z,22,6,2020,63,2,Ethiopia,ET,ETH,112078727,Africa,74,4532,22
2020-06-23T00:00:00Z,23,6,2020,131,1,Ethiopia,ET,ETH,112078727,Africa,75,4663,23
2020-06-24T00:00:00Z,24,6,2020,185,0,Ethiopia,ET,ETH,112078727,Africa,75,4848,24
2020-06-25T00:00:00Z,25,6,2020,186,3,Ethiopia,ET,ETH,112078727,Africa,78,5034,25
2020-03-30T00:00:00Z,30,3,2020,0,2,Finland,FI,FIN,5517919,Europe,11,1218,1
2020-03-31T00:00:00Z,31,3,2020,95,2,Finland,FI,FIN,5517919,Europe,13,1313,2
2020-04-01T00:00:00Z,1,4,2020,71,4,Finland,FI,FIN,5517919,Europe,17,1384,3
2020-04-02T00:00:00Z,2,4,2020,62,0,Finland,FI,FIN,5517919,Europe,17,1446,4
2020-04-03T00:00:00Z,3,4,2020,72,2,Finland,FI,FIN,5517919,Europe,19,1518,5
2020-04-04T00:00:00Z,4,4,2020,97,1,Finland,FI,FIN,5517919,Europe,20,1615,6
2020-04-05T00:00:00Z,5,4,2020,267,5,Finland,FI,FIN,5517919,Europe,25,1882,7
2020-04-06T00:00:00Z,6,4,2020,45,2,Finland,FI,FIN,5517919,Europe,27,1927,8
2020-04-07T00:00:00Z,7,4,2020,249,0,Finland,FI,FIN,5517919,Europe,27,2176,9
2020-04-08T00:00:00Z,8,4,2020,132,7,Finland,FI,FIN,5517919,Europe,34,2308,10
2020-04-09T00:00:00Z,9,4,2020,179,6,Finland,FI,FIN,5517919,Europe,40,2487,11
2020-04-10T00:00:00Z,10,4,2020,118,2,Finland,FI,FIN,5517919,Europe,42,2605,12
2020-04-11T00:00:00Z,11,4,2020,164,6,Finland,FI,FIN,5517919,Europe,48,2769,13
2020-04-12T00:00:00Z,12,4,2020,136,1,Finland,FI,FIN,5517919,Europe,49,2905,14
2020-04-13T00:00:00Z,13,4,2020,69,7,Finland,FI,FIN,5517919,Europe,56,2974,15
2020-04-14T00:00:00Z,14,4,2020,90,3,Finland,FI,FIN,5517919,Europe,59,3064,16
2020-04-15T00:00:00Z,15,4,2020,97,5,Finland,FI,FIN,5517919,Europe,64,3161,17
2020-04-16T00:00:00Z,16,4,2020,76,8,Finland,FI,FIN,5517919,Europe,72,3237,18
2020-04-17T00:00:00Z,17,4,2020,132,3,Finland,FI,FIN,5517919,Europe,75,3369,19
2020-04-18T00:00:00Z,18,4,2020,120,7,Finland,FI,FIN,5517919,Europe,82,3489,20
2020-04-19T00:00:00Z,19,4,2020,192,8,Finland,FI,FIN,5517919,Europe,90,3681,21
2020-04-20T00:00:00Z,20,4,2020,102,4,Finland,FI,FIN,5517919,Europe,94,3783,22
2020-04-21T00:00:00Z,21,4,2020,85,4,Finland,FI,FIN,5517919,Europe,98,3868,23
2020-04-22T00:00:00Z,22,4,2020,146,43,Finland,FI,FIN,5517919,Europe,141,4014,24
2020-04-23T00:00:00Z,23,4,2020,115,8,Finland,FI,FIN,5517919,Europe,149,4129,25
2020-04-24T00:00:00Z,24,4,2020,155,23,Finland,FI,FIN,5517919,Europe,172,4284,26
2020-04-25T00:00:00Z,25,4,2020,111,5,Finland,FI,FIN,5517919,Europe,177,4395,27
2020-04-26T00:00:00Z,26,4,2020,80,9,Finland,FI,FIN,5517919,Europe,186,4475,28
2020-04-27T00:00:00Z,27,4,2020,101,4,Finland,FI,FIN,5517919,Europe,190,4576,29
2020-04-28T00:00:00Z,28,4,2020,119,3,Finland,FI,FIN,5517919,Europe,193,4695,30
2020-04-29T00:00:00Z,29,4,2020,45,6,Finland,FI,FIN,5517919,Europe,199,4740,31
2020-04-30T00:00:00Z,30,4,2020,166,7,Finland,FI,FIN,5517919,Europe,206,4906,32
2020-05-01T00:00:00Z,1,5,2020,89,5,Finland,FI,FIN,5517919,Europe,211,4995,33
2020-05-02T00:00:00Z,2,5,2020,56,7,Finland,FI,FIN,5517919,Europe,218,5051,34
2020-05-03T00:00:00Z,3,5,2020,128,2,Finland,FI,FIN,5517919,Europe,220,5179,35
2020-05-04T00:00:00Z,4,5,2020,75,10,Finland,FI,FIN,5517919,Europe,230,5254,36
2020-05-05T00:00:00Z,5,5,2020,73,10,Finland,FI,FIN,5517919,Europe,240,5327,37
2020-05-06T00:00:00Z,6,5,2020,85,6,Finland,FI,FIN,5517919,Europe,246,5412,38
2020-05-07T00:00:00Z,7,5,2020,161,6,Finland,FI,FIN,5517919,Europe,252,5573,39
2020-05-08T00:00:00Z,8,5,2020,100,3,Finland,FI,FIN,5517919,Europe,255,5673,40
2020-05-09T00:00:00Z,9,5,2020,65,5,Finland,FI,FIN,5517919,Europe,260,5738,41
2020-05-10T00:00:00Z,10,5,2020,142,5,Finland,FI,FIN,5517919,Europe,265,5880,42
2020-05-11T00:00:00Z,11,5,2020,82,2,Finland,FI,FIN,5517919,Europe,267,5962,43
2020-05-12T00:00:00Z,12,5,2020,22,4,Finland,FI,FIN,5517919,Europe,271,5984,44
2020-05-13T00:00:00Z,13,5,2020,19,4,Finland,FI,FIN,5517919,Europe,275,6003,45
2020-05-14T00:00:00Z,14,5,2020,51,9,Finland,FI,FIN,5517919,Europe,284,6054,46
2020-05-15T00:00:00Z,15,5,2020,91,3,Finland,FI,FIN,5517919,Europe,287,6145,47
2020-05-16T00:00:00Z,16,5,2020,83,6,Finland,FI,FIN,5517919,Europe,293,6228,48
2020-05-17T00:00:00Z,17,5,2020,58,4,Finland,FI,FIN,5517919,Europe,297,6286,49
2020-05-18T00:00:00Z,18,5,2020,61,1,Finland,FI,FIN,5517919,Europe,298,6347,50
2020-05-19T00:00:00Z,19,5,2020,33,2,Finland,FI,FIN,5517919,Europe,300,6380,51
2020-05-20T00:00:00Z,20,5,2020,19,1,Finland,FI,FIN,5517919,Europe,301,6399,52
2020-05-21T00:00:00Z,21,5,2020,44,3,Finland,FI,FIN,5517919,Europe,304,6443,53
2020-05-22T00:00:00Z,22,5,2020,50,2,Finland,FI,FIN,5517919,Europe,306,6493,54
2020-05-23T00:00:00Z,23,5,2020,44,0,Finland,FI,FIN,5517919,Europe,306,6537,55
2020-05-24T00:00:00Z,24,5,2020,31,0,Finland,FI,FIN,5517919,Europe,306,6568,56
2020-05-25T00:00:00Z,25,5,2020,11,1,Finland,FI,FIN,5517919,Europe,307,6579,57
2020-05-26T00:00:00Z,26,5,2020,20,1,Finland,FI,FIN,5517919,Europe,308,6599,58
2020-05-27T00:00:00Z,27,5,2020,29,4,Finland,FI,FIN,5517919,Europe,312,6628,59
2020-05-28T00:00:00Z,28,5,2020,64,1,Finland,FI,FIN,5517919,Europe,313,6692,60
2020-05-29T00:00:00Z,29,5,2020,51,0,Finland,FI,FIN,5517919,Europe,313,6743,61
2020-05-30T00:00:00Z,30,5,2020,33,1,Finland,FI,FIN,5517919,Europe,314,6776,62
2020-05-31T00:00:00Z,31,5,2020,50,2,Finland,FI,FIN,5517919,Europe,316,6826,63
2020-06-01T00:00:00Z,1,6,2020,33,4,Finland,FI,FIN,5517919,Europe,320,6859,64
2020-06-02T00:00:00Z,2,6,2020,26,0,Finland,FI,FIN,5517919,Europe,320,6885,65
2020-06-03T00:00:00Z,3,6,2020,2,0,Finland,FI,FIN,5517919,Europe,320,6887,66
2020-06-04T00:00:00Z,4,6,2020,24,1,Finland,FI,FIN,5517919,Europe,321,6911,67
2020-06-05T00:00:00Z,5,6,2020,0,1,Finland,FI,FIN,5517919,Europe,322,6911,68
2020-06-06T00:00:00Z,6,6,2020,30,0,Finland,FI,FIN,5517919,Europe,322,6941,69
2020-06-07T00:00:00Z,7,6,2020,23,0,Finland,FI,FIN,5517919,Europe,322,6964,70
2020-06-08T00:00:00Z,8,6,2020,17,1,Finland,FI,FIN,5517919,Europe,323,6981,71
2020-06-09T00:00:00Z,9,6,2020,20,0,Finland,FI,FIN,5517919,Europe,323,7001,72
2020-06-10T00:00:00Z,10,6,2020,24,1,Finland,FI,FIN,5517919,Europe,324,7025,73
2020-06-11T00:00:00Z,11,6,2020,15,0,Finland,FI,FIN,5517919,Europe,324,7040,74
2020-06-12T00:00:00Z,12,6,2020,24,1,Finland,FI,FIN,5517919,Europe,325,7064,75
2020-06-13T00:00:00Z,13,6,2020,9,0,Finland,FI,FIN,5517919,Europe,325,7073,76
2020-06-14T00:00:00Z,14,6,2020,14,0,Finland,FI,FIN,5517919,Europe,325,7087,77
2020-06-15T00:00:00Z,15,6,2020,17,1,Finland,FI,FIN,5517919,Europe,326,7104,78
2020-06-16T00:00:00Z,16,6,2020,4,0,Finland,FI,FIN,5517919,Europe,326,7108,79
2020-06-17T00:00:00Z,17,6,2020,4,0,Finland,FI,FIN,5517919,Europe,326,7112,80
2020-06-18T00:00:00Z,18,6,2020,5,0,Finland,FI,FIN,5517919,Europe,326,7117,81
2020-06-19T00:00:00Z,19,6,2020,0,0,Finland,FI,FIN,5517919,Europe,326,7117,82
2020-06-20T00:00:00Z,20,6,2020,16,0,Finland,FI,FIN,5517919,Europe,326,7133,83
2020-06-21T00:00:00Z,21,6,2020,9,0,Finland,FI,FIN,5517919,Europe,326,7142,84
2020-06-22T00:00:00Z,22,6,2020,1,0,Finland,FI,FIN,5517919,Europe,326,7143,85
2020-06-23T00:00:00Z,23,6,2020,1,1,Finland,FI,FIN,5517919,Europe,327,7144,86
2020-06-24T00:00:00Z,24,6,2020,11,0,Finland,FI,FIN,5517919,Europe,327,7155,87
2020-06-25T00:00:00Z,25,6,2020,12,0,Finland,FI,FIN,5517919,Europe,327,7167,88
2020-03-08T00:00:00Z,8,3,2020,103,1,France,FR,FRA,67012883,Europe,10,716,1
2020-03-09T00:00:00Z,9,3,2020,410,9,France,FR,FRA,67012883,Europe,19,1126,2
2020-03-10T00:00:00Z,10,3,2020,286,11,France,FR,FRA,67012883,Europe,30,1412,3
2020-03-11T00:00:00Z,11,3,2020,372,3,France,FR,FRA,67012883,Europe,33,1784,4
2020-03-12T00:00:00Z,12,3,2020,497,15,France,FR,FRA,67012883,Europe,48,2281,5
2020-03-13T00:00:00Z,13,3,2020,595,13,France,FR,FRA,67012883,Europe,61,2876,6
2020-03-14T00:00:00Z,14,3,2020,785,18,France,FR,FRA,67012883,Europe,79,3661,7
2020-03-15T00:00:00Z,15,3,2020,838,12,France,FR,FRA,67012883,Europe,91,4499,8
2020-03-16T00:00:00Z,16,3,2020,924,36,France,FR,FRA,67012883,Europe,127,5423,9
2020-03-17T00:00:00Z,17,3,2020,1210,21,France,FR,FRA,67012883,Europe,148,6633,10
2020-03-18T00:00:00Z,18,3,2020,1097,27,France,FR,FRA,67012883,Europe,175,7730,11
2020-03-19T00:00:00Z,19,3,2020,1404,69,France,FR,FRA,67012883,Europe,244,9134,12
2020-03-20T00:00:00Z,20,3,2020,1861,128,France,FR,FRA,67012883,Europe,372,10995,13
2020-03-21T00:00:00Z,21,3,2020,1617,78,France,FR,FRA,67012883,Europe,450,12612,14
2020-03-22T00:00:00Z,22,3,2020,1847,112,France,FR,FRA,67012883,Europe,562,14459,15
2020-03-23T00:00:00Z,23,3,2020,1559,112,France,FR,FRA,67012883,Europe,674,16018,16
2020-03-24T00:00:00Z,24,3,2020,3838,186,France,FR,FRA,67012883,Europe,860,19856,17
2020-03-25T00:00:00Z,25,3,2020,2446,240,France,FR,FRA,67012883,Europe,1100,22302,18
2020-03-26T00:00:00Z,26,3,2020,2931,231,France,FR,FRA,67012883,Europe,1331,25233,19
2020-03-27T00:00:00Z,27,3,2020,3922,365,France,FR,FRA,67012883,Europe,1696,29155,20
2020-03-28T00:00:00Z,28,3,2020,3809,299,France,FR,FRA,67012883,Europe,1995,32964,21
2020-03-29T00:00:00Z,29,3,2020,4611,319,France,FR,FRA,67012883,Europe,2314,37575,22
2020-03-30T00:00:00Z,30,3,2020,2599,292,France,FR,FRA,67012883,Europe,2606,40174,23
2020-03-31T00:00:00Z,31,3,2020,4376,418,France,FR,FRA,67012883,Europe,3024,44550,24
2020-04-01T00:00:00Z,1,4,2020,7578,499,France,FR,FRA,67012883,Europe,3523,52128,25
2020-04-02T00:00:00Z,2,4,2020,4861,509,France,FR,FRA,67012883,Europe,4032,56989,26
2020-04-03T00:00:00Z,3,4,2020,2116,471,France,FR,FRA,67012883,Europe,4503,59105,27
2020-04-04T00:00:00Z,4,4,2020,5233,2004,France,FR,FRA,67012883,Europe,6507,64338,28
2020-04-05T00:00:00Z,5,4,2020,4267,1053,France,FR,FRA,67012883,Europe,7560,68605,29
2020-04-06T00:00:00Z,6,4,2020,1873,518,France,FR,FRA,67012883,Europe,8078,70478,30
2020-04-07T00:00:00Z,7,4,2020,3912,833,France,FR,FRA,67012883,Europe,8911,74390,31
2020-04-08T00:00:00Z,8,4,2020,3777,1417,France,FR,FRA,67012883,Europe,10328,78167,32
2020-04-09T00:00:00Z,9,4,2020,3881,541,France,FR,FRA,67012883,Europe,10869,82048,33
2020-04-10T00:00:00Z,10,4,2020,4286,1341,France,FR,FRA,67012883,Europe,12210,86334,34
2020-04-11T00:00:00Z,11,4,2020,4342,987,France,FR,FRA,67012883,Europe,13197,90676,35
2020-04-12T00:00:00Z,12,4,2020,3114,635,France,FR,FRA,67012883,Europe,13832,93790,36
2020-04-13T00:00:00Z,13,4,2020,1613,561,France,FR,FRA,67012883,Europe,14393,95403,37
2020-04-14T00:00:00Z,14,4,2020,2673,574,France,FR,FRA,67012883,Europe,14967,98076,38
2020-04-15T00:00:00Z,15,4,2020,5497,762,France,FR,FRA,67012883,Europe,15729,103573,39
2020-04-16T00:00:00Z,16,4,2020,2633,1438,France,FR,FRA,67012883,Europe,17167,106206,40
2020-04-17T00:00:00Z,17,4,2020,2641,753,France,FR,FRA,67012883,Europe,17920,108847,41
2020-04-18T00:00:00Z,18,4,2020,405,761,France,FR,FRA,67012883,Europe,18681,109252,42
2020-04-19T00:00:00Z,19,4,2020,2569,642,France,FR,FRA,67012883,Europe,19323,111821,43
2020-04-20T00:00:00Z,20,4,2020,785,395,France,FR,FRA,67012883,Europe,19718,112606,44
2020-04-21T00:00:00Z,21,4,2020,2051,547,France,FR,FRA,67012883,Europe,20265,114657,45
2020-04-22T00:00:00Z,22,4,2020,2667,531,France,FR,FRA,67012883,Europe,20796,117324,46
2020-04-23T00:00:00Z,23,4,2020,1827,544,France,FR,FRA,67012883,Europe,21340,119151,47
2020-04-24T00:00:00Z,24,4,2020,1653,516,France,FR,FRA,67012883,Europe,21856,120804,48
2020-04-25T00:00:00Z,25,4,2020,1773,389,France,FR,FRA,67012883,Europe,22245,122577,49
2020-04-26T00:00:00Z,26,4,2020,1537,369,France,FR,FRA,67012883,Europe,22614,124114,50
2020-04-27T00:00:00Z,27,4,2020,461,242,France,FR,FRA,67012883,Europe,22856,124575,51
2020-04-28T00:00:00Z,28,4,2020,1195,437,France,FR,FRA,67012883,Europe,23293,125770,52
2020-04-29T00:00:00Z,29,4,2020,1065,367,France,FR,FRA,67012883,Europe,23660,126835,53
2020-04-30T00:00:00Z,30,4,2020,1607,427,France,FR,FRA,67012883,Europe,24087,128442,54
2020-05-01T00:00:00Z,1,5,2020,1139,289,France,FR,FRA,67012883,Europe,24376,129581,55
2020-05-02T00:00:00Z,2,5,2020,604,218,France,FR,FRA,67012883,Europe,24594,130185,56
2020-05-03T00:00:00Z,3,5,2020,794,166,France,FR,FRA,67012883,Europe,24760,130979,57
2020-05-04T00:00:00Z,4,5,2020,308,135,France,FR,FRA,67012883,Europe,24895,131287,58
2020-05-05T00:00:00Z,5,5,2020,576,306,France,FR,FRA,67012883,Europe,25201,131863,59
2020-05-06T00:00:00Z,6,5,2020,1104,330,France,FR,FRA,67012883,Europe,25531,132967,60
2020-05-07T00:00:00Z,7,5,2020,4183,278,France,FR,FRA,67012883,Europe,25809,137150,61
2020-05-08T00:00:00Z,8,5,2020,629,178,France,FR,FRA,67012883,Europe,25987,137779,62
2020-05-09T00:00:00Z,9,5,2020,642,243,France,FR,FRA,67012883,Europe,26230,138421,63
2020-05-10T00:00:00Z,10,5,2020,433,80,France,FR,FRA,67012883,Europe,26310,138854,64
2020-05-11T00:00:00Z,11,5,2020,209,70,France,FR,FRA,67012883,Europe,26380,139063,65
2020-05-12T00:00:00Z,12,5,2020,456,263,France,FR,FRA,67012883,Europe,26643,139519,66
2020-05-13T00:00:00Z,13,5,2020,708,348,France,FR,FRA,67012883,Europe,26991,140227,67
2020-05-14T00:00:00Z,14,5,2020,507,83,France,FR,FRA,67012883,Europe,27074,140734,68
2020-05-15T00:00:00Z,15,5,2020,622,351,France,FR,FRA,67012883,Europe,27425,141356,69
2020-05-16T00:00:00Z,16,5,2020,563,130,France,FR,FRA,67012883,Europe,27555,141919,70
2020-05-17T00:00:00Z,17,5,2020,372,88,France,FR,FRA,67012883,Europe,27643,142291,71
2020-05-18T00:00:00Z,18,5,2020,120,68,France,FR,FRA,67012883,Europe,27711,142411,72
2020-05-19T00:00:00Z,19,5,2020,492,186,France,FR,FRA,67012883,Europe,27897,142903,73
2020-05-20T00:00:00Z,20,5,2020,524,125,France,FR,FRA,67012883,Europe,28022,143427,74
2020-05-21T00:00:00Z,21,5,2020,418,110,France,FR,FRA,67012883,Europe,28132,143845,75
2020-05-22T00:00:00Z,22,5,2020,318,83,France,FR,FRA,67012883,Europe,28215,144163,76
2020-05-23T00:00:00Z,23,5,2020,403,74,France,FR,FRA,67012883,Europe,28289,144566,77
2020-05-24T00:00:00Z,24,5,2020,240,43,France,FR,FRA,67012883,Europe,28332,144806,78
2020-05-25T00:00:00Z,25,5,2020,115,35,France,FR,FRA,67012883,Europe,28367,144921,79
2020-05-26T00:00:00Z,26,5,2020,358,65,France,FR,FRA,67012883,Europe,28432,145279,80
2020-05-27T00:00:00Z,27,5,2020,276,98,France,FR,FRA,67012883,Europe,28530,145555,81
2020-05-28T00:00:00Z,28,5,2020,191,66,France,FR,FRA,67012883,Europe,28596,145746,82
2020-05-29T00:00:00Z,29,5,2020,3325,66,France,FR,FRA,67012883,Europe,28662,149071,83
2020-05-30T00:00:00Z,30,5,2020,597,52,France,FR,FRA,67012883,Europe,28714,149668,84
2020-05-31T00:00:00Z,31,5,2020,1828,57,France,FR,FRA,67012883,Europe,28771,151496,85
2020-06-01T00:00:00Z,1,6,2020,257,31,France,FR,FRA,67012883,Europe,28802,151753,86
2020-06-02T00:00:00Z,2,6,2020,338,31,France,FR,FRA,67012883,Europe,28833,152091,87
2020-06-03T00:00:00Z,3,6,2020,-766,107,France,FR,FRA,67012883,Europe,28940,151325,88
2020-06-04T00:00:00Z,4,6,2020,352,81,France,FR,FRA,67012883,Europe,29021,151677,89
2020-06-05T00:00:00Z,5,6,2020,767,44,France,FR,FRA,67012883,Europe,29065,152444,90
2020-06-06T00:00:00Z,6,6,2020,611,46,France,FR,FRA,67012883,Europe,29111,153055,91
2020-06-07T00:00:00Z,7,6,2020,579,31,France,FR,FRA,67012883,Europe,29142,153634,92
2020-06-08T00:00:00Z,8,6,2020,343,13,France,FR,FRA,67012883,Europe,29155,153977,93
2020-06-09T00:00:00Z,9,6,2020,211,54,France,FR,FRA,67012883,Europe,29209,154188,94
2020-06-10T00:00:00Z,10,6,2020,403,87,France,FR,FRA,67012883,Europe,29296,154591,95
2020-06-11T00:00:00Z,11,6,2020,545,23,France,FR,FRA,67012883,Europe,29319,155136,96
2020-06-12T00:00:00Z,12,6,2020,425,27,France,FR,FRA,67012883,Europe,29346,155561,97
2020-06-13T00:00:00Z,13,6,2020,726,28,France,FR,FRA,67012883,Europe,29374,156287,98
2020-06-14T00:00:00Z,14,6,2020,526,24,France,FR,FRA,67012883,Europe,29398,156813,99
2020-06-15T00:00:00Z,15,6,2020,407,9,France,FR,FRA,67012883,Europe,29407,157220,100
2020-06-16T00:00:00Z,16,6,2020,152,29,France,FR,FRA,67012883,Europe,29436,157372,101
2020-06-17T00:00:00Z,17,6,2020,344,111,France,FR,FRA,67012883,Europe,29547,157716,102
2020-06-18T00:00:00Z,18,6,2020,458,28,France,FR,FRA,67012883,Europe,29575,158174,103
2020-06-19T00:00:00Z,19,6,2020,467,28,France,FR,FRA,67012883,Europe,29603,158641,104
2020-06-20T00:00:00Z,20,6,2020,811,14,France,FR,FRA,67012883,Europe,29617,159452,105
2020-06-21T00:00:00Z,21,6,2020,641,16,France,FR,FRA,67012883,Europe,29633,160093,106
2020-06-22T00:00:00Z,22,6,2020,284,7,France,FR,FRA,67012883,Europe,29640,160377,107
2020-06-23T00:00:00Z,23,6,2020,373,23,France,FR,FRA,67012883,Europe,29663,160750,108
2020-06-24T00:00:00Z,24,6,2020,517,57,France,FR,FRA,67012883,Europe,29720,161267,109
2020-06-25T00:00:00Z,25,6,2020,81,11,France,FR,FRA,67012883,Europe,29731,161348,110
2020-05-15T00:00:00Z,15,5,2020,100,1,Gabon,GA,GAB,2172578,Africa,10,1104,1
2020-05-16T00:00:00Z,16,5,2020,105,0,Gabon,GA,GAB,2172578,Africa,10,1209,2
2020-05-17T00:00:00Z,17,5,2020,111,1,Gabon,GA,GAB,2172578,Africa,11,1320,3
2020-05-18T00:00:00Z,18,5,2020,0,0,Gabon,GA,GAB,2172578,Africa,11,1320,4
2020-05-19T00:00:00Z,19,5,2020,112,0,Gabon,GA,GAB,2172578,Africa,11,1432,5
2020-05-20T00:00:00Z,20,5,2020,70,1,Gabon,GA,GAB,2172578,Africa,12,1502,6
2020-05-21T00:00:00Z,21,5,2020,65,0,Gabon,GA,GAB,2172578,Africa,12,1567,7
2020-05-22T00:00:00Z,22,5,2020,0,0,Gabon,GA,GAB,2172578,Africa,12,1567,8
2020-05-23T00:00:00Z,23,5,2020,161,0,Gabon,GA,GAB,2172578,Africa,12,1728,9
2020-05-24T00:00:00Z,24,5,2020,206,0,Gabon,GA,GAB,2172578,Africa,12,1934,10
2020-05-25T00:00:00Z,25,5,2020,0,0,Gabon,GA,GAB,2172578,Africa,12,1934,11
2020-05-26T00:00:00Z,26,5,2020,201,2,Gabon,GA,GAB,2172578,Africa,14,2135,12
2020-05-27T00:00:00Z,27,5,2020,103,0,Gabon,GA,GAB,2172578,Africa,14,2238,13
2020-05-28T00:00:00Z,28,5,2020,81,0,Gabon,GA,GAB,2172578,Africa,14,2319,14
2020-05-29T00:00:00Z,29,5,2020,112,0,Gabon,GA,GAB,2172578,Africa,14,2431,15
2020-05-30T00:00:00Z,30,5,2020,182,1,Gabon,GA,GAB,2172578,Africa,15,2613,16
2020-05-31T00:00:00Z,31,5,2020,42,2,Gabon,GA,GAB,2172578,Africa,17,2655,17
2020-06-01T00:00:00Z,1,6,2020,0,0,Gabon,GA,GAB,2172578,Africa,17,2655,18
2020-06-02T00:00:00Z,2,6,2020,0,0,Gabon,GA,GAB,2172578,Africa,17,2655,19
2020-06-03T00:00:00Z,3,6,2020,148,3,Gabon,GA,GAB,2172578,Africa,20,2803,20
2020-06-04T00:00:00Z,4,6,2020,99,0,Gabon,GA,GAB,2172578,Africa,20,2902,21
2020-06-05T00:00:00Z,5,6,2020,53,1,Gabon,GA,GAB,2172578,Africa,21,2955,22
2020-06-06T00:00:00Z,6,6,2020,146,0,Gabon,GA,GAB,2172578,Africa,21,3101,23
2020-06-07T00:00:00Z,7,6,2020,0,0,Gabon,GA,GAB,2172578,Africa,21,3101,24
2020-06-08T00:00:00Z,8,6,2020,0,0,Gabon,GA,GAB,2172578,Africa,21,3101,25
2020-06-09T00:00:00Z,9,6,2020,146,0,Gabon,GA,GAB,2172578,Africa,21,3247,26
2020-06-10T00:00:00Z,10,6,2020,47,0,Gabon,GA,GAB,2172578,Africa,21,3294,27
2020-06-11T00:00:00Z,11,6,2020,81,1,Gabon,GA,GAB,2172578,Africa,22,3375,28
2020-06-12T00:00:00Z,12,6,2020,88,1,Gabon,GA,GAB,2172578,Africa,23,3463,29
2020-06-13T00:00:00Z,13,6,2020,0,0,Gabon,GA,GAB,2172578,Africa,23,3463,30
2020-06-14T00:00:00Z,14,6,2020,0,0,Gabon,GA,GAB,2172578,Africa,23,3463,31
2020-06-15T00:00:00Z,15,6,2020,0,0,Gabon,GA,GAB,2172578,Africa,23,3463,32
2020-06-16T00:00:00Z,16,6,2020,570,4,Gabon,GA,GAB,2172578,Africa,27,4033,33
2020-06-17T00:00:00Z,17,6,2020,81,2,Gabon,GA,GAB,2172578,Africa,29,4114,34
2020-06-18T00:00:00Z,18,6,2020,115,1,Gabon,GA,GAB,2172578,Africa,30,4229,35
2020-06-19T00:00:00Z,19,6,2020,111,2,Gabon,GA,GAB,2172578,Africa,32,4340,36
2020-06-20T00:00:00Z,20,6,2020,88,2,Gabon,GA,GAB,2172578,Africa,34,4428,37
2020-06-21T00:00:00Z,21,6,2020,0,0,Gabon,GA,GAB,2172578,Africa,34,4428,38
2020-06-22T00:00:00Z,22,6,2020,0,0,Gabon,GA,GAB,2172578,Africa,34,4428,39
2020-06-23T00:00:00Z,23,6,2020,311,5,Gabon,GA,GAB,2172578,Africa,39,4739,40
2020-06-24T00:00:00Z,24,6,2020,134,0,Gabon,GA,GAB,2172578,Africa,39,4873,41
2020-06-25T00:00:00Z,25,6,2020,83,0,Gabon,GA,GAB,2172578,Africa,39,4956,42
2020-05-09T00:00:00Z,9,5,2020,8,1,Georgia,GE,GEO,3996762,Europe,10,623,1
2020-05-10T00:00:00Z,10,5,2020,3,0,Georgia,GE,GEO,3996762,Europe,10,626,2
2020-05-11T00:00:00Z,11,5,2020,9,0,Georgia,GE,GEO,3996762,Europe,10,635,3
2020-05-12T00:00:00Z,12,5,2020,3,1,Georgia,GE,GEO,3996762,Europe,11,638,4
2020-05-13T00:00:00Z,13,5,2020,4,0,Georgia,GE,GEO,3996762,Europe,11,642,5
2020-05-14T00:00:00Z,14,5,2020,5,0,Georgia,GE,GEO,3996762,Europe,11,647,6
2020-05-15T00:00:00Z,15,5,2020,20,1,Georgia,GE,GEO,3996762,Europe,12,667,7
2020-05-16T00:00:00Z,16,5,2020,4,0,Georgia,GE,GEO,3996762,Europe,12,671,8
2020-05-17T00:00:00Z,17,5,2020,24,0,Georgia,GE,GEO,3996762,Europe,12,695,9
2020-05-18T00:00:00Z,18,5,2020,6,0,Georgia,GE,GEO,3996762,Europe,12,701,10
2020-05-19T00:00:00Z,19,5,2020,1,0,Georgia,GE,GEO,3996762,Europe,12,702,11
2020-05-20T00:00:00Z,20,5,2020,5,0,Georgia,GE,GEO,3996762,Europe,12,707,12
2020-05-21T00:00:00Z,21,5,2020,6,0,Georgia,GE,GEO,3996762,Europe,12,713,13
2020-05-22T00:00:00Z,22,5,2020,8,0,Georgia,GE,GEO,3996762,Europe,12,721,14
2020-05-23T00:00:00Z,23,5,2020,2,0,Georgia,GE,GEO,3996762,Europe,12,723,15
2020-05-24T00:00:00Z,24,5,2020,5,0,Georgia,GE,GEO,3996762,Europe,12,728,16
2020-05-25T00:00:00Z,25,5,2020,2,0,Georgia,GE,GEO,3996762,Europe,12,730,17
2020-05-26T00:00:00Z,26,5,2020,1,0,Georgia,GE,GEO,3996762,Europe,12,731,18
2020-05-27T00:00:00Z,27,5,2020,1,0,Georgia,GE,GEO,3996762,Europe,12,732,19
2020-05-28T00:00:00Z,28,5,2020,3,0,Georgia,GE,GEO,3996762,Europe,12,735,20
2020-05-29T00:00:00Z,29,5,2020,3,0,Georgia,GE,GEO,3996762,Europe,12,738,21
2020-05-30T00:00:00Z,30,5,2020,8,0,Georgia,GE,GEO,3996762,Europe,12,746,22
2020-05-31T00:00:00Z,31,5,2020,11,0,Georgia,GE,GEO,3996762,Europe,12,757,23
2020-06-01T00:00:00Z,1,6,2020,26,0,Georgia,GE,GEO,3996762,Europe,12,783,24
2020-06-02T00:00:00Z,2,6,2020,13,0,Georgia,GE,GEO,3996762,Europe,12,796,25
2020-06-03T00:00:00Z,3,6,2020,4,1,Georgia,GE,GEO,3996762,Europe,13,800,26
2020-06-04T00:00:00Z,4,6,2020,0,0,Georgia,GE,GEO,3996762,Europe,13,800,27
2020-06-05T00:00:00Z,5,6,2020,1,0,Georgia,GE,GEO,3996762,Europe,13,801,28
2020-06-06T00:00:00Z,6,6,2020,4,0,Georgia,GE,GEO,3996762,Europe,13,805,29
2020-06-07T00:00:00Z,7,6,2020,3,0,Georgia,GE,GEO,3996762,Europe,13,808,30
2020-06-08T00:00:00Z,8,6,2020,0,0,Georgia,GE,GEO,3996762,Europe,13,808,31
2020-06-09T00:00:00Z,9,6,2020,4,0,Georgia,GE,GEO,3996762,Europe,13,812,32
2020-06-10T00:00:00Z,10,6,2020,6,0,Georgia,GE,GEO,3996762,Europe,13,818,33
2020-06-11T00:00:00Z,11,6,2020,9,0,Georgia,GE,GEO,3996762,Europe,13,827,34
2020-06-12T00:00:00Z,12,6,2020,4,0,Georgia,GE,GEO,3996762,Europe,13,831,35
2020-06-13T00:00:00Z,13,6,2020,12,0,Georgia,GE,GEO,3996762,Europe,13,843,36
2020-06-14T00:00:00Z,14,6,2020,8,1,Georgia,GE,GEO,3996762,Europe,14,851,37
2020-06-15T00:00:00Z,15,6,2020,28,0,Georgia,GE,GEO,3996762,Europe,14,879,38
2020-06-16T00:00:00Z,16,6,2020,0,0,Georgia,GE,GEO,3996762,Europe,14,879,39
2020-06-17T00:00:00Z,17,6,2020,9,0,Georgia,GE,GEO,3996762,Europe,14,888,40
2020-06-18T00:00:00Z,18,6,2020,5,0,Georgia,GE,GEO,3996762,Europe,14,893,41
2020-06-19T00:00:00Z,19,6,2020,2,0,Georgia,GE,GEO,3996762,Europe,14,895,42
2020-06-20T00:00:00Z,20,6,2020,1,0,Georgia,GE,GEO,3996762,Europe,14,896,43
2020-06-21T00:00:00Z,21,6,2020,2,0,Georgia,GE,GEO,3996762,Europe,14,898,44
2020-06-22T00:00:00Z,22,6,2020,10,0,Georgia,GE,GEO,3996762,Europe,14,908,45
2020-06-23T00:00:00Z,23,6,2020,3,0,Georgia,GE,GEO,3996762,Europe,14,911,46
2020-06-24T00:00:00Z,24,6,2020,3,0,Georgia,GE,GEO,3996762,Europe,14,914,47
2020-06-25T00:00:00Z,25,6,2020,3,0,Georgia,GE,GEO,3996762,Europe,14,917,48
2020-03-16T00:00:00Z,16,3,2020,1043,4,Germany,DE,DEU,83019213,Europe,12,4838,1
2020-03-17T00:00:00Z,17,3,2020,1174,1,Germany,DE,DEU,83019213,Europe,13,6012,2
2020-03-18T00:00:00Z,18,3,2020,1144,0,Germany,DE,DEU,83019213,Europe,13,7156,3
2020-03-19T00:00:00Z,19,3,2020,1042,0,Germany,DE,DEU,83019213,Europe,13,8198,4
2020-03-20T00:00:00Z,20,3,2020,5940,30,Germany,DE,DEU,83019213,Europe,43,14138,5
2020-03-21T00:00:00Z,21,3,2020,4049,2,Germany,DE,DEU,83019213,Europe,45,18187,6
2020-03-22T00:00:00Z,22,3,2020,3276,22,Germany,DE,DEU,83019213,Europe,67,21463,7
2020-03-23T00:00:00Z,23,3,2020,3311,27,Germany,DE,DEU,83019213,Europe,94,24774,8
2020-03-24T00:00:00Z,24,3,2020,4438,32,Germany,DE,DEU,83019213,Europe,126,29212,9
2020-03-25T00:00:00Z,25,3,2020,2342,23,Germany,DE,DEU,83019213,Europe,149,31554,10
2020-03-26T00:00:00Z,26,3,2020,4954,49,Germany,DE,DEU,83019213,Europe,198,36508,11
2020-03-27T00:00:00Z,27,3,2020,5780,55,Germany,DE,DEU,83019213,Europe,253,42288,12
2020-03-28T00:00:00Z,28,3,2020,6294,72,Germany,DE,DEU,83019213,Europe,325,48582,13
2020-03-29T00:00:00Z,29,3,2020,3965,64,Germany,DE,DEU,83019213,Europe,389,52547,14
2020-03-30T00:00:00Z,30,3,2020,4751,66,Germany,DE,DEU,83019213,Europe,455,57298,15
2020-03-31T00:00:00Z,31,3,2020,4615,128,Germany,DE,DEU,83019213,Europe,583,61913,16
2020-04-01T00:00:00Z,1,4,2020,5453,149,Germany,DE,DEU,83019213,Europe,732,67366,17
2020-04-02T00:00:00Z,2,4,2020,6156,140,Germany,DE,DEU,83019213,Europe,872,73522,18
2020-04-03T00:00:00Z,3,4,2020,6174,145,Germany,DE,DEU,83019213,Europe,1017,79696,19
2020-04-04T00:00:00Z,4,4,2020,6082,141,Germany,DE,DEU,83019213,Europe,1158,85778,20
2020-04-05T00:00:00Z,5,4,2020,5936,184,Germany,DE,DEU,83019213,Europe,1342,91714,21
2020-04-06T00:00:00Z,6,4,2020,3677,92,Germany,DE,DEU,83019213,Europe,1434,95391,22
2020-04-07T00:00:00Z,7,4,2020,3834,173,Germany,DE,DEU,83019213,Europe,1607,99225,23
2020-04-08T00:00:00Z,8,4,2020,4003,254,Germany,DE,DEU,83019213,Europe,1861,103228,24
2020-04-09T00:00:00Z,9,4,2020,4974,246,Germany,DE,DEU,83019213,Europe,2107,108202,25
2020-04-10T00:00:00Z,10,4,2020,5323,266,Germany,DE,DEU,83019213,Europe,2373,113525,26
2020-04-11T00:00:00Z,11,4,2020,4133,171,Germany,DE,DEU,83019213,Europe,2544,117658,27
2020-04-12T00:00:00Z,12,4,2020,2821,129,Germany,DE,DEU,83019213,Europe,2673,120479,28
2020-04-13T00:00:00Z,13,4,2020,2537,126,Germany,DE,DEU,83019213,Europe,2799,123016,29
2020-04-14T00:00:00Z,14,4,2020,2082,170,Germany,DE,DEU,83019213,Europe,2969,125098,30
2020-04-15T00:00:00Z,15,4,2020,2486,285,Germany,DE,DEU,83019213,Europe,3254,127584,31
2020-04-16T00:00:00Z,16,4,2020,2866,315,Germany,DE,DEU,83019213,Europe,3569,130450,32
2020-04-17T00:00:00Z,17,4,2020,3380,299,Germany,DE,DEU,83019213,Europe,3868,133830,33
2020-04-18T00:00:00Z,18,4,2020,3609,242,Germany,DE,DEU,83019213,Europe,4110,137439,34
2020-04-19T00:00:00Z,19,4,2020,2458,184,Germany,DE,DEU,83019213,Europe,4294,139897,35
2020-04-20T00:00:00Z,20,4,2020,1775,110,Germany,DE,DEU,83019213,Europe,4404,141672,36
2020-04-21T00:00:00Z,21,4,2020,1785,194,Germany,DE,DEU,83019213,Europe,4598,143457,37
2020-04-22T00:00:00Z,22,4,2020,2237,281,Germany,DE,DEU,83019213,Europe,4879,145694,38
2020-04-23T00:00:00Z,23,4,2020,2352,215,Germany,DE,DEU,83019213,Europe,5094,148046,39
2020-04-24T00:00:00Z,24,4,2020,2337,227,Germany,DE,DEU,83019213,Europe,5321,150383,40
2020-04-25T00:00:00Z,25,4,2020,2055,179,Germany,DE,DEU,83019213,Europe,5500,152438,41
2020-04-26T00:00:00Z,26,4,2020,1737,140,Germany,DE,DEU,83019213,Europe,5640,154175,42
2020-04-27T00:00:00Z,27,4,2020,1018,110,Germany,DE,DEU,83019213,Europe,5750,155193,43
2020-04-28T00:00:00Z,28,4,2020,1144,163,Germany,DE,DEU,83019213,Europe,5913,156337,44
2020-04-29T00:00:00Z,29,4,2020,1304,202,Germany,DE,DEU,83019213,Europe,6115,157641,45
2020-04-30T00:00:00Z,30,4,2020,1478,173,Germany,DE,DEU,83019213,Europe,6288,159119,46
2020-05-01T00:00:00Z,1,5,2020,0,0,Germany,DE,DEU,83019213,Europe,6288,159119,47
2020-05-02T00:00:00Z,2,5,2020,2584,287,Germany,DE,DEU,83019213,Europe,6575,161703,48
2020-05-03T00:00:00Z,3,5,2020,793,74,Germany,DE,DEU,83019213,Europe,6649,162496,49
2020-05-04T00:00:00Z,4,5,2020,679,43,Germany,DE,DEU,83019213,Europe,6692,163175,50
2020-05-05T00:00:00Z,5,5,2020,685,139,Germany,DE,DEU,83019213,Europe,6831,163860,51
2020-05-06T00:00:00Z,6,5,2020,1037,165,Germany,DE,DEU,83019213,Europe,6996,164897,52
2020-05-07T00:00:00Z,7,5,2020,1194,123,Germany,DE,DEU,83019213,Europe,7119,166091,53
2020-05-08T00:00:00Z,8,5,2020,1209,147,Germany,DE,DEU,83019213,Europe,7266,167300,54
2020-05-09T00:00:00Z,9,5,2020,1251,103,Germany,DE,DEU,83019213,Europe,7369,168551,55
2020-05-10T00:00:00Z,10,5,2020,667,26,Germany,DE,DEU,83019213,Europe,7395,169218,56
2020-05-11T00:00:00Z,11,5,2020,357,22,Germany,DE,DEU,83019213,Europe,7417,169575,57
2020-05-12T00:00:00Z,12,5,2020,933,116,Germany,DE,DEU,83019213,Europe,7533,170508,58
2020-05-13T00:00:00Z,13,5,2020,798,101,Germany,DE,DEU,83019213,Europe,7634,171306,59
2020-05-14T00:00:00Z,14,5,2020,933,89,Germany,DE,DEU,83019213,Europe,7723,172239,60
2020-05-15T00:00:00Z,15,5,2020,913,101,Germany,DE,DEU,83019213,Europe,7824,173152,61
2020-05-16T00:00:00Z,16,5,2020,620,57,Germany,DE,DEU,83019213,Europe,7881,173772,62
2020-05-17T00:00:00Z,17,5,2020,583,33,Germany,DE,DEU,83019213,Europe,7914,174355,63
2020-05-18T00:00:00Z,18,5,2020,342,21,Germany,DE,DEU,83019213,Europe,7935,174697,64
2020-05-19T00:00:00Z,19,5,2020,513,72,Germany,DE,DEU,83019213,Europe,8007,175210,65
2020-05-20T00:00:00Z,20,5,2020,797,83,Germany,DE,DEU,83019213,Europe,8090,176007,66
2020-05-21T00:00:00Z,21,5,2020,745,57,Germany,DE,DEU,83019213,Europe,8147,176752,67
2020-05-22T00:00:00Z,22,5,2020,460,27,Germany,DE,DEU,83019213,Europe,8174,177212,68
2020-05-23T00:00:00Z,23,5,2020,638,42,Germany,DE,DEU,83019213,Europe,8216,177850,69
2020-05-24T00:00:00Z,24,5,2020,431,31,Germany,DE,DEU,83019213,Europe,8247,178281,70
2020-05-25T00:00:00Z,25,5,2020,289,10,Germany,DE,DEU,83019213,Europe,8257,178570,71
2020-05-26T00:00:00Z,26,5,2020,432,45,Germany,DE,DEU,83019213,Europe,8302,179002,72
2020-05-27T00:00:00Z,27,5,2020,362,47,Germany,DE,DEU,83019213,Europe,8349,179364,73
2020-05-28T00:00:00Z,28,5,2020,353,62,Germany,DE,DEU,83019213,Europe,8411,179717,74
2020-05-29T00:00:00Z,29,5,2020,741,39,Germany,DE,DEU,83019213,Europe,8450,180458,75
2020-05-30T00:00:00Z,30,5,2020,738,39,Germany,DE,DEU,83019213,Europe,8489,181196,76
2020-05-31T00:00:00Z,31,5,2020,286,11,Germany,DE,DEU,83019213,Europe,8500,181482,77
2020-06-01T00:00:00Z,1,6,2020,333,11,Germany,DE,DEU,83019213,Europe,8511,181815,78
2020-06-02T00:00:00Z,2,6,2020,213,11,Germany,DE,DEU,83019213,Europe,8522,182028,79
2020-06-03T00:00:00Z,3,6,2020,342,29,Germany,DE,DEU,83019213,Europe,8551,182370,80
2020-06-04T00:00:00Z,4,6,2020,394,30,Germany,DE,DEU,83019213,Europe,8581,182764,81
2020-06-05T00:00:00Z,5,6,2020,507,32,Germany,DE,DEU,83019213,Europe,8613,183271,82
2020-06-06T00:00:00Z,6,6,2020,407,33,Germany,DE,DEU,83019213,Europe,8646,183678,83
2020-06-07T00:00:00Z,7,6,2020,301,22,Germany,DE,DEU,83019213,Europe,8668,183979,84
2020-06-08T00:00:00Z,8,6,2020,214,6,Germany,DE,DEU,83019213,Europe,8674,184193,85
2020-06-09T00:00:00Z,9,6,2020,350,37,Germany,DE,DEU,83019213,Europe,8711,184543,86
2020-06-10T00:00:00Z,10,6,2020,318,18,Germany,DE,DEU,83019213,Europe,8729,184861,87
2020-06-11T00:00:00Z,11,6,2020,555,26,Germany,DE,DEU,83019213,Europe,8755,185416,88
2020-06-12T00:00:00Z,12,6,2020,258,8,Germany,DE,DEU,83019213,Europe,8763,185674,89
2020-06-13T00:00:00Z,13,6,2020,348,18,Germany,DE,DEU,83019213,Europe,8781,186022,90
2020-06-14T00:00:00Z,14,6,2020,247,6,Germany,DE,DEU,83019213,Europe,8787,186269,91
2020-06-15T00:00:00Z,15,6,2020,192,4,Germany,DE,DEU,83019213,Europe,8791,186461,92
2020-06-16T00:00:00Z,16,6,2020,378,9,Germany,DE,DEU,83019213,Europe,8800,186839,93
2020-06-17T00:00:00Z,17,6,2020,345,30,Germany,DE,DEU,83019213,Europe,8830,187184,94
2020-06-18T00:00:00Z,18,6,2020,580,26,Germany,DE,DEU,83019213,Europe,8856,187764,95
2020-06-19T00:00:00Z,19,6,2020,770,16,Germany,DE,DEU,83019213,Europe,8872,188534,96
2020-06-20T00:00:00Z,20,6,2020,601,10,Germany,DE,DEU,83019213,Europe,8882,189135,97
2020-06-21T00:00:00Z,21,6,2020,687,0,Germany,DE,DEU,83019213,Europe,8882,189822,98
2020-06-22T00:00:00Z,22,6,2020,537,3,Germany,DE,DEU,83019213,Europe,8885,190359,99
2020-06-23T00:00:00Z,23,6,2020,503,10,Germany,DE,DEU,83019213,Europe,8895,190862,100
2020-06-24T00:00:00Z,24,6,2020,587,19,Germany,DE,DEU,83019213,Europe,8914,191449,101
2020-06-25T00:00:00Z,25,6,2020,630,13,Germany,DE,DEU,83019213,Europe,8927,192079,102
2020-04-25T00:00:00Z,25,4,2020,125,1,Ghana,GH,GHA,30417858,Africa,10,1279,1
2020-04-26T00:00:00Z,26,4,2020,0,0,Ghana,GH,GHA,30417858,Africa,10,1279,2
2020-04-27T00:00:00Z,27,4,2020,271,1,Ghana,GH,GHA,30417858,Africa,11,1550,3
2020-04-28T00:00:00Z,28,4,2020,0,0,Ghana,GH,GHA,30417858,Africa,11,1550,4
2020-04-29T00:00:00Z,29,4,2020,121,5,Ghana,GH,GHA,30417858,Africa,16,1671,5
2020-04-30T00:00:00Z,30,4,2020,0,0,Ghana,GH,GHA,30417858,Africa,16,1671,6
2020-05-01T00:00:00Z,1,5,2020,403,1,Ghana,GH,GHA,30417858,Africa,17,2074,7
2020-05-02T00:00:00Z,2,5,2020,0,0,Ghana,GH,GHA,30417858,Africa,17,2074,8
2020-05-03T00:00:00Z,3,5,2020,95,1,Ghana,GH,GHA,30417858,Africa,18,2169,9
2020-05-04T00:00:00Z,4,5,2020,0,0,Ghana,GH,GHA,30417858,Africa,18,2169,10
2020-05-05T00:00:00Z,5,5,2020,550,0,Ghana,GH,GHA,30417858,Africa,18,2719,11
2020-05-06T00:00:00Z,6,5,2020,0,0,Ghana,GH,GHA,30417858,Africa,18,2719,12
2020-05-07T00:00:00Z,7,5,2020,372,0,Ghana,GH,GHA,30417858,Africa,18,3091,13
2020-05-08T00:00:00Z,8,5,2020,0,0,Ghana,GH,GHA,30417858,Africa,18,3091,14
2020-05-09T00:00:00Z,9,5,2020,921,0,Ghana,GH,GHA,30417858,Africa,18,4012,15
2020-05-10T00:00:00Z,10,5,2020,251,4,Ghana,GH,GHA,30417858,Africa,22,4263,16
2020-05-11T00:00:00Z,11,5,2020,0,0,Ghana,GH,GHA,30417858,Africa,22,4263,17
2020-05-12T00:00:00Z,12,5,2020,437,0,Ghana,GH,GHA,30417858,Africa,22,4700,18
2020-05-13T00:00:00Z,13,5,2020,427,0,Ghana,GH,GHA,30417858,Africa,22,5127,19
2020-05-14T00:00:00Z,14,5,2020,281,2,Ghana,GH,GHA,30417858,Africa,24,5408,20
2020-05-15T00:00:00Z,15,5,2020,122,0,Ghana,GH,GHA,30417858,Africa,24,5530,21
2020-05-16T00:00:00Z,16,5,2020,108,4,Ghana,GH,GHA,30417858,Africa,28,5638,22
2020-05-17T00:00:00Z,17,5,2020,97,1,Ghana,GH,GHA,30417858,Africa,29,5735,23
2020-05-18T00:00:00Z,18,5,2020,0,0,Ghana,GH,GHA,30417858,Africa,29,5735,24
2020-05-19T00:00:00Z,19,5,2020,0,0,Ghana,GH,GHA,30417858,Africa,29,5735,25
2020-05-20T00:00:00Z,20,5,2020,361,2,Ghana,GH,GHA,30417858,Africa,31,6096,26
2020-05-21T00:00:00Z,21,5,2020,173,0,Ghana,GH,GHA,30417858,Africa,31,6269,27
2020-05-22T00:00:00Z,22,5,2020,217,0,Ghana,GH,GHA,30417858,Africa,31,6486,28
2020-05-23T00:00:00Z,23,5,2020,131,0,Ghana,GH,GHA,30417858,Africa,31,6617,29
2020-05-24T00:00:00Z,24,5,2020,0,0,Ghana,GH,GHA,30417858,Africa,31,6617,30
2020-05-25T00:00:00Z,25,5,2020,66,1,Ghana,GH,GHA,30417858,Africa,32,6683,31
2020-05-26T00:00:00Z,26,5,2020,125,0,Ghana,GH,GHA,30417858,Africa,32,6808,32
2020-05-27T00:00:00Z,27,5,2020,309,2,Ghana,GH,GHA,30417858,Africa,34,7117,33
2020-05-28T00:00:00Z,28,5,2020,186,0,Ghana,GH,GHA,30417858,Africa,34,7303,34
2020-05-29T00:00:00Z,29,5,2020,0,0,Ghana,GH,GHA,30417858,Africa,34,7303,35
2020-05-30T00:00:00Z,30,5,2020,313,0,Ghana,GH,GHA,30417858,Africa,34,7616,36
2020-05-31T00:00:00Z,31,5,2020,152,1,Ghana,GH,GHA,30417858,Africa,35,7768,37
2020-06-01T00:00:00Z,1,6,2020,302,1,Ghana,GH,GHA,30417858,Africa,36,8070,38
2020-06-02T00:00:00Z,2,6,2020,0,0,Ghana,GH,GHA,30417858,Africa,36,8070,39
2020-06-03T00:00:00Z,3,6,2020,227,2,Ghana,GH,GHA,30417858,Africa,38,8297,40
2020-06-04T00:00:00Z,4,6,2020,251,0,Ghana,GH,GHA,30417858,Africa,38,8548,41
2020-06-05T00:00:00Z,5,6,2020,337,0,Ghana,GH,GHA,30417858,Africa,38,8885,42
2020-06-06T00:00:00Z,6,6,2020,283,4,Ghana,GH,GHA,30417858,Africa,42,9168,43
2020-06-07T00:00:00Z,7,6,2020,294,2,Ghana,GH,GHA,30417858,Africa,44,9462,44
2020-06-08T00:00:00Z,8,6,2020,176,0,Ghana,GH,GHA,30417858,Africa,44,9638,45
2020-06-09T00:00:00Z,9,6,2020,272,4,Ghana,GH,GHA,30417858,Africa,48,9910,46
2020-06-10T00:00:00Z,10,6,2020,291,0,Ghana,GH,GHA,30417858,Africa,48,10201,47
2020-06-11T00:00:00Z,11,6,2020,157,0,Ghana,GH,GHA,30417858,Africa,48,10358,48
2020-06-12T00:00:00Z,12,6,2020,0,0,Ghana,GH,GHA,30417858,Africa,48,10358,49
2020-06-13T00:00:00Z,13,6,2020,760,0,Ghana,GH,GHA,30417858,Africa,48,11118,50
2020-06-14T00:00:00Z,14,6,2020,304,3,Ghana,GH,GHA,30417858,Africa,51,11422,51
2020-06-15T00:00:00Z,15,6,2020,542,3,Ghana,GH,GHA,30417858,Africa,54,11964,52
2020-06-16T00:00:00Z,16,6,2020,0,0,Ghana,GH,GHA,30417858,Africa,54,11964,53
2020-06-17T00:00:00Z,17,6,2020,229,4,Ghana,GH,GHA,30417858,Africa,58,12193,54
2020-06-18T00:00:00Z,18,6,2020,397,8,Ghana,GH,GHA,30417858,Africa,66,12590,55
2020-06-19T00:00:00Z,19,6,2020,339,0,Ghana,GH,GHA,30417858,Africa,66,12929,56
2020-06-20T00:00:00Z,20,6,2020,274,4,Ghana,GH,GHA,30417858,Africa,70,13203,57
2020-06-21T00:00:00Z,21,6,2020,508,15,Ghana,GH,GHA,30417858,Africa,85,13711,58
2020-06-22T00:00:00Z,22,6,2020,443,0,Ghana,GH,GHA,30417858,Africa,85,14154,59
2020-06-23T00:00:00Z,23,6,2020,0,0,Ghana,GH,GHA,30417858,Africa,85,14154,60
2020-06-24T00:00:00Z,24,6,2020,414,10,Ghana,GH,GHA,30417858,Africa,95,14568,61
2020-06-25T00:00:00Z,25,6,2020,445,0,Ghana,GH,GHA,30417858,Africa,95,15013,62
2020-03-22T00:00:00Z,22,3,2020,35,5,Greece,EL,GRC,10724599,Europe,13,530,1
2020-03-23T00:00:00Z,23,3,2020,94,2,Greece,EL,GRC,10724599,Europe,15,624,2
2020-03-24T00:00:00Z,24,3,2020,71,2,Greece,EL,GRC,10724599,Europe,17,695,3
2020-03-25T00:00:00Z,25,3,2020,48,3,Greece,EL,GRC,10724599,Europe,20,743,4
2020-03-26T00:00:00Z,26,3,2020,78,2,Greece,EL,GRC,10724599,Europe,22,821,5
2020-03-27T00:00:00Z,27,3,2020,71,4,Greece,EL,GRC,10724599,Europe,26,892,6
2020-03-28T00:00:00Z,28,3,2020,74,2,Greece,EL,GRC,10724599,Europe,28,966,7
2020-03-29T00:00:00Z,29,3,2020,95,4,Greece,EL,GRC,10724599,Europe,32,1061,8
2020-03-30T00:00:00Z,30,3,2020,95,6,Greece,EL,GRC,10724599,Europe,38,1156,9
2020-03-31T00:00:00Z,31,3,2020,56,5,Greece,EL,GRC,10724599,Europe,43,1212,10
2020-04-01T00:00:00Z,1,4,2020,102,6,Greece,EL,GRC,10724599,Europe,49,1314,11
2020-04-02T00:00:00Z,2,4,2020,61,1,Greece,EL,GRC,10724599,Europe,50,1375,12
2020-04-03T00:00:00Z,3,4,2020,139,3,Greece,EL,GRC,10724599,Europe,53,1514,13
2020-04-04T00:00:00Z,4,4,2020,99,6,Greece,EL,GRC,10724599,Europe,59,1613,14
2020-04-05T00:00:00Z,5,4,2020,60,9,Greece,EL,GRC,10724599,Europe,68,1673,15
2020-04-06T00:00:00Z,6,4,2020,62,5,Greece,EL,GRC,10724599,Europe,73,1735,16
2020-04-07T00:00:00Z,7,4,2020,20,6,Greece,EL,GRC,10724599,Europe,79,1755,17
2020-04-08T00:00:00Z,8,4,2020,77,2,Greece,EL,GRC,10724599,Europe,81,1832,18
2020-04-09T00:00:00Z,9,4,2020,52,2,Greece,EL,GRC,10724599,Europe,83,1884,19
2020-04-10T00:00:00Z,10,4,2020,71,3,Greece,EL,GRC,10724599,Europe,86,1955,20
2020-04-11T00:00:00Z,11,4,2020,56,4,Greece,EL,GRC,10724599,Europe,90,2011,21
2020-04-12T00:00:00Z,12,4,2020,70,3,Greece,EL,GRC,10724599,Europe,93,2081,22
2020-04-13T00:00:00Z,13,4,2020,33,5,Greece,EL,GRC,10724599,Europe,98,2114,23
2020-04-14T00:00:00Z,14,4,2020,31,1,Greece,EL,GRC,10724599,Europe,99,2145,24
2020-04-15T00:00:00Z,15,4,2020,25,2,Greece,EL,GRC,10724599,Europe,101,2170,25
2020-04-16T00:00:00Z,16,4,2020,22,1,Greece,EL,GRC,10724599,Europe,102,2192,26
2020-04-17T00:00:00Z,17,4,2020,15,3,Greece,EL,GRC,10724599,Europe,105,2207,27
2020-04-18T00:00:00Z,18,4,2020,0,0,Greece,EL,GRC,10724599,Europe,105,2207,28
2020-04-19T00:00:00Z,19,4,2020,0,0,Greece,EL,GRC,10724599,Europe,105,2207,29
2020-04-20T00:00:00Z,20,4,2020,28,5,Greece,EL,GRC,10724599,Europe,110,2235,30
2020-04-21T00:00:00Z,21,4,2020,10,6,Greece,EL,GRC,10724599,Europe,116,2245,31
2020-04-22T00:00:00Z,22,4,2020,156,5,Greece,EL,GRC,10724599,Europe,121,2401,32
2020-04-23T00:00:00Z,23,4,2020,7,0,Greece,EL,GRC,10724599,Europe,121,2408,33
2020-04-24T00:00:00Z,24,4,2020,55,4,Greece,EL,GRC,10724599,Europe,125,2463,34
2020-04-25T00:00:00Z,25,4,2020,27,5,Greece,EL,GRC,10724599,Europe,130,2490,35
2020-04-26T00:00:00Z,26,4,2020,16,0,Greece,EL,GRC,10724599,Europe,130,2506,36
2020-04-27T00:00:00Z,27,4,2020,0,0,Greece,EL,GRC,10724599,Europe,130,2506,37
2020-04-28T00:00:00Z,28,4,2020,28,6,Greece,EL,GRC,10724599,Europe,136,2534,38
2020-04-29T00:00:00Z,29,4,2020,0,0,Greece,EL,GRC,10724599,Europe,136,2534,39
2020-04-30T00:00:00Z,30,4,2020,42,3,Greece,EL,GRC,10724599,Europe,139,2576,40
2020-05-01T00:00:00Z,1,5,2020,15,1,Greece,EL,GRC,10724599,Europe,140,2591,41
2020-05-02T00:00:00Z,2,5,2020,0,0,Greece,EL,GRC,10724599,Europe,140,2591,42
2020-05-03T00:00:00Z,3,5,2020,29,3,Greece,EL,GRC,10724599,Europe,143,2620,43
2020-05-04T00:00:00Z,4,5,2020,6,1,Greece,EL,GRC,10724599,Europe,144,2626,44
2020-05-05T00:00:00Z,5,5,2020,6,2,Greece,EL,GRC,10724599,Europe,146,2632,45
2020-05-06T00:00:00Z,6,5,2020,10,0,Greece,EL,GRC,10724599,Europe,146,2642,46
2020-05-07T00:00:00Z,7,5,2020,21,1,Greece,EL,GRC,10724599,Europe,147,2663,47
2020-05-08T00:00:00Z,8,5,2020,15,1,Greece,EL,GRC,10724599,Europe,148,2678,48
2020-05-09T00:00:00Z,9,5,2020,13,2,Greece,EL,GRC,10724599,Europe,150,2691,49
2020-05-10T00:00:00Z,10,5,2020,19,1,Greece,EL,GRC,10724599,Europe,151,2710,50
2020-05-11T00:00:00Z,11,5,2020,6,0,Greece,EL,GRC,10724599,Europe,151,2716,51
2020-05-12T00:00:00Z,12,5,2020,10,0,Greece,EL,GRC,10724599,Europe,151,2726,52
2020-05-13T00:00:00Z,13,5,2020,18,1,Greece,EL,GRC,10724599,Europe,152,2744,53
2020-05-14T00:00:00Z,14,5,2020,16,3,Greece,EL,GRC,10724599,Europe,155,2760,54
2020-05-15T00:00:00Z,15,5,2020,10,1,Greece,EL,GRC,10724599,Europe,156,2770,55
2020-05-16T00:00:00Z,16,5,2020,40,4,Greece,EL,GRC,10724599,Europe,160,2810,56
2020-05-17T00:00:00Z,17,5,2020,9,2,Greece,EL,GRC,10724599,Europe,162,2819,57
2020-05-18T00:00:00Z,18,5,2020,15,1,Greece,EL,GRC,10724599,Europe,163,2834,58
2020-05-19T00:00:00Z,19,5,2020,2,2,Greece,EL,GRC,10724599,Europe,165,2836,59
2020-05-20T00:00:00Z,20,5,2020,4,0,Greece,EL,GRC,10724599,Europe,165,2840,60
2020-05-21T00:00:00Z,21,5,2020,10,1,Greece,EL,GRC,10724599,Europe,166,2850,61
2020-05-22T00:00:00Z,22,5,2020,3,2,Greece,EL,GRC,10724599,Europe,168,2853,62
2020-05-23T00:00:00Z,23,5,2020,20,1,Greece,EL,GRC,10724599,Europe,169,2873,63
2020-05-24T00:00:00Z,24,5,2020,3,2,Greece,EL,GRC,10724599,Europe,171,2876,64
2020-05-25T00:00:00Z,25,5,2020,2,0,Greece,EL,GRC,10724599,Europe,171,2878,65
2020-05-26T00:00:00Z,26,5,2020,4,1,Greece,EL,GRC,10724599,Europe,172,2882,66
2020-05-27T00:00:00Z,27,5,2020,10,1,Greece,EL,GRC,10724599,Europe,173,2892,67
2020-05-28T00:00:00Z,28,5,2020,11,0,Greece,EL,GRC,10724599,Europe,173,2903,68
2020-05-29T00:00:00Z,29,5,2020,3,2,Greece,EL,GRC,10724599,Europe,175,2906,69
2020-05-30T00:00:00Z,30,5,2020,3,0,Greece,EL,GRC,10724599,Europe,175,2909,70
2020-05-31T00:00:00Z,31,5,2020,6,0,Greece,EL,GRC,10724599,Europe,175,2915,71
2020-06-01T00:00:00Z,1,6,2020,2,0,Greece,EL,GRC,10724599,Europe,175,2917,72
2020-06-02T00:00:00Z,2,6,2020,0,0,Greece,EL,GRC,10724599,Europe,175,2917,73
2020-06-03T00:00:00Z,3,6,2020,1,4,Greece,EL,GRC,10724599,Europe,179,2918,74
2020-06-04T00:00:00Z,4,6,2020,19,0,Greece,EL,GRC,10724599,Europe,179,2937,75
2020-06-05T00:00:00Z,5,6,2020,0,0,Greece,EL,GRC,10724599,Europe,179,2937,76
2020-06-06T00:00:00Z,6,6,2020,0,0,Greece,EL,GRC,10724599,Europe,179,2937,77
2020-06-07T00:00:00Z,7,6,2020,15,1,Greece,EL,GRC,10724599,Europe,180,2952,78
2020-06-08T00:00:00Z,8,6,2020,0,0,Greece,EL,GRC,10724599,Europe,180,2952,79
2020-06-09T00:00:00Z,9,6,2020,97,2,Greece,EL,GRC,10724599,Europe,182,3049,80
2020-06-10T00:00:00Z,10,6,2020,9,1,Greece,EL,GRC,10724599,Europe,183,3058,81
2020-06-11T00:00:00Z,11,6,2020,10,0,Greece,EL,GRC,10724599,Europe,183,3068,82
2020-06-12T00:00:00Z,12,6,2020,20,0,Greece,EL,GRC,10724599,Europe,183,3088,83
2020-06-13T00:00:00Z,13,6,2020,20,0,Greece,EL,GRC,10724599,Europe,183,3108,84
2020-06-14T00:00:00Z,14,6,2020,4,0,Greece,EL,GRC,10724599,Europe,183,3112,85
2020-06-15T00:00:00Z,15,6,2020,9,0,Greece,EL,GRC,10724599,Europe,183,3121,86
2020-06-16T00:00:00Z,16,6,2020,13,1,Greece,EL,GRC,10724599,Europe,184,3134,87
2020-06-17T00:00:00Z,17,6,2020,14,1,Greece,EL,GRC,10724599,Europe,185,3148,88
2020-06-18T00:00:00Z,18,6,2020,55,2,Greece,EL,GRC,10724599,Europe,187,3203,89
2020-06-19T00:00:00Z,19,6,2020,24,1,Greece,EL,GRC,10724599,Europe,188,3227,90
2020-06-20T00:00:00Z,20,6,2020,10,1,Greece,EL,GRC,10724599,Europe,189,3237,91
2020-06-21T00:00:00Z,21,6,2020,19,1,Greece,EL,GRC,10724599,Europe,190,3256,92
2020-06-22T00:00:00Z,22,6,2020,10,0,Greece,EL,GRC,10724599,Europe,190,3266,93
2020-06-23T00:00:00Z,23,6,2020,21,0,Greece,EL,GRC,10724599,Europe,190,3287,94
2020-06-24T00:00:00Z,24,6,2020,15,0,Greece,EL,GRC,10724599,Europe,190,3302,95
2020-06-25T00:00:00Z,25,6,2020,8,0,Greece,EL,GRC,10724599,Europe,190,3310,96
2020-04-23T00:00:00Z,23,4,2020,26,2,Guatemala,GT,GTM,17581476,America,10,342,1
2020-04-24T00:00:00Z,24,4,2020,42,1,Guatemala,GT,GTM,17581476,America,11,384,2
2020-04-25T00:00:00Z,25,4,2020,46,0,Guatemala,GT,GTM,17581476,America,11,430,3
2020-04-26T00:00:00Z,26,4,2020,43,2,Guatemala,GT,GTM,17581476,America,13,473,4
2020-04-27T00:00:00Z,27,4,2020,27,2,Guatemala,GT,GTM,17581476,America,15,500,5
2020-04-28T00:00:00Z,28,4,2020,30,0,Guatemala,GT,GTM,17581476,America,15,530,6
2020-04-29T00:00:00Z,29,4,2020,27,1,Guatemala,GT,GTM,17581476,America,16,557,7
2020-04-30T00:00:00Z,30,4,2020,28,0,Guatemala,GT,GTM,17581476,America,16,585,8
2020-05-01T00:00:00Z,1,5,2020,14,0,Guatemala,GT,GTM,17581476,America,16,599,9
2020-05-02T00:00:00Z,2,5,2020,45,0,Guatemala,GT,GTM,17581476,America,16,644,10
2020-05-03T00:00:00Z,3,5,2020,44,1,Guatemala,GT,GTM,17581476,America,17,688,11
2020-05-04T00:00:00Z,4,5,2020,15,0,Guatemala,GT,GTM,17581476,America,17,703,12
2020-05-05T00:00:00Z,5,5,2020,27,2,Guatemala,GT,GTM,17581476,America,19,730,13
2020-05-06T00:00:00Z,6,5,2020,33,0,Guatemala,GT,GTM,17581476,America,19,763,14
2020-05-07T00:00:00Z,7,5,2020,35,2,Guatemala,GT,GTM,17581476,America,21,798,15
2020-05-08T00:00:00Z,8,5,2020,34,2,Guatemala,GT,GTM,17581476,America,23,832,16
2020-05-09T00:00:00Z,9,5,2020,68,1,Guatemala,GT,GTM,17581476,America,24,900,17
2020-05-10T00:00:00Z,10,5,2020,67,0,Guatemala,GT,GTM,17581476,America,24,967,18
2020-05-11T00:00:00Z,11,5,2020,85,2,Guatemala,GT,GTM,17581476,America,26,1052,19
2020-05-12T00:00:00Z,12,5,2020,62,0,Guatemala,GT,GTM,17581476,America,26,1114,20
2020-05-13T00:00:00Z,13,5,2020,85,1,Guatemala,GT,GTM,17581476,America,27,1199,21
2020-05-14T00:00:00Z,14,5,2020,143,2,Guatemala,GT,GTM,17581476,America,29,1342,22
2020-05-15T00:00:00Z,15,5,2020,176,0,Guatemala,GT,GTM,17581476,America,29,1518,23
2020-05-16T00:00:00Z,16,5,2020,125,1,Guatemala,GT,GTM,17581476,America,30,1643,24
2020-05-17T00:00:00Z,17,5,2020,120,3,Guatemala,GT,GTM,17581476,America,33,1763,25
2020-05-18T00:00:00Z,18,5,2020,149,2,Guatemala,GT,GTM,17581476,America,35,1912,26
2020-05-19T00:00:00Z,19,5,2020,89,3,Guatemala,GT,GTM,17581476,America,38,2001,27
2020-05-20T00:00:00Z,20,5,2020,132,5,Guatemala,GT,GTM,17581476,America,43,2133,28
2020-05-21T00:00:00Z,21,5,2020,132,2,Guatemala,GT,GTM,17581476,America,45,2265,29
2020-05-22T00:00:00Z,22,5,2020,247,3,Guatemala,GT,GTM,17581476,America,48,2512,30
2020-05-23T00:00:00Z,23,5,2020,231,3,Guatemala,GT,GTM,17581476,America,51,2743,31
2020-05-24T00:00:00Z,24,5,2020,311,4,Guatemala,GT,GTM,17581476,America,55,3054,32
2020-05-25T00:00:00Z,25,5,2020,370,3,Guatemala,GT,GTM,17581476,America,58,3424,33
2020-05-26T00:00:00Z,26,5,2020,336,1,Guatemala,GT,GTM,17581476,America,59,3760,34
2020-05-27T00:00:00Z,27,5,2020,194,4,Guatemala,GT,GTM,17581476,America,63,3954,35
2020-05-28T00:00:00Z,28,5,2020,191,5,Guatemala,GT,GTM,17581476,America,68,4145,36
2020-05-29T00:00:00Z,29,5,2020,203,12,Guatemala,GT,GTM,17581476,America,80,4348,37
2020-05-30T00:00:00Z,30,5,2020,259,10,Guatemala,GT,GTM,17581476,America,90,4607,38
2020-05-31T00:00:00Z,31,5,2020,132,12,Guatemala,GT,GTM,17581476,America,102,4739,39
2020-06-01T00:00:00Z,1,6,2020,348,6,Guatemala,GT,GTM,17581476,America,108,5087,40
2020-06-02T00:00:00Z,2,6,2020,249,8,Guatemala,GT,GTM,17581476,America,116,5336,41
2020-06-03T00:00:00Z,3,6,2020,250,7,Guatemala,GT,GTM,17581476,America,123,5586,42
2020-06-04T00:00:00Z,4,6,2020,174,20,Guatemala,GT,GTM,17581476,America,143,5760,43
2020-06-05T00:00:00Z,5,6,2020,394,15,Guatemala,GT,GTM,17581476,America,158,6154,44
2020-06-06T00:00:00Z,6,6,2020,331,58,Guatemala,GT,GTM,17581476,America,216,6485,45
2020-06-07T00:00:00Z,7,6,2020,307,14,Guatemala,GT,GTM,17581476,America,230,6792,46
2020-06-08T00:00:00Z,8,6,2020,263,22,Guatemala,GT,GTM,17581476,America,252,7055,47
2020-06-09T00:00:00Z,9,6,2020,447,15,Guatemala,GT,GTM,17581476,America,267,7502,48
2020-06-10T00:00:00Z,10,6,2020,364,22,Guatemala,GT,GTM,17581476,America,289,7866,49
2020-06-11T00:00:00Z,11,6,2020,355,27,Guatemala,GT,GTM,17581476,America,316,8221,50
2020-06-12T00:00:00Z,12,6,2020,340,18,Guatemala,GT,GTM,17581476,America,334,8561,51
2020-06-13T00:00:00Z,13,6,2020,421,17,Guatemala,GT,GTM,17581476,America,351,8982,52
2020-06-14T00:00:00Z,14,6,2020,509,16,Guatemala,GT,GTM,17581476,America,367,9491,53
2020-06-15T00:00:00Z,15,6,2020,354,17,Guatemala,GT,GTM,17581476,America,384,9845,54
2020-06-16T00:00:00Z,16,6,2020,427,15,Guatemala,GT,GTM,17581476,America,399,10272,55
2020-06-17T00:00:00Z,17,6,2020,434,19,Guatemala,GT,GTM,17581476,America,418,10706,56
2020-06-18T00:00:00Z,18,6,2020,545,14,Guatemala,GT,GTM,17581476,America,432,11251,57
2020-06-19T00:00:00Z,19,6,2020,617,17,Guatemala,GT,GTM,17581476,America,449,11868,58
2020-06-20T00:00:00Z,20,6,2020,641,34,Guatemala,GT,GTM,17581476,America,483,12509,59
2020-06-21T00:00:00Z,21,6,2020,246,31,Guatemala,GT,GTM,17581476,America,514,12755,60
2020-06-22T00:00:00Z,22,6,2020,390,17,Guatemala,GT,GTM,17581476,America,531,13145,61
2020-06-23T00:00:00Z,23,6,2020,624,16,Guatemala,GT,GTM,17581476,America,547,13769,62
2020-06-24T00:00:00Z,24,6,2020,771,35,Guatemala,GT,GTM,17581476,America,582,14540,63
2020-06-25T00:00:00Z,25,6,2020,279,19,Guatemala,GT,GTM,17581476,America,601,14819,64
2020-04-21T00:00:00Z,21,4,2020,0,1,Guernsey,GG,GGY,64468,Europe,10,239,1
2020-04-22T00:00:00Z,22,4,2020,0,0,Guernsey,GG,GGY,64468,Europe,10,239,2
2020-04-23T00:00:00Z,23,4,2020,4,0,Guernsey,GG,GGY,64468,Europe,10,243,3
2020-04-24T00:00:00Z,24,4,2020,2,0,Guernsey,GG,GGY,64468,Europe,10,245,4
2020-04-25T00:00:00Z,25,4,2020,0,1,Guernsey,GG,GGY,64468,Europe,11,245,5
2020-04-26T00:00:00Z,26,4,2020,0,1,Guernsey,GG,GGY,64468,Europe,12,245,6
2020-04-27T00:00:00Z,27,4,2020,2,1,Guernsey,GG,GGY,64468,Europe,13,247,7
2020-04-28T00:00:00Z,28,4,2020,0,0,Guernsey,GG,GGY,64468,Europe,13,247,8
2020-04-29T00:00:00Z,29,4,2020,0,0,Guernsey,GG,GGY,64468,Europe,13,247,9
2020-04-30T00:00:00Z,30,4,2020,4,0,Guernsey,GG,GGY,64468,Europe,13,251,10
2020-05-01T00:00:00Z,1,5,2020,0,0,Guernsey,GG,GGY,64468,Europe,13,251,11
2020-05-02T00:00:00Z,2,5,2020,1,0,Guernsey,GG,GGY,64468,Europe,13,252,12
2020-05-03T00:00:00Z,3,5,2020,0,0,Guernsey,GG,GGY,64468,Europe,13,252,13
2020-05-04T00:00:00Z,4,5,2020,0,0,Guernsey,GG,GGY,64468,Europe,13,252,14
2020-05-05T00:00:00Z,5,5,2020,0,0,Guernsey,GG,GGY,64468,Europe,13,252,15
2020-05-06T00:00:00Z,6,5,2020,0,0,Guernsey,GG,GGY,64468,Europe,13,252,16
2020-05-07T00:00:00Z,7,5,2020,0,0,Guernsey,GG,GGY,64468,Europe,13,252,17
2020-05-08T00:00:00Z,8,5,2020,0,0,Guernsey,GG,GGY,64468,Europe,13,252,18
2020-05-09T00:00:00Z,9,5,2020,0,0,Guernsey,GG,GGY,64468,Europe,13,252,19
2020-05-10T00:00:00Z,10,5,2020,0,0,Guernsey,GG,GGY,64468,Europe,13,252,20
2020-05-11T00:00:00Z,11,5,2020,0,0,Guernsey,GG,GGY,64468,Europe,13,252,21
2020-05-12T00:00:00Z,12,5,2020,0,0,Guernsey,GG,GGY,64468,Europe,13,252,22
2020-05-13T00:00:00Z,13,5,2020,0,0,Guernsey,GG,GGY,64468,Europe,13,252,23
2020-05-14T00:00:00Z,14,5,2020,0,0,Guernsey,GG,GGY,64468,Europe,13,252,24
2020-05-15T00:00:00Z,15,5,2020,0,0,Guernsey,GG,GGY,64468,Europe,13,252,25
2020-05-16T00:00:00Z,16,5,2020,0,0,Guernsey,GG,GGY,64468,Europe,13,252,26
2020-05-17T00:00:00Z,17,5,2020,0,0,Guernsey,GG,GGY,64468,Europe,13,252,27
2020-05-18T00:00:00Z,18,5,2020,0,0,Guernsey,GG,GGY,64468,Europe,13,252,28
2020-05-19T00:00:00Z,19,5,2020,0,0,Guernsey,GG,GGY,64468,Europe,13,252,29
2020-05-20T00:00:00Z,20,5,2020,0,0,Guernsey,GG,GGY,64468,Europe,13,252,30
2020-05-21T00:00:00Z,21,5,2020,0,0,Guernsey,GG,GGY,64468,Europe,13,252,31
2020-05-22T00:00:00Z,22,5,2020,0,0,Guernsey,GG,GGY,64468,Europe,13,252,32
2020-05-23T00:00:00Z,23,5,2020,0,0,Guernsey,GG,GGY,64468,Europe,13,252,33
2020-05-24T00:00:00Z,24,5,2020,0,0,Guernsey,GG,GGY,64468,Europe,13,252,34
2020-05-25T00:00:00Z,25,5,2020,0,0,Guernsey,GG,GGY,64468,Europe,13,252,35
2020-05-26T00:00:00Z,26,5,2020,0,0,Guernsey,GG,GGY,64468,Europe,13,252,36
2020-05-27T00:00:00Z,27,5,2020,0,0,Guernsey,GG,GGY,64468,Europe,13,252,37
2020-05-28T00:00:00Z,28,5,2020,0,0,Guernsey,GG,GGY,64468,Europe,13,252,38
2020-05-29T00:00:00Z,29,5,2020,0,0,Guernsey,GG,GGY,64468,Europe,13,252,39
2020-05-30T00:00:00Z,30,5,2020,0,0,Guernsey,GG,GGY,64468,Europe,13,252,40
2020-05-31T00:00:00Z,31,5,2020,0,0,Guernsey,GG,GGY,64468,Europe,13,252,41
2020-06-01T00:00:00Z,1,6,2020,0,0,Guernsey,GG,GGY,64468,Europe,13,252,42
2020-06-02T00:00:00Z,2,6,2020,0,0,Guernsey,GG,GGY,64468,Europe,13,252,43
2020-06-03T00:00:00Z,3,6,2020,0,0,Guernsey,GG,GGY,64468,Europe,13,252,44
2020-06-04T00:00:00Z,4,6,2020,0,0,Guernsey,GG,GGY,64468,Europe,13,252,45
2020-06-05T00:00:00Z,5,6,2020,0,0,Guernsey,GG,GGY,64468,Europe,13,252,46
2020-06-06T00:00:00Z,6,6,2020,0,0,Guernsey,GG,GGY,64468,Europe,13,252,47
2020-06-07T00:00:00Z,7,6,2020,0,0,Guernsey,GG,GGY,64468,Europe,13,252,48
2020-06-08T00:00:00Z,8,6,2020,0,0,Guernsey,GG,GGY,64468,Europe,13,252,49
2020-06-09T00:00:00Z,9,6,2020,0,0,Guernsey,GG,GGY,64468,Europe,13,252,50
2020-06-10T00:00:00Z,10,6,2020,0,0,Guernsey,GG,GGY,64468,Europe,13,252,51
2020-06-11T00:00:00Z,11,6,2020,0,0,Guernsey,GG,GGY,64468,Europe,13,252,52
2020-06-12T00:00:00Z,12,6,2020,0,0,Guernsey,GG,GGY,64468,Europe,13,252,53
2020-06-13T00:00:00Z,13,6,2020,0,0,Guernsey,GG,GGY,64468,Europe,13,252,54
2020-06-14T00:00:00Z,14,6,2020,0,0,Guernsey,GG,GGY,64468,Europe,13,252,55
2020-06-15T00:00:00Z,15,6,2020,0,0,Guernsey,GG,GGY,64468,Europe,13,252,56
2020-06-16T00:00:00Z,16,6,2020,0,0,Guernsey,GG,GGY,64468,Europe,13,252,57
2020-06-17T00:00:00Z,17,6,2020,0,0,Guernsey,GG,GGY,64468,Europe,13,252,58
2020-06-18T00:00:00Z,18,6,2020,0,0,Guernsey,GG,GGY,64468,Europe,13,252,59
2020-06-19T00:00:00Z,19,6,2020,0,0,Guernsey,GG,GGY,64468,Europe,13,252,60
2020-06-20T00:00:00Z,20,6,2020,0,0,Guernsey,GG,GGY,64468,Europe,13,252,61
2020-06-21T00:00:00Z,21,6,2020,0,0,Guernsey,GG,GGY,64468,Europe,13,252,62
2020-06-22T00:00:00Z,22,6,2020,0,0,Guernsey,GG,GGY,64468,Europe,13,252,63
2020-06-23T00:00:00Z,23,6,2020,0,0,Guernsey,GG,GGY,64468,Europe,13,252,64
2020-06-24T00:00:00Z,24,6,2020,0,0,Guernsey,GG,GGY,64468,Europe,13,252,65
2020-06-25T00:00:00Z,25,6,2020,0,0,Guernsey,GG,GGY,64468,Europe,13,252,66
2020-05-06T00:00:00Z,6,5,2020,101,1,Guinea,GN,GIN,12771246,Africa,10,1811,1
2020-05-07T00:00:00Z,7,5,2020,45,1,Guinea,GN,GIN,12771246,Africa,11,1856,2
2020-05-08T00:00:00Z,8,5,2020,71,0,Guinea,GN,GIN,12771246,Africa,11,1927,3
2020-05-09T00:00:00Z,9,5,2020,82,0,Guinea,GN,GIN,12771246,Africa,11,2009,4
2020-05-10T00:00:00Z,10,5,2020,33,0,Guinea,GN,GIN,12771246,Africa,11,2042,5
2020-05-11T00:00:00Z,11,5,2020,104,0,Guinea,GN,GIN,12771246,Africa,11,2146,6
2020-05-12T00:00:00Z,12,5,2020,67,0,Guinea,GN,GIN,12771246,Africa,11,2213,7
2020-05-13T00:00:00Z,13,5,2020,0,0,Guinea,GN,GIN,12771246,Africa,11,2213,8
2020-05-14T00:00:00Z,14,5,2020,161,3,Guinea,GN,GIN,12771246,Africa,14,2374,9
2020-05-15T00:00:00Z,15,5,2020,99,0,Guinea,GN,GIN,12771246,Africa,14,2473,10
2020-05-16T00:00:00Z,16,5,2020,58,1,Guinea,GN,GIN,12771246,Africa,15,2531,11
2020-05-17T00:00:00Z,17,5,2020,127,1,Guinea,GN,GIN,12771246,Africa,16,2658,12
2020-05-18T00:00:00Z,18,5,2020,0,0,Guinea,GN,GIN,12771246,Africa,16,2658,13
2020-05-19T00:00:00Z,19,5,2020,138,0,Guinea,GN,GIN,12771246,Africa,16,2796,14
2020-05-20T00:00:00Z,20,5,2020,67,2,Guinea,GN,GIN,12771246,Africa,18,2863,15
2020-05-21T00:00:00Z,21,5,2020,0,0,Guinea,GN,GIN,12771246,Africa,18,2863,16
2020-05-22T00:00:00Z,22,5,2020,204,1,Guinea,GN,GIN,12771246,Africa,19,3067,17
2020-05-23T00:00:00Z,23,5,2020,0,0,Guinea,GN,GIN,12771246,Africa,19,3067,18
2020-05-24T00:00:00Z,24,5,2020,109,1,Guinea,GN,GIN,12771246,Africa,20,3176,19
2020-05-25T00:00:00Z,25,5,2020,99,0,Guinea,GN,GIN,12771246,Africa,20,3275,20
2020-05-26T00:00:00Z,26,5,2020,0,0,Guinea,GN,GIN,12771246,Africa,20,3275,21
2020-05-27T00:00:00Z,27,5,2020,83,0,Guinea,GN,GIN,12771246,Africa,20,3358,22
2020-05-28T00:00:00Z,28,5,2020,88,1,Guinea,GN,GIN,12771246,Africa,21,3446,23
2020-05-29T00:00:00Z,29,5,2020,107,1,Guinea,GN,GIN,12771246,Africa,22,3553,24
2020-05-30T00:00:00Z,30,5,2020,103,0,Guinea,GN,GIN,12771246,Africa,22,3656,25
2020-05-31T00:00:00Z,31,5,2020,50,1,Guinea,GN,GIN,12771246,Africa,23,3706,26
2020-06-01T00:00:00Z,1,6,2020,65,0,Guinea,GN,GIN,12771246,Africa,23,3771,27
2020-06-02T00:00:00Z,2,6,2020,73,0,Guinea,GN,GIN,12771246,Africa,23,3844,28
2020-06-03T00:00:00Z,3,6,2020,0,0,Guinea,GN,GIN,12771246,Africa,23,3844,29
2020-06-04T00:00:00Z,4,6,2020,42,0,Guinea,GN,GIN,12771246,Africa,23,3886,30
2020-06-05T00:00:00Z,5,6,2020,105,0,Guinea,GN,GIN,12771246,Africa,23,3991,31
2020-06-06T00:00:00Z,6,6,2020,69,0,Guinea,GN,GIN,12771246,Africa,23,4060,32
2020-06-07T00:00:00Z,7,6,2020,57,0,Guinea,GN,GIN,12771246,Africa,23,4117,33
2020-06-08T00:00:00Z,8,6,2020,48,0,Guinea,GN,GIN,12771246,Africa,23,4165,34
2020-06-09T00:00:00Z,9,6,2020,51,0,Guinea,GN,GIN,12771246,Africa,23,4216,35
2020-06-10T00:00:00Z,10,6,2020,42,0,Guinea,GN,GIN,12771246,Africa,23,4258,36
2020-06-11T00:00:00Z,11,6,2020,0,0,Guinea,GN,GIN,12771246,Africa,23,4258,37
2020-06-12T00:00:00Z,12,6,2020,114,0,Guinea,GN,GIN,12771246,Africa,23,4372,38
2020-06-13T00:00:00Z,13,6,2020,54,1,Guinea,GN,GIN,12771246,Africa,24,4426,39
2020-06-14T00:00:00Z,14,6,2020,58,1,Guinea,GN,GIN,12771246,Africa,25,4484,40
2020-06-15T00:00:00Z,15,6,2020,48,0,Guinea,GN,GIN,12771246,Africa,25,4532,41
2020-06-16T00:00:00Z,16,6,2020,40,1,Guinea,GN,GIN,12771246,Africa,26,4572,42
2020-06-17T00:00:00Z,17,6,2020,67,0,Guinea,GN,GIN,12771246,Africa,26,4639,43
2020-06-18T00:00:00Z,18,6,2020,29,0,Guinea,GN,GIN,12771246,Africa,26,4668,44
2020-06-19T00:00:00Z,19,6,2020,173,0,Guinea,GN,GIN,12771246,Africa,26,4841,45
2020-06-20T00:00:00Z,20,6,2020,63,1,Guinea,GN,GIN,12771246,Africa,27,4904,46
2020-06-21T00:00:00Z,21,6,2020,56,0,Guinea,GN,GIN,12771246,Africa,27,4960,47
2020-06-22T00:00:00Z,22,6,2020,28,0,Guinea,GN,GIN,12771246,Africa,27,4988,48
2020-06-23T00:00:00Z,23,6,2020,0,0,Guinea,GN,GIN,12771246,Africa,27,4988,49
2020-06-24T00:00:00Z,24,6,2020,116,2,Guinea,GN,GIN,12771246,Africa,29,5104,50
2020-06-25T00:00:00Z,25,6,2020,70,0,Guinea,GN,GIN,12771246,Africa,29,5174,51
2020-06-06T00:00:00Z,6,6,2020,22,3,Guinea_Bissau,GW,GNB,1920917,Africa,12,1368,1
2020-06-07T00:00:00Z,7,6,2020,0,0,Guinea_Bissau,GW,GNB,1920917,Africa,12,1368,2
2020-06-08T00:00:00Z,8,6,2020,0,0,Guinea_Bissau,GW,GNB,1920917,Africa,12,1368,3
2020-06-09T00:00:00Z,9,6,2020,21,0,Guinea_Bissau,GW,GNB,1920917,Africa,12,1389,4
2020-06-10T00:00:00Z,10,6,2020,0,0,Guinea_Bissau,GW,GNB,1920917,Africa,12,1389,5
2020-06-11T00:00:00Z,11,6,2020,0,0,Guinea_Bissau,GW,GNB,1920917,Africa,12,1389,6
2020-06-12T00:00:00Z,12,6,2020,0,0,Guinea_Bissau,GW,GNB,1920917,Africa,12,1389,7
2020-06-13T00:00:00Z,13,6,2020,0,0,Guinea_Bissau,GW,GNB,1920917,Africa,12,1389,8
2020-06-14T00:00:00Z,14,6,2020,71,3,Guinea_Bissau,GW,GNB,1920917,Africa,15,1460,9
2020-06-15T00:00:00Z,15,6,2020,0,0,Guinea_Bissau,GW,GNB,1920917,Africa,15,1460,10
2020-06-16T00:00:00Z,16,6,2020,0,0,Guinea_Bissau,GW,GNB,1920917,Africa,15,1460,11
2020-06-17T00:00:00Z,17,6,2020,32,0,Guinea_Bissau,GW,GNB,1920917,Africa,15,1492,12
2020-06-18T00:00:00Z,18,6,2020,0,0,Guinea_Bissau,GW,GNB,1920917,Africa,15,1492,13
2020-06-19T00:00:00Z,19,6,2020,20,0,Guinea_Bissau,GW,GNB,1920917,Africa,15,1512,14
2020-06-20T00:00:00Z,20,6,2020,0,0,Guinea_Bissau,GW,GNB,1920917,Africa,15,1512,15
2020-06-21T00:00:00Z,21,6,2020,29,2,Guinea_Bissau,GW,GNB,1920917,Africa,17,1541,16
2020-06-22T00:00:00Z,22,6,2020,0,0,Guinea_Bissau,GW,GNB,1920917,Africa,17,1541,17
2020-06-23T00:00:00Z,23,6,2020,15,2,Guinea_Bissau,GW,GNB,1920917,Africa,19,1556,18
2020-06-24T00:00:00Z,24,6,2020,0,0,Guinea_Bissau,GW,GNB,1920917,Africa,19,1556,19
2020-06-25T00:00:00Z,25,6,2020,0,0,Guinea_Bissau,GW,GNB,1920917,Africa,19,1556,20
2020-05-06T00:00:00Z,6,5,2020,1,1,Guyana,GY,GUY,782775,America,10,93,1
2020-05-07T00:00:00Z,7,5,2020,0,0,Guyana,GY,GUY,782775,America,10,93,2
2020-05-08T00:00:00Z,8,5,2020,0,0,Guyana,GY,GUY,782775,America,10,93,3
2020-05-09T00:00:00Z,9,5,2020,1,0,Guyana,GY,GUY,782775,America,10,94,4
2020-05-10T00:00:00Z,10,5,2020,3,0,Guyana,GY,GUY,782775,America,10,97,5
2020-05-11T00:00:00Z,11,5,2020,7,0,Guyana,GY,GUY,782775,America,10,104,6
2020-05-12T00:00:00Z,12,5,2020,5,0,Guyana,GY,GUY,782775,America,10,109,7
2020-05-13T00:00:00Z,13,5,2020,4,0,Guyana,GY,GUY,782775,America,10,113,8
2020-05-14T00:00:00Z,14,5,2020,0,0,Guyana,GY,GUY,782775,America,10,113,9
2020-05-15T00:00:00Z,15,5,2020,0,0,Guyana,GY,GUY,782775,America,10,113,10
2020-05-16T00:00:00Z,16,5,2020,3,0,Guyana,GY,GUY,782775,America,10,116,11
2020-05-17T00:00:00Z,17,5,2020,1,0,Guyana,GY,GUY,782775,America,10,117,12
2020-05-18T00:00:00Z,18,5,2020,0,0,Guyana,GY,GUY,782775,America,10,117,13
2020-05-19T00:00:00Z,19,5,2020,7,0,Guyana,GY,GUY,782775,America,10,124,14
2020-05-20T00:00:00Z,20,5,2020,1,0,Guyana,GY,GUY,782775,America,10,125,15
2020-05-21T00:00:00Z,21,5,2020,0,0,Guyana,GY,GUY,782775,America,10,125,16
2020-05-22T00:00:00Z,22,5,2020,2,0,Guyana,GY,GUY,782775,America,10,127,17
2020-05-23T00:00:00Z,23,5,2020,0,0,Guyana,GY,GUY,782775,America,10,127,18
2020-05-24T00:00:00Z,24,5,2020,0,0,Guyana,GY,GUY,782775,America,10,127,19
2020-05-25T00:00:00Z,25,5,2020,8,0,Guyana,GY,GUY,782775,America,10,135,20
2020-05-26T00:00:00Z,26,5,2020,2,1,Guyana,GY,GUY,782775,America,11,137,21
2020-05-27T00:00:00Z,27,5,2020,2,0,Guyana,GY,GUY,782775,America,11,139,22
2020-05-28T00:00:00Z,28,5,2020,0,0,Guyana,GY,GUY,782775,America,11,139,23
2020-05-29T00:00:00Z,29,5,2020,11,0,Guyana,GY,GUY,782775,America,11,150,24
2020-05-30T00:00:00Z,30,5,2020,0,0,Guyana,GY,GUY,782775,America,11,150,25
2020-05-31T00:00:00Z,31,5,2020,2,1,Guyana,GY,GUY,782775,America,12,152,26
2020-06-01T00:00:00Z,1,6,2020,1,0,Guyana,GY,GUY,782775,America,12,153,27
2020-06-02T00:00:00Z,2,6,2020,0,0,Guyana,GY,GUY,782775,America,12,153,28
2020-06-03T00:00:00Z,3,6,2020,0,0,Guyana,GY,GUY,782775,America,12,153,29
2020-06-04T00:00:00Z,4,6,2020,0,0,Guyana,GY,GUY,782775,America,12,153,30
2020-06-05T00:00:00Z,5,6,2020,0,0,Guyana,GY,GUY,782775,America,12,153,31
2020-06-06T00:00:00Z,6,6,2020,0,0,Guyana,GY,GUY,782775,America,12,153,32
2020-06-07T00:00:00Z,7,6,2020,1,0,Guyana,GY,GUY,782775,America,12,154,33
2020-06-08T00:00:00Z,8,6,2020,0,0,Guyana,GY,GUY,782775,America,12,154,34
2020-06-09T00:00:00Z,9,6,2020,0,0,Guyana,GY,GUY,782775,America,12,154,35
2020-06-10T00:00:00Z,10,6,2020,2,0,Guyana,GY,GUY,782775,America,12,156,36
2020-06-11T00:00:00Z,11,6,2020,0,0,Guyana,GY,GUY,782775,America,12,156,37
2020-06-12T00:00:00Z,12,6,2020,2,0,Guyana,GY,GUY,782775,America,12,158,38
2020-06-13T00:00:00Z,13,6,2020,1,0,Guyana,GY,GUY,782775,America,12,159,39
2020-06-14T00:00:00Z,14,6,2020,0,0,Guyana,GY,GUY,782775,America,12,159,40
2020-06-15T00:00:00Z,15,6,2020,0,0,Guyana,GY,GUY,782775,America,12,159,41
2020-06-16T00:00:00Z,16,6,2020,0,0,Guyana,GY,GUY,782775,America,12,159,42
2020-06-17T00:00:00Z,17,6,2020,12,0,Guyana,GY,GUY,782775,America,12,171,43
2020-06-18T00:00:00Z,18,6,2020,0,0,Guyana,GY,GUY,782775,America,12,171,44
2020-06-19T00:00:00Z,19,6,2020,12,0,Guyana,GY,GUY,782775,America,12,183,45
2020-06-20T00:00:00Z,20,6,2020,0,0,Guyana,GY,GUY,782775,America,12,183,46
2020-06-21T00:00:00Z,21,6,2020,0,0,Guyana,GY,GUY,782775,America,12,183,47
2020-06-22T00:00:00Z,22,6,2020,1,0,Guyana,GY,GUY,782775,America,12,184,48
2020-06-23T00:00:00Z,23,6,2020,21,0,Guyana,GY,GUY,782775,America,12,205,49
2020-06-24T00:00:00Z,24,6,2020,1,0,Guyana,GY,GUY,782775,America,12,206,50
2020-06-25T00:00:00Z,25,6,2020,3,0,Guyana,GY,GUY,782775,America,12,209,51
2020-05-05T00:00:00Z,5,5,2020,15,3,Haiti,HT,HTI,11263079,America,11,100,1
2020-05-06T00:00:00Z,6,5,2020,1,1,Haiti,HT,HTI,11263079,America,12,101,2
2020-05-07T00:00:00Z,7,5,2020,7,0,Haiti,HT,HTI,11263079,America,12,108,3
2020-05-08T00:00:00Z,8,5,2020,21,0,Haiti,HT,HTI,11263079,America,12,129,4
2020-05-09T00:00:00Z,9,5,2020,17,0,Haiti,HT,HTI,11263079,America,12,146,5
2020-05-10T00:00:00Z,10,5,2020,5,0,Haiti,HT,HTI,11263079,America,12,151,6
2020-05-11T00:00:00Z,11,5,2020,31,3,Haiti,HT,HTI,11263079,America,15,182,7
2020-05-12T00:00:00Z,12,5,2020,27,1,Haiti,HT,HTI,11263079,America,16,209,8
2020-05-13T00:00:00Z,13,5,2020,10,2,Haiti,HT,HTI,11263079,America,18,219,9
2020-05-14T00:00:00Z,14,5,2020,15,0,Haiti,HT,HTI,11263079,America,18,234,10
2020-05-15T00:00:00Z,15,5,2020,39,2,Haiti,HT,HTI,11263079,America,20,273,11
2020-05-16T00:00:00Z,16,5,2020,37,0,Haiti,HT,HTI,11263079,America,20,310,12
2020-05-17T00:00:00Z,17,5,2020,48,0,Haiti,HT,HTI,11263079,America,20,358,13
2020-05-18T00:00:00Z,18,5,2020,98,0,Haiti,HT,HTI,11263079,America,20,456,14
2020-05-19T00:00:00Z,19,5,2020,77,1,Haiti,HT,HTI,11263079,America,21,533,15
2020-05-20T00:00:00Z,20,5,2020,63,1,Haiti,HT,HTI,11263079,America,22,596,16
2020-05-21T00:00:00Z,21,5,2020,0,0,Haiti,HT,HTI,11263079,America,22,596,17
2020-05-22T00:00:00Z,22,5,2020,138,3,Haiti,HT,HTI,11263079,America,25,734,18
2020-05-23T00:00:00Z,23,5,2020,78,0,Haiti,HT,HTI,11263079,America,25,812,19
2020-05-24T00:00:00Z,24,5,2020,53,1,Haiti,HT,HTI,11263079,America,26,865,20
2020-05-25T00:00:00Z,25,5,2020,93,1,Haiti,HT,HTI,11263079,America,27,958,21
2020-05-26T00:00:00Z,26,5,2020,105,4,Haiti,HT,HTI,11263079,America,31,1063,22
2020-05-27T00:00:00Z,27,5,2020,111,2,Haiti,HT,HTI,11263079,America,33,1174,23
2020-05-28T00:00:00Z,28,5,2020,146,1,Haiti,HT,HTI,11263079,America,34,1320,24
2020-05-29T00:00:00Z,29,5,2020,123,1,Haiti,HT,HTI,11263079,America,35,1443,25
2020-05-30T00:00:00Z,30,5,2020,141,0,Haiti,HT,HTI,11263079,America,35,1584,26
2020-05-31T00:00:00Z,31,5,2020,281,6,Haiti,HT,HTI,11263079,America,41,1865,27
2020-06-01T00:00:00Z,1,6,2020,259,3,Haiti,HT,HTI,11263079,America,44,2124,28
2020-06-02T00:00:00Z,2,6,2020,102,1,Haiti,HT,HTI,11263079,America,45,2226,29
2020-06-03T00:00:00Z,3,6,2020,281,3,Haiti,HT,HTI,11263079,America,48,2507,30
2020-06-04T00:00:00Z,4,6,2020,133,2,Haiti,HT,HTI,11263079,America,50,2640,31
2020-06-05T00:00:00Z,5,6,2020,0,0,Haiti,HT,HTI,11263079,America,50,2640,32
2020-06-06T00:00:00Z,6,6,2020,284,0,Haiti,HT,HTI,11263079,America,50,2924,33
2020-06-07T00:00:00Z,7,6,2020,148,0,Haiti,HT,HTI,11263079,America,50,3072,34
2020-06-08T00:00:00Z,8,6,2020,262,1,Haiti,HT,HTI,11263079,America,51,3334,35
2020-06-09T00:00:00Z,9,6,2020,204,3,Haiti,HT,HTI,11263079,America,54,3538,36
2020-06-10T00:00:00Z,10,6,2020,124,2,Haiti,HT,HTI,11263079,America,56,3662,37
2020-06-11T00:00:00Z,11,6,2020,134,2,Haiti,HT,HTI,11263079,America,58,3796,38
2020-06-12T00:00:00Z,12,6,2020,145,6,Haiti,HT,HTI,11263079,America,64,3941,39
2020-06-13T00:00:00Z,13,6,2020,0,0,Haiti,HT,HTI,11263079,America,64,3941,40
2020-06-14T00:00:00Z,14,6,2020,224,6,Haiti,HT,HTI,11263079,America,70,4165,41
2020-06-15T00:00:00Z,15,6,2020,144,3,Haiti,HT,HTI,11263079,America,73,4309,42
2020-06-16T00:00:00Z,16,6,2020,132,3,Haiti,HT,HTI,11263079,America,76,4441,43
2020-06-17T00:00:00Z,17,6,2020,106,4,Haiti,HT,HTI,11263079,America,80,4547,44
2020-06-18T00:00:00Z,18,6,2020,141,2,Haiti,HT,HTI,11263079,America,82,4688,45
2020-06-19T00:00:00Z,19,6,2020,228,2,Haiti,HT,HTI,11263079,America,84,4916,46
2020-06-20T00:00:00Z,20,6,2020,64,3,Haiti,HT,HTI,11263079,America,87,4980,47
2020-06-21T00:00:00Z,21,6,2020,97,1,Haiti,HT,HTI,11263079,America,88,5077,48
2020-06-22T00:00:00Z,22,6,2020,134,0,Haiti,HT,HTI,11263079,America,88,5211,49
2020-06-23T00:00:00Z,23,6,2020,0,0,Haiti,HT,HTI,11263079,America,88,5211,50
2020-06-24T00:00:00Z,24,6,2020,113,1,Haiti,HT,HTI,11263079,America,89,5324,51
2020-06-25T00:00:00Z,25,6,2020,105,3,Haiti,HT,HTI,11263079,America,92,5429,52
2020-04-01T00:00:00Z,1,4,2020,31,3,Honduras,HN,HND,9746115,America,10,172,1
2020-04-02T00:00:00Z,2,4,2020,47,4,Honduras,HN,HND,9746115,America,14,219,2
2020-04-03T00:00:00Z,3,4,2020,3,1,Honduras,HN,HND,9746115,America,15,222,3
2020-04-04T00:00:00Z,4,4,2020,42,0,Honduras,HN,HND,9746115,America,15,264,4
2020-04-05T00:00:00Z,5,4,2020,4,7,Honduras,HN,HND,9746115,America,22,268,5
2020-04-06T00:00:00Z,6,4,2020,30,0,Honduras,HN,HND,9746115,America,22,298,6
2020-04-07T00:00:00Z,7,4,2020,7,0,Honduras,HN,HND,9746115,America,22,305,7
2020-04-08T00:00:00Z,8,4,2020,7,0,Honduras,HN,HND,9746115,America,22,312,8
2020-04-09T00:00:00Z,9,4,2020,31,1,Honduras,HN,HND,9746115,America,23,343,9
2020-04-10T00:00:00Z,10,4,2020,39,0,Honduras,HN,HND,9746115,America,23,382,10
2020-04-11T00:00:00Z,11,4,2020,10,1,Honduras,HN,HND,9746115,America,24,392,11
2020-04-12T00:00:00Z,12,4,2020,1,1,Honduras,HN,HND,9746115,America,25,393,12
2020-04-13T00:00:00Z,13,4,2020,4,0,Honduras,HN,HND,9746115,America,25,397,13
2020-04-14T00:00:00Z,14,4,2020,10,1,Honduras,HN,HND,9746115,America,26,407,14
2020-04-15T00:00:00Z,15,4,2020,12,5,Honduras,HN,HND,9746115,America,31,419,15
2020-04-16T00:00:00Z,16,4,2020,7,4,Honduras,HN,HND,9746115,America,35,426,16
2020-04-17T00:00:00Z,17,4,2020,16,6,Honduras,HN,HND,9746115,America,41,442,17
2020-04-18T00:00:00Z,18,4,2020,15,5,Honduras,HN,HND,9746115,America,46,457,18
2020-04-19T00:00:00Z,19,4,2020,15,0,Honduras,HN,HND,9746115,America,46,472,19
2020-04-20T00:00:00Z,20,4,2020,5,0,Honduras,HN,HND,9746115,America,46,477,20
2020-04-21T00:00:00Z,21,4,2020,17,0,Honduras,HN,HND,9746115,America,46,494,21
2020-04-22T00:00:00Z,22,4,2020,16,0,Honduras,HN,HND,9746115,America,46,510,22
2020-04-23T00:00:00Z,23,4,2020,9,1,Honduras,HN,HND,9746115,America,47,519,23
2020-04-24T00:00:00Z,24,4,2020,0,0,Honduras,HN,HND,9746115,America,47,519,24
2020-04-25T00:00:00Z,25,4,2020,72,0,Honduras,HN,HND,9746115,America,47,591,25
2020-04-26T00:00:00Z,26,4,2020,36,12,Honduras,HN,HND,9746115,America,59,627,26
2020-04-27T00:00:00Z,27,4,2020,34,2,Honduras,HN,HND,9746115,America,61,661,27
2020-04-28T00:00:00Z,28,4,2020,32,0,Honduras,HN,HND,9746115,America,61,693,28
2020-04-29T00:00:00Z,29,4,2020,45,5,Honduras,HN,HND,9746115,America,66,738,29
2020-04-30T00:00:00Z,30,4,2020,33,5,Honduras,HN,HND,9746115,America,71,771,30
2020-05-01T00:00:00Z,1,5,2020,33,4,Honduras,HN,HND,9746115,America,75,804,31
2020-05-02T00:00:00Z,2,5,2020,95,0,Honduras,HN,HND,9746115,America,75,899,32
2020-05-03T00:00:00Z,3,5,2020,111,1,Honduras,HN,HND,9746115,America,76,1010,33
2020-05-04T00:00:00Z,4,5,2020,45,6,Honduras,HN,HND,9746115,America,82,1055,34
2020-05-05T00:00:00Z,5,5,2020,123,0,Honduras,HN,HND,9746115,America,82,1178,35
2020-05-06T00:00:00Z,6,5,2020,92,11,Honduras,HN,HND,9746115,America,93,1270,36
2020-05-07T00:00:00Z,7,5,2020,191,6,Honduras,HN,HND,9746115,America,99,1461,37
2020-05-08T00:00:00Z,8,5,2020,224,6,Honduras,HN,HND,9746115,America,105,1685,38
2020-05-09T00:00:00Z,9,5,2020,86,2,Honduras,HN,HND,9746115,America,107,1771,39
2020-05-10T00:00:00Z,10,5,2020,59,1,Honduras,HN,HND,9746115,America,108,1830,40
2020-05-11T00:00:00Z,11,5,2020,142,0,Honduras,HN,HND,9746115,America,108,1972,41
2020-05-12T00:00:00Z,12,5,2020,34,8,Honduras,HN,HND,9746115,America,116,2006,42
2020-05-13T00:00:00Z,13,5,2020,74,5,Honduras,HN,HND,9746115,America,121,2080,43
2020-05-14T00:00:00Z,14,5,2020,175,2,Honduras,HN,HND,9746115,America,123,2255,44
2020-05-15T00:00:00Z,15,5,2020,63,10,Honduras,HN,HND,9746115,America,133,2318,45
2020-05-16T00:00:00Z,16,5,2020,142,1,Honduras,HN,HND,9746115,America,134,2460,46
2020-05-17T00:00:00Z,17,5,2020,105,4,Honduras,HN,HND,9746115,America,138,2565,47
2020-05-18T00:00:00Z,18,5,2020,81,4,Honduras,HN,HND,9746115,America,142,2646,48
2020-05-19T00:00:00Z,19,5,2020,152,4,Honduras,HN,HND,9746115,America,146,2798,49
2020-05-20T00:00:00Z,20,5,2020,157,1,Honduras,HN,HND,9746115,America,147,2955,50
2020-05-21T00:00:00Z,21,5,2020,145,4,Honduras,HN,HND,9746115,America,151,3100,51
2020-05-22T00:00:00Z,22,5,2020,104,5,Honduras,HN,HND,9746115,America,156,3204,52
2020-05-23T00:00:00Z,23,5,2020,273,11,Honduras,HN,HND,9746115,America,167,3477,53
2020-05-24T00:00:00Z,24,5,2020,266,7,Honduras,HN,HND,9746115,America,174,3743,54
2020-05-25T00:00:00Z,25,5,2020,207,6,Honduras,HN,HND,9746115,America,180,3950,55
2020-05-26T00:00:00Z,26,5,2020,239,2,Honduras,HN,HND,9746115,America,182,4189,56
2020-05-27T00:00:00Z,27,5,2020,212,6,Honduras,HN,HND,9746115,America,188,4401,57
2020-05-28T00:00:00Z,28,5,2020,239,6,Honduras,HN,HND,9746115,America,194,4640,58
2020-05-29T00:00:00Z,29,5,2020,112,2,Honduras,HN,HND,9746115,America,196,4752,59
2020-05-30T00:00:00Z,30,5,2020,134,3,Honduras,HN,HND,9746115,America,199,4886,60
2020-05-31T00:00:00Z,31,5,2020,208,2,Honduras,HN,HND,9746115,America,201,5094,61
2020-06-01T00:00:00Z,1,6,2020,108,11,Honduras,HN,HND,9746115,America,212,5202,62
2020-06-02T00:00:00Z,2,6,2020,160,5,Honduras,HN,HND,9746115,America,217,5362,63
2020-06-03T00:00:00Z,3,6,2020,165,8,Honduras,HN,HND,9746115,America,225,5527,64
2020-06-04T00:00:00Z,4,6,2020,163,9,Honduras,HN,HND,9746115,America,234,5690,65
2020-06-05T00:00:00Z,5,6,2020,190,9,Honduras,HN,HND,9746115,America,243,5880,66
2020-06-06T00:00:00Z,6,6,2020,91,5,Honduras,HN,HND,9746115,America,248,5971,67
2020-06-07T00:00:00Z,7,6,2020,184,2,Honduras,HN,HND,9746115,America,250,6155,68
2020-06-08T00:00:00Z,8,6,2020,172,8,Honduras,HN,HND,9746115,America,258,6327,69
2020-06-09T00:00:00Z,9,6,2020,123,4,Honduras,HN,HND,9746115,America,262,6450,70
2020-06-10T00:00:00Z,10,6,2020,485,9,Honduras,HN,HND,9746115,America,271,6935,71
2020-06-11T00:00:00Z,11,6,2020,425,19,Honduras,HN,HND,9746115,America,290,7360,72
2020-06-12T00:00:00Z,12,6,2020,309,4,Honduras,HN,HND,9746115,America,294,7669,73
2020-06-13T00:00:00Z,13,6,2020,463,12,Honduras,HN,HND,9746115,America,306,8132,74
2020-06-14T00:00:00Z,14,6,2020,323,4,Honduras,HN,HND,9746115,America,310,8455,75
2020-06-15T00:00:00Z,15,6,2020,403,2,Honduras,HN,HND,9746115,America,312,8858,76
2020-06-16T00:00:00Z,16,6,2020,320,10,Honduras,HN,HND,9746115,America,322,9178,77
2020-06-17T00:00:00Z,17,6,2020,478,8,Honduras,HN,HND,9746115,America,330,9656,78
2020-06-18T00:00:00Z,18,6,2020,643,6,Honduras,HN,HND,9746115,America,336,10299,79
2020-06-19T00:00:00Z,19,6,2020,440,7,Honduras,HN,HND,9746115,America,343,10739,80
2020-06-20T00:00:00Z,20,6,2020,519,6,Honduras,HN,HND,9746115,America,349,11258,81
2020-06-21T00:00:00Z,21,6,2020,992,9,Honduras,HN,HND,9746115,America,358,12250,82
2020-06-22T00:00:00Z,22,6,2020,519,5,Honduras,HN,HND,9746115,America,363,12769,83
2020-06-23T00:00:00Z,23,6,2020,587,32,Honduras,HN,HND,9746115,America,395,13356,84
2020-06-24T00:00:00Z,24,6,2020,587,10,Honduras,HN,HND,9746115,America,405,13943,85
2020-06-25T00:00:00Z,25,6,2020,628,12,Honduras,HN,HND,9746115,America,417,14571,86
2020-03-25T00:00:00Z,25,3,2020,39,2,Hungary,HU,HUN,9772756,Europe,10,226,1
2020-03-26T00:00:00Z,26,3,2020,35,0,Hungary,HU,HUN,9772756,Europe,10,261,2
2020-03-27T00:00:00Z,27,3,2020,39,0,Hungary,HU,HUN,9772756,Europe,10,300,3
2020-03-28T00:00:00Z,28,3,2020,43,1,Hungary,HU,HUN,9772756,Europe,11,343,4
2020-03-29T00:00:00Z,29,3,2020,65,2,Hungary,HU,HUN,9772756,Europe,13,408,5
2020-03-30T00:00:00Z,30,3,2020,39,2,Hungary,HU,HUN,9772756,Europe,15,447,6
2020-03-31T00:00:00Z,31,3,2020,45,1,Hungary,HU,HUN,9772756,Europe,16,492,7
2020-04-01T00:00:00Z,1,4,2020,33,4,Hungary,HU,HUN,9772756,Europe,20,525,8
2020-04-02T00:00:00Z,2,4,2020,60,1,Hungary,HU,HUN,9772756,Europe,21,585,9
2020-04-03T00:00:00Z,3,4,2020,38,5,Hungary,HU,HUN,9772756,Europe,26,623,10
2020-04-04T00:00:00Z,4,4,2020,55,6,Hungary,HU,HUN,9772756,Europe,32,678,11
2020-04-05T00:00:00Z,5,4,2020,55,2,Hungary,HU,HUN,9772756,Europe,34,733,12
2020-04-06T00:00:00Z,6,4,2020,11,4,Hungary,HU,HUN,9772756,Europe,38,744,13
2020-04-07T00:00:00Z,7,4,2020,73,9,Hungary,HU,HUN,9772756,Europe,47,817,14
2020-04-08T00:00:00Z,8,4,2020,78,11,Hungary,HU,HUN,9772756,Europe,58,895,15
2020-04-09T00:00:00Z,9,4,2020,85,8,Hungary,HU,HUN,9772756,Europe,66,980,16
2020-04-10T00:00:00Z,10,4,2020,210,11,Hungary,HU,HUN,9772756,Europe,77,1190,17
2020-04-11T00:00:00Z,11,4,2020,120,8,Hungary,HU,HUN,9772756,Europe,85,1310,18
2020-04-12T00:00:00Z,12,4,2020,100,14,Hungary,HU,HUN,9772756,Europe,99,1410,19
2020-04-13T00:00:00Z,13,4,2020,48,10,Hungary,HU,HUN,9772756,Europe,109,1458,20
2020-04-14T00:00:00Z,14,4,2020,54,13,Hungary,HU,HUN,9772756,Europe,122,1512,21
2020-04-15T00:00:00Z,15,4,2020,67,12,Hungary,HU,HUN,9772756,Europe,134,1579,22
2020-04-16T00:00:00Z,16,4,2020,73,8,Hungary,HU,HUN,9772756,Europe,142,1652,23
2020-04-17T00:00:00Z,17,4,2020,111,14,Hungary,HU,HUN,9772756,Europe,156,1763,24
2020-04-18T00:00:00Z,18,4,2020,71,16,Hungary,HU,HUN,9772756,Europe,172,1834,25
2020-04-19T00:00:00Z,19,4,2020,82,17,Hungary,HU,HUN,9772756,Europe,189,1916,26
2020-04-20T00:00:00Z,20,4,2020,68,10,Hungary,HU,HUN,9772756,Europe,199,1984,27
2020-04-21T00:00:00Z,21,4,2020,114,14,Hungary,HU,HUN,9772756,Europe,213,2098,28
2020-04-22T00:00:00Z,22,4,2020,70,12,Hungary,HU,HUN,9772756,Europe,225,2168,29
2020-04-23T00:00:00Z,23,4,2020,116,0,Hungary,HU,HUN,9772756,Europe,225,2284,30
2020-04-24T00:00:00Z,24,4,2020,99,25,Hungary,HU,HUN,9772756,Europe,250,2383,31
2020-04-25T00:00:00Z,25,4,2020,60,12,Hungary,HU,HUN,9772756,Europe,262,2443,32
2020-04-26T00:00:00Z,26,4,2020,57,10,Hungary,HU,HUN,9772756,Europe,272,2500,33
2020-04-27T00:00:00Z,27,4,2020,83,8,Hungary,HU,HUN,9772756,Europe,280,2583,34
2020-04-28T00:00:00Z,28,4,2020,66,11,Hungary,HU,HUN,9772756,Europe,291,2649,35
2020-04-29T00:00:00Z,29,4,2020,78,9,Hungary,HU,HUN,9772756,Europe,300,2727,36
2020-04-30T00:00:00Z,30,4,2020,48,12,Hungary,HU,HUN,9772756,Europe,312,2775,37
2020-05-01T00:00:00Z,1,5,2020,88,11,Hungary,HU,HUN,9772756,Europe,323,2863,38
2020-05-02T00:00:00Z,2,5,2020,79,12,Hungary,HU,HUN,9772756,Europe,335,2942,39
2020-05-03T00:00:00Z,3,5,2020,56,5,Hungary,HU,HUN,9772756,Europe,340,2998,40
2020-05-04T00:00:00Z,4,5,2020,37,11,Hungary,HU,HUN,9772756,Europe,351,3035,41
2020-05-05T00:00:00Z,5,5,2020,30,12,Hungary,HU,HUN,9772756,Europe,363,3065,42
2020-05-06T00:00:00Z,6,5,2020,46,10,Hungary,HU,HUN,9772756,Europe,373,3111,43
2020-05-07T00:00:00Z,7,5,2020,39,10,Hungary,HU,HUN,9772756,Europe,383,3150,44
2020-05-08T00:00:00Z,8,5,2020,28,9,Hungary,HU,HUN,9772756,Europe,392,3178,45
2020-05-09T00:00:00Z,9,5,2020,35,13,Hungary,HU,HUN,9772756,Europe,405,3213,46
2020-05-10T00:00:00Z,10,5,2020,50,8,Hungary,HU,HUN,9772756,Europe,413,3263,47
2020-05-11T00:00:00Z,11,5,2020,21,8,Hungary,HU,HUN,9772756,Europe,421,3284,48
2020-05-12T00:00:00Z,12,5,2020,29,4,Hungary,HU,HUN,9772756,Europe,425,3313,49
2020-05-13T00:00:00Z,13,5,2020,28,5,Hungary,HU,HUN,9772756,Europe,430,3341,50
2020-05-14T00:00:00Z,14,5,2020,39,6,Hungary,HU,HUN,9772756,Europe,436,3380,51
2020-05-15T00:00:00Z,15,5,2020,37,6,Hungary,HU,HUN,9772756,Europe,442,3417,52
2020-05-16T00:00:00Z,16,5,2020,56,6,Hungary,HU,HUN,9772756,Europe,448,3473,53
2020-05-17T00:00:00Z,17,5,2020,36,3,Hungary,HU,HUN,9772756,Europe,451,3509,54
2020-05-18T00:00:00Z,18,5,2020,26,11,Hungary,HU,HUN,9772756,Europe,462,3535,55
2020-05-19T00:00:00Z,19,5,2020,21,5,Hungary,HU,HUN,9772756,Europe,467,3556,56
2020-05-20T00:00:00Z,20,5,2020,42,3,Hungary,HU,HUN,9772756,Europe,470,3598,57
2020-05-21T00:00:00Z,21,5,2020,43,3,Hungary,HU,HUN,9772756,Europe,473,3641,58
2020-05-22T00:00:00Z,22,5,2020,37,3,Hungary,HU,HUN,9772756,Europe,476,3678,59
2020-05-23T00:00:00Z,23,5,2020,35,6,Hungary,HU,HUN,9772756,Europe,482,3713,60
2020-05-24T00:00:00Z,24,5,2020,28,4,Hungary,HU,HUN,9772756,Europe,486,3741,61
2020-05-25T00:00:00Z,25,5,2020,15,5,Hungary,HU,HUN,9772756,Europe,491,3756,62
2020-05-26T00:00:00Z,26,5,2020,15,8,Hungary,HU,HUN,9772756,Europe,499,3771,63
2020-05-27T00:00:00Z,27,5,2020,22,6,Hungary,HU,HUN,9772756,Europe,505,3793,64
2020-05-28T00:00:00Z,28,5,2020,23,4,Hungary,HU,HUN,9772756,Europe,509,3816,65
2020-05-29T00:00:00Z,29,5,2020,25,8,Hungary,HU,HUN,9772756,Europe,517,3841,66
2020-05-30T00:00:00Z,30,5,2020,0,0,Hungary,HU,HUN,9772756,Europe,517,3841,67
2020-05-31T00:00:00Z,31,5,2020,26,7,Hungary,HU,HUN,9772756,Europe,524,3867,68
2020-06-01T00:00:00Z,1,6,2020,9,2,Hungary,HU,HUN,9772756,Europe,526,3876,69
2020-06-02T00:00:00Z,2,6,2020,45,6,Hungary,HU,HUN,9772756,Europe,532,3921,70
2020-06-03T00:00:00Z,3,6,2020,10,2,Hungary,HU,HUN,9772756,Europe,534,3931,71
2020-06-04T00:00:00Z,4,6,2020,0,0,Hungary,HU,HUN,9772756,Europe,534,3931,72
2020-06-05T00:00:00Z,5,6,2020,23,5,Hungary,HU,HUN,9772756,Europe,539,3954,73
2020-06-06T00:00:00Z,6,6,2020,16,3,Hungary,HU,HUN,9772756,Europe,542,3970,74
2020-06-07T00:00:00Z,7,6,2020,0,0,Hungary,HU,HUN,9772756,Europe,542,3970,75
2020-06-08T00:00:00Z,8,6,2020,0,0,Hungary,HU,HUN,9772756,Europe,542,3970,76
2020-06-09T00:00:00Z,9,6,2020,44,6,Hungary,HU,HUN,9772756,Europe,548,4014,77
2020-06-10T00:00:00Z,10,6,2020,3,2,Hungary,HU,HUN,9772756,Europe,550,4017,78
2020-06-11T00:00:00Z,11,6,2020,10,1,Hungary,HU,HUN,9772756,Europe,551,4027,79
2020-06-12T00:00:00Z,12,6,2020,12,2,Hungary,HU,HUN,9772756,Europe,553,4039,80
2020-06-13T00:00:00Z,13,6,2020,14,2,Hungary,HU,HUN,9772756,Europe,555,4053,81
2020-06-14T00:00:00Z,14,6,2020,11,4,Hungary,HU,HUN,9772756,Europe,559,4064,82
2020-06-15T00:00:00Z,15,6,2020,12,4,Hungary,HU,HUN,9772756,Europe,563,4076,83
2020-06-16T00:00:00Z,16,6,2020,1,2,Hungary,HU,HUN,9772756,Europe,565,4077,84
2020-06-17T00:00:00Z,17,6,2020,1,2,Hungary,HU,HUN,9772756,Europe,567,4078,85
2020-06-18T00:00:00Z,18,6,2020,1,1,Hungary,HU,HUN,9772756,Europe,568,4079,86
2020-06-19T00:00:00Z,19,6,2020,2,0,Hungary,HU,HUN,9772756,Europe,568,4081,87
2020-06-20T00:00:00Z,20,6,2020,5,2,Hungary,HU,HUN,9772756,Europe,570,4086,88
2020-06-21T00:00:00Z,21,6,2020,8,0,Hungary,HU,HUN,9772756,Europe,570,4094,89
2020-06-22T00:00:00Z,22,6,2020,8,2,Hungary,HU,HUN,9772756,Europe,572,4102,90
2020-06-23T00:00:00Z,23,6,2020,5,1,Hungary,HU,HUN,9772756,Europe,573,4107,91
2020-06-24T00:00:00Z,24,6,2020,0,0,Hungary,HU,HUN,9772756,Europe,573,4107,92
2020-06-25T00:00:00Z,25,6,2020,7,3,Hungary,HU,HUN,9772756,Europe,576,4114,93
2020-04-21T00:00:00Z,21,4,2020,2,1,Iceland,IS,ISL,356991,Europe,10,1773,1
2020-04-22T00:00:00Z,22,4,2020,5,0,Iceland,IS,ISL,356991,Europe,10,1778,2
2020-04-23T00:00:00Z,23,4,2020,7,0,Iceland,IS,ISL,356991,Europe,10,1785,3
2020-04-24T00:00:00Z,24,4,2020,4,0,Iceland,IS,ISL,356991,Europe,10,1789,4
2020-04-25T00:00:00Z,25,4,2020,0,0,Iceland,IS,ISL,356991,Europe,10,1789,5
2020-04-26T00:00:00Z,26,4,2020,1,0,Iceland,IS,ISL,356991,Europe,10,1790,6
2020-04-27T00:00:00Z,27,4,2020,2,0,Iceland,IS,ISL,356991,Europe,10,1792,7
2020-04-28T00:00:00Z,28,4,2020,0,0,Iceland,IS,ISL,356991,Europe,10,1792,8
2020-04-29T00:00:00Z,29,4,2020,3,0,Iceland,IS,ISL,356991,Europe,10,1795,9
2020-04-30T00:00:00Z,30,4,2020,2,0,Iceland,IS,ISL,356991,Europe,10,1797,10
2020-05-01T00:00:00Z,1,5,2020,0,0,Iceland,IS,ISL,356991,Europe,10,1797,11
2020-05-02T00:00:00Z,2,5,2020,1,0,Iceland,IS,ISL,356991,Europe,10,1798,12
2020-05-03T00:00:00Z,3,5,2020,0,0,Iceland,IS,ISL,356991,Europe,10,1798,13
2020-05-04T00:00:00Z,4,5,2020,1,0,Iceland,IS,ISL,356991,Europe,10,1799,14
2020-05-05T00:00:00Z,5,5,2020,0,0,Iceland,IS,ISL,356991,Europe,10,1799,15
2020-05-06T00:00:00Z,6,5,2020,0,0,Iceland,IS,ISL,356991,Europe,10,1799,16
2020-05-07T00:00:00Z,7,5,2020,0,0,Iceland,IS,ISL,356991,Europe,10,1799,17
2020-05-08T00:00:00Z,8,5,2020,2,0,Iceland,IS,ISL,356991,Europe,10,1801,18
2020-05-09T00:00:00Z,9,5,2020,0,0,Iceland,IS,ISL,356991,Europe,10,1801,19
2020-05-10T00:00:00Z,10,5,2020,0,0,Iceland,IS,ISL,356991,Europe,10,1801,20
2020-05-11T00:00:00Z,11,5,2020,0,0,Iceland,IS,ISL,356991,Europe,10,1801,21
2020-05-12T00:00:00Z,12,5,2020,0,0,Iceland,IS,ISL,356991,Europe,10,1801,22
2020-05-13T00:00:00Z,13,5,2020,0,0,Iceland,IS,ISL,356991,Europe,10,1801,23
2020-05-14T00:00:00Z,14,5,2020,1,0,Iceland,IS,ISL,356991,Europe,10,1802,24
2020-05-15T00:00:00Z,15,5,2020,0,0,Iceland,IS,ISL,356991,Europe,10,1802,25
2020-05-16T00:00:00Z,16,5,2020,0,0,Iceland,IS,ISL,356991,Europe,10,1802,26
2020-05-17T00:00:00Z,17,5,2020,0,0,Iceland,IS,ISL,356991,Europe,10,1802,27
2020-05-18T00:00:00Z,18,5,2020,0,0,Iceland,IS,ISL,356991,Europe,10,1802,28
2020-05-19T00:00:00Z,19,5,2020,0,0,Iceland,IS,ISL,356991,Europe,10,1802,29
2020-05-20T00:00:00Z,20,5,2020,0,0,Iceland,IS,ISL,356991,Europe,10,1802,30
2020-05-21T00:00:00Z,21,5,2020,1,0,Iceland,IS,ISL,356991,Europe,10,1803,31
2020-05-22T00:00:00Z,22,5,2020,0,0,Iceland,IS,ISL,356991,Europe,10,1803,32
2020-05-23T00:00:00Z,23,5,2020,0,0,Iceland,IS,ISL,356991,Europe,10,1803,33
2020-05-24T00:00:00Z,24,5,2020,1,0,Iceland,IS,ISL,356991,Europe,10,1804,34
2020-05-25T00:00:00Z,25,5,2020,0,0,Iceland,IS,ISL,356991,Europe,10,1804,35
2020-05-26T00:00:00Z,26,5,2020,0,0,Iceland,IS,ISL,356991,Europe,10,1804,36
2020-05-27T00:00:00Z,27,5,2020,0,0,Iceland,IS,ISL,356991,Europe,10,1804,37
2020-05-28T00:00:00Z,28,5,2020,1,0,Iceland,IS,ISL,356991,Europe,10,1805,38
2020-05-29T00:00:00Z,29,5,2020,0,0,Iceland,IS,ISL,356991,Europe,10,1805,39
2020-05-30T00:00:00Z,30,5,2020,0,0,Iceland,IS,ISL,356991,Europe,10,1805,40
2020-05-31T00:00:00Z,31,5,2020,1,0,Iceland,IS,ISL,356991,Europe,10,1806,41
2020-06-01T00:00:00Z,1,6,2020,0,0,Iceland,IS,ISL,356991,Europe,10,1806,42
2020-06-02T00:00:00Z,2,6,2020,0,0,Iceland,IS,ISL,356991,Europe,10,1806,43
2020-06-03T00:00:00Z,3,6,2020,0,0,Iceland,IS,ISL,356991,Europe,10,1806,44
2020-06-04T00:00:00Z,4,6,2020,0,0,Iceland,IS,ISL,356991,Europe,10,1806,45
2020-06-05T00:00:00Z,5,6,2020,0,0,Iceland,IS,ISL,356991,Europe,10,1806,46
2020-06-06T00:00:00Z,6,6,2020,0,0,Iceland,IS,ISL,356991,Europe,10,1806,47
2020-06-07T00:00:00Z,7,6,2020,0,0,Iceland,IS,ISL,356991,Europe,10,1806,48
2020-06-08T00:00:00Z,8,6,2020,1,0,Iceland,IS,ISL,356991,Europe,10,1807,49
2020-06-09T00:00:00Z,9,6,2020,0,0,Iceland,IS,ISL,356991,Europe,10,1807,50
2020-06-10T00:00:00Z,10,6,2020,0,0,Iceland,IS,ISL,356991,Europe,10,1807,51
2020-06-11T00:00:00Z,11,6,2020,0,0,Iceland,IS,ISL,356991,Europe,10,1807,52
2020-06-12T00:00:00Z,12,6,2020,0,0,Iceland,IS,ISL,356991,Europe,10,1807,53
2020-06-13T00:00:00Z,13,6,2020,0,0,Iceland,IS,ISL,356991,Europe,10,1807,54
2020-06-14T00:00:00Z,14,6,2020,1,0,Iceland,IS,ISL,356991,Europe,10,1808,55
2020-06-15T00:00:00Z,15,6,2020,2,0,Iceland,IS,ISL,356991,Europe,10,1810,56
2020-06-16T00:00:00Z,16,6,2020,0,0,Iceland,IS,ISL,356991,Europe,10,1810,57
2020-06-17T00:00:00Z,17,6,2020,2,0,Iceland,IS,ISL,356991,Europe,10,1812,58
2020-06-18T00:00:00Z,18,6,2020,3,0,Iceland,IS,ISL,356991,Europe,10,1815,59
2020-06-19T00:00:00Z,19,6,2020,1,0,Iceland,IS,ISL,356991,Europe,10,1816,60
2020-06-20T00:00:00Z,20,6,2020,3,0,Iceland,IS,ISL,356991,Europe,10,1819,61
2020-06-21T00:00:00Z,21,6,2020,3,0,Iceland,IS,ISL,356991,Europe,10,1822,62
2020-06-22T00:00:00Z,22,6,2020,1,0,Iceland,IS,ISL,356991,Europe,10,1823,63
2020-06-23T00:00:00Z,23,6,2020,0,0,Iceland,IS,ISL,356991,Europe,10,1823,64
2020-06-24T00:00:00Z,24,6,2020,1,0,Iceland,IS,ISL,356991,Europe,10,1824,65
2020-06-25T00:00:00Z,25,6,2020,3,0,Iceland,IS,ISL,356991,Europe,10,1827,66
2020-03-26T00:00:00Z,26,3,2020,87,4,India,IN,IND,1366417756,Asia,13,649,1
2020-03-27T00:00:00Z,27,3,2020,75,4,India,IN,IND,1366417756,Asia,17,724,2
2020-03-28T00:00:00Z,28,3,2020,149,2,India,IN,IND,1366417756,Asia,19,873,3
2020-03-29T00:00:00Z,29,3,2020,106,6,India,IN,IND,1366417756,Asia,25,979,4
2020-03-30T00:00:00Z,30,3,2020,92,4,India,IN,IND,1366417756,Asia,29,1071,5
2020-03-31T00:00:00Z,31,3,2020,180,3,India,IN,IND,1366417756,Asia,32,1251,6
2020-04-01T00:00:00Z,1,4,2020,146,3,India,IN,IND,1366417756,Asia,35,1397,7
2020-04-02T00:00:00Z,2,4,2020,568,15,India,IN,IND,1366417756,Asia,50,1965,8
2020-04-03T00:00:00Z,3,4,2020,336,6,India,IN,IND,1366417756,Asia,56,2301,9
2020-04-04T00:00:00Z,4,4,2020,601,12,India,IN,IND,1366417756,Asia,68,2902,10
2020-04-05T00:00:00Z,5,4,2020,472,9,India,IN,IND,1366417756,Asia,77,3374,11
2020-04-06T00:00:00Z,6,4,2020,693,32,India,IN,IND,1366417756,Asia,109,4067,12
2020-04-07T00:00:00Z,7,4,2020,354,5,India,IN,IND,1366417756,Asia,114,4421,13
2020-04-08T00:00:00Z,8,4,2020,773,35,India,IN,IND,1366417756,Asia,149,5194,14
2020-04-09T00:00:00Z,9,4,2020,540,17,India,IN,IND,1366417756,Asia,166,5734,15
2020-04-10T00:00:00Z,10,4,2020,678,33,India,IN,IND,1366417756,Asia,199,6412,16
2020-04-11T00:00:00Z,11,4,2020,1035,40,India,IN,IND,1366417756,Asia,239,7447,17
2020-04-12T00:00:00Z,12,4,2020,909,34,India,IN,IND,1366417756,Asia,273,8356,18
2020-04-13T00:00:00Z,13,4,2020,796,35,India,IN,IND,1366417756,Asia,308,9152,19
2020-04-14T00:00:00Z,14,4,2020,1211,31,India,IN,IND,1366417756,Asia,339,10363,20
2020-04-15T00:00:00Z,15,4,2020,1075,38,India,IN,IND,1366417756,Asia,377,11438,21
2020-04-16T00:00:00Z,16,4,2020,942,37,India,IN,IND,1366417756,Asia,414,12380,22
2020-04-17T00:00:00Z,17,4,2020,1007,23,India,IN,IND,1366417756,Asia,437,13387,23
2020-04-18T00:00:00Z,18,4,2020,991,43,India,IN,IND,1366417756,Asia,480,14378,24
2020-04-19T00:00:00Z,19,4,2020,1334,27,India,IN,IND,1366417756,Asia,507,15712,25
2020-04-20T00:00:00Z,20,4,2020,1553,36,India,IN,IND,1366417756,Asia,543,17265,26
2020-04-21T00:00:00Z,21,4,2020,1335,47,India,IN,IND,1366417756,Asia,590,18600,27
2020-04-22T00:00:00Z,22,4,2020,1384,50,India,IN,IND,1366417756,Asia,640,19984,28
2020-04-23T00:00:00Z,23,4,2020,1409,41,India,IN,IND,1366417756,Asia,681,21393,29
2020-04-24T00:00:00Z,24,4,2020,1684,37,India,IN,IND,1366417756,Asia,718,23077,30
2020-04-25T00:00:00Z,25,4,2020,1429,57,India,IN,IND,1366417756,Asia,775,24506,31
2020-04-26T00:00:00Z,26,4,2020,1990,49,India,IN,IND,1366417756,Asia,824,26496,32
2020-04-27T00:00:00Z,27,4,2020,1396,48,India,IN,IND,1366417756,Asia,872,27892,33
2020-04-28T00:00:00Z,28,4,2020,1543,62,India,IN,IND,1366417756,Asia,934,29435,34
2020-04-29T00:00:00Z,29,4,2020,1897,73,India,IN,IND,1366417756,Asia,1007,31332,35
2020-04-30T00:00:00Z,30,4,2020,1718,67,India,IN,IND,1366417756,Asia,1074,33050,36
2020-05-01T00:00:00Z,1,5,2020,1993,73,India,IN,IND,1366417756,Asia,1147,35043,37
2020-05-02T00:00:00Z,2,5,2020,2293,71,India,IN,IND,1366417756,Asia,1218,37336,38
2020-05-03T00:00:00Z,3,5,2020,2644,83,India,IN,IND,1366417756,Asia,1301,39980,39
2020-05-04T00:00:00Z,4,5,2020,2553,72,India,IN,IND,1366417756,Asia,1373,42533,40
2020-05-05T00:00:00Z,5,5,2020,3900,195,India,IN,IND,1366417756,Asia,1568,46433,41
2020-05-06T00:00:00Z,6,5,2020,2958,126,India,IN,IND,1366417756,Asia,1694,49391,42
2020-05-07T00:00:00Z,7,5,2020,3561,89,India,IN,IND,1366417756,Asia,1783,52952,43
2020-05-08T00:00:00Z,8,5,2020,3390,103,India,IN,IND,1366417756,Asia,1886,56342,44
2020-05-09T00:00:00Z,9,5,2020,3320,95,India,IN,IND,1366417756,Asia,1981,59662,45
2020-05-10T00:00:00Z,10,5,2020,3277,128,India,IN,IND,1366417756,Asia,2109,62939,46
2020-05-11T00:00:00Z,11,5,2020,4213,97,India,IN,IND,1366417756,Asia,2206,67152,47
2020-05-12T00:00:00Z,12,5,2020,3604,87,India,IN,IND,1366417756,Asia,2293,70756,48
2020-05-13T00:00:00Z,13,5,2020,3525,122,India,IN,IND,1366417756,Asia,2415,74281,49
2020-05-14T00:00:00Z,14,5,2020,3722,134,India,IN,IND,1366417756,Asia,2549,78003,50
2020-05-15T00:00:00Z,15,5,2020,3967,100,India,IN,IND,1366417756,Asia,2649,81970,51
2020-05-16T00:00:00Z,16,5,2020,3970,103,India,IN,IND,1366417756,Asia,2752,85940,52
2020-05-17T00:00:00Z,17,5,2020,4987,120,India,IN,IND,1366417756,Asia,2872,90927,53
2020-05-18T00:00:00Z,18,5,2020,5242,157,India,IN,IND,1366417756,Asia,3029,96169,54
2020-05-19T00:00:00Z,19,5,2020,4970,134,India,IN,IND,1366417756,Asia,3163,101139,55
2020-05-20T00:00:00Z,20,5,2020,5611,140,India,IN,IND,1366417756,Asia,3303,106750,56
2020-05-21T00:00:00Z,21,5,2020,5609,132,India,IN,IND,1366417756,Asia,3435,112359,57
2020-05-22T00:00:00Z,22,5,2020,6088,148,India,IN,IND,1366417756,Asia,3583,118447,58
2020-05-23T00:00:00Z,23,5,2020,6654,137,India,IN,IND,1366417756,Asia,3720,125101,59
2020-05-24T00:00:00Z,24,5,2020,6767,147,India,IN,IND,1366417756,Asia,3867,131868,60
2020-05-25T00:00:00Z,25,5,2020,6977,154,India,IN,IND,1366417756,Asia,4021,138845,61
2020-05-26T00:00:00Z,26,5,2020,6535,146,India,IN,IND,1366417756,Asia,4167,145380,62
2020-05-27T00:00:00Z,27,5,2020,6387,170,India,IN,IND,1366417756,Asia,4337,151767,63
2020-05-28T00:00:00Z,28,5,2020,6566,194,India,IN,IND,1366417756,Asia,4531,158333,64
2020-05-29T00:00:00Z,29,5,2020,7466,175,India,IN,IND,1366417756,Asia,4706,165799,65
2020-05-30T00:00:00Z,30,5,2020,7964,265,India,IN,IND,1366417756,Asia,4971,173763,66
2020-05-31T00:00:00Z,31,5,2020,8380,193,India,IN,IND,1366417756,Asia,5164,182143,67
2020-06-01T00:00:00Z,1,6,2020,8392,230,India,IN,IND,1366417756,Asia,5394,190535,68
2020-06-02T00:00:00Z,2,6,2020,8171,204,India,IN,IND,1366417756,Asia,5598,198706,69
2020-06-03T00:00:00Z,3,6,2020,8909,217,India,IN,IND,1366417756,Asia,5815,207615,70
2020-06-04T00:00:00Z,4,6,2020,9304,260,India,IN,IND,1366417756,Asia,6075,216919,71
2020-06-05T00:00:00Z,5,6,2020,9851,273,India,IN,IND,1366417756,Asia,6348,226770,72
2020-06-06T00:00:00Z,6,6,2020,9887,294,India,IN,IND,1366417756,Asia,6642,236657,73
2020-06-07T00:00:00Z,7,6,2020,9971,287,India,IN,IND,1366417756,Asia,6929,246628,74
2020-06-08T00:00:00Z,8,6,2020,9983,206,India,IN,IND,1366417756,Asia,7135,256611,75
2020-06-09T00:00:00Z,9,6,2020,9987,331,India,IN,IND,1366417756,Asia,7466,266598,76
2020-06-10T00:00:00Z,10,6,2020,9985,279,India,IN,IND,1366417756,Asia,7745,276583,77
2020-06-11T00:00:00Z,11,6,2020,9996,357,India,IN,IND,1366417756,Asia,8102,286579,78
2020-06-12T00:00:00Z,12,6,2020,10956,396,India,IN,IND,1366417756,Asia,8498,297535,79
2020-06-13T00:00:00Z,13,6,2020,11458,386,India,IN,IND,1366417756,Asia,8884,308993,80
2020-06-14T00:00:00Z,14,6,2020,11929,311,India,IN,IND,1366417756,Asia,9195,320922,81
2020-06-15T00:00:00Z,15,6,2020,11502,325,India,IN,IND,1366417756,Asia,9520,332424,82
2020-06-16T00:00:00Z,16,6,2020,10667,380,India,IN,IND,1366417756,Asia,9900,343091,83
2020-06-17T00:00:00Z,17,6,2020,10974,2003,India,IN,IND,1366417756,Asia,11903,354065,84
2020-06-18T00:00:00Z,18,6,2020,12881,334,India,IN,IND,1366417756,Asia,12237,366946,85
2020-06-19T00:00:00Z,19,6,2020,13586,336,India,IN,IND,1366417756,Asia,12573,380532,86
2020-06-20T00:00:00Z,20,6,2020,14516,375,India,IN,IND,1366417756,Asia,12948,395048,87
2020-06-21T00:00:00Z,21,6,2020,15413,306,India,IN,IND,1366417756,Asia,13254,410461,88
2020-06-22T00:00:00Z,22,6,2020,14821,445,India,IN,IND,1366417756,Asia,13699,425282,89
2020-06-23T00:00:00Z,23,6,2020,14933,312,India,IN,IND,1366417756,Asia,14011,440215,90
2020-06-24T00:00:00Z,24,6,2020,15968,465,India,IN,IND,1366417756,Asia,14476,456183,91
2020-06-25T00:00:00Z,25,6,2020,16922,418,India,IN,IND,1366417756,Asia,14894,473105,92
2020-03-20T00:00:00Z,20,3,2020,55,14,Indonesia,ID,IDN,270625567,Asia,19,227,1
2020-03-21T00:00:00Z,21,3,2020,82,6,Indonesia,ID,IDN,270625567,Asia,25,309,2
2020-03-22T00:00:00Z,22,3,2020,141,13,Indonesia,ID,IDN,270625567,Asia,38,450,3
2020-03-23T00:00:00Z,23,3,2020,64,10,Indonesia,ID,IDN,270625567,Asia,48,514,4
2020-03-24T00:00:00Z,24,3,2020,65,1,Indonesia,ID,IDN,270625567,Asia,49,579,5
2020-03-25T00:00:00Z,25,3,2020,107,6,Indonesia,ID,IDN,270625567,Asia,55,686,6
2020-03-26T00:00:00Z,26,3,2020,104,3,Indonesia,ID,IDN,270625567,Asia,58,790,7
2020-03-27T00:00:00Z,27,3,2020,103,20,Indonesia,ID,IDN,270625567,Asia,78,893,8
2020-03-28T00:00:00Z,28,3,2020,153,9,Indonesia,ID,IDN,270625567,Asia,87,1046,9
2020-03-29T00:00:00Z,29,3,2020,109,15,Indonesia,ID,IDN,270625567,Asia,102,1155,10
2020-03-30T00:00:00Z,30,3,2020,130,12,Indonesia,ID,IDN,270625567,Asia,114,1285,11
2020-03-31T00:00:00Z,31,3,2020,129,8,Indonesia,ID,IDN,270625567,Asia,122,1414,12
2020-04-01T00:00:00Z,1,4,2020,114,14,Indonesia,ID,IDN,270625567,Asia,136,1528,13
2020-04-02T00:00:00Z,2,4,2020,149,21,Indonesia,ID,IDN,270625567,Asia,157,1677,14
2020-04-03T00:00:00Z,3,4,2020,113,13,Indonesia,ID,IDN,270625567,Asia,170,1790,15
2020-04-04T00:00:00Z,4,4,2020,196,11,Indonesia,ID,IDN,270625567,Asia,181,1986,16
2020-04-05T00:00:00Z,5,4,2020,106,10,Indonesia,ID,IDN,270625567,Asia,191,2092,17
2020-04-06T00:00:00Z,6,4,2020,181,7,Indonesia,ID,IDN,270625567,Asia,198,2273,18
2020-04-07T00:00:00Z,7,4,2020,218,11,Indonesia,ID,IDN,270625567,Asia,209,2491,19
2020-04-08T00:00:00Z,8,4,2020,247,12,Indonesia,ID,IDN,270625567,Asia,221,2738,20
2020-04-09T00:00:00Z,9,4,2020,218,19,Indonesia,ID,IDN,270625567,Asia,240,2956,21
2020-04-10T00:00:00Z,10,4,2020,337,40,Indonesia,ID,IDN,270625567,Asia,280,3293,22
2020-04-11T00:00:00Z,11,4,2020,219,26,Indonesia,ID,IDN,270625567,Asia,306,3512,23
2020-04-12T00:00:00Z,12,4,2020,330,21,Indonesia,ID,IDN,270625567,Asia,327,3842,24
2020-04-13T00:00:00Z,13,4,2020,399,46,Indonesia,ID,IDN,270625567,Asia,373,4241,25
2020-04-14T00:00:00Z,14,4,2020,316,26,Indonesia,ID,IDN,270625567,Asia,399,4557,26
2020-04-15T00:00:00Z,15,4,2020,282,60,Indonesia,ID,IDN,270625567,Asia,459,4839,27
2020-04-16T00:00:00Z,16,4,2020,297,10,Indonesia,ID,IDN,270625567,Asia,469,5136,28
2020-04-17T00:00:00Z,17,4,2020,380,27,Indonesia,ID,IDN,270625567,Asia,496,5516,29
2020-04-18T00:00:00Z,18,4,2020,407,24,Indonesia,ID,IDN,270625567,Asia,520,5923,30
2020-04-19T00:00:00Z,19,4,2020,325,15,Indonesia,ID,IDN,270625567,Asia,535,6248,31
2020-04-20T00:00:00Z,20,4,2020,327,47,Indonesia,ID,IDN,270625567,Asia,582,6575,32
2020-04-21T00:00:00Z,21,4,2020,185,8,Indonesia,ID,IDN,270625567,Asia,590,6760,33
2020-04-22T00:00:00Z,22,4,2020,375,26,Indonesia,ID,IDN,270625567,Asia,616,7135,34
2020-04-23T00:00:00Z,23,4,2020,283,19,Indonesia,ID,IDN,270625567,Asia,635,7418,35
2020-04-24T00:00:00Z,24,4,2020,357,12,Indonesia,ID,IDN,270625567,Asia,647,7775,36
2020-04-25T00:00:00Z,25,4,2020,436,42,Indonesia,ID,IDN,270625567,Asia,689,8211,37
2020-04-26T00:00:00Z,26,4,2020,396,31,Indonesia,ID,IDN,270625567,Asia,720,8607,38
2020-04-27T00:00:00Z,27,4,2020,275,23,Indonesia,ID,IDN,270625567,Asia,743,8882,39
2020-04-28T00:00:00Z,28,4,2020,214,22,Indonesia,ID,IDN,270625567,Asia,765,9096,40
2020-04-29T00:00:00Z,29,4,2020,415,8,Indonesia,ID,IDN,270625567,Asia,773,9511,41
2020-04-30T00:00:00Z,30,4,2020,260,11,Indonesia,ID,IDN,270625567,Asia,784,9771,42
2020-05-01T00:00:00Z,1,5,2020,347,8,Indonesia,ID,IDN,270625567,Asia,792,10118,43
2020-05-02T00:00:00Z,2,5,2020,433,8,Indonesia,ID,IDN,270625567,Asia,800,10551,44
2020-05-03T00:00:00Z,3,5,2020,292,31,Indonesia,ID,IDN,270625567,Asia,831,10843,45
2020-05-04T00:00:00Z,4,5,2020,349,14,Indonesia,ID,IDN,270625567,Asia,845,11192,46
2020-05-05T00:00:00Z,5,5,2020,395,19,Indonesia,ID,IDN,270625567,Asia,864,11587,47
2020-05-06T00:00:00Z,6,5,2020,484,8,Indonesia,ID,IDN,270625567,Asia,872,12071,48
2020-05-07T00:00:00Z,7,5,2020,367,23,Indonesia,ID,IDN,270625567,Asia,895,12438,49
2020-05-08T00:00:00Z,8,5,2020,338,35,Indonesia,ID,IDN,270625567,Asia,930,12776,50
2020-05-09T00:00:00Z,9,5,2020,336,13,Indonesia,ID,IDN,270625567,Asia,943,13112,51
2020-05-10T00:00:00Z,10,5,2020,533,16,Indonesia,ID,IDN,270625567,Asia,959,13645,52
2020-05-11T00:00:00Z,11,5,2020,387,14,Indonesia,ID,IDN,270625567,Asia,973,14032,53
2020-05-12T00:00:00Z,12,5,2020,233,18,Indonesia,ID,IDN,270625567,Asia,991,14265,54
2020-05-13T00:00:00Z,13,5,2020,484,16,Indonesia,ID,IDN,270625567,Asia,1007,14749,55
2020-05-14T00:00:00Z,14,5,2020,689,21,Indonesia,ID,IDN,270625567,Asia,1028,15438,56
2020-05-15T00:00:00Z,15,5,2020,568,15,Indonesia,ID,IDN,270625567,Asia,1043,16006,57
2020-05-16T00:00:00Z,16,5,2020,490,33,Indonesia,ID,IDN,270625567,Asia,1076,16496,58
2020-05-17T00:00:00Z,17,5,2020,529,13,Indonesia,ID,IDN,270625567,Asia,1089,17025,59
2020-05-18T00:00:00Z,18,5,2020,489,59,Indonesia,ID,IDN,270625567,Asia,1148,17514,60
2020-05-19T00:00:00Z,19,5,2020,496,43,Indonesia,ID,IDN,270625567,Asia,1191,18010,61
2020-05-20T00:00:00Z,20,5,2020,486,30,Indonesia,ID,IDN,270625567,Asia,1221,18496,62
2020-05-21T00:00:00Z,21,5,2020,693,21,Indonesia,ID,IDN,270625567,Asia,1242,19189,63
2020-05-22T00:00:00Z,22,5,2020,973,36,Indonesia,ID,IDN,270625567,Asia,1278,20162,64
2020-05-23T00:00:00Z,23,5,2020,634,48,Indonesia,ID,IDN,270625567,Asia,1326,20796,65
2020-05-24T00:00:00Z,24,5,2020,949,25,Indonesia,ID,IDN,270625567,Asia,1351,21745,66
2020-05-25T00:00:00Z,25,5,2020,526,21,Indonesia,ID,IDN,270625567,Asia,1372,22271,67
2020-05-26T00:00:00Z,26,5,2020,479,19,Indonesia,ID,IDN,270625567,Asia,1391,22750,68
2020-05-27T00:00:00Z,27,5,2020,415,27,Indonesia,ID,IDN,270625567,Asia,1418,23165,69
2020-05-28T00:00:00Z,28,5,2020,686,55,Indonesia,ID,IDN,270625567,Asia,1473,23851,70
2020-05-29T00:00:00Z,29,5,2020,687,23,Indonesia,ID,IDN,270625567,Asia,1496,24538,71
2020-05-30T00:00:00Z,30,5,2020,678,24,Indonesia,ID,IDN,270625567,Asia,1520,25216,72
2020-05-31T00:00:00Z,31,5,2020,557,53,Indonesia,ID,IDN,270625567,Asia,1573,25773,73
2020-06-01T00:00:00Z,1,6,2020,700,40,Indonesia,ID,IDN,270625567,Asia,1613,26473,74
2020-06-02T00:00:00Z,2,6,2020,467,28,Indonesia,ID,IDN,270625567,Asia,1641,26940,75
2020-06-03T00:00:00Z,3,6,2020,609,22,Indonesia,ID,IDN,270625567,Asia,1663,27549,76
2020-06-04T00:00:00Z,4,6,2020,684,35,Indonesia,ID,IDN,270625567,Asia,1698,28233,77
2020-06-05T00:00:00Z,5,6,2020,585,23,Indonesia,ID,IDN,270625567,Asia,1721,28818,78
2020-06-06T00:00:00Z,6,6,2020,703,49,Indonesia,ID,IDN,270625567,Asia,1770,29521,79
2020-06-07T00:00:00Z,7,6,2020,993,31,Indonesia,ID,IDN,270625567,Asia,1801,30514,80
2020-06-08T00:00:00Z,8,6,2020,672,50,Indonesia,ID,IDN,270625567,Asia,1851,31186,81
2020-06-09T00:00:00Z,9,6,2020,847,32,Indonesia,ID,IDN,270625567,Asia,1883,32033,82
2020-06-10T00:00:00Z,10,6,2020,1043,40,Indonesia,ID,IDN,270625567,Asia,1923,33076,83
2020-06-11T00:00:00Z,11,6,2020,1240,36,Indonesia,ID,IDN,270625567,Asia,1959,34316,84
2020-06-12T00:00:00Z,12,6,2020,979,41,Indonesia,ID,IDN,270625567,Asia,2000,35295,85
2020-06-13T00:00:00Z,13,6,2020,1111,48,Indonesia,ID,IDN,270625567,Asia,2048,36406,86
2020-06-14T00:00:00Z,14,6,2020,1014,43,Indonesia,ID,IDN,270625567,Asia,2091,37420,87
2020-06-15T00:00:00Z,15,6,2020,857,43,Indonesia,ID,IDN,270625567,Asia,2134,38277,88
2020-06-16T00:00:00Z,16,6,2020,1017,64,Indonesia,ID,IDN,270625567,Asia,2198,39294,89
2020-06-17T00:00:00Z,17,6,2020,1106,33,Indonesia,ID,IDN,270625567,Asia,2231,40400,90
2020-06-18T00:00:00Z,18,6,2020,1031,45,Indonesia,ID,IDN,270625567,Asia,2276,41431,91
2020-06-19T00:00:00Z,19,6,2020,1331,63,Indonesia,ID,IDN,270625567,Asia,2339,42762,92
2020-06-20T00:00:00Z,20,6,2020,1041,34,Indonesia,ID,IDN,270625567,Asia,2373,43803,93
2020-06-21T00:00:00Z,21,6,2020,1226,56,Indonesia,ID,IDN,270625567,Asia,2429,45029,94
2020-06-22T00:00:00Z,22,6,2020,862,36,Indonesia,ID,IDN,270625567,Asia,2465,45891,95
2020-06-23T00:00:00Z,23,6,2020,954,35,Indonesia,ID,IDN,270625567,Asia,2500,46845,96
2020-06-24T00:00:00Z,24,6,2020,1051,35,Indonesia,ID,IDN,270625567,Asia,2535,47896,97
2020-06-25T00:00:00Z,25,6,2020,1113,38,Indonesia,ID,IDN,270625567,Asia,2573,49009,98
2020-02-25T00:00:00Z,25,2,2020,18,4,Iran,IR,IRN,82913893,Asia,12,61,1
2020-02-26T00:00:00Z,26,2,2020,34,3,Iran,IR,IRN,82913893,Asia,15,95,2
2020-02-27T00:00:00Z,27,2,2020,44,4,Iran,IR,IRN,82913893,Asia,19,139,3
2020-02-28T00:00:00Z,28,2,2020,106,7,Iran,IR,IRN,82913893,Asia,26,245,4
2020-02-29T00:00:00Z,29,2,2020,143,8,Iran,IR,IRN,82913893,Asia,34,388,5
2020-03-01T00:00:00Z,1,3,2020,205,9,Iran,IR,IRN,82913893,Asia,43,593,6
2020-03-02T00:00:00Z,2,3,2020,385,11,Iran,IR,IRN,82913893,Asia,54,978,7
2020-03-03T00:00:00Z,3,3,2020,523,12,Iran,IR,IRN,82913893,Asia,66,1501,8
2020-03-04T00:00:00Z,4,3,2020,835,11,Iran,IR,IRN,82913893,Asia,77,2336,9
2020-03-05T00:00:00Z,5,3,2020,586,15,Iran,IR,IRN,82913893,Asia,92,2922,10
2020-03-06T00:00:00Z,6,3,2020,591,15,Iran,IR,IRN,82913893,Asia,107,3513,11
2020-03-07T00:00:00Z,7,3,2020,1234,17,Iran,IR,IRN,82913893,Asia,124,4747,12
2020-03-08T00:00:00Z,8,3,2020,1076,21,Iran,IR,IRN,82913893,Asia,145,5823,13
2020-03-09T00:00:00Z,9,3,2020,743,49,Iran,IR,IRN,82913893,Asia,194,6566,14
2020-03-10T00:00:00Z,10,3,2020,595,43,Iran,IR,IRN,82913893,Asia,237,7161,15
2020-03-11T00:00:00Z,11,3,2020,881,54,Iran,IR,IRN,82913893,Asia,291,8042,16
2020-03-12T00:00:00Z,12,3,2020,958,63,Iran,IR,IRN,82913893,Asia,354,9000,17
2020-03-13T00:00:00Z,13,3,2020,1075,75,Iran,IR,IRN,82913893,Asia,429,10075,18
2020-03-14T00:00:00Z,14,3,2020,1289,85,Iran,IR,IRN,82913893,Asia,514,11364,19
2020-03-15T00:00:00Z,15,3,2020,1365,97,Iran,IR,IRN,82913893,Asia,611,12729,20
2020-03-16T00:00:00Z,16,3,2020,1209,113,Iran,IR,IRN,82913893,Asia,724,13938,21
2020-03-17T00:00:00Z,17,3,2020,1053,129,Iran,IR,IRN,82913893,Asia,853,14991,22
2020-03-18T00:00:00Z,18,3,2020,1178,135,Iran,IR,IRN,82913893,Asia,988,16169,23
2020-03-19T00:00:00Z,19,3,2020,1192,147,Iran,IR,IRN,82913893,Asia,1135,17361,24
2020-03-20T00:00:00Z,20,3,2020,1046,149,Iran,IR,IRN,82913893,Asia,1284,18407,25
2020-03-21T00:00:00Z,21,3,2020,1237,149,Iran,IR,IRN,82913893,Asia,1433,19644,26
2020-03-22T00:00:00Z,22,3,2020,966,123,Iran,IR,IRN,82913893,Asia,1556,20610,27
2020-03-23T00:00:00Z,23,3,2020,1028,129,Iran,IR,IRN,82913893,Asia,1685,21638,28
2020-03-24T00:00:00Z,24,3,2020,1411,127,Iran,IR,IRN,82913893,Asia,1812,23049,29
2020-03-25T00:00:00Z,25,3,2020,1762,122,Iran,IR,IRN,82913893,Asia,1934,24811,30
2020-03-26T00:00:00Z,26,3,2020,2206,143,Iran,IR,IRN,82913893,Asia,2077,27017,31
2020-03-27T00:00:00Z,27,3,2020,2389,157,Iran,IR,IRN,82913893,Asia,2234,29406,32
2020-03-28T00:00:00Z,28,3,2020,2926,144,Iran,IR,IRN,82913893,Asia,2378,32332,33
2020-03-29T00:00:00Z,29,3,2020,3076,139,Iran,IR,IRN,82913893,Asia,2517,35408,34
2020-03-30T00:00:00Z,30,3,2020,2901,123,Iran,IR,IRN,82913893,Asia,2640,38309,35
2020-03-31T00:00:00Z,31,3,2020,3186,117,Iran,IR,IRN,82913893,Asia,2757,41495,36
2020-04-01T00:00:00Z,1,4,2020,3111,141,Iran,IR,IRN,82913893,Asia,2898,44606,37
2020-04-02T00:00:00Z,2,4,2020,2987,138,Iran,IR,IRN,82913893,Asia,3036,47593,38
2020-04-03T00:00:00Z,3,4,2020,2875,124,Iran,IR,IRN,82913893,Asia,3160,50468,39
2020-04-04T00:00:00Z,4,4,2020,0,0,Iran,IR,IRN,82913893,Asia,3160,50468,40
2020-04-05T00:00:00Z,5,4,2020,5275,292,Iran,IR,IRN,82913893,Asia,3452,55743,41
2020-04-06T00:00:00Z,6,4,2020,2483,151,Iran,IR,IRN,82913893,Asia,3603,58226,42
2020-04-07T00:00:00Z,7,4,2020,2274,136,Iran,IR,IRN,82913893,Asia,3739,60500,43
2020-04-08T00:00:00Z,8,4,2020,2089,133,Iran,IR,IRN,82913893,Asia,3872,62589,44
2020-04-09T00:00:00Z,9,4,2020,1997,121,Iran,IR,IRN,82913893,Asia,3993,64586,45
2020-04-10T00:00:00Z,10,4,2020,1634,117,Iran,IR,IRN,82913893,Asia,4110,66220,46
2020-04-11T00:00:00Z,11,4,2020,1972,122,Iran,IR,IRN,82913893,Asia,4232,68192,47
2020-04-12T00:00:00Z,12,4,2020,1837,125,Iran,IR,IRN,82913893,Asia,4357,70029,48
2020-04-13T00:00:00Z,13,4,2020,1657,117,Iran,IR,IRN,82913893,Asia,4474,71686,49
2020-04-14T00:00:00Z,14,4,2020,1617,111,Iran,IR,IRN,82913893,Asia,4585,73303,50
2020-04-15T00:00:00Z,15,4,2020,1574,98,Iran,IR,IRN,82913893,Asia,4683,74877,51
2020-04-16T00:00:00Z,16,4,2020,1512,94,Iran,IR,IRN,82913893,Asia,4777,76389,52
2020-04-17T00:00:00Z,17,4,2020,1606,92,Iran,IR,IRN,82913893,Asia,4869,77995,53
2020-04-18T00:00:00Z,18,4,2020,1499,89,Iran,IR,IRN,82913893,Asia,4958,79494,54
2020-04-19T00:00:00Z,19,4,2020,1374,73,Iran,IR,IRN,82913893,Asia,5031,80868,55
2020-04-20T00:00:00Z,20,4,2020,1343,87,Iran,IR,IRN,82913893,Asia,5118,82211,56
2020-04-21T00:00:00Z,21,4,2020,1294,91,Iran,IR,IRN,82913893,Asia,5209,83505,57
2020-04-22T00:00:00Z,22,4,2020,1297,88,Iran,IR,IRN,82913893,Asia,5297,84802,58
2020-04-23T00:00:00Z,23,4,2020,1194,94,Iran,IR,IRN,82913893,Asia,5391,85996,59
2020-04-24T00:00:00Z,24,4,2020,1030,90,Iran,IR,IRN,82913893,Asia,5481,87026,60
2020-04-25T00:00:00Z,25,4,2020,1168,93,Iran,IR,IRN,82913893,Asia,5574,88194,61
2020-04-26T00:00:00Z,26,4,2020,1134,76,Iran,IR,IRN,82913893,Asia,5650,89328,62
2020-04-27T00:00:00Z,27,4,2020,1153,60,Iran,IR,IRN,82913893,Asia,5710,90481,63
2020-04-28T00:00:00Z,28,4,2020,991,96,Iran,IR,IRN,82913893,Asia,5806,91472,64
2020-04-29T00:00:00Z,29,4,2020,1112,71,Iran,IR,IRN,82913893,Asia,5877,92584,65
2020-04-30T00:00:00Z,30,4,2020,1073,80,Iran,IR,IRN,82913893,Asia,5957,93657,66
2020-05-01T00:00:00Z,1,5,2020,983,71,Iran,IR,IRN,82913893,Asia,6028,94640,67
2020-05-02T00:00:00Z,2,5,2020,1006,63,Iran,IR,IRN,82913893,Asia,6091,95646,68
2020-05-03T00:00:00Z,3,5,2020,802,65,Iran,IR,IRN,82913893,Asia,6156,96448,69
2020-05-04T00:00:00Z,4,5,2020,976,47,Iran,IR,IRN,82913893,Asia,6203,97424,70
2020-05-05T00:00:00Z,5,5,2020,1223,74,Iran,IR,IRN,82913893,Asia,6277,98647,71
2020-05-06T00:00:00Z,6,5,2020,1323,63,Iran,IR,IRN,82913893,Asia,6340,99970,72
2020-05-07T00:00:00Z,7,5,2020,1680,78,Iran,IR,IRN,82913893,Asia,6418,101650,73
2020-05-08T00:00:00Z,8,5,2020,1485,68,Iran,IR,IRN,82913893,Asia,6486,103135,74
2020-05-09T00:00:00Z,9,5,2020,1556,55,Iran,IR,IRN,82913893,Asia,6541,104691,75
2020-05-10T00:00:00Z,10,5,2020,1529,48,Iran,IR,IRN,82913893,Asia,6589,106220,76
2020-05-11T00:00:00Z,11,5,2020,1383,51,Iran,IR,IRN,82913893,Asia,6640,107603,77
2020-05-12T00:00:00Z,12,5,2020,1683,45,Iran,IR,IRN,82913893,Asia,6685,109286,78
2020-05-13T00:00:00Z,13,5,2020,1481,48,Iran,IR,IRN,82913893,Asia,6733,110767,79
2020-05-14T00:00:00Z,14,5,2020,1958,50,Iran,IR,IRN,82913893,Asia,6783,112725,80
2020-05-15T00:00:00Z,15,5,2020,1808,71,Iran,IR,IRN,82913893,Asia,6854,114533,81
2020-05-16T00:00:00Z,16,5,2020,2102,48,Iran,IR,IRN,82913893,Asia,6902,116635,82
2020-05-17T00:00:00Z,17,5,2020,1757,35,Iran,IR,IRN,82913893,Asia,6937,118392,83
2020-05-18T00:00:00Z,18,5,2020,1806,51,Iran,IR,IRN,82913893,Asia,6988,120198,84
2020-05-19T00:00:00Z,19,5,2020,2294,69,Iran,IR,IRN,82913893,Asia,7057,122492,85
2020-05-20T00:00:00Z,20,5,2020,2111,62,Iran,IR,IRN,82913893,Asia,7119,124603,86
2020-05-21T00:00:00Z,21,5,2020,2346,64,Iran,IR,IRN,82913893,Asia,7183,126949,87
2020-05-22T00:00:00Z,22,5,2020,2392,66,Iran,IR,IRN,82913893,Asia,7249,129341,88
2020-05-23T00:00:00Z,23,5,2020,2311,51,Iran,IR,IRN,82913893,Asia,7300,131652,89
2020-05-24T00:00:00Z,24,5,2020,1869,59,Iran,IR,IRN,82913893,Asia,7359,133521,90
2020-05-25T00:00:00Z,25,5,2020,2180,58,Iran,IR,IRN,82913893,Asia,7417,135701,91
2020-05-26T00:00:00Z,26,5,2020,2023,34,Iran,IR,IRN,82913893,Asia,7451,137724,92
2020-05-27T00:00:00Z,27,5,2020,1787,57,Iran,IR,IRN,82913893,Asia,7508,139511,93
2020-05-28T00:00:00Z,28,5,2020,2080,56,Iran,IR,IRN,82913893,Asia,7564,141591,94
2020-05-29T00:00:00Z,29,5,2020,2258,63,Iran,IR,IRN,82913893,Asia,7627,143849,95
2020-05-30T00:00:00Z,30,5,2020,2819,50,Iran,IR,IRN,82913893,Asia,7677,146668,96
2020-05-31T00:00:00Z,31,5,2020,2282,57,Iran,IR,IRN,82913893,Asia,7734,148950,97
2020-06-01T00:00:00Z,1,6,2020,2516,63,Iran,IR,IRN,82913893,Asia,7797,151466,98
2020-06-02T00:00:00Z,2,6,2020,2979,81,Iran,IR,IRN,82913893,Asia,7878,154445,99
2020-06-03T00:00:00Z,3,6,2020,3117,64,Iran,IR,IRN,82913893,Asia,7942,157562,100
2020-06-04T00:00:00Z,4,6,2020,3134,70,Iran,IR,IRN,82913893,Asia,8012,160696,101
2020-06-05T00:00:00Z,5,6,2020,3574,59,Iran,IR,IRN,82913893,Asia,8071,164270,102
2020-06-06T00:00:00Z,6,6,2020,2886,63,Iran,IR,IRN,82913893,Asia,8134,167156,103
2020-06-07T00:00:00Z,7,6,2020,2269,75,Iran,IR,IRN,82913893,Asia,8209,169425,104
2020-06-08T00:00:00Z,8,6,2020,2364,72,Iran,IR,IRN,82913893,Asia,8281,171789,105
2020-06-09T00:00:00Z,9,6,2020,2043,70,Iran,IR,IRN,82913893,Asia,8351,173832,106
2020-06-10T00:00:00Z,10,6,2020,2095,74,Iran,IR,IRN,82913893,Asia,8425,175927,107
2020-06-11T00:00:00Z,11,6,2020,2011,81,Iran,IR,IRN,82913893,Asia,8506,177938,108
2020-06-12T00:00:00Z,12,6,2020,2238,78,Iran,IR,IRN,82913893,Asia,8584,180176,109
2020-06-13T00:00:00Z,13,6,2020,2369,75,Iran,IR,IRN,82913893,Asia,8659,182545,110
2020-06-14T00:00:00Z,14,6,2020,2410,71,Iran,IR,IRN,82913893,Asia,8730,184955,111
2020-06-15T00:00:00Z,15,6,2020,2472,107,Iran,IR,IRN,82913893,Asia,8837,187427,112
2020-06-16T00:00:00Z,16,6,2020,2449,113,Iran,IR,IRN,82913893,Asia,8950,189876,113
2020-06-17T00:00:00Z,17,6,2020,2563,115,Iran,IR,IRN,82913893,Asia,9065,192439,114
2020-06-18T00:00:00Z,18,6,2020,2612,120,Iran,IR,IRN,82913893,Asia,9185,195051,115
2020-06-19T00:00:00Z,19,6,2020,2596,87,Iran,IR,IRN,82913893,Asia,9272,197647,116
2020-06-20T00:00:00Z,20,6,2020,2615,120,Iran,IR,IRN,82913893,Asia,9392,200262,117
2020-06-21T00:00:00Z,21,6,2020,2322,115,Iran,IR,IRN,82913893,Asia,9507,202584,118
2020-06-22T00:00:00Z,22,6,2020,2368,116,Iran,IR,IRN,82913893,Asia,9623,204952,119
2020-06-23T00:00:00Z,23,6,2020,2573,119,Iran,IR,IRN,82913893,Asia,9742,207525,120
2020-06-24T00:00:00Z,24,6,2020,2445,121,Iran,IR,IRN,82913893,Asia,9863,209970,121
2020-06-25T00:00:00Z,25,6,2020,2531,133,Iran,IR,IRN,82913893,Asia,9996,212501,122
2020-03-18T00:00:00Z,18,3,2020,30,2,Iraq,IQ,IRQ,39309789,Asia,11,154,1
2020-03-19T00:00:00Z,19,3,2020,10,1,Iraq,IQ,IRQ,39309789,Asia,12,164,2
2020-03-20T00:00:00Z,20,3,2020,13,0,Iraq,IQ,IRQ,39309789,Asia,12,177,3
2020-03-21T00:00:00Z,21,3,2020,16,2,Iraq,IQ,IRQ,39309789,Asia,14,193,4
2020-03-22T00:00:00Z,22,3,2020,21,3,Iraq,IQ,IRQ,39309789,Asia,17,214,5
2020-03-23T00:00:00Z,23,3,2020,19,3,Iraq,IQ,IRQ,39309789,Asia,20,233,6
2020-03-24T00:00:00Z,24,3,2020,33,3,Iraq,IQ,IRQ,39309789,Asia,23,266,7
2020-03-25T00:00:00Z,25,3,2020,50,4,Iraq,IQ,IRQ,39309789,Asia,27,316,8
2020-03-26T00:00:00Z,26,3,2020,30,2,Iraq,IQ,IRQ,39309789,Asia,29,346,9
2020-03-27T00:00:00Z,27,3,2020,36,7,Iraq,IQ,IRQ,39309789,Asia,36,382,10
2020-03-28T00:00:00Z,28,3,2020,76,4,Iraq,IQ,IRQ,39309789,Asia,40,458,11
2020-03-29T00:00:00Z,29,3,2020,48,2,Iraq,IQ,IRQ,39309789,Asia,42,506,12
2020-03-30T00:00:00Z,30,3,2020,41,0,Iraq,IQ,IRQ,39309789,Asia,42,547,13
2020-03-31T00:00:00Z,31,3,2020,83,4,Iraq,IQ,IRQ,39309789,Asia,46,630,14
2020-04-01T00:00:00Z,1,4,2020,64,4,Iraq,IQ,IRQ,39309789,Asia,50,694,15
2020-04-02T00:00:00Z,2,4,2020,0,0,Iraq,IQ,IRQ,39309789,Asia,50,694,16
2020-04-03T00:00:00Z,3,4,2020,78,4,Iraq,IQ,IRQ,39309789,Asia,54,772,17
2020-04-04T00:00:00Z,4,4,2020,0,0,Iraq,IQ,IRQ,39309789,Asia,54,772,18
2020-04-05T00:00:00Z,5,4,2020,106,2,Iraq,IQ,IRQ,39309789,Asia,56,878,19
2020-04-06T00:00:00Z,6,4,2020,83,5,Iraq,IQ,IRQ,39309789,Asia,61,961,20
2020-04-07T00:00:00Z,7,4,2020,70,3,Iraq,IQ,IRQ,39309789,Asia,64,1031,21
2020-04-08T00:00:00Z,8,4,2020,0,0,Iraq,IQ,IRQ,39309789,Asia,64,1031,22
2020-04-09T00:00:00Z,9,4,2020,171,5,Iraq,IQ,IRQ,39309789,Asia,69,1202,23
2020-04-10T00:00:00Z,10,4,2020,30,0,Iraq,IQ,IRQ,39309789,Asia,69,1232,24
2020-04-11T00:00:00Z,11,4,2020,47,1,Iraq,IQ,IRQ,39309789,Asia,70,1279,25
2020-04-12T00:00:00Z,12,4,2020,39,2,Iraq,IQ,IRQ,39309789,Asia,72,1318,26
2020-04-13T00:00:00Z,13,4,2020,34,4,Iraq,IQ,IRQ,39309789,Asia,76,1352,27
2020-04-14T00:00:00Z,14,4,2020,26,2,Iraq,IQ,IRQ,39309789,Asia,78,1378,28
2020-04-15T00:00:00Z,15,4,2020,22,0,Iraq,IQ,IRQ,39309789,Asia,78,1400,29
2020-04-16T00:00:00Z,16,4,2020,15,1,Iraq,IQ,IRQ,39309789,Asia,79,1415,30
2020-04-17T00:00:00Z,17,4,2020,19,1,Iraq,IQ,IRQ,39309789,Asia,80,1434,31
2020-04-18T00:00:00Z,18,4,2020,48,1,Iraq,IQ,IRQ,39309789,Asia,81,1482,32
2020-04-19T00:00:00Z,19,4,2020,0,0,Iraq,IQ,IRQ,39309789,Asia,81,1482,33
2020-04-20T00:00:00Z,20,4,2020,57,1,Iraq,IQ,IRQ,39309789,Asia,82,1539,34
2020-04-21T00:00:00Z,21,4,2020,35,0,Iraq,IQ,IRQ,39309789,Asia,82,1574,35
2020-04-22T00:00:00Z,22,4,2020,28,1,Iraq,IQ,IRQ,39309789,Asia,83,1602,36
2020-04-23T00:00:00Z,23,4,2020,0,0,Iraq,IQ,IRQ,39309789,Asia,83,1602,37
2020-04-24T00:00:00Z,24,4,2020,75,0,Iraq,IQ,IRQ,39309789,Asia,83,1677,38
2020-04-25T00:00:00Z,25,4,2020,31,3,Iraq,IQ,IRQ,39309789,Asia,86,1708,39
2020-04-26T00:00:00Z,26,4,2020,55,0,Iraq,IQ,IRQ,39309789,Asia,86,1763,40
2020-04-27T00:00:00Z,27,4,2020,57,1,Iraq,IQ,IRQ,39309789,Asia,87,1820,41
2020-04-28T00:00:00Z,28,4,2020,27,1,Iraq,IQ,IRQ,39309789,Asia,88,1847,42
2020-04-29T00:00:00Z,29,4,2020,0,0,Iraq,IQ,IRQ,39309789,Asia,88,1847,43
2020-04-30T00:00:00Z,30,4,2020,156,4,Iraq,IQ,IRQ,39309789,Asia,92,2003,44
2020-05-01T00:00:00Z,1,5,2020,82,1,Iraq,IQ,IRQ,39309789,Asia,93,2085,45
2020-05-02T00:00:00Z,2,5,2020,68,1,Iraq,IQ,IRQ,39309789,Asia,94,2153,46
2020-05-03T00:00:00Z,3,5,2020,66,1,Iraq,IQ,IRQ,39309789,Asia,95,2219,47
2020-05-04T00:00:00Z,4,5,2020,77,2,Iraq,IQ,IRQ,39309789,Asia,97,2296,48
2020-05-05T00:00:00Z,5,5,2020,50,1,Iraq,IQ,IRQ,39309789,Asia,98,2346,49
2020-05-06T00:00:00Z,6,5,2020,85,4,Iraq,IQ,IRQ,39309789,Asia,102,2431,50
2020-05-07T00:00:00Z,7,5,2020,49,0,Iraq,IQ,IRQ,39309789,Asia,102,2480,51
2020-05-08T00:00:00Z,8,5,2020,63,0,Iraq,IQ,IRQ,39309789,Asia,102,2543,52
2020-05-09T00:00:00Z,9,5,2020,60,2,Iraq,IQ,IRQ,39309789,Asia,104,2603,53
2020-05-10T00:00:00Z,10,5,2020,76,3,Iraq,IQ,IRQ,39309789,Asia,107,2679,54
2020-05-11T00:00:00Z,11,5,2020,88,2,Iraq,IQ,IRQ,39309789,Asia,109,2767,55
2020-05-12T00:00:00Z,12,5,2020,51,1,Iraq,IQ,IRQ,39309789,Asia,110,2818,56
2020-05-13T00:00:00Z,13,5,2020,95,2,Iraq,IQ,IRQ,39309789,Asia,112,2913,57
2020-05-14T00:00:00Z,14,5,2020,119,3,Iraq,IQ,IRQ,39309789,Asia,115,3032,58
2020-05-15T00:00:00Z,15,5,2020,111,0,Iraq,IQ,IRQ,39309789,Asia,115,3143,59
2020-05-16T00:00:00Z,16,5,2020,50,2,Iraq,IQ,IRQ,39309789,Asia,117,3193,60
2020-05-17T00:00:00Z,17,5,2020,67,4,Iraq,IQ,IRQ,39309789,Asia,121,3260,61
2020-05-18T00:00:00Z,18,5,2020,144,2,Iraq,IQ,IRQ,39309789,Asia,123,3404,62
2020-05-19T00:00:00Z,19,5,2020,150,4,Iraq,IQ,IRQ,39309789,Asia,127,3554,63
2020-05-20T00:00:00Z,20,5,2020,57,4,Iraq,IQ,IRQ,39309789,Asia,131,3611,64
2020-05-21T00:00:00Z,21,5,2020,113,3,Iraq,IQ,IRQ,39309789,Asia,134,3724,65
2020-05-22T00:00:00Z,22,5,2020,153,6,Iraq,IQ,IRQ,39309789,Asia,140,3877,66
2020-05-23T00:00:00Z,23,5,2020,87,7,Iraq,IQ,IRQ,39309789,Asia,147,3964,67
2020-05-24T00:00:00Z,24,5,2020,308,5,Iraq,IQ,IRQ,39309789,Asia,152,4272,68
2020-05-25T00:00:00Z,25,5,2020,197,8,Iraq,IQ,IRQ,39309789,Asia,160,4469,69
2020-05-26T00:00:00Z,26,5,2020,163,3,Iraq,IQ,IRQ,39309789,Asia,163,4632,70
2020-05-27T00:00:00Z,27,5,2020,216,6,Iraq,IQ,IRQ,39309789,Asia,169,4848,71
2020-05-28T00:00:00Z,28,5,2020,287,6,Iraq,IQ,IRQ,39309789,Asia,175,5135,72
2020-05-29T00:00:00Z,29,5,2020,322,4,Iraq,IQ,IRQ,39309789,Asia,179,5457,73
2020-05-30T00:00:00Z,30,5,2020,416,6,Iraq,IQ,IRQ,39309789,Asia,185,5873,74
2020-05-31T00:00:00Z,31,5,2020,306,10,Iraq,IQ,IRQ,39309789,Asia,195,6179,75
2020-06-01T00:00:00Z,1,6,2020,260,10,Iraq,IQ,IRQ,39309789,Asia,205,6439,76
2020-06-02T00:00:00Z,2,6,2020,429,10,Iraq,IQ,IRQ,39309789,Asia,215,6868,77
2020-06-03T00:00:00Z,3,6,2020,519,20,Iraq,IQ,IRQ,39309789,Asia,235,7387,78
2020-06-04T00:00:00Z,4,6,2020,781,21,Iraq,IQ,IRQ,39309789,Asia,256,8168,79
2020-06-05T00:00:00Z,5,6,2020,672,15,Iraq,IQ,IRQ,39309789,Asia,271,8840,80
2020-06-06T00:00:00Z,6,6,2020,1006,14,Iraq,IQ,IRQ,39309789,Asia,285,9846,81
2020-06-07T00:00:00Z,7,6,2020,1252,33,Iraq,IQ,IRQ,39309789,Asia,318,11098,82
2020-06-08T00:00:00Z,8,6,2020,1268,28,Iraq,IQ,IRQ,39309789,Asia,346,12366,83
2020-06-09T00:00:00Z,9,6,2020,1115,24,Iraq,IQ,IRQ,39309789,Asia,370,13481,84
2020-06-10T00:00:00Z,10,6,2020,787,22,Iraq,IQ,IRQ,39309789,Asia,392,14268,85
2020-06-11T00:00:00Z,11,6,2020,1146,34,Iraq,IQ,IRQ,39309789,Asia,426,15414,86
2020-06-12T00:00:00Z,12,6,2020,1261,31,Iraq,IQ,IRQ,39309789,Asia,457,16675,87
2020-06-13T00:00:00Z,13,6,2020,1095,39,Iraq,IQ,IRQ,39309789,Asia,496,17770,88
2020-06-14T00:00:00Z,14,6,2020,1180,53,Iraq,IQ,IRQ,39309789,Asia,549,18950,89
2020-06-15T00:00:00Z,15,6,2020,1259,58,Iraq,IQ,IRQ,39309789,Asia,607,20209,90
2020-06-16T00:00:00Z,16,6,2020,1106,45,Iraq,IQ,IRQ,39309789,Asia,652,21315,91
2020-06-17T00:00:00Z,17,6,2020,1385,60,Iraq,IQ,IRQ,39309789,Asia,712,22700,92
2020-06-18T00:00:00Z,18,6,2020,1554,61,Iraq,IQ,IRQ,39309789,Asia,773,24254,93
2020-06-19T00:00:00Z,19,6,2020,1463,83,Iraq,IQ,IRQ,39309789,Asia,856,25717,94
2020-06-20T00:00:00Z,20,6,2020,0,0,Iraq,IQ,IRQ,39309789,Asia,856,25717,95
2020-06-21T00:00:00Z,21,6,2020,3505,157,Iraq,IQ,IRQ,39309789,Asia,1013,29222,96
2020-06-22T00:00:00Z,22,6,2020,1646,87,Iraq,IQ,IRQ,39309789,Asia,1100,30868,97
2020-06-23T00:00:00Z,23,6,2020,1808,67,Iraq,IQ,IRQ,39309789,Asia,1167,32676,98
2020-06-24T00:00:00Z,24,6,2020,1826,84,Iraq,IQ,IRQ,39309789,Asia,1251,34502,99
2020-06-25T00:00:00Z,25,6,2020,2200,79,Iraq,IQ,IRQ,39309789,Asia,1330,36702,100
2020-03-27T00:00:00Z,27,3,2020,255,10,Ireland,IE,IRL,4904240,Europe,19,1819,1
2020-03-28T00:00:00Z,28,3,2020,302,3,Ireland,IE,IRL,4904240,Europe,22,2121,2
2020-03-29T00:00:00Z,29,3,2020,294,14,Ireland,IE,IRL,4904240,Europe,36,2415,3
2020-03-30T00:00:00Z,30,3,2020,200,10,Ireland,IE,IRL,4904240,Europe,46,2615,4
2020-03-31T00:00:00Z,31,3,2020,295,8,Ireland,IE,IRL,4904240,Europe,54,2910,5
2020-04-01T00:00:00Z,1,4,2020,325,17,Ireland,IE,IRL,4904240,Europe,71,3235,6
2020-04-02T00:00:00Z,2,4,2020,212,14,Ireland,IE,IRL,4904240,Europe,85,3447,7
2020-04-03T00:00:00Z,3,4,2020,402,13,Ireland,IE,IRL,4904240,Europe,98,3849,8
2020-04-04T00:00:00Z,4,4,2020,424,22,Ireland,IE,IRL,4904240,Europe,120,4273,9
2020-04-05T00:00:00Z,5,4,2020,331,17,Ireland,IE,IRL,4904240,Europe,137,4604,10
2020-04-06T00:00:00Z,6,4,2020,507,21,Ireland,IE,IRL,4904240,Europe,158,5111,11
2020-04-07T00:00:00Z,7,4,2020,253,16,Ireland,IE,IRL,4904240,Europe,174,5364,12
2020-04-08T00:00:00Z,8,4,2020,345,36,Ireland,IE,IRL,4904240,Europe,210,5709,13
2020-04-09T00:00:00Z,9,4,2020,515,25,Ireland,IE,IRL,4904240,Europe,235,6224,14
2020-04-10T00:00:00Z,10,4,2020,1169,28,Ireland,IE,IRL,4904240,Europe,263,7393,15
2020-04-11T00:00:00Z,11,4,2020,696,24,Ireland,IE,IRL,4904240,Europe,287,8089,16
2020-04-12T00:00:00Z,12,4,2020,839,33,Ireland,IE,IRL,4904240,Europe,320,8928,17
2020-04-13T00:00:00Z,13,4,2020,727,14,Ireland,IE,IRL,4904240,Europe,334,9655,18
2020-04-14T00:00:00Z,14,4,2020,992,31,Ireland,IE,IRL,4904240,Europe,365,10647,19
2020-04-15T00:00:00Z,15,4,2020,832,41,Ireland,IE,IRL,4904240,Europe,406,11479,20
2020-04-16T00:00:00Z,16,4,2020,1068,38,Ireland,IE,IRL,4904240,Europe,444,12547,21
2020-04-17T00:00:00Z,17,4,2020,724,42,Ireland,IE,IRL,4904240,Europe,486,13271,22
2020-04-18T00:00:00Z,18,4,2020,709,44,Ireland,IE,IRL,4904240,Europe,530,13980,23
2020-04-19T00:00:00Z,19,4,2020,778,41,Ireland,IE,IRL,4904240,Europe,571,14758,24
2020-04-20T00:00:00Z,20,4,2020,493,39,Ireland,IE,IRL,4904240,Europe,610,15251,25
2020-04-21T00:00:00Z,21,4,2020,401,77,Ireland,IE,IRL,4904240,Europe,687,15652,26
2020-04-22T00:00:00Z,22,4,2020,388,43,Ireland,IE,IRL,4904240,Europe,730,16040,27
2020-04-23T00:00:00Z,23,4,2020,631,39,Ireland,IE,IRL,4904240,Europe,769,16671,28
2020-04-24T00:00:00Z,24,4,2020,936,25,Ireland,IE,IRL,4904240,Europe,794,17607,29
2020-04-25T00:00:00Z,25,4,2020,577,35,Ireland,IE,IRL,4904240,Europe,829,18184,30
2020-04-26T00:00:00Z,26,4,2020,377,234,Ireland,IE,IRL,4904240,Europe,1063,18561,31
2020-04-27T00:00:00Z,27,4,2020,701,24,Ireland,IE,IRL,4904240,Europe,1087,19262,32
2020-04-28T00:00:00Z,28,4,2020,386,15,Ireland,IE,IRL,4904240,Europe,1102,19648,33
2020-04-29T00:00:00Z,29,4,2020,229,57,Ireland,IE,IRL,4904240,Europe,1159,19877,34
2020-04-30T00:00:00Z,30,4,2020,376,31,Ireland,IE,IRL,4904240,Europe,1190,20253,35
2020-05-01T00:00:00Z,1,5,2020,359,42,Ireland,IE,IRL,4904240,Europe,1232,20612,36
2020-05-02T00:00:00Z,2,5,2020,221,33,Ireland,IE,IRL,4904240,Europe,1265,20833,37
2020-05-03T00:00:00Z,3,5,2020,343,0,Ireland,IE,IRL,4904240,Europe,1265,21176,38
2020-05-04T00:00:00Z,4,5,2020,330,38,Ireland,IE,IRL,4904240,Europe,1303,21506,39
2020-05-05T00:00:00Z,5,5,2020,216,16,Ireland,IE,IRL,4904240,Europe,1319,21722,40
2020-05-06T00:00:00Z,6,5,2020,261,20,Ireland,IE,IRL,4904240,Europe,1339,21983,41
2020-05-07T00:00:00Z,7,5,2020,265,36,Ireland,IE,IRL,4904240,Europe,1375,22248,42
2020-05-08T00:00:00Z,8,5,2020,137,28,Ireland,IE,IRL,4904240,Europe,1403,22385,43
2020-05-09T00:00:00Z,9,5,2020,156,26,Ireland,IE,IRL,4904240,Europe,1429,22541,44
2020-05-10T00:00:00Z,10,5,2020,219,17,Ireland,IE,IRL,4904240,Europe,1446,22760,45
2020-05-11T00:00:00Z,11,5,2020,236,12,Ireland,IE,IRL,4904240,Europe,1458,22996,46
2020-05-12T00:00:00Z,12,5,2020,139,9,Ireland,IE,IRL,4904240,Europe,1467,23135,47
2020-05-13T00:00:00Z,13,5,2020,107,21,Ireland,IE,IRL,4904240,Europe,1488,23242,48
2020-05-14T00:00:00Z,14,5,2020,159,9,Ireland,IE,IRL,4904240,Europe,1497,23401,49
2020-05-15T00:00:00Z,15,5,2020,426,9,Ireland,IE,IRL,4904240,Europe,1506,23827,50
2020-05-16T00:00:00Z,16,5,2020,129,12,Ireland,IE,IRL,4904240,Europe,1518,23956,51
2020-05-17T00:00:00Z,17,5,2020,92,15,Ireland,IE,IRL,4904240,Europe,1533,24048,52
2020-05-18T00:00:00Z,18,5,2020,64,10,Ireland,IE,IRL,4904240,Europe,1543,24112,53
2020-05-19T00:00:00Z,19,5,2020,88,4,Ireland,IE,IRL,4904240,Europe,1547,24200,54
2020-05-20T00:00:00Z,20,5,2020,51,14,Ireland,IE,IRL,4904240,Europe,1561,24251,55
2020-05-21T00:00:00Z,21,5,2020,64,10,Ireland,IE,IRL,4904240,Europe,1571,24315,56
2020-05-22T00:00:00Z,22,5,2020,76,12,Ireland,IE,IRL,4904240,Europe,1583,24391,57
2020-05-23T00:00:00Z,23,5,2020,115,9,Ireland,IE,IRL,4904240,Europe,1592,24506,58
2020-05-24T00:00:00Z,24,5,2020,76,12,Ireland,IE,IRL,4904240,Europe,1604,24582,59
2020-05-25T00:00:00Z,25,5,2020,57,2,Ireland,IE,IRL,4904240,Europe,1606,24639,60
2020-05-26T00:00:00Z,26,5,2020,59,0,Ireland,IE,IRL,4904240,Europe,1606,24698,61
2020-05-27T00:00:00Z,27,5,2020,37,9,Ireland,IE,IRL,4904240,Europe,1615,24735,62
2020-05-28T00:00:00Z,28,5,2020,68,16,Ireland,IE,IRL,4904240,Europe,1631,24803,63
2020-05-29T00:00:00Z,29,5,2020,38,8,Ireland,IE,IRL,4904240,Europe,1639,24841,64
2020-05-30T00:00:00Z,30,5,2020,35,6,Ireland,IE,IRL,4904240,Europe,1645,24876,65
2020-05-31T00:00:00Z,31,5,2020,53,5,Ireland,IE,IRL,4904240,Europe,1650,24929,66
2020-06-01T00:00:00Z,1,6,2020,61,0,Ireland,IE,IRL,4904240,Europe,1650,24990,67
2020-06-02T00:00:00Z,2,6,2020,72,0,Ireland,IE,IRL,4904240,Europe,1650,25062,68
2020-06-03T00:00:00Z,3,6,2020,4,8,Ireland,IE,IRL,4904240,Europe,1658,25066,69
2020-06-04T00:00:00Z,4,6,2020,45,1,Ireland,IE,IRL,4904240,Europe,1659,25111,70
2020-06-05T00:00:00Z,5,6,2020,31,5,Ireland,IE,IRL,4904240,Europe,1664,25142,71
2020-06-06T00:00:00Z,6,6,2020,21,6,Ireland,IE,IRL,4904240,Europe,1670,25163,72
2020-06-07T00:00:00Z,7,6,2020,20,0,Ireland,IE,IRL,4904240,Europe,1670,25183,73
2020-06-08T00:00:00Z,8,6,2020,18,9,Ireland,IE,IRL,4904240,Europe,1679,25201,74
2020-06-09T00:00:00Z,9,6,2020,6,4,Ireland,IE,IRL,4904240,Europe,1683,25207,75
2020-06-10T00:00:00Z,10,6,2020,8,8,Ireland,IE,IRL,4904240,Europe,1691,25215,76
2020-06-11T00:00:00Z,11,6,2020,16,4,Ireland,IE,IRL,4904240,Europe,1695,25231,77
2020-06-12T00:00:00Z,12,6,2020,7,8,Ireland,IE,IRL,4904240,Europe,1703,25238,78
2020-06-13T00:00:00Z,13,6,2020,12,2,Ireland,IE,IRL,4904240,Europe,1705,25250,79
2020-06-14T00:00:00Z,14,6,2020,45,0,Ireland,IE,IRL,4904240,Europe,1705,25295,80
2020-06-15T00:00:00Z,15,6,2020,8,1,Ireland,IE,IRL,4904240,Europe,1706,25303,81
2020-06-16T00:00:00Z,16,6,2020,18,0,Ireland,IE,IRL,4904240,Europe,1706,25321,82
2020-06-17T00:00:00Z,17,6,2020,13,3,Ireland,IE,IRL,4904240,Europe,1709,25334,83
2020-06-18T00:00:00Z,18,6,2020,7,1,Ireland,IE,IRL,4904240,Europe,1710,25341,84
2020-06-19T00:00:00Z,19,6,2020,14,4,Ireland,IE,IRL,4904240,Europe,1714,25355,85
2020-06-20T00:00:00Z,20,6,2020,13,0,Ireland,IE,IRL,4904240,Europe,1714,25368,86
2020-06-21T00:00:00Z,21,6,2020,6,1,Ireland,IE,IRL,4904240,Europe,1715,25374,87
2020-06-22T00:00:00Z,22,6,2020,5,0,Ireland,IE,IRL,4904240,Europe,1715,25379,88
2020-06-23T00:00:00Z,23,6,2020,4,2,Ireland,IE,IRL,4904240,Europe,1717,25383,89
2020-06-24T00:00:00Z,24,6,2020,8,3,Ireland,IE,IRL,4904240,Europe,1720,25391,90
2020-06-25T00:00:00Z,25,6,2020,5,6,Ireland,IE,IRL,4904240,Europe,1726,25396,91
2020-04-22T00:00:00Z,22,4,2020,7,1,Isle_of_Man,IM,IMN,84589,Europe,10,307,1
2020-04-23T00:00:00Z,23,4,2020,0,5,Isle_of_Man,IM,IMN,84589,Europe,15,307,2
2020-04-24T00:00:00Z,24,4,2020,0,1,Isle_of_Man,IM,IMN,84589,Europe,16,307,3
2020-04-25T00:00:00Z,25,4,2020,1,2,Isle_of_Man,IM,IMN,84589,Europe,18,308,4
2020-04-26T00:00:00Z,26,4,2020,0,0,Isle_of_Man,IM,IMN,84589,Europe,18,308,5
2020-04-27T00:00:00Z,27,4,2020,0,0,Isle_of_Man,IM,IMN,84589,Europe,18,308,6
2020-04-28T00:00:00Z,28,4,2020,0,0,Isle_of_Man,IM,IMN,84589,Europe,18,308,7
2020-04-29T00:00:00Z,29,4,2020,1,3,Isle_of_Man,IM,IMN,84589,Europe,21,309,8
2020-04-30T00:00:00Z,30,4,2020,4,0,Isle_of_Man,IM,IMN,84589,Europe,21,313,9
2020-05-01T00:00:00Z,1,5,2020,2,0,Isle_of_Man,IM,IMN,84589,Europe,21,315,10
2020-05-02T00:00:00Z,2,5,2020,1,1,Isle_of_Man,IM,IMN,84589,Europe,22,316,11
2020-05-03T00:00:00Z,3,5,2020,4,0,Isle_of_Man,IM,IMN,84589,Europe,22,320,12
2020-05-04T00:00:00Z,4,5,2020,1,0,Isle_of_Man,IM,IMN,84589,Europe,22,321,13
2020-05-05T00:00:00Z,5,5,2020,4,1,Isle_of_Man,IM,IMN,84589,Europe,23,325,14
2020-05-06T00:00:00Z,6,5,2020,1,0,Isle_of_Man,IM,IMN,84589,Europe,23,326,15
2020-05-07T00:00:00Z,7,5,2020,1,0,Isle_of_Man,IM,IMN,84589,Europe,23,327,16
2020-05-08T00:00:00Z,8,5,2020,2,0,Isle_of_Man,IM,IMN,84589,Europe,23,329,17
2020-05-09T00:00:00Z,9,5,2020,0,0,Isle_of_Man,IM,IMN,84589,Europe,23,329,18
2020-05-10T00:00:00Z,10,5,2020,1,0,Isle_of_Man,IM,IMN,84589,Europe,23,330,19
2020-05-11T00:00:00Z,11,5,2020,0,0,Isle_of_Man,IM,IMN,84589,Europe,23,330,20
2020-05-12T00:00:00Z,12,5,2020,0,0,Isle_of_Man,IM,IMN,84589,Europe,23,330,21
2020-05-13T00:00:00Z,13,5,2020,1,0,Isle_of_Man,IM,IMN,84589,Europe,23,331,22
2020-05-14T00:00:00Z,14,5,2020,1,0,Isle_of_Man,IM,IMN,84589,Europe,23,332,23
2020-05-15T00:00:00Z,15,5,2020,0,0,Isle_of_Man,IM,IMN,84589,Europe,23,332,24
2020-05-16T00:00:00Z,16,5,2020,2,1,Isle_of_Man,IM,IMN,84589,Europe,24,334,25
2020-05-17T00:00:00Z,17,5,2020,1,0,Isle_of_Man,IM,IMN,84589,Europe,24,335,26
2020-05-18T00:00:00Z,18,5,2020,0,0,Isle_of_Man,IM,IMN,84589,Europe,24,335,27
2020-05-19T00:00:00Z,19,5,2020,0,0,Isle_of_Man,IM,IMN,84589,Europe,24,335,28
2020-05-20T00:00:00Z,20,5,2020,0,0,Isle_of_Man,IM,IMN,84589,Europe,24,335,29
2020-05-21T00:00:00Z,21,5,2020,1,0,Isle_of_Man,IM,IMN,84589,Europe,24,336,30
2020-05-22T00:00:00Z,22,5,2020,0,0,Isle_of_Man,IM,IMN,84589,Europe,24,336,31
2020-05-23T00:00:00Z,23,5,2020,0,0,Isle_of_Man,IM,IMN,84589,Europe,24,336,32
2020-05-24T00:00:00Z,24,5,2020,0,0,Isle_of_Man,IM,IMN,84589,Europe,24,336,33
2020-05-25T00:00:00Z,25,5,2020,0,0,Isle_of_Man,IM,IMN,84589,Europe,24,336,34
2020-05-26T00:00:00Z,26,5,2020,0,0,Isle_of_Man,IM,IMN,84589,Europe,24,336,35
2020-05-27T00:00:00Z,27,5,2020,0,0,Isle_of_Man,IM,IMN,84589,Europe,24,336,36
2020-05-28T00:00:00Z,28,5,2020,0,0,Isle_of_Man,IM,IMN,84589,Europe,24,336,37
2020-05-29T00:00:00Z,29,5,2020,0,0,Isle_of_Man,IM,IMN,84589,Europe,24,336,38
2020-05-30T00:00:00Z,30,5,2020,0,0,Isle_of_Man,IM,IMN,84589,Europe,24,336,39
2020-05-31T00:00:00Z,31,5,2020,0,0,Isle_of_Man,IM,IMN,84589,Europe,24,336,40
2020-06-01T00:00:00Z,1,6,2020,0,0,Isle_of_Man,IM,IMN,84589,Europe,24,336,41
2020-06-02T00:00:00Z,2,6,2020,0,0,Isle_of_Man,IM,IMN,84589,Europe,24,336,42
2020-06-03T00:00:00Z,3,6,2020,0,0,Isle_of_Man,IM,IMN,84589,Europe,24,336,43
2020-06-04T00:00:00Z,4,6,2020,0,0,Isle_of_Man,IM,IMN,84589,Europe,24,336,44
2020-06-05T00:00:00Z,5,6,2020,0,0,Isle_of_Man,IM,IMN,84589,Europe,24,336,45
2020-06-06T00:00:00Z,6,6,2020,0,0,Isle_of_Man,IM,IMN,84589,Europe,24,336,46
2020-06-07T00:00:00Z,7,6,2020,0,0,Isle_of_Man,IM,IMN,84589,Europe,24,336,47
2020-06-08T00:00:00Z,8,6,2020,0,0,Isle_of_Man,IM,IMN,84589,Europe,24,336,48
2020-06-09T00:00:00Z,9,6,2020,0,0,Isle_of_Man,IM,IMN,84589,Europe,24,336,49
2020-06-10T00:00:00Z,10,6,2020,0,0,Isle_of_Man,IM,IMN,84589,Europe,24,336,50
2020-06-11T00:00:00Z,11,6,2020,0,0,Isle_of_Man,IM,IMN,84589,Europe,24,336,51
2020-06-12T00:00:00Z,12,6,2020,0,0,Isle_of_Man,IM,IMN,84589,Europe,24,336,52
2020-06-13T00:00:00Z,13,6,2020,0,0,Isle_of_Man,IM,IMN,84589,Europe,24,336,53
2020-06-14T00:00:00Z,14,6,2020,0,0,Isle_of_Man,IM,IMN,84589,Europe,24,336,54
2020-06-15T00:00:00Z,15,6,2020,0,0,Isle_of_Man,IM,IMN,84589,Europe,24,336,55
2020-06-16T00:00:00Z,16,6,2020,0,0,Isle_of_Man,IM,IMN,84589,Europe,24,336,56
2020-06-17T00:00:00Z,17,6,2020,0,0,Isle_of_Man,IM,IMN,84589,Europe,24,336,57
2020-06-18T00:00:00Z,18,6,2020,0,0,Isle_of_Man,IM,IMN,84589,Europe,24,336,58
2020-06-19T00:00:00Z,19,6,2020,0,0,Isle_of_Man,IM,IMN,84589,Europe,24,336,59
2020-06-20T00:00:00Z,20,6,2020,0,0,Isle_of_Man,IM,IMN,84589,Europe,24,336,60
2020-06-21T00:00:00Z,21,6,2020,0,0,Isle_of_Man,IM,IMN,84589,Europe,24,336,61
2020-06-22T00:00:00Z,22,6,2020,0,0,Isle_of_Man,IM,IMN,84589,Europe,24,336,62
2020-06-23T00:00:00Z,23,6,2020,0,0,Isle_of_Man,IM,IMN,84589,Europe,24,336,63
2020-06-24T00:00:00Z,24,6,2020,0,0,Isle_of_Man,IM,IMN,84589,Europe,24,336,64
2020-06-25T00:00:00Z,25,6,2020,0,0,Isle_of_Man,IM,IMN,84589,Europe,24,336,65
2020-03-28T00:00:00Z,28,3,2020,369,2,Israel,IL,ISR,8519373,Asia,10,3035,1
2020-03-29T00:00:00Z,29,3,2020,584,2,Israel,IL,ISR,8519373,Asia,12,3619,2
2020-03-30T00:00:00Z,30,3,2020,628,3,Israel,IL,ISR,8519373,Asia,15,4247,3
2020-03-31T00:00:00Z,31,3,2020,226,2,Israel,IL,ISR,8519373,Asia,17,4473,4
2020-04-01T00:00:00Z,1,4,2020,443,3,Israel,IL,ISR,8519373,Asia,20,4916,5
2020-04-02T00:00:00Z,2,4,2020,675,1,Israel,IL,ISR,8519373,Asia,21,5591,6
2020-04-03T00:00:00Z,3,4,2020,661,13,Israel,IL,ISR,8519373,Asia,34,6252,7
2020-04-04T00:00:00Z,4,4,2020,1176,5,Israel,IL,ISR,8519373,Asia,39,7428,8
2020-04-05T00:00:00Z,5,4,2020,590,7,Israel,IL,ISR,8519373,Asia,46,8018,9
2020-04-06T00:00:00Z,6,4,2020,412,3,Israel,IL,ISR,8519373,Asia,49,8430,10
2020-04-07T00:00:00Z,7,4,2020,474,8,Israel,IL,ISR,8519373,Asia,57,8904,11
2020-04-08T00:00:00Z,8,4,2020,344,8,Israel,IL,ISR,8519373,Asia,65,9248,12
2020-04-09T00:00:00Z,9,4,2020,156,6,Israel,IL,ISR,8519373,Asia,71,9404,13
2020-04-10T00:00:00Z,10,4,2020,564,15,Israel,IL,ISR,8519373,Asia,86,9968,14
2020-04-11T00:00:00Z,11,4,2020,440,9,Israel,IL,ISR,8519373,Asia,95,10408,15
2020-04-12T00:00:00Z,12,4,2020,335,6,Israel,IL,ISR,8519373,Asia,101,10743,16
2020-04-13T00:00:00Z,13,4,2020,402,2,Israel,IL,ISR,8519373,Asia,103,11145,17
2020-04-14T00:00:00Z,14,4,2020,441,13,Israel,IL,ISR,8519373,Asia,116,11586,18
2020-04-15T00:00:00Z,15,4,2020,460,7,Israel,IL,ISR,8519373,Asia,123,12046,19
2020-04-16T00:00:00Z,16,4,2020,455,7,Israel,IL,ISR,8519373,Asia,130,12501,20
2020-04-17T00:00:00Z,17,4,2020,257,12,Israel,IL,ISR,8519373,Asia,142,12758,21
2020-04-18T00:00:00Z,18,4,2020,224,9,Israel,IL,ISR,8519373,Asia,151,12982,22
2020-04-19T00:00:00Z,19,4,2020,283,13,Israel,IL,ISR,8519373,Asia,164,13265,23
2020-04-20T00:00:00Z,20,4,2020,226,8,Israel,IL,ISR,8519373,Asia,172,13491,24
2020-04-21T00:00:00Z,21,4,2020,222,5,Israel,IL,ISR,8519373,Asia,177,13713,25
2020-04-22T00:00:00Z,22,4,2020,229,7,Israel,IL,ISR,8519373,Asia,184,13942,26
2020-04-23T00:00:00Z,23,4,2020,650,7,Israel,IL,ISR,8519373,Asia,191,14592,27
2020-04-24T00:00:00Z,24,4,2020,290,2,Israel,IL,ISR,8519373,Asia,193,14882,28
2020-04-25T00:00:00Z,25,4,2020,176,1,Israel,IL,ISR,8519373,Asia,194,15058,29
2020-04-26T00:00:00Z,26,4,2020,240,5,Israel,IL,ISR,8519373,Asia,199,15298,30
2020-04-27T00:00:00Z,27,4,2020,100,0,Israel,IL,ISR,8519373,Asia,199,15398,31
2020-04-28T00:00:00Z,28,4,2020,68,3,Israel,IL,ISR,8519373,Asia,202,15466,32
2020-04-29T00:00:00Z,29,4,2020,123,6,Israel,IL,ISR,8519373,Asia,208,15589,33
2020-04-30T00:00:00Z,30,4,2020,245,7,Israel,IL,ISR,8519373,Asia,215,15834,34
2020-05-01T00:00:00Z,1,5,2020,112,7,Israel,IL,ISR,8519373,Asia,222,15946,35
2020-05-02T00:00:00Z,2,5,2020,155,3,Israel,IL,ISR,8519373,Asia,225,16101,36
2020-05-03T00:00:00Z,3,5,2020,84,4,Israel,IL,ISR,8519373,Asia,229,16185,37
2020-05-04T00:00:00Z,4,5,2020,23,3,Israel,IL,ISR,8519373,Asia,232,16208,38
2020-05-05T00:00:00Z,5,5,2020,38,3,Israel,IL,ISR,8519373,Asia,235,16246,39
2020-05-06T00:00:00Z,6,5,2020,43,3,Israel,IL,ISR,8519373,Asia,238,16289,40
2020-05-07T00:00:00Z,7,5,2020,21,1,Israel,IL,ISR,8519373,Asia,239,16310,41
2020-05-08T00:00:00Z,8,5,2020,71,1,Israel,IL,ISR,8519373,Asia,240,16381,42
2020-05-09T00:00:00Z,9,5,2020,55,5,Israel,IL,ISR,8519373,Asia,245,16436,43
2020-05-10T00:00:00Z,10,5,2020,18,2,Israel,IL,ISR,8519373,Asia,247,16454,44
2020-05-11T00:00:00Z,11,5,2020,23,5,Israel,IL,ISR,8519373,Asia,252,16477,45
2020-05-12T00:00:00Z,12,5,2020,29,6,Israel,IL,ISR,8519373,Asia,258,16506,46
2020-05-13T00:00:00Z,13,5,2020,23,2,Israel,IL,ISR,8519373,Asia,260,16529,47
2020-05-14T00:00:00Z,14,5,2020,19,4,Israel,IL,ISR,8519373,Asia,264,16548,48
2020-05-15T00:00:00Z,15,5,2020,31,1,Israel,IL,ISR,8519373,Asia,265,16579,49
2020-05-16T00:00:00Z,16,5,2020,10,1,Israel,IL,ISR,8519373,Asia,266,16589,50
2020-05-17T00:00:00Z,17,5,2020,19,2,Israel,IL,ISR,8519373,Asia,268,16608,51
2020-05-18T00:00:00Z,18,5,2020,9,4,Israel,IL,ISR,8519373,Asia,272,16617,52
2020-05-19T00:00:00Z,19,5,2020,4,0,Israel,IL,ISR,8519373,Asia,272,16621,53
2020-05-20T00:00:00Z,20,5,2020,29,5,Israel,IL,ISR,8519373,Asia,277,16650,54
2020-05-21T00:00:00Z,21,5,2020,20,2,Israel,IL,ISR,8519373,Asia,279,16670,55
2020-05-22T00:00:00Z,22,5,2020,20,0,Israel,IL,ISR,8519373,Asia,279,16690,56
2020-05-23T00:00:00Z,23,5,2020,0,0,Israel,IL,ISR,8519373,Asia,279,16690,57
2020-05-24T00:00:00Z,24,5,2020,0,0,Israel,IL,ISR,8519373,Asia,279,16690,58
2020-05-25T00:00:00Z,25,5,2020,30,1,Israel,IL,ISR,8519373,Asia,280,16720,59
2020-05-26T00:00:00Z,26,5,2020,14,1,Israel,IL,ISR,8519373,Asia,281,16734,60
2020-05-27T00:00:00Z,27,5,2020,23,0,Israel,IL,ISR,8519373,Asia,281,16757,61
2020-05-28T00:00:00Z,28,5,2020,36,0,Israel,IL,ISR,8519373,Asia,281,16793,62
2020-05-29T00:00:00Z,29,5,2020,79,3,Israel,IL,ISR,8519373,Asia,284,16872,63
2020-05-30T00:00:00Z,30,5,2020,115,0,Israel,IL,ISR,8519373,Asia,284,16987,64
2020-05-31T00:00:00Z,31,5,2020,25,0,Israel,IL,ISR,8519373,Asia,284,17012,65
2020-06-01T00:00:00Z,1,6,2020,59,1,Israel,IL,ISR,8519373,Asia,285,17071,66
2020-06-02T00:00:00Z,2,6,2020,148,2,Israel,IL,ISR,8519373,Asia,287,17219,67
2020-06-03T00:00:00Z,3,6,2020,123,3,Israel,IL,ISR,8519373,Asia,290,17342,68
2020-06-04T00:00:00Z,4,6,2020,87,1,Israel,IL,ISR,8519373,Asia,291,17429,69
2020-06-05T00:00:00Z,5,6,2020,133,0,Israel,IL,ISR,8519373,Asia,291,17562,70
2020-06-06T00:00:00Z,6,6,2020,144,1,Israel,IL,ISR,8519373,Asia,292,17706,71
2020-06-07T00:00:00Z,7,6,2020,77,5,Israel,IL,ISR,8519373,Asia,297,17783,72
2020-06-08T00:00:00Z,8,6,2020,132,1,Israel,IL,ISR,8519373,Asia,298,17915,73
2020-06-09T00:00:00Z,9,6,2020,174,0,Israel,IL,ISR,8519373,Asia,298,18089,74
2020-06-10T00:00:00Z,10,6,2020,179,1,Israel,IL,ISR,8519373,Asia,299,18268,75
2020-06-11T00:00:00Z,11,6,2020,87,0,Israel,IL,ISR,8519373,Asia,299,18355,76
2020-06-12T00:00:00Z,12,6,2020,346,1,Israel,IL,ISR,8519373,Asia,300,18701,77
2020-06-13T00:00:00Z,13,6,2020,175,0,Israel,IL,ISR,8519373,Asia,300,18876,78
2020-06-14T00:00:00Z,14,6,2020,132,0,Israel,IL,ISR,8519373,Asia,300,19008,79
2020-06-15T00:00:00Z,15,6,2020,113,2,Israel,IL,ISR,8519373,Asia,302,19121,80
2020-06-16T00:00:00Z,16,6,2020,217,0,Israel,IL,ISR,8519373,Asia,302,19338,81
2020-06-17T00:00:00Z,17,6,2020,299,1,Israel,IL,ISR,8519373,Asia,303,19637,82
2020-06-18T00:00:00Z,18,6,2020,257,0,Israel,IL,ISR,8519373,Asia,303,19894,83
2020-06-19T00:00:00Z,19,6,2020,142,0,Israel,IL,ISR,8519373,Asia,303,20036,84
2020-06-20T00:00:00Z,20,6,2020,303,1,Israel,IL,ISR,8519373,Asia,304,20339,85
2020-06-21T00:00:00Z,21,6,2020,294,1,Israel,IL,ISR,8519373,Asia,305,20633,86
2020-06-22T00:00:00Z,22,6,2020,145,1,Israel,IL,ISR,8519373,Asia,306,20778,87
2020-06-23T00:00:00Z,23,6,2020,304,1,Israel,IL,ISR,8519373,Asia,307,21082,88
2020-06-24T00:00:00Z,24,6,2020,430,1,Israel,IL,ISR,8519373,Asia,308,21512,89
2020-06-25T00:00:00Z,25,6,2020,532,0,Israel,IL,ISR,8519373,Asia,308,22044,90
2020-02-26T00:00:00Z,26,2,2020,93,5,Italy,IT,ITA,60359546,Europe,11,322,1
2020-02-27T00:00:00Z,27,2,2020,78,1,Italy,IT,ITA,60359546,Europe,12,400,2
2020-02-28T00:00:00Z,28,2,2020,250,5,Italy,IT,ITA,60359546,Europe,17,650,3
2020-02-29T00:00:00Z,29,2,2020,238,4,Italy,IT,ITA,60359546,Europe,21,888,4
2020-03-01T00:00:00Z,1,3,2020,240,8,Italy,IT,ITA,60359546,Europe,29,1128,5
2020-03-02T00:00:00Z,2,3,2020,561,6,Italy,IT,ITA,60359546,Europe,35,1689,6
2020-03-03T00:00:00Z,3,3,2020,347,17,Italy,IT,ITA,60359546,Europe,52,2036,7
2020-03-04T00:00:00Z,4,3,2020,466,28,Italy,IT,ITA,60359546,Europe,80,2502,8
2020-03-05T00:00:00Z,5,3,2020,587,27,Italy,IT,ITA,60359546,Europe,107,3089,9
2020-03-06T00:00:00Z,6,3,2020,769,41,Italy,IT,ITA,60359546,Europe,148,3858,10
2020-03-07T00:00:00Z,7,3,2020,778,49,Italy,IT,ITA,60359546,Europe,197,4636,11
2020-03-08T00:00:00Z,8,3,2020,1247,36,Italy,IT,ITA,60359546,Europe,233,5883,12
2020-03-09T00:00:00Z,9,3,2020,1492,133,Italy,IT,ITA,60359546,Europe,366,7375,13
2020-03-10T00:00:00Z,10,3,2020,1797,98,Italy,IT,ITA,60359546,Europe,464,9172,14
2020-03-11T00:00:00Z,11,3,2020,977,167,Italy,IT,ITA,60359546,Europe,631,10149,15
2020-03-12T00:00:00Z,12,3,2020,2313,196,Italy,IT,ITA,60359546,Europe,827,12462,16
2020-03-13T00:00:00Z,13,3,2020,2651,189,Italy,IT,ITA,60359546,Europe,1016,15113,17
2020-03-14T00:00:00Z,14,3,2020,2547,252,Italy,IT,ITA,60359546,Europe,1268,17660,18
2020-03-15T00:00:00Z,15,3,2020,3497,173,Italy,IT,ITA,60359546,Europe,1441,21157,19
2020-03-16T00:00:00Z,16,3,2020,2823,370,Italy,IT,ITA,60359546,Europe,1811,23980,20
2020-03-17T00:00:00Z,17,3,2020,4000,347,Italy,IT,ITA,60359546,Europe,2158,27980,21
2020-03-18T00:00:00Z,18,3,2020,3526,347,Italy,IT,ITA,60359546,Europe,2505,31506,22
2020-03-19T00:00:00Z,19,3,2020,4207,473,Italy,IT,ITA,60359546,Europe,2978,35713,23
2020-03-20T00:00:00Z,20,3,2020,5322,429,Italy,IT,ITA,60359546,Europe,3407,41035,24
2020-03-21T00:00:00Z,21,3,2020,5986,625,Italy,IT,ITA,60359546,Europe,4032,47021,25
2020-03-22T00:00:00Z,22,3,2020,6557,795,Italy,IT,ITA,60359546,Europe,4827,53578,26
2020-03-23T00:00:00Z,23,3,2020,5560,649,Italy,IT,ITA,60359546,Europe,5476,59138,27
2020-03-24T00:00:00Z,24,3,2020,4789,601,Italy,IT,ITA,60359546,Europe,6077,63927,28
2020-03-25T00:00:00Z,25,3,2020,5249,743,Italy,IT,ITA,60359546,Europe,6820,69176,29
2020-03-26T00:00:00Z,26,3,2020,5210,685,Italy,IT,ITA,60359546,Europe,7505,74386,30
2020-03-27T00:00:00Z,27,3,2020,6153,660,Italy,IT,ITA,60359546,Europe,8165,80539,31
2020-03-28T00:00:00Z,28,3,2020,5959,971,Italy,IT,ITA,60359546,Europe,9136,86498,32
2020-03-29T00:00:00Z,29,3,2020,5974,887,Italy,IT,ITA,60359546,Europe,10023,92472,33
2020-03-30T00:00:00Z,30,3,2020,5217,758,Italy,IT,ITA,60359546,Europe,10781,97689,34
2020-03-31T00:00:00Z,31,3,2020,4050,810,Italy,IT,ITA,60359546,Europe,11591,101739,35
2020-04-01T00:00:00Z,1,4,2020,4053,839,Italy,IT,ITA,60359546,Europe,12430,105792,36
2020-04-02T00:00:00Z,2,4,2020,4782,727,Italy,IT,ITA,60359546,Europe,13157,110574,37
2020-04-03T00:00:00Z,3,4,2020,4668,760,Italy,IT,ITA,60359546,Europe,13917,115242,38
2020-04-04T00:00:00Z,4,4,2020,4585,764,Italy,IT,ITA,60359546,Europe,14681,119827,39
2020-04-05T00:00:00Z,5,4,2020,4805,681,Italy,IT,ITA,60359546,Europe,15362,124632,40
2020-04-06T00:00:00Z,6,4,2020,4316,527,Italy,IT,ITA,60359546,Europe,15889,128948,41
2020-04-07T00:00:00Z,7,4,2020,3599,636,Italy,IT,ITA,60359546,Europe,16525,132547,42
2020-04-08T00:00:00Z,8,4,2020,3039,604,Italy,IT,ITA,60359546,Europe,17129,135586,43
2020-04-09T00:00:00Z,9,4,2020,3836,540,Italy,IT,ITA,60359546,Europe,17669,139422,44
2020-04-10T00:00:00Z,10,4,2020,4204,612,Italy,IT,ITA,60359546,Europe,18281,143626,45
2020-04-11T00:00:00Z,11,4,2020,3951,570,Italy,IT,ITA,60359546,Europe,18851,147577,46
2020-04-12T00:00:00Z,12,4,2020,4694,619,Italy,IT,ITA,60359546,Europe,19470,152271,47
2020-04-13T00:00:00Z,13,4,2020,4092,431,Italy,IT,ITA,60359546,Europe,19901,156363,48
2020-04-14T00:00:00Z,14,4,2020,3153,564,Italy,IT,ITA,60359546,Europe,20465,159516,49
2020-04-15T00:00:00Z,15,4,2020,2972,604,Italy,IT,ITA,60359546,Europe,21069,162488,50
2020-04-16T00:00:00Z,16,4,2020,2667,578,Italy,IT,ITA,60359546,Europe,21647,165155,51
2020-04-17T00:00:00Z,17,4,2020,3786,525,Italy,IT,ITA,60359546,Europe,22172,168941,52
2020-04-18T00:00:00Z,18,4,2020,3493,575,Italy,IT,ITA,60359546,Europe,22747,172434,53
2020-04-19T00:00:00Z,19,4,2020,3491,480,Italy,IT,ITA,60359546,Europe,23227,175925,54
2020-04-20T00:00:00Z,20,4,2020,3047,433,Italy,IT,ITA,60359546,Europe,23660,178972,55
2020-04-21T00:00:00Z,21,4,2020,2256,454,Italy,IT,ITA,60359546,Europe,24114,181228,56
2020-04-22T00:00:00Z,22,4,2020,2729,534,Italy,IT,ITA,60359546,Europe,24648,183957,57
2020-04-23T00:00:00Z,23,4,2020,3370,437,Italy,IT,ITA,60359546,Europe,25085,187327,58
2020-04-24T00:00:00Z,24,4,2020,2646,464,Italy,IT,ITA,60359546,Europe,25549,189973,59
2020-04-25T00:00:00Z,25,4,2020,3021,420,Italy,IT,ITA,60359546,Europe,25969,192994,60
2020-04-26T00:00:00Z,26,4,2020,2357,415,Italy,IT,ITA,60359546,Europe,26384,195351,61
2020-04-27T00:00:00Z,27,4,2020,2324,260,Italy,IT,ITA,60359546,Europe,26644,197675,62
2020-04-28T00:00:00Z,28,4,2020,1739,333,Italy,IT,ITA,60359546,Europe,26977,199414,63
2020-04-29T00:00:00Z,29,4,2020,2091,382,Italy,IT,ITA,60359546,Europe,27359,201505,64
2020-04-30T00:00:00Z,30,4,2020,2086,323,Italy,IT,ITA,60359546,Europe,27682,203591,65
2020-05-01T00:00:00Z,1,5,2020,1872,285,Italy,IT,ITA,60359546,Europe,27967,205463,66
2020-05-02T00:00:00Z,2,5,2020,1965,269,Italy,IT,ITA,60359546,Europe,28236,207428,67
2020-05-03T00:00:00Z,3,5,2020,1900,474,Italy,IT,ITA,60359546,Europe,28710,209328,68
2020-05-04T00:00:00Z,4,5,2020,1389,174,Italy,IT,ITA,60359546,Europe,28884,210717,69
2020-05-05T00:00:00Z,5,5,2020,1221,195,Italy,IT,ITA,60359546,Europe,29079,211938,70
2020-05-06T00:00:00Z,6,5,2020,1075,236,Italy,IT,ITA,60359546,Europe,29315,213013,71
2020-05-07T00:00:00Z,7,5,2020,1444,369,Italy,IT,ITA,60359546,Europe,29684,214457,72
2020-05-08T00:00:00Z,8,5,2020,1401,274,Italy,IT,ITA,60359546,Europe,29958,215858,73
2020-05-09T00:00:00Z,9,5,2020,1327,243,Italy,IT,ITA,60359546,Europe,30201,217185,74
2020-05-10T00:00:00Z,10,5,2020,1083,194,Italy,IT,ITA,60359546,Europe,30395,218268,75
2020-05-11T00:00:00Z,11,5,2020,802,165,Italy,IT,ITA,60359546,Europe,30560,219070,76
2020-05-12T00:00:00Z,12,5,2020,744,179,Italy,IT,ITA,60359546,Europe,30739,219814,77
2020-05-13T00:00:00Z,13,5,2020,1402,172,Italy,IT,ITA,60359546,Europe,30911,221216,78
2020-05-14T00:00:00Z,14,5,2020,888,195,Italy,IT,ITA,60359546,Europe,31106,222104,79
2020-05-15T00:00:00Z,15,5,2020,992,262,Italy,IT,ITA,60359546,Europe,31368,223096,80
2020-05-16T00:00:00Z,16,5,2020,789,242,Italy,IT,ITA,60359546,Europe,31610,223885,81
2020-05-17T00:00:00Z,17,5,2020,875,153,Italy,IT,ITA,60359546,Europe,31763,224760,82
2020-05-18T00:00:00Z,18,5,2020,675,145,Italy,IT,ITA,60359546,Europe,31908,225435,83
2020-05-19T00:00:00Z,19,5,2020,451,99,Italy,IT,ITA,60359546,Europe,32007,225886,84
2020-05-20T00:00:00Z,20,5,2020,813,162,Italy,IT,ITA,60359546,Europe,32169,226699,85
2020-05-21T00:00:00Z,21,5,2020,665,161,Italy,IT,ITA,60359546,Europe,32330,227364,86
2020-05-22T00:00:00Z,22,5,2020,642,156,Italy,IT,ITA,60359546,Europe,32486,228006,87
2020-05-23T00:00:00Z,23,5,2020,652,130,Italy,IT,ITA,60359546,Europe,32616,228658,88
2020-05-24T00:00:00Z,24,5,2020,669,119,Italy,IT,ITA,60359546,Europe,32735,229327,89
2020-05-25T00:00:00Z,25,5,2020,531,50,Italy,IT,ITA,60359546,Europe,32785,229858,90
2020-05-26T00:00:00Z,26,5,2020,300,92,Italy,IT,ITA,60359546,Europe,32877,230158,91
2020-05-27T00:00:00Z,27,5,2020,397,78,Italy,IT,ITA,60359546,Europe,32955,230555,92
2020-05-28T00:00:00Z,28,5,2020,584,117,Italy,IT,ITA,60359546,Europe,33072,231139,93
2020-05-29T00:00:00Z,29,5,2020,593,70,Italy,IT,ITA,60359546,Europe,33142,231732,94
2020-05-30T00:00:00Z,30,5,2020,516,87,Italy,IT,ITA,60359546,Europe,33229,232248,95
2020-05-31T00:00:00Z,31,5,2020,416,111,Italy,IT,ITA,60359546,Europe,33340,232664,96
2020-06-01T00:00:00Z,1,6,2020,355,75,Italy,IT,ITA,60359546,Europe,33415,233019,97
2020-06-02T00:00:00Z,2,6,2020,178,60,Italy,IT,ITA,60359546,Europe,33475,233197,98
2020-06-03T00:00:00Z,3,6,2020,318,55,Italy,IT,ITA,60359546,Europe,33530,233515,99
2020-06-04T00:00:00Z,4,6,2020,321,71,Italy,IT,ITA,60359546,Europe,33601,233836,100
2020-06-05T00:00:00Z,5,6,2020,177,88,Italy,IT,ITA,60359546,Europe,33689,234013,101
2020-06-06T00:00:00Z,6,6,2020,518,85,Italy,IT,ITA,60359546,Europe,33774,234531,102
2020-06-07T00:00:00Z,7,6,2020,270,72,Italy,IT,ITA,60359546,Europe,33846,234801,103
2020-06-08T00:00:00Z,8,6,2020,197,53,Italy,IT,ITA,60359546,Europe,33899,234998,104
2020-06-09T00:00:00Z,9,6,2020,280,65,Italy,IT,ITA,60359546,Europe,33964,235278,105
2020-06-10T00:00:00Z,10,6,2020,283,79,Italy,IT,ITA,60359546,Europe,34043,235561,106
2020-06-11T00:00:00Z,11,6,2020,202,71,Italy,IT,ITA,60359546,Europe,34114,235763,107
2020-06-12T00:00:00Z,12,6,2020,379,53,Italy,IT,ITA,60359546,Europe,34167,236142,108
2020-06-13T00:00:00Z,13,6,2020,163,56,Italy,IT,ITA,60359546,Europe,34223,236305,109
2020-06-14T00:00:00Z,14,6,2020,346,78,Italy,IT,ITA,60359546,Europe,34301,236651,110
2020-06-15T00:00:00Z,15,6,2020,338,44,Italy,IT,ITA,60359546,Europe,34345,236989,111
2020-06-16T00:00:00Z,16,6,2020,301,26,Italy,IT,ITA,60359546,Europe,34371,237290,112
2020-06-17T00:00:00Z,17,6,2020,210,34,Italy,IT,ITA,60359546,Europe,34405,237500,113
2020-06-18T00:00:00Z,18,6,2020,328,43,Italy,IT,ITA,60359546,Europe,34448,237828,114
2020-06-19T00:00:00Z,19,6,2020,331,66,Italy,IT,ITA,60359546,Europe,34514,238159,115
2020-06-20T00:00:00Z,20,6,2020,-148,47,Italy,IT,ITA,60359546,Europe,34561,238011,116
2020-06-21T00:00:00Z,21,6,2020,264,49,Italy,IT,ITA,60359546,Europe,34610,238275,117
2020-06-22T00:00:00Z,22,6,2020,224,24,Italy,IT,ITA,60359546,Europe,34634,238499,118
2020-06-23T00:00:00Z,23,6,2020,221,23,Italy,IT,ITA,60359546,Europe,34657,238720,119
2020-06-24T00:00:00Z,24,6,2020,113,18,Italy,IT,ITA,60359546,Europe,34675,238833,120
2020-06-25T00:00:00Z,25,6,2020,577,-31,Italy,IT,ITA,60359546,Europe,34644,239410,121
2020-06-05T00:00:00Z,5,6,2020,1,1,Jamaica,JM,JAM,2948277,America,10,591,1
2020-06-06T00:00:00Z,6,6,2020,4,0,Jamaica,JM,JAM,2948277,America,10,595,2
2020-06-07T00:00:00Z,7,6,2020,1,0,Jamaica,JM,JAM,2948277,America,10,596,3
2020-06-08T00:00:00Z,8,6,2020,2,0,Jamaica,JM,JAM,2948277,America,10,598,4
2020-06-09T00:00:00Z,9,6,2020,1,0,Jamaica,JM,JAM,2948277,America,10,599,5
2020-06-10T00:00:00Z,10,6,2020,6,0,Jamaica,JM,JAM,2948277,America,10,605,6
2020-06-11T00:00:00Z,11,6,2020,0,0,Jamaica,JM,JAM,2948277,America,10,605,7
2020-06-12T00:00:00Z,12,6,2020,6,0,Jamaica,JM,JAM,2948277,America,10,611,8
2020-06-13T00:00:00Z,13,6,2020,3,0,Jamaica,JM,JAM,2948277,America,10,614,9
2020-06-14T00:00:00Z,14,6,2020,1,0,Jamaica,JM,JAM,2948277,America,10,615,10
2020-06-15T00:00:00Z,15,6,2020,2,0,Jamaica,JM,JAM,2948277,America,10,617,11
2020-06-16T00:00:00Z,16,6,2020,4,0,Jamaica,JM,JAM,2948277,America,10,621,12
2020-06-17T00:00:00Z,17,6,2020,0,0,Jamaica,JM,JAM,2948277,America,10,621,13
2020-06-18T00:00:00Z,18,6,2020,5,0,Jamaica,JM,JAM,2948277,America,10,626,14
2020-06-19T00:00:00Z,19,6,2020,0,0,Jamaica,JM,JAM,2948277,America,10,626,15
2020-06-20T00:00:00Z,20,6,2020,26,0,Jamaica,JM,JAM,2948277,America,10,652,16
2020-06-21T00:00:00Z,21,6,2020,5,0,Jamaica,JM,JAM,2948277,America,10,657,17
2020-06-22T00:00:00Z,22,6,2020,2,0,Jamaica,JM,JAM,2948277,America,10,659,18
2020-06-23T00:00:00Z,23,6,2020,6,0,Jamaica,JM,JAM,2948277,America,10,665,19
2020-06-24T00:00:00Z,24,6,2020,5,0,Jamaica,JM,JAM,2948277,America,10,670,20
2020-06-25T00:00:00Z,25,6,2020,8,0,Jamaica,JM,JAM,2948277,America,10,678,21
2020-03-11T00:00:00Z,11,3,2020,54,3,Japan,JP,JPN,126860299,Asia,12,568,1
2020-03-12T00:00:00Z,12,3,2020,51,3,Japan,JP,JPN,126860299,Asia,15,619,2
2020-03-13T00:00:00Z,13,3,2020,56,4,Japan,JP,JPN,126860299,Asia,19,675,3
2020-03-14T00:00:00Z,14,3,2020,62,2,Japan,JP,JPN,126860299,Asia,21,737,4
2020-03-15T00:00:00Z,15,3,2020,43,1,Japan,JP,JPN,126860299,Asia,22,780,5
2020-03-16T00:00:00Z,16,3,2020,34,2,Japan,JP,JPN,126860299,Asia,24,814,6
2020-03-17T00:00:00Z,17,3,2020,10,4,Japan,JP,JPN,126860299,Asia,28,824,7
2020-03-18T00:00:00Z,18,3,2020,5,0,Japan,JP,JPN,126860299,Asia,28,829,8
2020-03-19T00:00:00Z,19,3,2020,44,1,Japan,JP,JPN,126860299,Asia,29,873,9
2020-03-20T00:00:00Z,20,3,2020,77,4,Japan,JP,JPN,126860299,Asia,33,950,10
2020-03-21T00:00:00Z,21,3,2020,57,2,Japan,JP,JPN,126860299,Asia,35,1007,11
2020-03-22T00:00:00Z,22,3,2020,39,1,Japan,JP,JPN,126860299,Asia,36,1046,12
2020-03-23T00:00:00Z,23,3,2020,43,5,Japan,JP,JPN,126860299,Asia,41,1089,13
2020-03-24T00:00:00Z,24,3,2020,39,1,Japan,JP,JPN,126860299,Asia,42,1128,14
2020-03-25T00:00:00Z,25,3,2020,65,1,Japan,JP,JPN,126860299,Asia,43,1193,15
2020-03-26T00:00:00Z,26,3,2020,75,2,Japan,JP,JPN,126860299,Asia,45,1268,16
2020-03-27T00:00:00Z,27,3,2020,96,1,Japan,JP,JPN,126860299,Asia,46,1364,17
2020-03-28T00:00:00Z,28,3,2020,135,3,Japan,JP,JPN,126860299,Asia,49,1499,18
2020-03-29T00:00:00Z,29,3,2020,194,3,Japan,JP,JPN,126860299,Asia,52,1693,19
2020-03-30T00:00:00Z,30,3,2020,173,2,Japan,JP,JPN,126860299,Asia,54,1866,20
2020-03-31T00:00:00Z,31,3,2020,87,2,Japan,JP,JPN,126860299,Asia,56,1953,21
2020-04-01T00:00:00Z,1,4,2020,0,0,Japan,JP,JPN,126860299,Asia,56,1953,22
2020-04-02T00:00:00Z,2,4,2020,225,1,Japan,JP,JPN,126860299,Asia,57,2178,23
2020-04-03T00:00:00Z,3,4,2020,439,6,Japan,JP,JPN,126860299,Asia,63,2617,24
2020-04-04T00:00:00Z,4,4,2020,318,6,Japan,JP,JPN,126860299,Asia,69,2935,25
2020-04-05T00:00:00Z,5,4,2020,336,1,Japan,JP,JPN,126860299,Asia,70,3271,26
2020-04-06T00:00:00Z,6,4,2020,383,3,Japan,JP,JPN,126860299,Asia,73,3654,27
2020-04-07T00:00:00Z,7,4,2020,163,7,Japan,JP,JPN,126860299,Asia,80,3817,28
2020-04-08T00:00:00Z,8,4,2020,89,0,Japan,JP,JPN,126860299,Asia,80,3906,29
2020-04-09T00:00:00Z,9,4,2020,351,1,Japan,JP,JPN,126860299,Asia,81,4257,30
2020-04-10T00:00:00Z,10,4,2020,410,4,Japan,JP,JPN,126860299,Asia,85,4667,31
2020-04-11T00:00:00Z,11,4,2020,680,3,Japan,JP,JPN,126860299,Asia,88,5347,32
2020-04-12T00:00:00Z,12,4,2020,1401,10,Japan,JP,JPN,126860299,Asia,98,6748,33
2020-04-13T00:00:00Z,13,4,2020,507,4,Japan,JP,JPN,126860299,Asia,102,7255,34
2020-04-14T00:00:00Z,14,4,2020,390,7,Japan,JP,JPN,126860299,Asia,109,7645,35
2020-04-15T00:00:00Z,15,4,2020,455,10,Japan,JP,JPN,126860299,Asia,119,8100,36
2020-04-16T00:00:00Z,16,4,2020,482,17,Japan,JP,JPN,126860299,Asia,136,8582,37
2020-04-17T00:00:00Z,17,4,2020,585,12,Japan,JP,JPN,126860299,Asia,148,9167,38
2020-04-18T00:00:00Z,18,4,2020,628,6,Japan,JP,JPN,126860299,Asia,154,9795,39
2020-04-19T00:00:00Z,19,4,2020,566,7,Japan,JP,JPN,126860299,Asia,161,10361,40
2020-04-20T00:00:00Z,20,4,2020,390,10,Japan,JP,JPN,126860299,Asia,171,10751,41
2020-04-21T00:00:00Z,21,4,2020,367,15,Japan,JP,JPN,126860299,Asia,186,11118,42
2020-04-22T00:00:00Z,22,4,2020,378,0,Japan,JP,JPN,126860299,Asia,186,11496,43
2020-04-23T00:00:00Z,23,4,2020,276,101,Japan,JP,JPN,126860299,Asia,287,11772,44
2020-04-24T00:00:00Z,24,4,2020,468,30,Japan,JP,JPN,126860299,Asia,317,12240,45
2020-04-25T00:00:00Z,25,4,2020,652,17,Japan,JP,JPN,126860299,Asia,334,12892,46
2020-04-26T00:00:00Z,26,4,2020,290,14,Japan,JP,JPN,126860299,Asia,348,13182,47
2020-04-27T00:00:00Z,27,4,2020,203,3,Japan,JP,JPN,126860299,Asia,351,13385,48
2020-04-28T00:00:00Z,28,4,2020,191,25,Japan,JP,JPN,126860299,Asia,376,13576,49
2020-04-29T00:00:00Z,29,4,2020,276,13,Japan,JP,JPN,126860299,Asia,389,13852,50
2020-04-30T00:00:00Z,30,4,2020,236,26,Japan,JP,JPN,126860299,Asia,415,14088,51
2020-05-01T00:00:00Z,1,5,2020,193,17,Japan,JP,JPN,126860299,Asia,432,14281,52
2020-05-02T00:00:00Z,2,5,2020,263,26,Japan,JP,JPN,126860299,Asia,458,14544,53
2020-05-03T00:00:00Z,3,5,2020,295,34,Japan,JP,JPN,126860299,Asia,492,14839,54
2020-05-04T00:00:00Z,4,5,2020,218,18,Japan,JP,JPN,126860299,Asia,510,15057,55
2020-05-05T00:00:00Z,5,5,2020,174,11,Japan,JP,JPN,126860299,Asia,521,15231,56
2020-05-06T00:00:00Z,6,5,2020,123,22,Japan,JP,JPN,126860299,Asia,543,15354,57
2020-05-07T00:00:00Z,7,5,2020,109,8,Japan,JP,JPN,126860299,Asia,551,15463,58
2020-05-08T00:00:00Z,8,5,2020,84,6,Japan,JP,JPN,126860299,Asia,557,15547,59
2020-05-09T00:00:00Z,9,5,2020,81,44,Japan,JP,JPN,126860299,Asia,601,15628,60
2020-05-10T00:00:00Z,10,5,2020,119,12,Japan,JP,JPN,126860299,Asia,613,15747,61
2020-05-11T00:00:00Z,11,5,2020,51,8,Japan,JP,JPN,126860299,Asia,621,15798,62
2020-05-12T00:00:00Z,12,5,2020,76,22,Japan,JP,JPN,126860299,Asia,643,15874,63
2020-05-13T00:00:00Z,13,5,2020,150,25,Japan,JP,JPN,126860299,Asia,668,16024,64
2020-05-14T00:00:00Z,14,5,2020,55,19,Japan,JP,JPN,126860299,Asia,687,16079,65
2020-05-15T00:00:00Z,15,5,2020,114,23,Japan,JP,JPN,126860299,Asia,710,16193,66
2020-05-16T00:00:00Z,16,5,2020,44,15,Japan,JP,JPN,126860299,Asia,725,16237,67
2020-05-17T00:00:00Z,17,5,2020,48,19,Japan,JP,JPN,126860299,Asia,744,16285,68
2020-05-18T00:00:00Z,18,5,2020,20,5,Japan,JP,JPN,126860299,Asia,749,16305,69
2020-05-19T00:00:00Z,19,5,2020,60,14,Japan,JP,JPN,126860299,Asia,763,16365,70
2020-05-20T00:00:00Z,20,5,2020,20,8,Japan,JP,JPN,126860299,Asia,771,16385,71
2020-05-21T00:00:00Z,21,5,2020,39,6,Japan,JP,JPN,126860299,Asia,777,16424,72
2020-05-22T00:00:00Z,22,5,2020,89,19,Japan,JP,JPN,126860299,Asia,796,16513,73
2020-05-23T00:00:00Z,23,5,2020,23,12,Japan,JP,JPN,126860299,Asia,808,16536,74
2020-05-24T00:00:00Z,24,5,2020,14,12,Japan,JP,JPN,126860299,Asia,820,16550,75
2020-05-25T00:00:00Z,25,5,2020,31,10,Japan,JP,JPN,126860299,Asia,830,16581,76
2020-05-26T00:00:00Z,26,5,2020,42,16,Japan,JP,JPN,126860299,Asia,846,16623,77
2020-05-27T00:00:00Z,27,5,2020,28,12,Japan,JP,JPN,126860299,Asia,858,16651,78
2020-05-28T00:00:00Z,28,5,2020,0,0,Japan,JP,JPN,126860299,Asia,858,16651,79
2020-05-29T00:00:00Z,29,5,2020,68,16,Japan,JP,JPN,126860299,Asia,874,16719,80
2020-05-30T00:00:00Z,30,5,2020,85,12,Japan,JP,JPN,126860299,Asia,886,16804,81
2020-05-31T00:00:00Z,31,5,2020,47,5,Japan,JP,JPN,126860299,Asia,891,16851,82
2020-06-01T00:00:00Z,1,6,2020,33,1,Japan,JP,JPN,126860299,Asia,892,16884,83
2020-06-02T00:00:00Z,2,6,2020,46,2,Japan,JP,JPN,126860299,Asia,894,16930,84
2020-06-03T00:00:00Z,3,6,2020,56,6,Japan,JP,JPN,126860299,Asia,900,16986,85
2020-06-04T00:00:00Z,4,6,2020,32,3,Japan,JP,JPN,126860299,Asia,903,17018,86
2020-06-05T00:00:00Z,5,6,2020,46,4,Japan,JP,JPN,126860299,Asia,907,17064,87
2020-06-06T00:00:00Z,6,6,2020,39,7,Japan,JP,JPN,126860299,Asia,914,17103,88
2020-06-07T00:00:00Z,7,6,2020,38,2,Japan,JP,JPN,126860299,Asia,916,17141,89
2020-06-08T00:00:00Z,8,6,2020,33,0,Japan,JP,JPN,126860299,Asia,916,17174,90
2020-06-09T00:00:00Z,9,6,2020,36,0,Japan,JP,JPN,126860299,Asia,916,17210,91
2020-06-10T00:00:00Z,10,6,2020,41,3,Japan,JP,JPN,126860299,Asia,919,17251,92
2020-06-11T00:00:00Z,11,6,2020,41,1,Japan,JP,JPN,126860299,Asia,920,17292,93
2020-06-12T00:00:00Z,12,6,2020,40,2,Japan,JP,JPN,126860299,Asia,922,17332,94
2020-06-13T00:00:00Z,13,6,2020,50,2,Japan,JP,JPN,126860299,Asia,924,17382,95
2020-06-14T00:00:00Z,14,6,2020,47,1,Japan,JP,JPN,126860299,Asia,925,17429,96
2020-06-15T00:00:00Z,15,6,2020,73,0,Japan,JP,JPN,126860299,Asia,925,17502,97
2020-06-16T00:00:00Z,16,6,2020,85,2,Japan,JP,JPN,126860299,Asia,927,17587,98
2020-06-17T00:00:00Z,17,6,2020,41,4,Japan,JP,JPN,126860299,Asia,931,17628,99
2020-06-18T00:00:00Z,18,6,2020,40,4,Japan,JP,JPN,126860299,Asia,935,17668,100
2020-06-19T00:00:00Z,19,6,2020,72,0,Japan,JP,JPN,126860299,Asia,935,17740,101
2020-06-20T00:00:00Z,20,6,2020,59,17,Japan,JP,JPN,126860299,Asia,952,17799,102
2020-06-21T00:00:00Z,21,6,2020,0,0,Japan,JP,JPN,126860299,Asia,952,17799,103
2020-06-22T00:00:00Z,22,6,2020,117,1,Japan,JP,JPN,126860299,Asia,953,17916,104
2020-06-23T00:00:00Z,23,6,2020,52,2,Japan,JP,JPN,126860299,Asia,955,17968,105
2020-06-24T00:00:00Z,24,6,2020,59,8,Japan,JP,JPN,126860299,Asia,963,18027,106
2020-06-25T00:00:00Z,25,6,2020,83,5,Japan,JP,JPN,126860299,Asia,968,18110,107
2020-04-17T00:00:00Z,17,4,2020,6,4,Jersey,JE,JEY,107796,Europe,10,223,1
2020-04-18T00:00:00Z,18,4,2020,1,1,Jersey,JE,JEY,107796,Europe,11,224,2
2020-04-19T00:00:00Z,19,4,2020,21,1,Jersey,JE,JEY,107796,Europe,12,245,3
2020-04-20T00:00:00Z,20,4,2020,4,0,Jersey,JE,JEY,107796,Europe,12,249,4
2020-04-21T00:00:00Z,21,4,2020,0,2,Jersey,JE,JEY,107796,Europe,14,249,5
2020-04-22T00:00:00Z,22,4,2020,6,0,Jersey,JE,JEY,107796,Europe,14,255,6
2020-04-23T00:00:00Z,23,4,2020,0,4,Jersey,JE,JEY,107796,Europe,18,255,7
2020-04-24T00:00:00Z,24,4,2020,21,1,Jersey,JE,JEY,107796,Europe,19,276,8
2020-04-25T00:00:00Z,25,4,2020,2,0,Jersey,JE,JEY,107796,Europe,19,278,9
2020-04-26T00:00:00Z,26,4,2020,2,0,Jersey,JE,JEY,107796,Europe,19,280,10
2020-04-27T00:00:00Z,27,4,2020,1,0,Jersey,JE,JEY,107796,Europe,19,281,11
2020-04-28T00:00:00Z,28,4,2020,2,0,Jersey,JE,JEY,107796,Europe,19,283,12
2020-04-29T00:00:00Z,29,4,2020,1,1,Jersey,JE,JEY,107796,Europe,20,284,13
2020-04-30T00:00:00Z,30,4,2020,2,1,Jersey,JE,JEY,107796,Europe,21,286,14
2020-05-01T00:00:00Z,1,5,2020,0,2,Jersey,JE,JEY,107796,Europe,23,286,15
2020-05-02T00:00:00Z,2,5,2020,0,1,Jersey,JE,JEY,107796,Europe,24,286,16
2020-05-03T00:00:00Z,3,5,2020,5,0,Jersey,JE,JEY,107796,Europe,24,291,17
2020-05-04T00:00:00Z,4,5,2020,1,0,Jersey,JE,JEY,107796,Europe,24,292,18
2020-05-05T00:00:00Z,5,5,2020,1,0,Jersey,JE,JEY,107796,Europe,24,293,19
2020-05-06T00:00:00Z,6,5,2020,0,0,Jersey,JE,JEY,107796,Europe,24,293,20
2020-05-07T00:00:00Z,7,5,2020,0,1,Jersey,JE,JEY,107796,Europe,25,293,21
2020-05-08T00:00:00Z,8,5,2020,0,0,Jersey,JE,JEY,107796,Europe,25,293,22
2020-05-09T00:00:00Z,9,5,2020,0,0,Jersey,JE,JEY,107796,Europe,25,293,23
2020-05-10T00:00:00Z,10,5,2020,0,0,Jersey,JE,JEY,107796,Europe,25,293,24
2020-05-11T00:00:00Z,11,5,2020,1,0,Jersey,JE,JEY,107796,Europe,25,294,25
2020-05-12T00:00:00Z,12,5,2020,0,0,Jersey,JE,JEY,107796,Europe,25,294,26
2020-05-13T00:00:00Z,13,5,2020,1,1,Jersey,JE,JEY,107796,Europe,26,295,27
2020-05-14T00:00:00Z,14,5,2020,1,1,Jersey,JE,JEY,107796,Europe,27,296,28
2020-05-15T00:00:00Z,15,5,2020,1,0,Jersey,JE,JEY,107796,Europe,27,297,29
2020-05-16T00:00:00Z,16,5,2020,0,0,Jersey,JE,JEY,107796,Europe,27,297,30
2020-05-17T00:00:00Z,17,5,2020,5,0,Jersey,JE,JEY,107796,Europe,27,302,31
2020-05-18T00:00:00Z,18,5,2020,0,0,Jersey,JE,JEY,107796,Europe,27,302,32
2020-05-19T00:00:00Z,19,5,2020,1,0,Jersey,JE,JEY,107796,Europe,27,303,33
2020-05-20T00:00:00Z,20,5,2020,0,1,Jersey,JE,JEY,107796,Europe,28,303,34
2020-05-21T00:00:00Z,21,5,2020,3,1,Jersey,JE,JEY,107796,Europe,29,306,35
2020-05-22T00:00:00Z,22,5,2020,0,0,Jersey,JE,JEY,107796,Europe,29,306,36
2020-05-23T00:00:00Z,23,5,2020,0,0,Jersey,JE,JEY,107796,Europe,29,306,37
2020-05-24T00:00:00Z,24,5,2020,0,0,Jersey,JE,JEY,107796,Europe,29,306,38
2020-05-25T00:00:00Z,25,5,2020,0,0,Jersey,JE,JEY,107796,Europe,29,306,39
2020-05-26T00:00:00Z,26,5,2020,1,0,Jersey,JE,JEY,107796,Europe,29,307,40
2020-05-27T00:00:00Z,27,5,2020,0,0,Jersey,JE,JEY,107796,Europe,29,307,41
2020-05-28T00:00:00Z,28,5,2020,1,0,Jersey,JE,JEY,107796,Europe,29,308,42
2020-05-29T00:00:00Z,29,5,2020,0,0,Jersey,JE,JEY,107796,Europe,29,308,43
2020-05-30T00:00:00Z,30,5,2020,0,0,Jersey,JE,JEY,107796,Europe,29,308,44
2020-05-31T00:00:00Z,31,5,2020,0,0,Jersey,JE,JEY,107796,Europe,29,308,45
2020-06-01T00:00:00Z,1,6,2020,0,0,Jersey,JE,JEY,107796,Europe,29,308,46
2020-06-02T00:00:00Z,2,6,2020,0,0,Jersey,JE,JEY,107796,Europe,29,308,47
2020-06-03T00:00:00Z,3,6,2020,0,1,Jersey,JE,JEY,107796,Europe,30,308,48
2020-06-04T00:00:00Z,4,6,2020,1,0,Jersey,JE,JEY,107796,Europe,30,309,49
2020-06-05T00:00:00Z,5,6,2020,0,0,Jersey,JE,JEY,107796,Europe,30,309,50
2020-06-06T00:00:00Z,6,6,2020,0,0,Jersey,JE,JEY,107796,Europe,30,309,51
2020-06-07T00:00:00Z,7,6,2020,2,0,Jersey,JE,JEY,107796,Europe,30,311,52
2020-06-08T00:00:00Z,8,6,2020,0,0,Jersey,JE,JEY,107796,Europe,30,311,53
2020-06-09T00:00:00Z,9,6,2020,1,0,Jersey,JE,JEY,107796,Europe,30,312,54
2020-06-10T00:00:00Z,10,6,2020,1,0,Jersey,JE,JEY,107796,Europe,30,313,55
2020-06-11T00:00:00Z,11,6,2020,0,0,Jersey,JE,JEY,107796,Europe,30,313,56
2020-06-12T00:00:00Z,12,6,2020,0,0,Jersey,JE,JEY,107796,Europe,30,313,57
2020-06-13T00:00:00Z,13,6,2020,0,0,Jersey,JE,JEY,107796,Europe,30,313,58
2020-06-14T00:00:00Z,14,6,2020,0,0,Jersey,JE,JEY,107796,Europe,30,313,59
2020-06-15T00:00:00Z,15,6,2020,0,0,Jersey,JE,JEY,107796,Europe,30,313,60
2020-06-16T00:00:00Z,16,6,2020,3,0,Jersey,JE,JEY,107796,Europe,30,316,61
2020-06-17T00:00:00Z,17,6,2020,0,0,Jersey,JE,JEY,107796,Europe,30,316,62
2020-06-18T00:00:00Z,18,6,2020,2,0,Jersey,JE,JEY,107796,Europe,30,318,63
2020-06-19T00:00:00Z,19,6,2020,0,0,Jersey,JE,JEY,107796,Europe,30,318,64
2020-06-20T00:00:00Z,20,6,2020,0,1,Jersey,JE,JEY,107796,Europe,31,318,65
2020-06-21T00:00:00Z,21,6,2020,0,0,Jersey,JE,JEY,107796,Europe,31,318,66
2020-06-22T00:00:00Z,22,6,2020,0,0,Jersey,JE,JEY,107796,Europe,31,318,67
2020-06-23T00:00:00Z,23,6,2020,0,0,Jersey,JE,JEY,107796,Europe,31,318,68
2020-06-24T00:00:00Z,24,6,2020,0,0,Jersey,JE,JEY,107796,Europe,31,318,69
2020-06-25T00:00:00Z,25,6,2020,1,0,Jersey,JE,JEY,107796,Europe,31,319,70
2020-04-11T00:00:00Z,11,4,2020,38,1,Kazakhstan,KZ,KAZ,18551428,Asia,10,840,1
2020-04-12T00:00:00Z,12,4,2020,40,0,Kazakhstan,KZ,KAZ,18551428,Asia,10,880,2
2020-04-13T00:00:00Z,13,4,2020,81,0,Kazakhstan,KZ,KAZ,18551428,Asia,10,961,3
2020-04-14T00:00:00Z,14,4,2020,218,4,Kazakhstan,KZ,KAZ,18551428,Asia,14,1179,4
2020-04-15T00:00:00Z,15,4,2020,88,0,Kazakhstan,KZ,KAZ,18551428,Asia,14,1267,5
2020-04-16T00:00:00Z,16,4,2020,64,2,Kazakhstan,KZ,KAZ,18551428,Asia,16,1331,6
2020-04-17T00:00:00Z,17,4,2020,139,1,Kazakhstan,KZ,KAZ,18551428,Asia,17,1470,7
2020-04-18T00:00:00Z,18,4,2020,121,0,Kazakhstan,KZ,KAZ,18551428,Asia,17,1591,8
2020-04-19T00:00:00Z,19,4,2020,63,0,Kazakhstan,KZ,KAZ,18551428,Asia,17,1654,9
2020-04-20T00:00:00Z,20,4,2020,81,2,Kazakhstan,KZ,KAZ,18551428,Asia,19,1735,10
2020-04-21T00:00:00Z,21,4,2020,214,0,Kazakhstan,KZ,KAZ,18551428,Asia,19,1949,11
2020-04-22T00:00:00Z,22,4,2020,76,0,Kazakhstan,KZ,KAZ,18551428,Asia,19,2025,12
2020-04-23T00:00:00Z,23,4,2020,166,0,Kazakhstan,KZ,KAZ,18551428,Asia,19,2191,13
2020-04-24T00:00:00Z,24,4,2020,143,3,Kazakhstan,KZ,KAZ,18551428,Asia,22,2334,14
2020-04-25T00:00:00Z,25,4,2020,148,3,Kazakhstan,KZ,KAZ,18551428,Asia,25,2482,15
2020-04-26T00:00:00Z,26,4,2020,170,0,Kazakhstan,KZ,KAZ,18551428,Asia,25,2652,16
2020-04-27T00:00:00Z,27,4,2020,65,0,Kazakhstan,KZ,KAZ,18551428,Asia,25,2717,17
2020-04-28T00:00:00Z,28,4,2020,143,0,Kazakhstan,KZ,KAZ,18551428,Asia,25,2860,18
2020-04-29T00:00:00Z,29,4,2020,203,0,Kazakhstan,KZ,KAZ,18551428,Asia,25,3063,19
2020-04-30T00:00:00Z,30,4,2020,142,0,Kazakhstan,KZ,KAZ,18551428,Asia,25,3205,20
2020-05-01T00:00:00Z,1,5,2020,299,0,Kazakhstan,KZ,KAZ,18551428,Asia,25,3504,21
2020-05-02T00:00:00Z,2,5,2020,167,0,Kazakhstan,KZ,KAZ,18551428,Asia,25,3671,22
2020-05-03T00:00:00Z,3,5,2020,206,0,Kazakhstan,KZ,KAZ,18551428,Asia,25,3877,23
2020-05-04T00:00:00Z,4,5,2020,87,2,Kazakhstan,KZ,KAZ,18551428,Asia,27,3964,24
2020-05-05T00:00:00Z,5,5,2020,157,2,Kazakhstan,KZ,KAZ,18551428,Asia,29,4121,25
2020-05-06T00:00:00Z,6,5,2020,156,0,Kazakhstan,KZ,KAZ,18551428,Asia,29,4277,26
2020-05-07T00:00:00Z,7,5,2020,225,1,Kazakhstan,KZ,KAZ,18551428,Asia,30,4502,27
2020-05-08T00:00:00Z,8,5,2020,188,1,Kazakhstan,KZ,KAZ,18551428,Asia,31,4690,28
2020-05-09T00:00:00Z,9,5,2020,144,0,Kazakhstan,KZ,KAZ,18551428,Asia,31,4834,29
2020-05-10T00:00:00Z,10,5,2020,202,0,Kazakhstan,KZ,KAZ,18551428,Asia,31,5036,30
2020-05-11T00:00:00Z,11,5,2020,90,0,Kazakhstan,KZ,KAZ,18551428,Asia,31,5126,31
2020-05-12T00:00:00Z,12,5,2020,114,1,Kazakhstan,KZ,KAZ,18551428,Asia,32,5240,32
2020-05-13T00:00:00Z,13,5,2020,177,0,Kazakhstan,KZ,KAZ,18551428,Asia,32,5417,33
2020-05-14T00:00:00Z,14,5,2020,154,0,Kazakhstan,KZ,KAZ,18551428,Asia,32,5571,34
2020-05-15T00:00:00Z,15,5,2020,0,0,Kazakhstan,KZ,KAZ,18551428,Asia,32,5571,35
2020-05-16T00:00:00Z,16,5,2020,279,2,Kazakhstan,KZ,KAZ,18551428,Asia,34,5850,36
2020-05-17T00:00:00Z,17,5,2020,307,0,Kazakhstan,KZ,KAZ,18551428,Asia,34,6157,37
2020-05-18T00:00:00Z,18,5,2020,283,0,Kazakhstan,KZ,KAZ,18551428,Asia,34,6440,38
2020-05-19T00:00:00Z,19,5,2020,311,1,Kazakhstan,KZ,KAZ,18551428,Asia,35,6751,39
2020-05-20T00:00:00Z,20,5,2020,218,0,Kazakhstan,KZ,KAZ,18551428,Asia,35,6969,40
2020-05-21T00:00:00Z,21,5,2020,265,0,Kazakhstan,KZ,KAZ,18551428,Asia,35,7234,41
2020-05-22T00:00:00Z,22,5,2020,363,0,Kazakhstan,KZ,KAZ,18551428,Asia,35,7597,42
2020-05-23T00:00:00Z,23,5,2020,322,0,Kazakhstan,KZ,KAZ,18551428,Asia,35,7919,43
2020-05-24T00:00:00Z,24,5,2020,403,0,Kazakhstan,KZ,KAZ,18551428,Asia,35,8322,44
2020-05-25T00:00:00Z,25,5,2020,209,0,Kazakhstan,KZ,KAZ,18551428,Asia,35,8531,45
2020-05-26T00:00:00Z,26,5,2020,438,0,Kazakhstan,KZ,KAZ,18551428,Asia,35,8969,46
2020-05-27T00:00:00Z,27,5,2020,335,2,Kazakhstan,KZ,KAZ,18551428,Asia,37,9304,47
2020-05-28T00:00:00Z,28,5,2020,272,0,Kazakhstan,KZ,KAZ,18551428,Asia,37,9576,48
2020-05-29T00:00:00Z,29,5,2020,356,0,Kazakhstan,KZ,KAZ,18551428,Asia,37,9932,49
2020-05-30T00:00:00Z,30,5,2020,450,0,Kazakhstan,KZ,KAZ,18551428,Asia,37,10382,50
2020-05-31T00:00:00Z,31,5,2020,476,1,Kazakhstan,KZ,KAZ,18551428,Asia,38,10858,51
2020-06-01T00:00:00Z,1,6,2020,450,3,Kazakhstan,KZ,KAZ,18551428,Asia,41,11308,52
2020-06-02T00:00:00Z,2,6,2020,263,0,Kazakhstan,KZ,KAZ,18551428,Asia,41,11571,53
2020-06-03T00:00:00Z,3,6,2020,225,3,Kazakhstan,KZ,KAZ,18551428,Asia,44,11796,54
2020-06-04T00:00:00Z,4,6,2020,271,4,Kazakhstan,KZ,KAZ,18551428,Asia,48,12067,55
2020-06-05T00:00:00Z,5,6,2020,245,4,Kazakhstan,KZ,KAZ,18551428,Asia,52,12312,56
2020-06-06T00:00:00Z,6,6,2020,199,0,Kazakhstan,KZ,KAZ,18551428,Asia,52,12511,57
2020-06-07T00:00:00Z,7,6,2020,183,1,Kazakhstan,KZ,KAZ,18551428,Asia,53,12694,58
2020-06-08T00:00:00Z,8,6,2020,165,3,Kazakhstan,KZ,KAZ,18551428,Asia,56,12859,59
2020-06-09T00:00:00Z,9,6,2020,215,2,Kazakhstan,KZ,KAZ,18551428,Asia,58,13074,60
2020-06-10T00:00:00Z,10,6,2020,245,3,Kazakhstan,KZ,KAZ,18551428,Asia,61,13319,61
2020-06-11T00:00:00Z,11,6,2020,239,6,Kazakhstan,KZ,KAZ,18551428,Asia,67,13558,62
2020-06-12T00:00:00Z,12,6,2020,314,0,Kazakhstan,KZ,KAZ,18551428,Asia,67,13872,63
2020-06-13T00:00:00Z,13,6,2020,366,3,Kazakhstan,KZ,KAZ,18551428,Asia,70,14238,64
2020-06-14T00:00:00Z,14,6,2020,258,3,Kazakhstan,KZ,KAZ,18551428,Asia,73,14496,65
2020-06-15T00:00:00Z,15,6,2020,313,4,Kazakhstan,KZ,KAZ,18551428,Asia,77,14809,66
2020-06-16T00:00:00Z,16,6,2020,383,4,Kazakhstan,KZ,KAZ,18551428,Asia,81,15192,67
2020-06-17T00:00:00Z,17,6,2020,350,7,Kazakhstan,KZ,KAZ,18551428,Asia,88,15542,68
2020-06-18T00:00:00Z,18,6,2020,335,12,Kazakhstan,KZ,KAZ,18551428,Asia,100,15877,69
2020-06-19T00:00:00Z,19,6,2020,474,5,Kazakhstan,KZ,KAZ,18551428,Asia,105,16351,70
2020-06-20T00:00:00Z,20,6,2020,428,8,Kazakhstan,KZ,KAZ,18551428,Asia,113,16779,71
2020-06-21T00:00:00Z,21,6,2020,446,5,Kazakhstan,KZ,KAZ,18551428,Asia,118,17225,72
2020-06-22T00:00:00Z,22,6,2020,507,2,Kazakhstan,KZ,KAZ,18551428,Asia,120,17732,73
2020-06-23T00:00:00Z,23,6,2020,499,7,Kazakhstan,KZ,KAZ,18551428,Asia,127,18231,74
2020-06-24T00:00:00Z,24,6,2020,534,7,Kazakhstan,KZ,KAZ,18551428,Asia,134,18765,75
2020-06-25T00:00:00Z,25,6,2020,520,2,Kazakhstan,KZ,KAZ,18551428,Asia,136,19285,76
2020-04-16T00:00:00Z,16,4,2020,9,1,Kenya,KE,KEN,52573967,Africa,10,225,1
2020-04-17T00:00:00Z,17,4,2020,9,1,Kenya,KE,KEN,52573967,Africa,11,234,2
2020-04-18T00:00:00Z,18,4,2020,12,0,Kenya,KE,KEN,52573967,Africa,11,246,3
2020-04-19T00:00:00Z,19,4,2020,16,1,Kenya,KE,KEN,52573967,Africa,12,262,4
2020-04-20T00:00:00Z,20,4,2020,8,2,Kenya,KE,KEN,52573967,Africa,14,270,5
2020-04-21T00:00:00Z,21,4,2020,11,0,Kenya,KE,KEN,52573967,Africa,14,281,6
2020-04-22T00:00:00Z,22,4,2020,0,0,Kenya,KE,KEN,52573967,Africa,14,281,7
2020-04-23T00:00:00Z,23,4,2020,22,0,Kenya,KE,KEN,52573967,Africa,14,303,8
2020-04-24T00:00:00Z,24,4,2020,17,0,Kenya,KE,KEN,52573967,Africa,14,320,9
2020-04-25T00:00:00Z,25,4,2020,16,0,Kenya,KE,KEN,52573967,Africa,14,336,10
2020-04-26T00:00:00Z,26,4,2020,7,0,Kenya,KE,KEN,52573967,Africa,14,343,11
2020-04-27T00:00:00Z,27,4,2020,12,0,Kenya,KE,KEN,52573967,Africa,14,355,12
2020-04-28T00:00:00Z,28,4,2020,8,0,Kenya,KE,KEN,52573967,Africa,14,363,13
2020-04-29T00:00:00Z,29,4,2020,11,0,Kenya,KE,KEN,52573967,Africa,14,374,14
2020-04-30T00:00:00Z,30,4,2020,10,1,Kenya,KE,KEN,52573967,Africa,15,384,15
2020-05-01T00:00:00Z,1,5,2020,12,2,Kenya,KE,KEN,52573967,Africa,17,396,16
2020-05-02T00:00:00Z,2,5,2020,15,4,Kenya,KE,KEN,52573967,Africa,21,411,17
2020-05-03T00:00:00Z,3,5,2020,24,1,Kenya,KE,KEN,52573967,Africa,22,435,18
2020-05-04T00:00:00Z,4,5,2020,30,2,Kenya,KE,KEN,52573967,Africa,24,465,19
2020-05-05T00:00:00Z,5,5,2020,25,0,Kenya,KE,KEN,52573967,Africa,24,490,20
2020-05-06T00:00:00Z,6,5,2020,45,0,Kenya,KE,KEN,52573967,Africa,24,535,21
2020-05-07T00:00:00Z,7,5,2020,47,2,Kenya,KE,KEN,52573967,Africa,26,582,22
2020-05-08T00:00:00Z,8,5,2020,25,3,Kenya,KE,KEN,52573967,Africa,29,607,23
2020-05-09T00:00:00Z,9,5,2020,14,0,Kenya,KE,KEN,52573967,Africa,29,621,24
2020-05-10T00:00:00Z,10,5,2020,28,1,Kenya,KE,KEN,52573967,Africa,30,649,25
2020-05-11T00:00:00Z,11,5,2020,23,2,Kenya,KE,KEN,52573967,Africa,32,672,26
2020-05-12T00:00:00Z,12,5,2020,28,1,Kenya,KE,KEN,52573967,Africa,33,700,27
2020-05-13T00:00:00Z,13,5,2020,15,3,Kenya,KE,KEN,52573967,Africa,36,715,28
2020-05-14T00:00:00Z,14,5,2020,22,4,Kenya,KE,KEN,52573967,Africa,40,737,29
2020-05-15T00:00:00Z,15,5,2020,21,2,Kenya,KE,KEN,52573967,Africa,42,758,30
2020-05-16T00:00:00Z,16,5,2020,23,3,Kenya,KE,KEN,52573967,Africa,45,781,31
2020-05-17T00:00:00Z,17,5,2020,49,5,Kenya,KE,KEN,52573967,Africa,50,830,32
2020-05-18T00:00:00Z,18,5,2020,57,0,Kenya,KE,KEN,52573967,Africa,50,887,33
2020-05-19T00:00:00Z,19,5,2020,25,0,Kenya,KE,KEN,52573967,Africa,50,912,34
2020-05-20T00:00:00Z,20,5,2020,51,0,Kenya,KE,KEN,52573967,Africa,50,963,35
2020-05-21T00:00:00Z,21,5,2020,66,0,Kenya,KE,KEN,52573967,Africa,50,1029,36
2020-05-22T00:00:00Z,22,5,2020,80,0,Kenya,KE,KEN,52573967,Africa,50,1109,37
2020-05-23T00:00:00Z,23,5,2020,52,0,Kenya,KE,KEN,52573967,Africa,50,1161,38
2020-05-24T00:00:00Z,24,5,2020,31,0,Kenya,KE,KEN,52573967,Africa,50,1192,39
2020-05-25T00:00:00Z,25,5,2020,22,1,Kenya,KE,KEN,52573967,Africa,51,1214,40
2020-05-26T00:00:00Z,26,5,2020,72,1,Kenya,KE,KEN,52573967,Africa,52,1286,41
2020-05-27T00:00:00Z,27,5,2020,62,0,Kenya,KE,KEN,52573967,Africa,52,1348,42
2020-05-28T00:00:00Z,28,5,2020,123,3,Kenya,KE,KEN,52573967,Africa,55,1471,43
2020-05-29T00:00:00Z,29,5,2020,147,3,Kenya,KE,KEN,52573967,Africa,58,1618,44
2020-05-30T00:00:00Z,30,5,2020,127,4,Kenya,KE,KEN,52573967,Africa,62,1745,45
2020-05-31T00:00:00Z,31,5,2020,143,1,Kenya,KE,KEN,52573967,Africa,63,1888,46
2020-06-01T00:00:00Z,1,6,2020,74,1,Kenya,KE,KEN,52573967,Africa,64,1962,47
2020-06-02T00:00:00Z,2,6,2020,59,5,Kenya,KE,KEN,52573967,Africa,69,2021,48
2020-06-03T00:00:00Z,3,6,2020,72,2,Kenya,KE,KEN,52573967,Africa,71,2093,49
2020-06-04T00:00:00Z,4,6,2020,123,3,Kenya,KE,KEN,52573967,Africa,74,2216,50
2020-06-05T00:00:00Z,5,6,2020,124,4,Kenya,KE,KEN,52573967,Africa,78,2340,51
2020-06-06T00:00:00Z,6,6,2020,134,1,Kenya,KE,KEN,52573967,Africa,79,2474,52
2020-06-07T00:00:00Z,7,6,2020,126,4,Kenya,KE,KEN,52573967,Africa,83,2600,53
2020-06-08T00:00:00Z,8,6,2020,167,1,Kenya,KE,KEN,52573967,Africa,84,2767,54
2020-06-09T00:00:00Z,9,6,2020,95,1,Kenya,KE,KEN,52573967,Africa,85,2862,55
2020-06-10T00:00:00Z,10,6,2020,127,3,Kenya,KE,KEN,52573967,Africa,88,2989,56
2020-06-11T00:00:00Z,11,6,2020,105,1,Kenya,KE,KEN,52573967,Africa,89,3094,57
2020-06-12T00:00:00Z,12,6,2020,121,3,Kenya,KE,KEN,52573967,Africa,92,3215,58
2020-06-13T00:00:00Z,13,6,2020,90,4,Kenya,KE,KEN,52573967,Africa,96,3305,59
2020-06-14T00:00:00Z,14,6,2020,152,4,Kenya,KE,KEN,52573967,Africa,100,3457,60
2020-06-15T00:00:00Z,15,6,2020,137,3,Kenya,KE,KEN,52573967,Africa,103,3594,61
2020-06-16T00:00:00Z,16,6,2020,133,1,Kenya,KE,KEN,52573967,Africa,104,3727,62
2020-06-17T00:00:00Z,17,6,2020,133,1,Kenya,KE,KEN,52573967,Africa,105,3860,63
2020-06-18T00:00:00Z,18,6,2020,184,2,Kenya,KE,KEN,52573967,Africa,107,4044,64
2020-06-19T00:00:00Z,19,6,2020,213,10,Kenya,KE,KEN,52573967,Africa,117,4257,65
2020-06-20T00:00:00Z,20,6,2020,117,2,Kenya,KE,KEN,52573967,Africa,119,4374,66
2020-06-21T00:00:00Z,21,6,2020,104,2,Kenya,KE,KEN,52573967,Africa,121,4478,67
2020-06-22T00:00:00Z,22,6,2020,260,2,Kenya,KE,KEN,52573967,Africa,123,4738,68
2020-06-23T00:00:00Z,23,6,2020,59,2,Kenya,KE,KEN,52573967,Africa,125,4797,69
2020-06-24T00:00:00Z,24,6,2020,155,3,Kenya,KE,KEN,52573967,Africa,128,4952,70
2020-06-25T00:00:00Z,25,6,2020,254,2,Kenya,KE,KEN,52573967,Africa,130,5206,71
2020-04-17T00:00:00Z,17,4,2020,26,2,Kosovo,XK,XKX,1798506,Europe,11,449,1
2020-04-18T00:00:00Z,18,4,2020,31,1,Kosovo,XK,XKX,1798506,Europe,12,480,2
2020-04-19T00:00:00Z,19,4,2020,30,0,Kosovo,XK,XKX,1798506,Europe,12,510,3
2020-04-20T00:00:00Z,20,4,2020,0,0,Kosovo,XK,XKX,1798506,Europe,12,510,4
2020-04-21T00:00:00Z,21,4,2020,88,3,Kosovo,XK,XKX,1798506,Europe,15,598,5
2020-04-22T00:00:00Z,22,4,2020,6,3,Kosovo,XK,XKX,1798506,Europe,18,604,6
2020-04-23T00:00:00Z,23,4,2020,26,0,Kosovo,XK,XKX,1798506,Europe,18,630,7
2020-04-24T00:00:00Z,24,4,2020,39,1,Kosovo,XK,XKX,1798506,Europe,19,669,8
2020-04-25T00:00:00Z,25,4,2020,34,0,Kosovo,XK,XKX,1798506,Europe,19,703,9
2020-04-26T00:00:00Z,26,4,2020,28,1,Kosovo,XK,XKX,1798506,Europe,20,731,10
2020-04-27T00:00:00Z,27,4,2020,32,1,Kosovo,XK,XKX,1798506,Europe,21,763,11
2020-04-28T00:00:00Z,28,4,2020,17,1,Kosovo,XK,XKX,1798506,Europe,22,780,12
2020-04-29T00:00:00Z,29,4,2020,10,0,Kosovo,XK,XKX,1798506,Europe,22,790,13
2020-04-30T00:00:00Z,30,4,2020,9,0,Kosovo,XK,XKX,1798506,Europe,22,799,14
2020-05-01T00:00:00Z,1,5,2020,0,0,Kosovo,XK,XKX,1798506,Europe,22,799,15
2020-05-02T00:00:00Z,2,5,2020,14,0,Kosovo,XK,XKX,1798506,Europe,22,813,16
2020-05-03T00:00:00Z,3,5,2020,10,0,Kosovo,XK,XKX,1798506,Europe,22,823,17
2020-05-04T00:00:00Z,4,5,2020,28,0,Kosovo,XK,XKX,1798506,Europe,22,851,18
2020-05-05T00:00:00Z,5,5,2020,4,4,Kosovo,XK,XKX,1798506,Europe,26,855,19
2020-05-06T00:00:00Z,6,5,2020,1,0,Kosovo,XK,XKX,1798506,Europe,26,856,20
2020-05-07T00:00:00Z,7,5,2020,4,0,Kosovo,XK,XKX,1798506,Europe,26,860,21
2020-05-08T00:00:00Z,8,5,2020,1,1,Kosovo,XK,XKX,1798506,Europe,27,861,22
2020-05-09T00:00:00Z,9,5,2020,1,1,Kosovo,XK,XKX,1798506,Europe,28,862,23
2020-05-10T00:00:00Z,10,5,2020,8,0,Kosovo,XK,XKX,1798506,Europe,28,870,24
2020-05-11T00:00:00Z,11,5,2020,0,0,Kosovo,XK,XKX,1798506,Europe,28,870,25
2020-05-12T00:00:00Z,12,5,2020,14,0,Kosovo,XK,XKX,1798506,Europe,28,884,26
2020-05-13T00:00:00Z,13,5,2020,35,1,Kosovo,XK,XKX,1798506,Europe,29,919,27
2020-05-14T00:00:00Z,14,5,2020,0,0,Kosovo,XK,XKX,1798506,Europe,29,919,28
2020-05-15T00:00:00Z,15,5,2020,25,0,Kosovo,XK,XKX,1798506,Europe,29,944,29
2020-05-16T00:00:00Z,16,5,2020,0,0,Kosovo,XK,XKX,1798506,Europe,29,944,30
2020-05-17T00:00:00Z,17,5,2020,0,0,Kosovo,XK,XKX,1798506,Europe,29,944,31
2020-05-18T00:00:00Z,18,5,2020,11,0,Kosovo,XK,XKX,1798506,Europe,29,955,32
2020-05-19T00:00:00Z,19,5,2020,0,0,Kosovo,XK,XKX,1798506,Europe,29,955,33
2020-05-20T00:00:00Z,20,5,2020,34,0,Kosovo,XK,XKX,1798506,Europe,29,989,34
2020-05-21T00:00:00Z,21,5,2020,0,0,Kosovo,XK,XKX,1798506,Europe,29,989,35
2020-05-22T00:00:00Z,22,5,2020,14,0,Kosovo,XK,XKX,1798506,Europe,29,1003,36
2020-05-23T00:00:00Z,23,5,2020,1,0,Kosovo,XK,XKX,1798506,Europe,29,1004,37
2020-05-24T00:00:00Z,24,5,2020,21,0,Kosovo,XK,XKX,1798506,Europe,29,1025,38
2020-05-25T00:00:00Z,25,5,2020,7,0,Kosovo,XK,XKX,1798506,Europe,29,1032,39
2020-05-26T00:00:00Z,26,5,2020,6,1,Kosovo,XK,XKX,1798506,Europe,30,1038,40
2020-05-27T00:00:00Z,27,5,2020,0,0,Kosovo,XK,XKX,1798506,Europe,30,1038,41
2020-05-28T00:00:00Z,28,5,2020,9,0,Kosovo,XK,XKX,1798506,Europe,30,1047,42
2020-05-29T00:00:00Z,29,5,2020,1,0,Kosovo,XK,XKX,1798506,Europe,30,1048,43
2020-05-30T00:00:00Z,30,5,2020,0,0,Kosovo,XK,XKX,1798506,Europe,30,1048,44
2020-05-31T00:00:00Z,31,5,2020,16,0,Kosovo,XK,XKX,1798506,Europe,30,1064,45
2020-06-01T00:00:00Z,1,6,2020,0,0,Kosovo,XK,XKX,1798506,Europe,30,1064,46
2020-06-02T00:00:00Z,2,6,2020,0,0,Kosovo,XK,XKX,1798506,Europe,30,1064,47
2020-06-03T00:00:00Z,3,6,2020,3,0,Kosovo,XK,XKX,1798506,Europe,30,1067,48
2020-06-04T00:00:00Z,4,6,2020,75,0,Kosovo,XK,XKX,1798506,Europe,30,1142,49
2020-06-05T00:00:00Z,5,6,2020,0,0,Kosovo,XK,XKX,1798506,Europe,30,1142,50
2020-06-06T00:00:00Z,6,6,2020,0,0,Kosovo,XK,XKX,1798506,Europe,30,1142,51
2020-06-07T00:00:00Z,7,6,2020,0,0,Kosovo,XK,XKX,1798506,Europe,30,1142,52
2020-06-08T00:00:00Z,8,6,2020,0,0,Kosovo,XK,XKX,1798506,Europe,30,1142,53
2020-06-09T00:00:00Z,9,6,2020,121,1,Kosovo,XK,XKX,1798506,Europe,31,1263,54
2020-06-10T00:00:00Z,10,6,2020,0,0,Kosovo,XK,XKX,1798506,Europe,31,1263,55
2020-06-11T00:00:00Z,11,6,2020,35,0,Kosovo,XK,XKX,1798506,Europe,31,1298,56
2020-06-12T00:00:00Z,12,6,2020,28,0,Kosovo,XK,XKX,1798506,Europe,31,1326,57
2020-06-13T00:00:00Z,13,6,2020,0,0,Kosovo,XK,XKX,1798506,Europe,31,1326,58
2020-06-14T00:00:00Z,14,6,2020,111,1,Kosovo,XK,XKX,1798506,Europe,32,1437,59
2020-06-15T00:00:00Z,15,6,2020,0,0,Kosovo,XK,XKX,1798506,Europe,32,1437,60
2020-06-16T00:00:00Z,16,6,2020,49,1,Kosovo,XK,XKX,1798506,Europe,33,1486,61
2020-06-17T00:00:00Z,17,6,2020,0,0,Kosovo,XK,XKX,1798506,Europe,33,1486,62
2020-06-18T00:00:00Z,18,6,2020,0,0,Kosovo,XK,XKX,1798506,Europe,33,1486,63
2020-06-19T00:00:00Z,19,6,2020,0,0,Kosovo,XK,XKX,1798506,Europe,33,1486,64
2020-06-20T00:00:00Z,20,6,2020,0,0,Kosovo,XK,XKX,1798506,Europe,33,1486,65
2020-06-21T00:00:00Z,21,6,2020,0,0,Kosovo,XK,XKX,1798506,Europe,33,1486,66
2020-06-22T00:00:00Z,22,6,2020,0,0,Kosovo,XK,XKX,1798506,Europe,33,1486,67
2020-06-23T00:00:00Z,23,6,2020,683,4,Kosovo,XK,XKX,1798506,Europe,37,2169,68
2020-06-24T00:00:00Z,24,6,2020,0,0,Kosovo,XK,XKX,1798506,Europe,37,2169,69
2020-06-25T00:00:00Z,25,6,2020,0,0,Kosovo,XK,XKX,1798506,Europe,37,2169,70
2020-04-22T00:00:00Z,22,4,2020,85,2,Kuwait,KW,KWT,4207077,Asia,11,2080,1
2020-04-23T00:00:00Z,23,4,2020,168,2,Kuwait,KW,KWT,4207077,Asia,13,2248,2
2020-04-24T00:00:00Z,24,4,2020,151,1,Kuwait,KW,KWT,4207077,Asia,14,2399,3
2020-04-25T00:00:00Z,25,4,2020,215,1,Kuwait,KW,KWT,4207077,Asia,15,2614,4
2020-04-26T00:00:00Z,26,4,2020,278,4,Kuwait,KW,KWT,4207077,Asia,19,2892,5
2020-04-27T00:00:00Z,27,4,2020,183,1,Kuwait,KW,KWT,4207077,Asia,20,3075,6
2020-04-28T00:00:00Z,28,4,2020,213,2,Kuwait,KW,KWT,4207077,Asia,22,3288,7
2020-04-29T00:00:00Z,29,4,2020,152,1,Kuwait,KW,KWT,4207077,Asia,23,3440,8
2020-04-30T00:00:00Z,30,4,2020,300,1,Kuwait,KW,KWT,4207077,Asia,24,3740,9
2020-05-01T00:00:00Z,1,5,2020,284,2,Kuwait,KW,KWT,4207077,Asia,26,4024,10
2020-05-02T00:00:00Z,2,5,2020,353,4,Kuwait,KW,KWT,4207077,Asia,30,4377,11
2020-05-03T00:00:00Z,3,5,2020,242,3,Kuwait,KW,KWT,4207077,Asia,33,4619,12
2020-05-04T00:00:00Z,4,5,2020,364,5,Kuwait,KW,KWT,4207077,Asia,38,4983,13
2020-05-05T00:00:00Z,5,5,2020,295,2,Kuwait,KW,KWT,4207077,Asia,40,5278,14
2020-05-06T00:00:00Z,6,5,2020,526,0,Kuwait,KW,KWT,4207077,Asia,40,5804,15
2020-05-07T00:00:00Z,7,5,2020,485,2,Kuwait,KW,KWT,4207077,Asia,42,6289,16
2020-05-08T00:00:00Z,8,5,2020,278,2,Kuwait,KW,KWT,4207077,Asia,44,6567,17
2020-05-09T00:00:00Z,9,5,2020,641,3,Kuwait,KW,KWT,4207077,Asia,47,7208,18
2020-05-10T00:00:00Z,10,5,2020,415,2,Kuwait,KW,KWT,4207077,Asia,49,7623,19
2020-05-11T00:00:00Z,11,5,2020,1065,9,Kuwait,KW,KWT,4207077,Asia,58,8688,20
2020-05-12T00:00:00Z,12,5,2020,598,7,Kuwait,KW,KWT,4207077,Asia,65,9286,21
2020-05-13T00:00:00Z,13,5,2020,991,10,Kuwait,KW,KWT,4207077,Asia,75,10277,22
2020-05-14T00:00:00Z,14,5,2020,751,7,Kuwait,KW,KWT,4207077,Asia,82,11028,23
2020-05-15T00:00:00Z,15,5,2020,947,6,Kuwait,KW,KWT,4207077,Asia,88,11975,24
2020-05-16T00:00:00Z,16,5,2020,885,8,Kuwait,KW,KWT,4207077,Asia,96,12860,25
2020-05-17T00:00:00Z,17,5,2020,942,11,Kuwait,KW,KWT,4207077,Asia,107,13802,26
2020-05-18T00:00:00Z,18,5,2020,1048,5,Kuwait,KW,KWT,4207077,Asia,112,14850,27
2020-05-19T00:00:00Z,19,5,2020,841,6,Kuwait,KW,KWT,4207077,Asia,118,15691,28
2020-05-20T00:00:00Z,20,5,2020,1073,3,Kuwait,KW,KWT,4207077,Asia,121,16764,29
2020-05-21T00:00:00Z,21,5,2020,804,3,Kuwait,KW,KWT,4207077,Asia,124,17568,30
2020-05-22T00:00:00Z,22,5,2020,1041,5,Kuwait,KW,KWT,4207077,Asia,129,18609,31
2020-05-23T00:00:00Z,23,5,2020,955,9,Kuwait,KW,KWT,4207077,Asia,138,19564,32
2020-05-24T00:00:00Z,24,5,2020,900,10,Kuwait,KW,KWT,4207077,Asia,148,20464,33
2020-05-25T00:00:00Z,25,5,2020,838,8,Kuwait,KW,KWT,4207077,Asia,156,21302,34
2020-05-26T00:00:00Z,26,5,2020,665,9,Kuwait,KW,KWT,4207077,Asia,165,21967,35
2020-05-27T00:00:00Z,27,5,2020,608,7,Kuwait,KW,KWT,4207077,Asia,172,22575,36
2020-05-28T00:00:00Z,28,5,2020,692,3,Kuwait,KW,KWT,4207077,Asia,175,23267,37
2020-05-29T00:00:00Z,29,5,2020,845,10,Kuwait,KW,KWT,4207077,Asia,185,24112,38
2020-05-30T00:00:00Z,30,5,2020,1072,9,Kuwait,KW,KWT,4207077,Asia,194,25184,39
2020-05-31T00:00:00Z,31,5,2020,1008,11,Kuwait,KW,KWT,4207077,Asia,205,26192,40
2020-06-01T00:00:00Z,1,6,2020,851,7,Kuwait,KW,KWT,4207077,Asia,212,27043,41
2020-06-02T00:00:00Z,2,6,2020,719,8,Kuwait,KW,KWT,4207077,Asia,220,27762,42
2020-06-03T00:00:00Z,3,6,2020,887,6,Kuwait,KW,KWT,4207077,Asia,226,28649,43
2020-06-04T00:00:00Z,4,6,2020,710,4,Kuwait,KW,KWT,4207077,Asia,230,29359,44
2020-06-05T00:00:00Z,5,6,2020,562,6,Kuwait,KW,KWT,4207077,Asia,236,29921,45
2020-06-06T00:00:00Z,6,6,2020,723,8,Kuwait,KW,KWT,4207077,Asia,244,30644,46
2020-06-07T00:00:00Z,7,6,2020,487,10,Kuwait,KW,KWT,4207077,Asia,254,31131,47
2020-06-08T00:00:00Z,8,6,2020,717,10,Kuwait,KW,KWT,4207077,Asia,264,31848,48
2020-06-09T00:00:00Z,9,6,2020,662,5,Kuwait,KW,KWT,4207077,Asia,269,32510,49
2020-06-10T00:00:00Z,10,6,2020,630,4,Kuwait,KW,KWT,4207077,Asia,273,33140,50
2020-06-11T00:00:00Z,11,6,2020,683,2,Kuwait,KW,KWT,4207077,Asia,275,33823,51
2020-06-12T00:00:00Z,12,6,2020,609,4,Kuwait,KW,KWT,4207077,Asia,279,34432,52
2020-06-13T00:00:00Z,13,6,2020,520,6,Kuwait,KW,KWT,4207077,Asia,285,34952,53
2020-06-14T00:00:00Z,14,6,2020,514,4,Kuwait,KW,KWT,4207077,Asia,289,35466,54
2020-06-15T00:00:00Z,15,6,2020,454,7,Kuwait,KW,KWT,4207077,Asia,296,35920,55
2020-06-16T00:00:00Z,16,6,2020,511,2,Kuwait,KW,KWT,4207077,Asia,298,36431,56
2020-06-17T00:00:00Z,17,6,2020,527,5,Kuwait,KW,KWT,4207077,Asia,303,36958,57
2020-06-18T00:00:00Z,18,6,2020,575,3,Kuwait,KW,KWT,4207077,Asia,306,37533,58
2020-06-19T00:00:00Z,19,6,2020,541,2,Kuwait,KW,KWT,4207077,Asia,308,38074,59
2020-06-20T00:00:00Z,20,6,2020,604,5,Kuwait,KW,KWT,4207077,Asia,313,38678,60
2020-06-21T00:00:00Z,21,6,2020,467,6,Kuwait,KW,KWT,4207077,Asia,319,39145,61
2020-06-22T00:00:00Z,22,6,2020,505,7,Kuwait,KW,KWT,4207077,Asia,326,39650,62
2020-06-23T00:00:00Z,23,6,2020,641,4,Kuwait,KW,KWT,4207077,Asia,330,40291,63
2020-06-24T00:00:00Z,24,6,2020,742,4,Kuwait,KW,KWT,4207077,Asia,334,41033,64
2020-06-25T00:00:00Z,25,6,2020,846,3,Kuwait,KW,KWT,4207077,Asia,337,41879,65
2020-05-03T00:00:00Z,3,5,2020,26,2,Kyrgyzstan,KG,KGZ,6415851,Asia,10,795,1
2020-05-04T00:00:00Z,4,5,2020,35,0,Kyrgyzstan,KG,KGZ,6415851,Asia,10,830,2
2020-05-05T00:00:00Z,5,5,2020,13,1,Kyrgyzstan,KG,KGZ,6415851,Asia,11,843,3
2020-05-06T00:00:00Z,6,5,2020,28,1,Kyrgyzstan,KG,KGZ,6415851,Asia,12,871,4
2020-05-07T00:00:00Z,7,5,2020,24,0,Kyrgyzstan,KG,KGZ,6415851,Asia,12,895,5
2020-05-08T00:00:00Z,8,5,2020,11,0,Kyrgyzstan,KG,KGZ,6415851,Asia,12,906,6
2020-05-09T00:00:00Z,9,5,2020,25,0,Kyrgyzstan,KG,KGZ,6415851,Asia,12,931,7
2020-05-10T00:00:00Z,10,5,2020,71,0,Kyrgyzstan,KG,KGZ,6415851,Asia,12,1002,8
2020-05-11T00:00:00Z,11,5,2020,14,0,Kyrgyzstan,KG,KGZ,6415851,Asia,12,1016,9
2020-05-12T00:00:00Z,12,5,2020,21,0,Kyrgyzstan,KG,KGZ,6415851,Asia,12,1037,10
2020-05-13T00:00:00Z,13,5,2020,7,0,Kyrgyzstan,KG,KGZ,6415851,Asia,12,1044,11
2020-05-14T00:00:00Z,14,5,2020,38,0,Kyrgyzstan,KG,KGZ,6415851,Asia,12,1082,12
2020-05-15T00:00:00Z,15,5,2020,29,2,Kyrgyzstan,KG,KGZ,6415851,Asia,14,1111,13
2020-05-16T00:00:00Z,16,5,2020,6,0,Kyrgyzstan,KG,KGZ,6415851,Asia,14,1117,14
2020-05-17T00:00:00Z,17,5,2020,21,0,Kyrgyzstan,KG,KGZ,6415851,Asia,14,1138,15
2020-05-18T00:00:00Z,18,5,2020,78,0,Kyrgyzstan,KG,KGZ,6415851,Asia,14,1216,16
2020-05-19T00:00:00Z,19,5,2020,27,0,Kyrgyzstan,KG,KGZ,6415851,Asia,14,1243,17
2020-05-20T00:00:00Z,20,5,2020,27,0,Kyrgyzstan,KG,KGZ,6415851,Asia,14,1270,18
2020-05-21T00:00:00Z,21,5,2020,43,0,Kyrgyzstan,KG,KGZ,6415851,Asia,14,1313,19
2020-05-22T00:00:00Z,22,5,2020,37,0,Kyrgyzstan,KG,KGZ,6415851,Asia,14,1350,20
2020-05-23T00:00:00Z,23,5,2020,14,0,Kyrgyzstan,KG,KGZ,6415851,Asia,14,1364,21
2020-05-24T00:00:00Z,24,5,2020,39,0,Kyrgyzstan,KG,KGZ,6415851,Asia,14,1403,22
2020-05-25T00:00:00Z,25,5,2020,30,2,Kyrgyzstan,KG,KGZ,6415851,Asia,16,1433,23
2020-05-26T00:00:00Z,26,5,2020,35,0,Kyrgyzstan,KG,KGZ,6415851,Asia,16,1468,24
2020-05-27T00:00:00Z,27,5,2020,52,0,Kyrgyzstan,KG,KGZ,6415851,Asia,16,1520,25
2020-05-28T00:00:00Z,28,5,2020,74,0,Kyrgyzstan,KG,KGZ,6415851,Asia,16,1594,26
2020-05-29T00:00:00Z,29,5,2020,68,0,Kyrgyzstan,KG,KGZ,6415851,Asia,16,1662,27
2020-05-30T00:00:00Z,30,5,2020,60,0,Kyrgyzstan,KG,KGZ,6415851,Asia,16,1722,28
2020-05-31T00:00:00Z,31,5,2020,26,0,Kyrgyzstan,KG,KGZ,6415851,Asia,16,1748,29
2020-06-01T00:00:00Z,1,6,2020,69,0,Kyrgyzstan,KG,KGZ,6415851,Asia,16,1817,30
2020-06-02T00:00:00Z,2,6,2020,28,1,Kyrgyzstan,KG,KGZ,6415851,Asia,17,1845,31
2020-06-03T00:00:00Z,3,6,2020,26,3,Kyrgyzstan,KG,KGZ,6415851,Asia,20,1871,32
2020-06-04T00:00:00Z,4,6,2020,28,0,Kyrgyzstan,KG,KGZ,6415851,Asia,20,1899,33
2020-06-05T00:00:00Z,5,6,2020,37,2,Kyrgyzstan,KG,KGZ,6415851,Asia,22,1936,34
2020-06-06T00:00:00Z,6,6,2020,38,0,Kyrgyzstan,KG,KGZ,6415851,Asia,22,1974,35
2020-06-07T00:00:00Z,7,6,2020,33,0,Kyrgyzstan,KG,KGZ,6415851,Asia,22,2007,36
2020-06-08T00:00:00Z,8,6,2020,25,1,Kyrgyzstan,KG,KGZ,6415851,Asia,23,2032,37
2020-06-09T00:00:00Z,9,6,2020,23,1,Kyrgyzstan,KG,KGZ,6415851,Asia,24,2055,38
2020-06-10T00:00:00Z,10,6,2020,38,2,Kyrgyzstan,KG,KGZ,6415851,Asia,26,2093,39
2020-06-11T00:00:00Z,11,6,2020,36,0,Kyrgyzstan,KG,KGZ,6415851,Asia,26,2129,40
2020-06-12T00:00:00Z,12,6,2020,37,0,Kyrgyzstan,KG,KGZ,6415851,Asia,26,2166,41
2020-06-13T00:00:00Z,13,6,2020,41,1,Kyrgyzstan,KG,KGZ,6415851,Asia,27,2207,42
2020-06-14T00:00:00Z,14,6,2020,78,0,Kyrgyzstan,KG,KGZ,6415851,Asia,27,2285,43
2020-06-15T00:00:00Z,15,6,2020,87,0,Kyrgyzstan,KG,KGZ,6415851,Asia,27,2372,44
2020-06-16T00:00:00Z,16,6,2020,100,1,Kyrgyzstan,KG,KGZ,6415851,Asia,28,2472,45
2020-06-17T00:00:00Z,17,6,2020,90,2,Kyrgyzstan,KG,KGZ,6415851,Asia,30,2562,46
2020-06-18T00:00:00Z,18,6,2020,95,1,Kyrgyzstan,KG,KGZ,6415851,Asia,31,2657,47
2020-06-19T00:00:00Z,19,6,2020,132,1,Kyrgyzstan,KG,KGZ,6415851,Asia,32,2789,48
2020-06-20T00:00:00Z,20,6,2020,192,3,Kyrgyzstan,KG,KGZ,6415851,Asia,35,2981,49
2020-06-21T00:00:00Z,21,6,2020,170,2,Kyrgyzstan,KG,KGZ,6415851,Asia,37,3151,50
2020-06-22T00:00:00Z,22,6,2020,205,3,Kyrgyzstan,KG,KGZ,6415851,Asia,40,3356,51
2020-06-23T00:00:00Z,23,6,2020,163,1,Kyrgyzstan,KG,KGZ,6415851,Asia,41,3519,52
2020-06-24T00:00:00Z,24,6,2020,207,1,Kyrgyzstan,KG,KGZ,6415851,Asia,42,3726,53
2020-06-25T00:00:00Z,25,6,2020,228,1,Kyrgyzstan,KG,KGZ,6415851,Asia,43,3954,54
2020-04-23T00:00:00Z,23,4,2020,13,2,Latvia,LV,LVA,1919968,Europe,11,761,1
2020-04-24T00:00:00Z,24,4,2020,17,0,Latvia,LV,LVA,1919968,Europe,11,778,2
2020-04-25T00:00:00Z,25,4,2020,6,1,Latvia,LV,LVA,1919968,Europe,12,784,3
2020-04-26T00:00:00Z,26,4,2020,20,0,Latvia,LV,LVA,1919968,Europe,12,804,4
2020-04-27T00:00:00Z,27,4,2020,8,0,Latvia,LV,LVA,1919968,Europe,12,812,5
2020-04-28T00:00:00Z,28,4,2020,6,1,Latvia,LV,LVA,1919968,Europe,13,818,6
2020-04-29T00:00:00Z,29,4,2020,18,0,Latvia,LV,LVA,1919968,Europe,13,836,7
2020-04-30T00:00:00Z,30,4,2020,13,2,Latvia,LV,LVA,1919968,Europe,15,849,8
2020-05-01T00:00:00Z,1,5,2020,9,0,Latvia,LV,LVA,1919968,Europe,15,858,9
2020-05-02T00:00:00Z,2,5,2020,12,1,Latvia,LV,LVA,1919968,Europe,16,870,10
2020-05-03T00:00:00Z,3,5,2020,1,0,Latvia,LV,LVA,1919968,Europe,16,871,11
2020-05-04T00:00:00Z,4,5,2020,8,0,Latvia,LV,LVA,1919968,Europe,16,879,12
2020-05-05T00:00:00Z,5,5,2020,17,0,Latvia,LV,LVA,1919968,Europe,16,896,13
2020-05-06T00:00:00Z,6,5,2020,0,1,Latvia,LV,LVA,1919968,Europe,17,896,14
2020-05-07T00:00:00Z,7,5,2020,4,0,Latvia,LV,LVA,1919968,Europe,17,900,15
2020-05-08T00:00:00Z,8,5,2020,9,1,Latvia,LV,LVA,1919968,Europe,18,909,16
2020-05-09T00:00:00Z,9,5,2020,19,0,Latvia,LV,LVA,1919968,Europe,18,928,17
2020-05-10T00:00:00Z,10,5,2020,2,0,Latvia,LV,LVA,1919968,Europe,18,930,18
2020-05-11T00:00:00Z,11,5,2020,9,0,Latvia,LV,LVA,1919968,Europe,18,939,19
2020-05-12T00:00:00Z,12,5,2020,7,0,Latvia,LV,LVA,1919968,Europe,18,946,20
2020-05-13T00:00:00Z,13,5,2020,4,0,Latvia,LV,LVA,1919968,Europe,18,950,21
2020-05-14T00:00:00Z,14,5,2020,1,1,Latvia,LV,LVA,1919968,Europe,19,951,22
2020-05-15T00:00:00Z,15,5,2020,11,0,Latvia,LV,LVA,1919968,Europe,19,962,23
2020-05-16T00:00:00Z,16,5,2020,8,0,Latvia,LV,LVA,1919968,Europe,19,970,24
2020-05-17T00:00:00Z,17,5,2020,27,0,Latvia,LV,LVA,1919968,Europe,19,997,25
2020-05-18T00:00:00Z,18,5,2020,11,0,Latvia,LV,LVA,1919968,Europe,19,1008,26
2020-05-19T00:00:00Z,19,5,2020,1,0,Latvia,LV,LVA,1919968,Europe,19,1009,27
2020-05-20T00:00:00Z,20,5,2020,3,2,Latvia,LV,LVA,1919968,Europe,21,1012,28
2020-05-21T00:00:00Z,21,5,2020,4,0,Latvia,LV,LVA,1919968,Europe,21,1016,29
2020-05-22T00:00:00Z,22,5,2020,9,1,Latvia,LV,LVA,1919968,Europe,22,1025,30
2020-05-23T00:00:00Z,23,5,2020,5,0,Latvia,LV,LVA,1919968,Europe,22,1030,31
2020-05-24T00:00:00Z,24,5,2020,16,0,Latvia,LV,LVA,1919968,Europe,22,1046,32
2020-05-25T00:00:00Z,25,5,2020,1,0,Latvia,LV,LVA,1919968,Europe,22,1047,33
2020-05-26T00:00:00Z,26,5,2020,2,0,Latvia,LV,LVA,1919968,Europe,22,1049,34
2020-05-27T00:00:00Z,27,5,2020,4,0,Latvia,LV,LVA,1919968,Europe,22,1053,35
2020-05-28T00:00:00Z,28,5,2020,4,1,Latvia,LV,LVA,1919968,Europe,23,1057,36
2020-05-29T00:00:00Z,29,5,2020,4,1,Latvia,LV,LVA,1919968,Europe,24,1061,37
2020-05-30T00:00:00Z,30,5,2020,3,0,Latvia,LV,LVA,1919968,Europe,24,1064,38
2020-05-31T00:00:00Z,31,5,2020,1,0,Latvia,LV,LVA,1919968,Europe,24,1065,39
2020-06-01T00:00:00Z,1,6,2020,1,0,Latvia,LV,LVA,1919968,Europe,24,1066,40
2020-06-02T00:00:00Z,2,6,2020,5,0,Latvia,LV,LVA,1919968,Europe,24,1071,41
2020-06-03T00:00:00Z,3,6,2020,8,0,Latvia,LV,LVA,1919968,Europe,24,1079,42
2020-06-04T00:00:00Z,4,6,2020,0,0,Latvia,LV,LVA,1919968,Europe,24,1079,43
2020-06-05T00:00:00Z,5,6,2020,3,1,Latvia,LV,LVA,1919968,Europe,25,1082,44
2020-06-06T00:00:00Z,6,6,2020,0,0,Latvia,LV,LVA,1919968,Europe,25,1082,45
2020-06-07T00:00:00Z,7,6,2020,4,0,Latvia,LV,LVA,1919968,Europe,25,1086,46
2020-06-08T00:00:00Z,8,6,2020,2,0,Latvia,LV,LVA,1919968,Europe,25,1088,47
2020-06-09T00:00:00Z,9,6,2020,0,1,Latvia,LV,LVA,1919968,Europe,26,1088,48
2020-06-10T00:00:00Z,10,6,2020,1,0,Latvia,LV,LVA,1919968,Europe,26,1089,49
2020-06-11T00:00:00Z,11,6,2020,3,0,Latvia,LV,LVA,1919968,Europe,26,1092,50
2020-06-12T00:00:00Z,12,6,2020,2,0,Latvia,LV,LVA,1919968,Europe,26,1094,51
2020-06-13T00:00:00Z,13,6,2020,2,1,Latvia,LV,LVA,1919968,Europe,27,1096,52
2020-06-14T00:00:00Z,14,6,2020,1,1,Latvia,LV,LVA,1919968,Europe,28,1097,53
2020-06-15T00:00:00Z,15,6,2020,0,0,Latvia,LV,LVA,1919968,Europe,28,1097,54
2020-06-16T00:00:00Z,16,6,2020,0,0,Latvia,LV,LVA,1919968,Europe,28,1097,55
2020-06-17T00:00:00Z,17,6,2020,1,0,Latvia,LV,LVA,1919968,Europe,28,1098,56
2020-06-18T00:00:00Z,18,6,2020,6,2,Latvia,LV,LVA,1919968,Europe,30,1104,57
2020-06-19T00:00:00Z,19,6,2020,4,0,Latvia,LV,LVA,1919968,Europe,30,1108,58
2020-06-20T00:00:00Z,20,6,2020,2,0,Latvia,LV,LVA,1919968,Europe,30,1110,59
2020-06-21T00:00:00Z,21,6,2020,1,0,Latvia,LV,LVA,1919968,Europe,30,1111,60
2020-06-22T00:00:00Z,22,6,2020,0,0,Latvia,LV,LVA,1919968,Europe,30,1111,61
2020-06-23T00:00:00Z,23,6,2020,0,0,Latvia,LV,LVA,1919968,Europe,30,1111,62
2020-06-24T00:00:00Z,24,6,2020,0,0,Latvia,LV,LVA,1919968,Europe,30,1111,63
2020-06-25T00:00:00Z,25,6,2020,0,0,Latvia,LV,LVA,1919968,Europe,30,1111,64
2020-03-30T00:00:00Z,30,3,2020,26,2,Lebanon,LB,LBN,6855709,Asia,10,438,1
2020-03-31T00:00:00Z,31,3,2020,8,1,Lebanon,LB,LBN,6855709,Asia,11,446,2
2020-04-01T00:00:00Z,1,4,2020,17,1,Lebanon,LB,LBN,6855709,Asia,12,463,3
2020-04-02T00:00:00Z,2,4,2020,16,0,Lebanon,LB,LBN,6855709,Asia,12,479,4
2020-04-03T00:00:00Z,3,4,2020,15,4,Lebanon,LB,LBN,6855709,Asia,16,494,5
2020-04-04T00:00:00Z,4,4,2020,0,0,Lebanon,LB,LBN,6855709,Asia,16,494,6
2020-04-05T00:00:00Z,5,4,2020,26,1,Lebanon,LB,LBN,6855709,Asia,17,520,7
2020-04-06T00:00:00Z,6,4,2020,7,1,Lebanon,LB,LBN,6855709,Asia,18,527,8
2020-04-07T00:00:00Z,7,4,2020,14,1,Lebanon,LB,LBN,6855709,Asia,19,541,9
2020-04-08T00:00:00Z,8,4,2020,7,0,Lebanon,LB,LBN,6855709,Asia,19,548,10
2020-04-09T00:00:00Z,9,4,2020,27,0,Lebanon,LB,LBN,6855709,Asia,19,575,11
2020-04-10T00:00:00Z,10,4,2020,7,0,Lebanon,LB,LBN,6855709,Asia,19,582,12
2020-04-11T00:00:00Z,11,4,2020,27,1,Lebanon,LB,LBN,6855709,Asia,20,609,13
2020-04-12T00:00:00Z,12,4,2020,10,0,Lebanon,LB,LBN,6855709,Asia,20,619,14
2020-04-13T00:00:00Z,13,4,2020,11,0,Lebanon,LB,LBN,6855709,Asia,20,630,15
2020-04-14T00:00:00Z,14,4,2020,2,0,Lebanon,LB,LBN,6855709,Asia,20,632,16
2020-04-15T00:00:00Z,15,4,2020,9,1,Lebanon,LB,LBN,6855709,Asia,21,641,17
2020-04-16T00:00:00Z,16,4,2020,17,0,Lebanon,LB,LBN,6855709,Asia,21,658,18
2020-04-17T00:00:00Z,17,4,2020,5,0,Lebanon,LB,LBN,6855709,Asia,21,663,19
2020-04-18T00:00:00Z,18,4,2020,5,0,Lebanon,LB,LBN,6855709,Asia,21,668,20
2020-04-19T00:00:00Z,19,4,2020,4,0,Lebanon,LB,LBN,6855709,Asia,21,672,21
2020-04-20T00:00:00Z,20,4,2020,1,0,Lebanon,LB,LBN,6855709,Asia,21,673,22
2020-04-21T00:00:00Z,21,4,2020,4,0,Lebanon,LB,LBN,6855709,Asia,21,677,23
2020-04-22T00:00:00Z,22,4,2020,0,0,Lebanon,LB,LBN,6855709,Asia,21,677,24
2020-04-23T00:00:00Z,23,4,2020,5,1,Lebanon,LB,LBN,6855709,Asia,22,682,25
2020-04-24T00:00:00Z,24,4,2020,6,0,Lebanon,LB,LBN,6855709,Asia,22,688,26
2020-04-25T00:00:00Z,25,4,2020,8,0,Lebanon,LB,LBN,6855709,Asia,22,696,27
2020-04-26T00:00:00Z,26,4,2020,8,2,Lebanon,LB,LBN,6855709,Asia,24,704,28
2020-04-27T00:00:00Z,27,4,2020,3,0,Lebanon,LB,LBN,6855709,Asia,24,707,29
2020-04-28T00:00:00Z,28,4,2020,3,0,Lebanon,LB,LBN,6855709,Asia,24,710,30
2020-04-29T00:00:00Z,29,4,2020,7,0,Lebanon,LB,LBN,6855709,Asia,24,717,31
2020-04-30T00:00:00Z,30,4,2020,4,0,Lebanon,LB,LBN,6855709,Asia,24,721,32
2020-05-01T00:00:00Z,1,5,2020,4,0,Lebanon,LB,LBN,6855709,Asia,24,725,33
2020-05-02T00:00:00Z,2,5,2020,4,0,Lebanon,LB,LBN,6855709,Asia,24,729,34
2020-05-03T00:00:00Z,3,5,2020,4,1,Lebanon,LB,LBN,6855709,Asia,25,733,35
2020-05-04T00:00:00Z,4,5,2020,4,0,Lebanon,LB,LBN,6855709,Asia,25,737,36
2020-05-05T00:00:00Z,5,5,2020,3,0,Lebanon,LB,LBN,6855709,Asia,25,740,37
2020-05-06T00:00:00Z,6,5,2020,1,0,Lebanon,LB,LBN,6855709,Asia,25,741,38
2020-05-07T00:00:00Z,7,5,2020,9,0,Lebanon,LB,LBN,6855709,Asia,25,750,39
2020-05-08T00:00:00Z,8,5,2020,34,0,Lebanon,LB,LBN,6855709,Asia,25,784,40
2020-05-09T00:00:00Z,9,5,2020,12,1,Lebanon,LB,LBN,6855709,Asia,26,796,41
2020-05-10T00:00:00Z,10,5,2020,13,0,Lebanon,LB,LBN,6855709,Asia,26,809,42
2020-05-11T00:00:00Z,11,5,2020,36,0,Lebanon,LB,LBN,6855709,Asia,26,845,43
2020-05-12T00:00:00Z,12,5,2020,14,0,Lebanon,LB,LBN,6855709,Asia,26,859,44
2020-05-13T00:00:00Z,13,5,2020,11,0,Lebanon,LB,LBN,6855709,Asia,26,870,45
2020-05-14T00:00:00Z,14,5,2020,8,0,Lebanon,LB,LBN,6855709,Asia,26,878,46
2020-05-15T00:00:00Z,15,5,2020,8,0,Lebanon,LB,LBN,6855709,Asia,26,886,47
2020-05-16T00:00:00Z,16,5,2020,5,0,Lebanon,LB,LBN,6855709,Asia,26,891,48
2020-05-17T00:00:00Z,17,5,2020,11,0,Lebanon,LB,LBN,6855709,Asia,26,902,49
2020-05-18T00:00:00Z,18,5,2020,9,0,Lebanon,LB,LBN,6855709,Asia,26,911,50
2020-05-19T00:00:00Z,19,5,2020,20,0,Lebanon,LB,LBN,6855709,Asia,26,931,51
2020-05-20T00:00:00Z,20,5,2020,23,0,Lebanon,LB,LBN,6855709,Asia,26,954,52
2020-05-21T00:00:00Z,21,5,2020,7,0,Lebanon,LB,LBN,6855709,Asia,26,961,53
2020-05-22T00:00:00Z,22,5,2020,63,0,Lebanon,LB,LBN,6855709,Asia,26,1024,54
2020-05-23T00:00:00Z,23,5,2020,62,0,Lebanon,LB,LBN,6855709,Asia,26,1086,55
2020-05-24T00:00:00Z,24,5,2020,11,0,Lebanon,LB,LBN,6855709,Asia,26,1097,56
2020-05-25T00:00:00Z,25,5,2020,17,0,Lebanon,LB,LBN,6855709,Asia,26,1114,57
2020-05-26T00:00:00Z,26,5,2020,5,0,Lebanon,LB,LBN,6855709,Asia,26,1119,58
2020-05-27T00:00:00Z,27,5,2020,21,0,Lebanon,LB,LBN,6855709,Asia,26,1140,59
2020-05-28T00:00:00Z,28,5,2020,21,0,Lebanon,LB,LBN,6855709,Asia,26,1161,60
2020-05-29T00:00:00Z,29,5,2020,7,0,Lebanon,LB,LBN,6855709,Asia,26,1168,61
2020-05-30T00:00:00Z,30,5,2020,4,0,Lebanon,LB,LBN,6855709,Asia,26,1172,62
2020-05-31T00:00:00Z,31,5,2020,19,0,Lebanon,LB,LBN,6855709,Asia,26,1191,63
2020-06-01T00:00:00Z,1,6,2020,29,1,Lebanon,LB,LBN,6855709,Asia,27,1220,64
2020-06-02T00:00:00Z,2,6,2020,13,0,Lebanon,LB,LBN,6855709,Asia,27,1233,65
2020-06-03T00:00:00Z,3,6,2020,9,0,Lebanon,LB,LBN,6855709,Asia,27,1242,66
2020-06-04T00:00:00Z,4,6,2020,14,0,Lebanon,LB,LBN,6855709,Asia,27,1256,67
2020-06-05T00:00:00Z,5,6,2020,50,1,Lebanon,LB,LBN,6855709,Asia,28,1306,68
2020-06-06T00:00:00Z,6,6,2020,6,0,Lebanon,LB,LBN,6855709,Asia,28,1312,69
2020-06-07T00:00:00Z,7,6,2020,8,1,Lebanon,LB,LBN,6855709,Asia,29,1320,70
2020-06-08T00:00:00Z,8,6,2020,11,1,Lebanon,LB,LBN,6855709,Asia,30,1331,71
2020-06-09T00:00:00Z,9,6,2020,19,0,Lebanon,LB,LBN,6855709,Asia,30,1350,72
2020-06-10T00:00:00Z,10,6,2020,18,0,Lebanon,LB,LBN,6855709,Asia,30,1368,73
2020-06-11T00:00:00Z,11,6,2020,20,0,Lebanon,LB,LBN,6855709,Asia,30,1388,74
2020-06-12T00:00:00Z,12,6,2020,14,1,Lebanon,LB,LBN,6855709,Asia,31,1402,75
2020-06-13T00:00:00Z,13,6,2020,20,0,Lebanon,LB,LBN,6855709,Asia,31,1422,76
2020-06-14T00:00:00Z,14,6,2020,20,1,Lebanon,LB,LBN,6855709,Asia,32,1442,77
2020-06-15T00:00:00Z,15,6,2020,4,0,Lebanon,LB,LBN,6855709,Asia,32,1446,78
2020-06-16T00:00:00Z,16,6,2020,18,0,Lebanon,LB,LBN,6855709,Asia,32,1464,79
2020-06-17T00:00:00Z,17,6,2020,9,0,Lebanon,LB,LBN,6855709,Asia,32,1473,80
2020-06-18T00:00:00Z,18,6,2020,16,0,Lebanon,LB,LBN,6855709,Asia,32,1489,81
2020-06-19T00:00:00Z,19,6,2020,6,0,Lebanon,LB,LBN,6855709,Asia,32,1495,82
2020-06-20T00:00:00Z,20,6,2020,15,0,Lebanon,LB,LBN,6855709,Asia,32,1510,83
2020-06-21T00:00:00Z,21,6,2020,26,0,Lebanon,LB,LBN,6855709,Asia,32,1536,84
2020-06-22T00:00:00Z,22,6,2020,51,0,Lebanon,LB,LBN,6855709,Asia,32,1587,85
2020-06-23T00:00:00Z,23,6,2020,16,0,Lebanon,LB,LBN,6855709,Asia,32,1603,86
2020-06-24T00:00:00Z,24,6,2020,19,0,Lebanon,LB,LBN,6855709,Asia,32,1622,87
2020-06-25T00:00:00Z,25,6,2020,22,1,Lebanon,LB,LBN,6855709,Asia,33,1644,88
2020-04-26T00:00:00Z,26,4,2020,3,3,Liberia,LR,LBR,4937374,Africa,11,120,1
2020-04-27T00:00:00Z,27,4,2020,4,1,Liberia,LR,LBR,4937374,Africa,12,124,2
2020-04-28T00:00:00Z,28,4,2020,9,4,Liberia,LR,LBR,4937374,Africa,16,133,3
2020-04-29T00:00:00Z,29,4,2020,8,0,Liberia,LR,LBR,4937374,Africa,16,141,4
2020-04-30T00:00:00Z,30,4,2020,0,0,Liberia,LR,LBR,4937374,Africa,16,141,5
2020-05-01T00:00:00Z,1,5,2020,0,0,Liberia,LR,LBR,4937374,Africa,16,141,6
2020-05-02T00:00:00Z,2,5,2020,11,2,Liberia,LR,LBR,4937374,Africa,18,152,7
2020-05-03T00:00:00Z,3,5,2020,2,0,Liberia,LR,LBR,4937374,Africa,18,154,8
2020-05-04T00:00:00Z,4,5,2020,4,0,Liberia,LR,LBR,4937374,Africa,18,158,9
2020-05-05T00:00:00Z,5,5,2020,8,0,Liberia,LR,LBR,4937374,Africa,18,166,10
2020-05-06T00:00:00Z,6,5,2020,4,2,Liberia,LR,LBR,4937374,Africa,20,170,11
2020-05-07T00:00:00Z,7,5,2020,8,0,Liberia,LR,LBR,4937374,Africa,20,178,12
2020-05-08T00:00:00Z,8,5,2020,11,0,Liberia,LR,LBR,4937374,Africa,20,189,13
2020-05-09T00:00:00Z,9,5,2020,10,0,Liberia,LR,LBR,4937374,Africa,20,199,14
2020-05-10T00:00:00Z,10,5,2020,0,0,Liberia,LR,LBR,4937374,Africa,20,199,15
2020-05-11T00:00:00Z,11,5,2020,0,0,Liberia,LR,LBR,4937374,Africa,20,199,16
2020-05-12T00:00:00Z,12,5,2020,12,0,Liberia,LR,LBR,4937374,Africa,20,211,17
2020-05-13T00:00:00Z,13,5,2020,1,0,Liberia,LR,LBR,4937374,Africa,20,212,18
2020-05-14T00:00:00Z,14,5,2020,1,0,Liberia,LR,LBR,4937374,Africa,20,213,19
2020-05-15T00:00:00Z,15,5,2020,2,0,Liberia,LR,LBR,4937374,Africa,20,215,20
2020-05-16T00:00:00Z,16,5,2020,4,0,Liberia,LR,LBR,4937374,Africa,20,219,21
2020-05-17T00:00:00Z,17,5,2020,4,0,Liberia,LR,LBR,4937374,Africa,20,223,22
2020-05-18T00:00:00Z,18,5,2020,3,1,Liberia,LR,LBR,4937374,Africa,21,226,23
2020-05-19T00:00:00Z,19,5,2020,3,1,Liberia,LR,LBR,4937374,Africa,22,229,24
2020-05-20T00:00:00Z,20,5,2020,4,1,Liberia,LR,LBR,4937374,Africa,23,233,25
2020-05-21T00:00:00Z,21,5,2020,5,0,Liberia,LR,LBR,4937374,Africa,23,238,26
2020-05-22T00:00:00Z,22,5,2020,2,0,Liberia,LR,LBR,4937374,Africa,23,240,27
2020-05-23T00:00:00Z,23,5,2020,9,1,Liberia,LR,LBR,4937374,Africa,24,249,28
2020-05-24T00:00:00Z,24,5,2020,6,2,Liberia,LR,LBR,4937374,Africa,26,255,29
2020-05-25T00:00:00Z,25,5,2020,10,0,Liberia,LR,LBR,4937374,Africa,26,265,30
2020-05-26T00:00:00Z,26,5,2020,0,0,Liberia,LR,LBR,4937374,Africa,26,265,31
2020-05-27T00:00:00Z,27,5,2020,1,0,Liberia,LR,LBR,4937374,Africa,26,266,32
2020-05-28T00:00:00Z,28,5,2020,0,1,Liberia,LR,LBR,4937374,Africa,27,266,33
2020-05-29T00:00:00Z,29,5,2020,3,0,Liberia,LR,LBR,4937374,Africa,27,269,34
2020-05-30T00:00:00Z,30,5,2020,4,0,Liberia,LR,LBR,4937374,Africa,27,273,35
2020-05-31T00:00:00Z,31,5,2020,7,0,Liberia,LR,LBR,4937374,Africa,27,280,36
2020-06-01T00:00:00Z,1,6,2020,8,0,Liberia,LR,LBR,4937374,Africa,27,288,37
2020-06-02T00:00:00Z,2,6,2020,8,0,Liberia,LR,LBR,4937374,Africa,27,296,38
2020-06-03T00:00:00Z,3,6,2020,15,1,Liberia,LR,LBR,4937374,Africa,28,311,39
2020-06-04T00:00:00Z,4,6,2020,5,0,Liberia,LR,LBR,4937374,Africa,28,316,40
2020-06-05T00:00:00Z,5,6,2020,5,0,Liberia,LR,LBR,4937374,Africa,28,321,41
2020-06-06T00:00:00Z,6,6,2020,13,2,Liberia,LR,LBR,4937374,Africa,30,334,42
2020-06-07T00:00:00Z,7,6,2020,11,0,Liberia,LR,LBR,4937374,Africa,30,345,43
2020-06-08T00:00:00Z,8,6,2020,14,0,Liberia,LR,LBR,4937374,Africa,30,359,44
2020-06-09T00:00:00Z,9,6,2020,11,0,Liberia,LR,LBR,4937374,Africa,30,370,45
2020-06-10T00:00:00Z,10,6,2020,13,1,Liberia,LR,LBR,4937374,Africa,31,383,46
2020-06-11T00:00:00Z,11,6,2020,14,0,Liberia,LR,LBR,4937374,Africa,31,397,47
2020-06-12T00:00:00Z,12,6,2020,13,0,Liberia,LR,LBR,4937374,Africa,31,410,48
2020-06-13T00:00:00Z,13,6,2020,11,1,Liberia,LR,LBR,4937374,Africa,32,421,49
2020-06-14T00:00:00Z,14,6,2020,25,0,Liberia,LR,LBR,4937374,Africa,32,446,50
2020-06-15T00:00:00Z,15,6,2020,12,0,Liberia,LR,LBR,4937374,Africa,32,458,51
2020-06-16T00:00:00Z,16,6,2020,40,1,Liberia,LR,LBR,4937374,Africa,33,498,52
2020-06-17T00:00:00Z,17,6,2020,11,0,Liberia,LR,LBR,4937374,Africa,33,509,53
2020-06-18T00:00:00Z,18,6,2020,0,0,Liberia,LR,LBR,4937374,Africa,33,509,54
2020-06-19T00:00:00Z,19,6,2020,33,0,Liberia,LR,LBR,4937374,Africa,33,542,55
2020-06-20T00:00:00Z,20,6,2020,39,0,Liberia,LR,LBR,4937374,Africa,33,581,56
2020-06-21T00:00:00Z,21,6,2020,20,0,Liberia,LR,LBR,4937374,Africa,33,601,57
2020-06-22T00:00:00Z,22,6,2020,25,1,Liberia,LR,LBR,4937374,Africa,34,626,58
2020-06-23T00:00:00Z,23,6,2020,24,0,Liberia,LR,LBR,4937374,Africa,34,650,59
2020-06-24T00:00:00Z,24,6,2020,2,0,Liberia,LR,LBR,4937374,Africa,34,652,60
2020-06-25T00:00:00Z,25,6,2020,10,0,Liberia,LR,LBR,4937374,Africa,34,662,61
2020-06-16T00:00:00Z,16,6,2020,49,2,Libya,LY,LBY,6777453,Africa,10,467,1
2020-06-17T00:00:00Z,17,6,2020,0,0,Libya,LY,LBY,6777453,Africa,10,467,2
2020-06-18T00:00:00Z,18,6,2020,0,0,Libya,LY,LBY,6777453,Africa,10,467,3
2020-06-19T00:00:00Z,19,6,2020,33,0,Libya,LY,LBY,6777453,Africa,10,500,4
2020-06-20T00:00:00Z,20,6,2020,10,0,Libya,LY,LBY,6777453,Africa,10,510,5
2020-06-21T00:00:00Z,21,6,2020,10,0,Libya,LY,LBY,6777453,Africa,10,520,6
2020-06-22T00:00:00Z,22,6,2020,24,0,Libya,LY,LBY,6777453,Africa,10,544,7
2020-06-23T00:00:00Z,23,6,2020,27,0,Libya,LY,LBY,6777453,Africa,10,571,8
2020-06-24T00:00:00Z,24,6,2020,68,7,Libya,LY,LBY,6777453,Africa,17,639,9
2020-06-25T00:00:00Z,25,6,2020,0,1,Libya,LY,LBY,6777453,Africa,18,639,10
2020-04-06T00:00:00Z,6,4,2020,40,4,Lithuania,LT,LTU,2794184,Europe,13,811,1
2020-04-07T00:00:00Z,7,4,2020,32,1,Lithuania,LT,LTU,2794184,Europe,14,843,2
2020-04-08T00:00:00Z,8,4,2020,37,1,Lithuania,LT,LTU,2794184,Europe,15,880,3
2020-04-09T00:00:00Z,9,4,2020,32,0,Lithuania,LT,LTU,2794184,Europe,15,912,4
2020-04-10T00:00:00Z,10,4,2020,43,0,Lithuania,LT,LTU,2794184,Europe,15,955,5
2020-04-11T00:00:00Z,11,4,2020,44,2,Lithuania,LT,LTU,2794184,Europe,17,999,6
2020-04-12T00:00:00Z,12,4,2020,54,6,Lithuania,LT,LTU,2794184,Europe,23,1053,7
2020-04-13T00:00:00Z,13,4,2020,9,1,Lithuania,LT,LTU,2794184,Europe,24,1062,8
2020-04-14T00:00:00Z,14,4,2020,8,0,Lithuania,LT,LTU,2794184,Europe,24,1070,9
2020-04-15T00:00:00Z,15,4,2020,0,0,Lithuania,LT,LTU,2794184,Europe,24,1070,10
2020-04-16T00:00:00Z,16,4,2020,21,5,Lithuania,LT,LTU,2794184,Europe,29,1091,11
2020-04-17T00:00:00Z,17,4,2020,58,3,Lithuania,LT,LTU,2794184,Europe,32,1149,12
2020-04-18T00:00:00Z,18,4,2020,90,1,Lithuania,LT,LTU,2794184,Europe,33,1239,13
2020-04-19T00:00:00Z,19,4,2020,59,0,Lithuania,LT,LTU,2794184,Europe,33,1298,14
2020-04-20T00:00:00Z,20,4,2020,28,3,Lithuania,LT,LTU,2794184,Europe,36,1326,15
2020-04-21T00:00:00Z,21,4,2020,24,1,Lithuania,LT,LTU,2794184,Europe,37,1350,16
2020-04-22T00:00:00Z,22,4,2020,20,1,Lithuania,LT,LTU,2794184,Europe,38,1370,17
2020-04-23T00:00:00Z,23,4,2020,28,0,Lithuania,LT,LTU,2794184,Europe,38,1398,18
2020-04-24T00:00:00Z,24,4,2020,12,2,Lithuania,LT,LTU,2794184,Europe,40,1410,19
2020-04-25T00:00:00Z,25,4,2020,0,0,Lithuania,LT,LTU,2794184,Europe,40,1410,20
2020-04-26T00:00:00Z,26,4,2020,16,1,Lithuania,LT,LTU,2794184,Europe,41,1426,21
2020-04-27T00:00:00Z,27,4,2020,12,0,Lithuania,LT,LTU,2794184,Europe,41,1438,22
2020-04-28T00:00:00Z,28,4,2020,11,0,Lithuania,LT,LTU,2794184,Europe,41,1449,23
2020-04-29T00:00:00Z,29,4,2020,-105,3,Lithuania,LT,LTU,2794184,Europe,44,1344,24
2020-04-30T00:00:00Z,30,4,2020,31,1,Lithuania,LT,LTU,2794184,Europe,45,1375,25
2020-05-01T00:00:00Z,1,5,2020,10,0,Lithuania,LT,LTU,2794184,Europe,45,1385,26
2020-05-02T00:00:00Z,2,5,2020,14,0,Lithuania,LT,LTU,2794184,Europe,45,1399,27
2020-05-03T00:00:00Z,3,5,2020,7,1,Lithuania,LT,LTU,2794184,Europe,46,1406,28
2020-05-04T00:00:00Z,4,5,2020,4,0,Lithuania,LT,LTU,2794184,Europe,46,1410,29
2020-05-05T00:00:00Z,5,5,2020,9,0,Lithuania,LT,LTU,2794184,Europe,46,1419,30
2020-05-06T00:00:00Z,6,5,2020,4,0,Lithuania,LT,LTU,2794184,Europe,46,1423,31
2020-05-07T00:00:00Z,7,5,2020,5,2,Lithuania,LT,LTU,2794184,Europe,48,1428,32
2020-05-08T00:00:00Z,8,5,2020,5,1,Lithuania,LT,LTU,2794184,Europe,49,1433,33
2020-05-09T00:00:00Z,9,5,2020,3,0,Lithuania,LT,LTU,2794184,Europe,49,1436,34
2020-05-10T00:00:00Z,10,5,2020,8,1,Lithuania,LT,LTU,2794184,Europe,50,1444,35
2020-05-11T00:00:00Z,11,5,2020,35,0,Lithuania,LT,LTU,2794184,Europe,50,1479,36
2020-05-12T00:00:00Z,12,5,2020,6,0,Lithuania,LT,LTU,2794184,Europe,50,1485,37
2020-05-13T00:00:00Z,13,5,2020,6,0,Lithuania,LT,LTU,2794184,Europe,50,1491,38
2020-05-14T00:00:00Z,14,5,2020,14,4,Lithuania,LT,LTU,2794184,Europe,54,1505,39
2020-05-15T00:00:00Z,15,5,2020,6,0,Lithuania,LT,LTU,2794184,Europe,54,1511,40
2020-05-16T00:00:00Z,16,5,2020,12,0,Lithuania,LT,LTU,2794184,Europe,54,1523,41
2020-05-17T00:00:00Z,17,5,2020,11,1,Lithuania,LT,LTU,2794184,Europe,55,1534,42
2020-05-18T00:00:00Z,18,5,2020,7,1,Lithuania,LT,LTU,2794184,Europe,56,1541,43
2020-05-19T00:00:00Z,19,5,2020,6,3,Lithuania,LT,LTU,2794184,Europe,59,1547,44
2020-05-20T00:00:00Z,20,5,2020,15,1,Lithuania,LT,LTU,2794184,Europe,60,1562,45
2020-05-21T00:00:00Z,21,5,2020,15,0,Lithuania,LT,LTU,2794184,Europe,60,1577,46
2020-05-22T00:00:00Z,22,5,2020,17,1,Lithuania,LT,LTU,2794184,Europe,61,1594,47
2020-05-23T00:00:00Z,23,5,2020,10,0,Lithuania,LT,LTU,2794184,Europe,61,1604,48
2020-05-24T00:00:00Z,24,5,2020,12,2,Lithuania,LT,LTU,2794184,Europe,63,1616,49
2020-05-25T00:00:00Z,25,5,2020,7,0,Lithuania,LT,LTU,2794184,Europe,63,1623,50
2020-05-26T00:00:00Z,26,5,2020,12,0,Lithuania,LT,LTU,2794184,Europe,63,1635,51
2020-05-27T00:00:00Z,27,5,2020,4,2,Lithuania,LT,LTU,2794184,Europe,65,1639,52
2020-05-28T00:00:00Z,28,5,2020,8,1,Lithuania,LT,LTU,2794184,Europe,66,1647,53
2020-05-29T00:00:00Z,29,5,2020,9,2,Lithuania,LT,LTU,2794184,Europe,68,1656,54
2020-05-30T00:00:00Z,30,5,2020,6,0,Lithuania,LT,LTU,2794184,Europe,68,1662,55
2020-05-31T00:00:00Z,31,5,2020,8,2,Lithuania,LT,LTU,2794184,Europe,70,1670,56
2020-06-01T00:00:00Z,1,6,2020,5,0,Lithuania,LT,LTU,2794184,Europe,70,1675,57
2020-06-02T00:00:00Z,2,6,2020,3,0,Lithuania,LT,LTU,2794184,Europe,70,1678,58
2020-06-03T00:00:00Z,3,6,2020,4,1,Lithuania,LT,LTU,2794184,Europe,71,1682,59
2020-06-04T00:00:00Z,4,6,2020,2,0,Lithuania,LT,LTU,2794184,Europe,71,1684,60
2020-06-05T00:00:00Z,5,6,2020,3,0,Lithuania,LT,LTU,2794184,Europe,71,1687,61
2020-06-06T00:00:00Z,6,6,2020,7,0,Lithuania,LT,LTU,2794184,Europe,71,1694,62
2020-06-07T00:00:00Z,7,6,2020,11,0,Lithuania,LT,LTU,2794184,Europe,71,1705,63
2020-06-08T00:00:00Z,8,6,2020,9,0,Lithuania,LT,LTU,2794184,Europe,71,1714,64
2020-06-09T00:00:00Z,9,6,2020,6,0,Lithuania,LT,LTU,2794184,Europe,71,1720,65
2020-06-10T00:00:00Z,10,6,2020,7,1,Lithuania,LT,LTU,2794184,Europe,72,1727,66
2020-06-11T00:00:00Z,11,6,2020,6,2,Lithuania,LT,LTU,2794184,Europe,74,1733,67
2020-06-12T00:00:00Z,12,6,2020,19,0,Lithuania,LT,LTU,2794184,Europe,74,1752,68
2020-06-13T00:00:00Z,13,6,2020,4,0,Lithuania,LT,LTU,2794184,Europe,74,1756,69
2020-06-14T00:00:00Z,14,6,2020,7,1,Lithuania,LT,LTU,2794184,Europe,75,1763,70
2020-06-15T00:00:00Z,15,6,2020,5,0,Lithuania,LT,LTU,2794184,Europe,75,1768,71
2020-06-16T00:00:00Z,16,6,2020,5,1,Lithuania,LT,LTU,2794184,Europe,76,1773,72
2020-06-17T00:00:00Z,17,6,2020,3,0,Lithuania,LT,LTU,2794184,Europe,76,1776,73
2020-06-18T00:00:00Z,18,6,2020,2,0,Lithuania,LT,LTU,2794184,Europe,76,1778,74
2020-06-19T00:00:00Z,19,6,2020,6,0,Lithuania,LT,LTU,2794184,Europe,76,1784,75
2020-06-20T00:00:00Z,20,6,2020,8,0,Lithuania,LT,LTU,2794184,Europe,76,1792,76
2020-06-21T00:00:00Z,21,6,2020,3,0,Lithuania,LT,LTU,2794184,Europe,76,1795,77
2020-06-22T00:00:00Z,22,6,2020,3,0,Lithuania,LT,LTU,2794184,Europe,76,1798,78
2020-06-23T00:00:00Z,23,6,2020,3,0,Lithuania,LT,LTU,2794184,Europe,76,1801,79
2020-06-24T00:00:00Z,24,6,2020,2,1,Lithuania,LT,LTU,2794184,Europe,77,1803,80
2020-06-25T00:00:00Z,25,6,2020,1,1,Lithuania,LT,LTU,2794184,Europe,78,1804,81
2020-03-28T00:00:00Z,28,3,2020,152,6,Luxembourg,LU,LUX,613894,Europe,15,1605,1
2020-03-29T00:00:00Z,29,3,2020,226,3,Luxembourg,LU,LUX,613894,Europe,18,1831,2
2020-03-30T00:00:00Z,30,3,2020,119,3,Luxembourg,LU,LUX,613894,Europe,21,1950,3
2020-03-31T00:00:00Z,31,3,2020,38,1,Luxembourg,LU,LUX,613894,Europe,22,1988,4
2020-04-01T00:00:00Z,1,4,2020,190,1,Luxembourg,LU,LUX,613894,Europe,23,2178,5
2020-04-02T00:00:00Z,2,4,2020,141,6,Luxembourg,LU,LUX,613894,Europe,29,2319,6
2020-04-03T00:00:00Z,3,4,2020,168,1,Luxembourg,LU,LUX,613894,Europe,30,2487,7
2020-04-04T00:00:00Z,4,4,2020,125,1,Luxembourg,LU,LUX,613894,Europe,31,2612,8
2020-04-05T00:00:00Z,5,4,2020,117,0,Luxembourg,LU,LUX,613894,Europe,31,2729,9
2020-04-06T00:00:00Z,6,4,2020,75,5,Luxembourg,LU,LUX,613894,Europe,36,2804,10
2020-04-07T00:00:00Z,7,4,2020,39,5,Luxembourg,LU,LUX,613894,Europe,41,2843,11
2020-04-08T00:00:00Z,8,4,2020,127,3,Luxembourg,LU,LUX,613894,Europe,44,2970,12
2020-04-09T00:00:00Z,9,4,2020,64,2,Luxembourg,LU,LUX,613894,Europe,46,3034,13
2020-04-10T00:00:00Z,10,4,2020,81,6,Luxembourg,LU,LUX,613894,Europe,52,3115,14
2020-04-11T00:00:00Z,11,4,2020,108,2,Luxembourg,LU,LUX,613894,Europe,54,3223,15
2020-04-12T00:00:00Z,12,4,2020,47,8,Luxembourg,LU,LUX,613894,Europe,62,3270,16
2020-04-13T00:00:00Z,13,4,2020,11,4,Luxembourg,LU,LUX,613894,Europe,66,3281,17
2020-04-14T00:00:00Z,14,4,2020,11,1,Luxembourg,LU,LUX,613894,Europe,67,3292,18
2020-04-15T00:00:00Z,15,4,2020,15,0,Luxembourg,LU,LUX,613894,Europe,67,3307,19
2020-04-16T00:00:00Z,16,4,2020,66,2,Luxembourg,LU,LUX,613894,Europe,69,3373,20
2020-04-17T00:00:00Z,17,4,2020,71,0,Luxembourg,LU,LUX,613894,Europe,69,3444,21
2020-04-18T00:00:00Z,18,4,2020,36,3,Luxembourg,LU,LUX,613894,Europe,72,3480,22
2020-04-19T00:00:00Z,19,4,2020,57,0,Luxembourg,LU,LUX,613894,Europe,72,3537,23
2020-04-20T00:00:00Z,20,4,2020,13,1,Luxembourg,LU,LUX,613894,Europe,73,3550,24
2020-04-21T00:00:00Z,21,4,2020,8,2,Luxembourg,LU,LUX,613894,Europe,75,3558,25
2020-04-22T00:00:00Z,22,4,2020,60,3,Luxembourg,LU,LUX,613894,Europe,78,3618,26
2020-04-23T00:00:00Z,23,4,2020,36,2,Luxembourg,LU,LUX,613894,Europe,80,3654,27
2020-04-24T00:00:00Z,24,4,2020,11,3,Luxembourg,LU,LUX,613894,Europe,83,3665,28
2020-04-25T00:00:00Z,25,4,2020,30,2,Luxembourg,LU,LUX,613894,Europe,85,3695,29
2020-04-26T00:00:00Z,26,4,2020,16,0,Luxembourg,LU,LUX,613894,Europe,85,3711,30
2020-04-27T00:00:00Z,27,4,2020,12,3,Luxembourg,LU,LUX,613894,Europe,88,3723,31
2020-04-28T00:00:00Z,28,4,2020,6,0,Luxembourg,LU,LUX,613894,Europe,88,3729,32
2020-04-29T00:00:00Z,29,4,2020,12,1,Luxembourg,LU,LUX,613894,Europe,89,3741,33
2020-04-30T00:00:00Z,30,4,2020,28,0,Luxembourg,LU,LUX,613894,Europe,89,3769,34
2020-05-01T00:00:00Z,1,5,2020,15,1,Luxembourg,LU,LUX,613894,Europe,90,3784,35
2020-05-02T00:00:00Z,2,5,2020,18,2,Luxembourg,LU,LUX,613894,Europe,92,3802,36
2020-05-03T00:00:00Z,3,5,2020,10,0,Luxembourg,LU,LUX,613894,Europe,92,3812,37
2020-05-04T00:00:00Z,4,5,2020,12,4,Luxembourg,LU,LUX,613894,Europe,96,3824,38
2020-05-05T00:00:00Z,5,5,2020,4,0,Luxembourg,LU,LUX,613894,Europe,96,3828,39
2020-05-06T00:00:00Z,6,5,2020,12,0,Luxembourg,LU,LUX,613894,Europe,96,3840,40
2020-05-07T00:00:00Z,7,5,2020,11,2,Luxembourg,LU,LUX,613894,Europe,98,3851,41
2020-05-08T00:00:00Z,8,5,2020,8,2,Luxembourg,LU,LUX,613894,Europe,100,3859,42
2020-05-09T00:00:00Z,9,5,2020,12,0,Luxembourg,LU,LUX,613894,Europe,100,3871,43
2020-05-10T00:00:00Z,10,5,2020,6,1,Luxembourg,LU,LUX,613894,Europe,101,3877,44
2020-05-11T00:00:00Z,11,5,2020,9,0,Luxembourg,LU,LUX,613894,Europe,101,3886,45
2020-05-12T00:00:00Z,12,5,2020,2,0,Luxembourg,LU,LUX,613894,Europe,101,3888,46
2020-05-13T00:00:00Z,13,5,2020,6,1,Luxembourg,LU,LUX,613894,Europe,102,3894,47
2020-05-14T00:00:00Z,14,5,2020,10,1,Luxembourg,LU,LUX,613894,Europe,103,3904,48
2020-05-15T00:00:00Z,15,5,2020,11,0,Luxembourg,LU,LUX,613894,Europe,103,3915,49
2020-05-16T00:00:00Z,16,5,2020,8,1,Luxembourg,LU,LUX,613894,Europe,104,3923,50
2020-05-17T00:00:00Z,17,5,2020,7,0,Luxembourg,LU,LUX,613894,Europe,104,3930,51
2020-05-18T00:00:00Z,18,5,2020,15,3,Luxembourg,LU,LUX,613894,Europe,107,3945,52
2020-05-19T00:00:00Z,19,5,2020,2,0,Luxembourg,LU,LUX,613894,Europe,107,3947,53
2020-05-20T00:00:00Z,20,5,2020,11,2,Luxembourg,LU,LUX,613894,Europe,109,3958,54
2020-05-21T00:00:00Z,21,5,2020,13,0,Luxembourg,LU,LUX,613894,Europe,109,3971,55
2020-05-22T00:00:00Z,22,5,2020,9,0,Luxembourg,LU,LUX,613894,Europe,109,3980,56
2020-05-23T00:00:00Z,23,5,2020,1,0,Luxembourg,LU,LUX,613894,Europe,109,3981,57
2020-05-24T00:00:00Z,24,5,2020,9,0,Luxembourg,LU,LUX,613894,Europe,109,3990,58
2020-05-25T00:00:00Z,25,5,2020,2,1,Luxembourg,LU,LUX,613894,Europe,110,3992,59
2020-05-26T00:00:00Z,26,5,2020,1,0,Luxembourg,LU,LUX,613894,Europe,110,3993,60
2020-05-27T00:00:00Z,27,5,2020,2,0,Luxembourg,LU,LUX,613894,Europe,110,3995,61
2020-05-28T00:00:00Z,28,5,2020,6,0,Luxembourg,LU,LUX,613894,Europe,110,4001,62
2020-05-29T00:00:00Z,29,5,2020,7,0,Luxembourg,LU,LUX,613894,Europe,110,4008,63
2020-05-30T00:00:00Z,30,5,2020,4,0,Luxembourg,LU,LUX,613894,Europe,110,4012,64
2020-05-31T00:00:00Z,31,5,2020,4,0,Luxembourg,LU,LUX,613894,Europe,110,4016,65
2020-06-01T00:00:00Z,1,6,2020,2,0,Luxembourg,LU,LUX,613894,Europe,110,4018,66
2020-06-02T00:00:00Z,2,6,2020,1,0,Luxembourg,LU,LUX,613894,Europe,110,4019,67
2020-06-03T00:00:00Z,3,6,2020,1,0,Luxembourg,LU,LUX,613894,Europe,110,4020,68
2020-06-04T00:00:00Z,4,6,2020,0,0,Luxembourg,LU,LUX,613894,Europe,110,4020,69
2020-06-05T00:00:00Z,5,6,2020,7,0,Luxembourg,LU,LUX,613894,Europe,110,4027,70
2020-06-06T00:00:00Z,6,6,2020,5,0,Luxembourg,LU,LUX,613894,Europe,110,4032,71
2020-06-07T00:00:00Z,7,6,2020,3,0,Luxembourg,LU,LUX,613894,Europe,110,4035,72
2020-06-08T00:00:00Z,8,6,2020,4,0,Luxembourg,LU,LUX,613894,Europe,110,4039,73
2020-06-09T00:00:00Z,9,6,2020,1,0,Luxembourg,LU,LUX,613894,Europe,110,4040,74
2020-06-10T00:00:00Z,10,6,2020,6,0,Luxembourg,LU,LUX,613894,Europe,110,4046,75
2020-06-11T00:00:00Z,11,6,2020,3,0,Luxembourg,LU,LUX,613894,Europe,110,4049,76
2020-06-12T00:00:00Z,12,6,2020,3,0,Luxembourg,LU,LUX,613894,Europe,110,4052,77
2020-06-13T00:00:00Z,13,6,2020,3,0,Luxembourg,LU,LUX,613894,Europe,110,4055,78
2020-06-14T00:00:00Z,14,6,2020,8,0,Luxembourg,LU,LUX,613894,Europe,110,4063,79
2020-06-15T00:00:00Z,15,6,2020,7,0,Luxembourg,LU,LUX,613894,Europe,110,4070,80
2020-06-16T00:00:00Z,16,6,2020,2,0,Luxembourg,LU,LUX,613894,Europe,110,4072,81
2020-06-17T00:00:00Z,17,6,2020,3,0,Luxembourg,LU,LUX,613894,Europe,110,4075,82
2020-06-18T00:00:00Z,18,6,2020,10,0,Luxembourg,LU,LUX,613894,Europe,110,4085,83
2020-06-19T00:00:00Z,19,6,2020,6,0,Luxembourg,LU,LUX,613894,Europe,110,4091,84
2020-06-20T00:00:00Z,20,6,2020,8,0,Luxembourg,LU,LUX,613894,Europe,110,4099,85
2020-06-21T00:00:00Z,21,6,2020,6,0,Luxembourg,LU,LUX,613894,Europe,110,4105,86
2020-06-22T00:00:00Z,22,6,2020,15,0,Luxembourg,LU,LUX,613894,Europe,110,4120,87
2020-06-23T00:00:00Z,23,6,2020,1,0,Luxembourg,LU,LUX,613894,Europe,110,4121,88
2020-06-24T00:00:00Z,24,6,2020,12,0,Luxembourg,LU,LUX,613894,Europe,110,4133,89
2020-06-25T00:00:00Z,25,6,2020,7,0,Luxembourg,LU,LUX,613894,Europe,110,4140,90
2020-06-11T00:00:00Z,11,6,2020,24,1,Madagascar,MG,MDG,26969306,Africa,10,1162,1
2020-06-12T00:00:00Z,12,6,2020,41,0,Madagascar,MG,MDG,26969306,Africa,10,1203,2
2020-06-13T00:00:00Z,13,6,2020,27,0,Madagascar,MG,MDG,26969306,Africa,10,1230,3
2020-06-14T00:00:00Z,14,6,2020,22,0,Madagascar,MG,MDG,26969306,Africa,10,1252,4
2020-06-15T00:00:00Z,15,6,2020,20,0,Madagascar,MG,MDG,26969306,Africa,10,1272,5
2020-06-16T00:00:00Z,16,6,2020,18,0,Madagascar,MG,MDG,26969306,Africa,10,1290,6
2020-06-17T00:00:00Z,17,6,2020,27,2,Madagascar,MG,MDG,26969306,Africa,12,1317,7
2020-06-18T00:00:00Z,18,6,2020,61,0,Madagascar,MG,MDG,26969306,Africa,12,1378,8
2020-06-19T00:00:00Z,19,6,2020,25,1,Madagascar,MG,MDG,26969306,Africa,13,1403,9
2020-06-20T00:00:00Z,20,6,2020,40,0,Madagascar,MG,MDG,26969306,Africa,13,1443,10
2020-06-21T00:00:00Z,21,6,2020,60,0,Madagascar,MG,MDG,26969306,Africa,13,1503,11
2020-06-22T00:00:00Z,22,6,2020,93,1,Madagascar,MG,MDG,26969306,Africa,14,1596,12
2020-06-23T00:00:00Z,23,6,2020,44,1,Madagascar,MG,MDG,26969306,Africa,15,1640,13
2020-06-24T00:00:00Z,24,6,2020,84,0,Madagascar,MG,MDG,26969306,Africa,15,1724,14
2020-06-25T00:00:00Z,25,6,2020,63,1,Madagascar,MG,MDG,26969306,Africa,16,1787,15
2020-06-22T00:00:00Z,22,6,2020,110,3,Malawi,MW,MWI,18628749,Africa,11,730,1
2020-06-23T00:00:00Z,23,6,2020,73,0,Malawi,MW,MWI,18628749,Africa,11,803,2
2020-06-24T00:00:00Z,24,6,2020,45,0,Malawi,MW,MWI,18628749,Africa,11,848,3
2020-06-25T00:00:00Z,25,6,2020,93,0,Malawi,MW,MWI,18628749,Africa,11,941,4
2020-03-23T00:00:00Z,23,3,2020,123,6,Malaysia,MY,MYS,31949789,Asia,10,1306,1
2020-03-24T00:00:00Z,24,3,2020,212,4,Malaysia,MY,MYS,31949789,Asia,14,1518,2
2020-03-25T00:00:00Z,25,3,2020,106,1,Malaysia,MY,MYS,31949789,Asia,15,1624,3
2020-03-26T00:00:00Z,26,3,2020,172,4,Malaysia,MY,MYS,31949789,Asia,19,1796,4
2020-03-27T00:00:00Z,27,3,2020,235,4,Malaysia,MY,MYS,31949789,Asia,23,2031,5
2020-03-28T00:00:00Z,28,3,2020,130,3,Malaysia,MY,MYS,31949789,Asia,26,2161,6
2020-03-29T00:00:00Z,29,3,2020,159,1,Malaysia,MY,MYS,31949789,Asia,27,2320,7
2020-03-30T00:00:00Z,30,3,2020,150,7,Malaysia,MY,MYS,31949789,Asia,34,2470,8
2020-03-31T00:00:00Z,31,3,2020,156,3,Malaysia,MY,MYS,31949789,Asia,37,2626,9
2020-04-01T00:00:00Z,1,4,2020,140,6,Malaysia,MY,MYS,31949789,Asia,43,2766,10
2020-04-02T00:00:00Z,2,4,2020,142,2,Malaysia,MY,MYS,31949789,Asia,45,2908,11
2020-04-03T00:00:00Z,3,4,2020,208,5,Malaysia,MY,MYS,31949789,Asia,50,3116,12
2020-04-04T00:00:00Z,4,4,2020,217,3,Malaysia,MY,MYS,31949789,Asia,53,3333,13
2020-04-05T00:00:00Z,5,4,2020,150,4,Malaysia,MY,MYS,31949789,Asia,57,3483,14
2020-04-06T00:00:00Z,6,4,2020,179,4,Malaysia,MY,MYS,31949789,Asia,61,3662,15
2020-04-07T00:00:00Z,7,4,2020,131,1,Malaysia,MY,MYS,31949789,Asia,62,3793,16
2020-04-08T00:00:00Z,8,4,2020,170,1,Malaysia,MY,MYS,31949789,Asia,63,3963,17
2020-04-09T00:00:00Z,9,4,2020,156,2,Malaysia,MY,MYS,31949789,Asia,65,4119,18
2020-04-10T00:00:00Z,10,4,2020,109,2,Malaysia,MY,MYS,31949789,Asia,67,4228,19
2020-04-11T00:00:00Z,11,4,2020,118,3,Malaysia,MY,MYS,31949789,Asia,70,4346,20
2020-04-12T00:00:00Z,12,4,2020,184,3,Malaysia,MY,MYS,31949789,Asia,73,4530,21
2020-04-13T00:00:00Z,13,4,2020,153,3,Malaysia,MY,MYS,31949789,Asia,76,4683,22
2020-04-14T00:00:00Z,14,4,2020,134,1,Malaysia,MY,MYS,31949789,Asia,77,4817,23
2020-04-15T00:00:00Z,15,4,2020,170,5,Malaysia,MY,MYS,31949789,Asia,82,4987,24
2020-04-16T00:00:00Z,16,4,2020,85,1,Malaysia,MY,MYS,31949789,Asia,83,5072,25
2020-04-17T00:00:00Z,17,4,2020,110,1,Malaysia,MY,MYS,31949789,Asia,84,5182,26
2020-04-18T00:00:00Z,18,4,2020,69,2,Malaysia,MY,MYS,31949789,Asia,86,5251,27
2020-04-19T00:00:00Z,19,4,2020,54,2,Malaysia,MY,MYS,31949789,Asia,88,5305,28
2020-04-20T00:00:00Z,20,4,2020,84,1,Malaysia,MY,MYS,31949789,Asia,89,5389,29
2020-04-21T00:00:00Z,21,4,2020,36,0,Malaysia,MY,MYS,31949789,Asia,89,5425,30
2020-04-22T00:00:00Z,22,4,2020,57,3,Malaysia,MY,MYS,31949789,Asia,92,5482,31
2020-04-23T00:00:00Z,23,4,2020,50,1,Malaysia,MY,MYS,31949789,Asia,93,5532,32
2020-04-24T00:00:00Z,24,4,2020,71,2,Malaysia,MY,MYS,31949789,Asia,95,5603,33
2020-04-25T00:00:00Z,25,4,2020,88,1,Malaysia,MY,MYS,31949789,Asia,96,5691,34
2020-04-26T00:00:00Z,26,4,2020,51,2,Malaysia,MY,MYS,31949789,Asia,98,5742,35
2020-04-27T00:00:00Z,27,4,2020,38,0,Malaysia,MY,MYS,31949789,Asia,98,5780,36
2020-04-28T00:00:00Z,28,4,2020,40,1,Malaysia,MY,MYS,31949789,Asia,99,5820,37
2020-04-29T00:00:00Z,29,4,2020,31,1,Malaysia,MY,MYS,31949789,Asia,100,5851,38
2020-04-30T00:00:00Z,30,4,2020,94,0,Malaysia,MY,MYS,31949789,Asia,100,5945,39
2020-05-01T00:00:00Z,1,5,2020,57,2,Malaysia,MY,MYS,31949789,Asia,102,6002,40
2020-05-02T00:00:00Z,2,5,2020,69,1,Malaysia,MY,MYS,31949789,Asia,103,6071,41
2020-05-03T00:00:00Z,3,5,2020,105,0,Malaysia,MY,MYS,31949789,Asia,103,6176,42
2020-05-04T00:00:00Z,4,5,2020,122,2,Malaysia,MY,MYS,31949789,Asia,105,6298,43
2020-05-05T00:00:00Z,5,5,2020,55,0,Malaysia,MY,MYS,31949789,Asia,105,6353,44
2020-05-06T00:00:00Z,6,5,2020,30,1,Malaysia,MY,MYS,31949789,Asia,106,6383,45
2020-05-07T00:00:00Z,7,5,2020,45,1,Malaysia,MY,MYS,31949789,Asia,107,6428,46
2020-05-08T00:00:00Z,8,5,2020,39,0,Malaysia,MY,MYS,31949789,Asia,107,6467,47
2020-05-09T00:00:00Z,9,5,2020,68,0,Malaysia,MY,MYS,31949789,Asia,107,6535,48
2020-05-10T00:00:00Z,10,5,2020,54,1,Malaysia,MY,MYS,31949789,Asia,108,6589,49
2020-05-11T00:00:00Z,11,5,2020,67,0,Malaysia,MY,MYS,31949789,Asia,108,6656,50
2020-05-12T00:00:00Z,12,5,2020,70,1,Malaysia,MY,MYS,31949789,Asia,109,6726,51
2020-05-13T00:00:00Z,13,5,2020,16,0,Malaysia,MY,MYS,31949789,Asia,109,6742,52
2020-05-14T00:00:00Z,14,5,2020,37,2,Malaysia,MY,MYS,31949789,Asia,111,6779,53
2020-05-15T00:00:00Z,15,5,2020,40,1,Malaysia,MY,MYS,31949789,Asia,112,6819,54
2020-05-16T00:00:00Z,16,5,2020,36,0,Malaysia,MY,MYS,31949789,Asia,112,6855,55
2020-05-17T00:00:00Z,17,5,2020,17,1,Malaysia,MY,MYS,31949789,Asia,113,6872,56
2020-05-18T00:00:00Z,18,5,2020,22,0,Malaysia,MY,MYS,31949789,Asia,113,6894,57
2020-05-19T00:00:00Z,19,5,2020,47,0,Malaysia,MY,MYS,31949789,Asia,113,6941,58
2020-05-20T00:00:00Z,20,5,2020,37,1,Malaysia,MY,MYS,31949789,Asia,114,6978,59
2020-05-21T00:00:00Z,21,5,2020,31,0,Malaysia,MY,MYS,31949789,Asia,114,7009,60
2020-05-22T00:00:00Z,22,5,2020,50,0,Malaysia,MY,MYS,31949789,Asia,114,7059,61
2020-05-23T00:00:00Z,23,5,2020,78,1,Malaysia,MY,MYS,31949789,Asia,115,7137,62
2020-05-24T00:00:00Z,24,5,2020,48,0,Malaysia,MY,MYS,31949789,Asia,115,7185,63
2020-05-25T00:00:00Z,25,5,2020,60,0,Malaysia,MY,MYS,31949789,Asia,115,7245,64
2020-05-26T00:00:00Z,26,5,2020,172,0,Malaysia,MY,MYS,31949789,Asia,115,7417,65
2020-05-27T00:00:00Z,27,5,2020,187,0,Malaysia,MY,MYS,31949789,Asia,115,7604,66
2020-05-28T00:00:00Z,28,5,2020,15,0,Malaysia,MY,MYS,31949789,Asia,115,7619,67
2020-05-29T00:00:00Z,29,5,2020,10,0,Malaysia,MY,MYS,31949789,Asia,115,7629,68
2020-05-30T00:00:00Z,30,5,2020,103,0,Malaysia,MY,MYS,31949789,Asia,115,7732,69
2020-05-31T00:00:00Z,31,5,2020,30,0,Malaysia,MY,MYS,31949789,Asia,115,7762,70
2020-06-01T00:00:00Z,1,6,2020,57,0,Malaysia,MY,MYS,31949789,Asia,115,7819,71
2020-06-02T00:00:00Z,2,6,2020,38,0,Malaysia,MY,MYS,31949789,Asia,115,7857,72
2020-06-03T00:00:00Z,3,6,2020,20,0,Malaysia,MY,MYS,31949789,Asia,115,7877,73
2020-06-04T00:00:00Z,4,6,2020,93,0,Malaysia,MY,MYS,31949789,Asia,115,7970,74
2020-06-05T00:00:00Z,5,6,2020,0,0,Malaysia,MY,MYS,31949789,Asia,115,7970,75
2020-06-06T00:00:00Z,6,6,2020,296,1,Malaysia,MY,MYS,31949789,Asia,116,8266,76
2020-06-07T00:00:00Z,7,6,2020,37,1,Malaysia,MY,MYS,31949789,Asia,117,8303,77
2020-06-08T00:00:00Z,8,6,2020,19,0,Malaysia,MY,MYS,31949789,Asia,117,8322,78
2020-06-09T00:00:00Z,9,6,2020,7,0,Malaysia,MY,MYS,31949789,Asia,117,8329,79
2020-06-10T00:00:00Z,10,6,2020,7,0,Malaysia,MY,MYS,31949789,Asia,117,8336,80
2020-06-11T00:00:00Z,11,6,2020,2,1,Malaysia,MY,MYS,31949789,Asia,118,8338,81
2020-06-12T00:00:00Z,12,6,2020,31,0,Malaysia,MY,MYS,31949789,Asia,118,8369,82
2020-06-13T00:00:00Z,13,6,2020,33,1,Malaysia,MY,MYS,31949789,Asia,119,8402,83
2020-06-14T00:00:00Z,14,6,2020,43,1,Malaysia,MY,MYS,31949789,Asia,120,8445,84
2020-06-15T00:00:00Z,15,6,2020,8,1,Malaysia,MY,MYS,31949789,Asia,121,8453,85
2020-06-16T00:00:00Z,16,6,2020,41,0,Malaysia,MY,MYS,31949789,Asia,121,8494,86
2020-06-17T00:00:00Z,17,6,2020,11,0,Malaysia,MY,MYS,31949789,Asia,121,8505,87
2020-06-18T00:00:00Z,18,6,2020,10,0,Malaysia,MY,MYS,31949789,Asia,121,8515,88
2020-06-19T00:00:00Z,19,6,2020,14,0,Malaysia,MY,MYS,31949789,Asia,121,8529,89
2020-06-20T00:00:00Z,20,6,2020,6,0,Malaysia,MY,MYS,31949789,Asia,121,8535,90
2020-06-21T00:00:00Z,21,6,2020,21,0,Malaysia,MY,MYS,31949789,Asia,121,8556,91
2020-06-22T00:00:00Z,22,6,2020,16,0,Malaysia,MY,MYS,31949789,Asia,121,8572,92
2020-06-23T00:00:00Z,23,6,2020,15,0,Malaysia,MY,MYS,31949789,Asia,121,8587,93
2020-06-24T00:00:00Z,24,6,2020,3,0,Malaysia,MY,MYS,31949789,Asia,121,8590,94
2020-06-25T00:00:00Z,25,6,2020,6,0,Malaysia,MY,MYS,31949789,Asia,121,8596,95
2020-04-14T00:00:00Z,14,4,2020,7,1,Mali,ML,MLI,19658023,Africa,10,123,1
2020-04-15T00:00:00Z,15,4,2020,21,3,Mali,ML,MLI,19658023,Africa,13,144,2
2020-04-16T00:00:00Z,16,4,2020,4,0,Mali,ML,MLI,19658023,Africa,13,148,3
2020-04-17T00:00:00Z,17,4,2020,23,0,Mali,ML,MLI,19658023,Africa,13,171,4
2020-04-18T00:00:00Z,18,4,2020,19,0,Mali,ML,MLI,19658023,Africa,13,190,5
2020-04-19T00:00:00Z,19,4,2020,26,0,Mali,ML,MLI,19658023,Africa,13,216,6
2020-04-20T00:00:00Z,20,4,2020,8,1,Mali,ML,MLI,19658023,Africa,14,224,7
2020-04-21T00:00:00Z,21,4,2020,22,0,Mali,ML,MLI,19658023,Africa,14,246,8
2020-04-22T00:00:00Z,22,4,2020,12,0,Mali,ML,MLI,19658023,Africa,14,258,9
2020-04-23T00:00:00Z,23,4,2020,35,3,Mali,ML,MLI,19658023,Africa,17,293,10
2020-04-24T00:00:00Z,24,4,2020,16,4,Mali,ML,MLI,19658023,Africa,21,309,11
2020-04-25T00:00:00Z,25,4,2020,16,0,Mali,ML,MLI,19658023,Africa,21,325,12
2020-04-26T00:00:00Z,26,4,2020,45,0,Mali,ML,MLI,19658023,Africa,21,370,13
2020-04-27T00:00:00Z,27,4,2020,19,2,Mali,ML,MLI,19658023,Africa,23,389,14
2020-04-28T00:00:00Z,28,4,2020,19,0,Mali,ML,MLI,19658023,Africa,23,408,15
2020-04-29T00:00:00Z,29,4,2020,16,1,Mali,ML,MLI,19658023,Africa,24,424,16
2020-04-30T00:00:00Z,30,4,2020,58,1,Mali,ML,MLI,19658023,Africa,25,482,17
2020-05-01T00:00:00Z,1,5,2020,8,1,Mali,ML,MLI,19658023,Africa,26,490,18
2020-05-02T00:00:00Z,2,5,2020,18,0,Mali,ML,MLI,19658023,Africa,26,508,19
2020-05-03T00:00:00Z,3,5,2020,36,0,Mali,ML,MLI,19658023,Africa,26,544,20
2020-05-04T00:00:00Z,4,5,2020,19,1,Mali,ML,MLI,19658023,Africa,27,563,21
2020-05-05T00:00:00Z,5,5,2020,17,2,Mali,ML,MLI,19658023,Africa,29,580,22
2020-05-06T00:00:00Z,6,5,2020,32,3,Mali,ML,MLI,19658023,Africa,32,612,23
2020-05-07T00:00:00Z,7,5,2020,19,0,Mali,ML,MLI,19658023,Africa,32,631,24
2020-05-08T00:00:00Z,8,5,2020,19,0,Mali,ML,MLI,19658023,Africa,32,650,25
2020-05-09T00:00:00Z,9,5,2020,18,3,Mali,ML,MLI,19658023,Africa,35,668,26
2020-05-10T00:00:00Z,10,5,2020,24,2,Mali,ML,MLI,19658023,Africa,37,692,27
2020-05-11T00:00:00Z,11,5,2020,12,1,Mali,ML,MLI,19658023,Africa,38,704,28
2020-05-12T00:00:00Z,12,5,2020,8,1,Mali,ML,MLI,19658023,Africa,39,712,29
2020-05-13T00:00:00Z,13,5,2020,18,1,Mali,ML,MLI,19658023,Africa,40,730,30
2020-05-14T00:00:00Z,14,5,2020,28,4,Mali,ML,MLI,19658023,Africa,44,758,31
2020-05-15T00:00:00Z,15,5,2020,21,2,Mali,ML,MLI,19658023,Africa,46,779,32
2020-05-16T00:00:00Z,16,5,2020,27,0,Mali,ML,MLI,19658023,Africa,46,806,33
2020-05-17T00:00:00Z,17,5,2020,29,2,Mali,ML,MLI,19658023,Africa,48,835,34
2020-05-18T00:00:00Z,18,5,2020,25,4,Mali,ML,MLI,19658023,Africa,52,860,35
2020-05-19T00:00:00Z,19,5,2020,14,0,Mali,ML,MLI,19658023,Africa,52,874,36
2020-05-20T00:00:00Z,20,5,2020,27,1,Mali,ML,MLI,19658023,Africa,53,901,37
2020-05-21T00:00:00Z,21,5,2020,30,2,Mali,ML,MLI,19658023,Africa,55,931,38
2020-05-22T00:00:00Z,22,5,2020,16,5,Mali,ML,MLI,19658023,Africa,60,947,39
2020-05-23T00:00:00Z,23,5,2020,22,2,Mali,ML,MLI,19658023,Africa,62,969,40
2020-05-24T00:00:00Z,24,5,2020,46,1,Mali,ML,MLI,19658023,Africa,63,1015,41
2020-05-25T00:00:00Z,25,5,2020,15,2,Mali,ML,MLI,19658023,Africa,65,1030,42
2020-05-26T00:00:00Z,26,5,2020,29,2,Mali,ML,MLI,19658023,Africa,67,1059,43
2020-05-27T00:00:00Z,27,5,2020,18,3,Mali,ML,MLI,19658023,Africa,70,1077,44
2020-05-28T00:00:00Z,28,5,2020,39,0,Mali,ML,MLI,19658023,Africa,70,1116,45
2020-05-29T00:00:00Z,29,5,2020,78,2,Mali,ML,MLI,19658023,Africa,72,1194,46
2020-05-30T00:00:00Z,30,5,2020,32,1,Mali,ML,MLI,19658023,Africa,73,1226,47
2020-05-31T00:00:00Z,31,5,2020,24,3,Mali,ML,MLI,19658023,Africa,76,1250,48
2020-06-01T00:00:00Z,1,6,2020,15,1,Mali,ML,MLI,19658023,Africa,77,1265,49
2020-06-02T00:00:00Z,2,6,2020,50,1,Mali,ML,MLI,19658023,Africa,78,1315,50
2020-06-03T00:00:00Z,3,6,2020,36,0,Mali,ML,MLI,19658023,Africa,78,1351,51
2020-06-04T00:00:00Z,4,6,2020,0,0,Mali,ML,MLI,19658023,Africa,78,1351,52
2020-06-05T00:00:00Z,5,6,2020,110,7,Mali,ML,MLI,19658023,Africa,85,1461,53
2020-06-06T00:00:00Z,6,6,2020,24,2,Mali,ML,MLI,19658023,Africa,87,1485,54
2020-06-07T00:00:00Z,7,6,2020,38,3,Mali,ML,MLI,19658023,Africa,90,1523,55
2020-06-08T00:00:00Z,8,6,2020,10,2,Mali,ML,MLI,19658023,Africa,92,1533,56
2020-06-09T00:00:00Z,9,6,2020,14,0,Mali,ML,MLI,19658023,Africa,92,1547,57
2020-06-10T00:00:00Z,10,6,2020,39,2,Mali,ML,MLI,19658023,Africa,94,1586,58
2020-06-11T00:00:00Z,11,6,2020,81,2,Mali,ML,MLI,19658023,Africa,96,1667,59
2020-06-12T00:00:00Z,12,6,2020,55,1,Mali,ML,MLI,19658023,Africa,97,1722,60
2020-06-13T00:00:00Z,13,6,2020,30,4,Mali,ML,MLI,19658023,Africa,101,1752,61
2020-06-14T00:00:00Z,14,6,2020,24,3,Mali,ML,MLI,19658023,Africa,104,1776,62
2020-06-15T00:00:00Z,15,6,2020,33,0,Mali,ML,MLI,19658023,Africa,104,1809,63
2020-06-16T00:00:00Z,16,6,2020,51,0,Mali,ML,MLI,19658023,Africa,104,1860,64
2020-06-17T00:00:00Z,17,6,2020,25,2,Mali,ML,MLI,19658023,Africa,106,1885,65
2020-06-18T00:00:00Z,18,6,2020,5,1,Mali,ML,MLI,19658023,Africa,107,1890,66
2020-06-19T00:00:00Z,19,6,2020,16,0,Mali,ML,MLI,19658023,Africa,107,1906,67
2020-06-20T00:00:00Z,20,6,2020,17,1,Mali,ML,MLI,19658023,Africa,108,1923,68
2020-06-21T00:00:00Z,21,6,2020,10,1,Mali,ML,MLI,19658023,Africa,109,1933,69
2020-06-22T00:00:00Z,22,6,2020,28,2,Mali,ML,MLI,19658023,Africa,111,1961,70
2020-06-23T00:00:00Z,23,6,2020,0,0,Mali,ML,MLI,19658023,Africa,111,1961,71
2020-06-24T00:00:00Z,24,6,2020,17,0,Mali,ML,MLI,19658023,Africa,111,1978,72
2020-06-25T00:00:00Z,25,6,2020,23,1,Mali,ML,MLI,19658023,Africa,112,2001,73
2020-05-28T00:00:00Z,28,5,2020,30,7,Mauritania,MR,MRT,4525698,Africa,16,292,1
2020-05-29T00:00:00Z,29,5,2020,0,0,Mauritania,MR,MRT,4525698,Africa,16,292,2
2020-05-30T00:00:00Z,30,5,2020,131,4,Mauritania,MR,MRT,4525698,Africa,20,423,3
2020-05-31T00:00:00Z,31,5,2020,60,1,Mauritania,MR,MRT,4525698,Africa,21,483,4
2020-06-01T00:00:00Z,1,6,2020,47,2,Mauritania,MR,MRT,4525698,Africa,23,530,5
2020-06-02T00:00:00Z,2,6,2020,0,0,Mauritania,MR,MRT,4525698,Africa,23,530,6
2020-06-03T00:00:00Z,3,6,2020,138,8,Mauritania,MR,MRT,4525698,Africa,31,668,7
2020-06-04T00:00:00Z,4,6,2020,0,0,Mauritania,MR,MRT,4525698,Africa,31,668,8
2020-06-05T00:00:00Z,5,6,2020,116,8,Mauritania,MR,MRT,4525698,Africa,39,784,9
2020-06-06T00:00:00Z,6,6,2020,99,4,Mauritania,MR,MRT,4525698,Africa,43,883,10
2020-06-07T00:00:00Z,7,6,2020,64,0,Mauritania,MR,MRT,4525698,Africa,43,947,11
2020-06-08T00:00:00Z,8,6,2020,0,0,Mauritania,MR,MRT,4525698,Africa,43,947,12
2020-06-09T00:00:00Z,9,6,2020,0,0,Mauritania,MR,MRT,4525698,Africa,43,947,13
2020-06-10T00:00:00Z,10,6,2020,215,18,Mauritania,MR,MRT,4525698,Africa,61,1162,14
2020-06-11T00:00:00Z,11,6,2020,0,0,Mauritania,MR,MRT,4525698,Africa,61,1162,15
2020-06-12T00:00:00Z,12,6,2020,0,0,Mauritania,MR,MRT,4525698,Africa,61,1162,16
2020-06-13T00:00:00Z,13,6,2020,277,13,Mauritania,MR,MRT,4525698,Africa,74,1439,17
2020-06-14T00:00:00Z,14,6,2020,0,0,Mauritania,MR,MRT,4525698,Africa,74,1439,18
2020-06-15T00:00:00Z,15,6,2020,344,13,Mauritania,MR,MRT,4525698,Africa,87,1783,19
2020-06-16T00:00:00Z,16,6,2020,104,4,Mauritania,MR,MRT,4525698,Africa,91,1887,20
2020-06-17T00:00:00Z,17,6,2020,170,2,Mauritania,MR,MRT,4525698,Africa,93,2057,21
2020-06-18T00:00:00Z,18,6,2020,0,0,Mauritania,MR,MRT,4525698,Africa,93,2057,22
2020-06-19T00:00:00Z,19,6,2020,166,2,Mauritania,MR,MRT,4525698,Africa,95,2223,23
2020-06-20T00:00:00Z,20,6,2020,0,0,Mauritania,MR,MRT,4525698,Africa,95,2223,24
2020-06-21T00:00:00Z,21,6,2020,590,13,Mauritania,MR,MRT,4525698,Africa,108,2813,25
2020-06-22T00:00:00Z,22,6,2020,0,0,Mauritania,MR,MRT,4525698,Africa,108,2813,26
2020-06-23T00:00:00Z,23,6,2020,171,3,Mauritania,MR,MRT,4525698,Africa,111,2984,27
2020-06-24T00:00:00Z,24,6,2020,0,0,Mauritania,MR,MRT,4525698,Africa,111,2984,28
2020-06-25T00:00:00Z,25,6,2020,308,3,Mauritania,MR,MRT,4525698,Africa,114,3292,29
2020-04-28T00:00:00Z,28,4,2020,0,1,Mauritius,MU,MUS,1269670,Africa,10,332,1
2020-04-29T00:00:00Z,29,4,2020,0,0,Mauritius,MU,MUS,1269670,Africa,10,332,2
2020-04-30T00:00:00Z,30,4,2020,0,0,Mauritius,MU,MUS,1269670,Africa,10,332,3
2020-05-01T00:00:00Z,1,5,2020,0,0,Mauritius,MU,MUS,1269670,Africa,10,332,4
2020-05-02T00:00:00Z,2,5,2020,0,0,Mauritius,MU,MUS,1269670,Africa,10,332,5
2020-05-03T00:00:00Z,3,5,2020,0,0,Mauritius,MU,MUS,1269670,Africa,10,332,6
2020-05-04T00:00:00Z,4,5,2020,0,0,Mauritius,MU,MUS,1269670,Africa,10,332,7
2020-05-05T00:00:00Z,5,5,2020,0,0,Mauritius,MU,MUS,1269670,Africa,10,332,8
2020-05-06T00:00:00Z,6,5,2020,0,0,Mauritius,MU,MUS,1269670,Africa,10,332,9
2020-05-07T00:00:00Z,7,5,2020,0,0,Mauritius,MU,MUS,1269670,Africa,10,332,10
2020-05-08T00:00:00Z,8,5,2020,0,0,Mauritius,MU,MUS,1269670,Africa,10,332,11
2020-05-09T00:00:00Z,9,5,2020,0,0,Mauritius,MU,MUS,1269670,Africa,10,332,12
2020-05-10T00:00:00Z,10,5,2020,0,0,Mauritius,MU,MUS,1269670,Africa,10,332,13
2020-05-11T00:00:00Z,11,5,2020,0,0,Mauritius,MU,MUS,1269670,Africa,10,332,14
2020-05-12T00:00:00Z,12,5,2020,0,0,Mauritius,MU,MUS,1269670,Africa,10,332,15
2020-05-13T00:00:00Z,13,5,2020,0,0,Mauritius,MU,MUS,1269670,Africa,10,332,16
2020-05-14T00:00:00Z,14,5,2020,0,0,Mauritius,MU,MUS,1269670,Africa,10,332,17
2020-05-15T00:00:00Z,15,5,2020,0,0,Mauritius,MU,MUS,1269670,Africa,10,332,18
2020-05-16T00:00:00Z,16,5,2020,0,0,Mauritius,MU,MUS,1269670,Africa,10,332,19
2020-05-17T00:00:00Z,17,5,2020,0,0,Mauritius,MU,MUS,1269670,Africa,10,332,20
2020-05-18T00:00:00Z,18,5,2020,0,0,Mauritius,MU,MUS,1269670,Africa,10,332,21
2020-05-19T00:00:00Z,19,5,2020,0,0,Mauritius,MU,MUS,1269670,Africa,10,332,22
2020-05-20T00:00:00Z,20,5,2020,0,0,Mauritius,MU,MUS,1269670,Africa,10,332,23
2020-05-21T00:00:00Z,21,5,2020,0,0,Mauritius,MU,MUS,1269670,Africa,10,332,24
2020-05-22T00:00:00Z,22,5,2020,0,0,Mauritius,MU,MUS,1269670,Africa,10,332,25
2020-05-23T00:00:00Z,23,5,2020,0,0,Mauritius,MU,MUS,1269670,Africa,10,332,26
2020-05-24T00:00:00Z,24,5,2020,0,0,Mauritius,MU,MUS,1269670,Africa,10,332,27
2020-05-25T00:00:00Z,25,5,2020,2,0,Mauritius,MU,MUS,1269670,Africa,10,334,28
2020-05-26T00:00:00Z,26,5,2020,0,0,Mauritius,MU,MUS,1269670,Africa,10,334,29
2020-05-27T00:00:00Z,27,5,2020,0,0,Mauritius,MU,MUS,1269670,Africa,10,334,30
2020-05-28T00:00:00Z,28,5,2020,0,0,Mauritius,MU,MUS,1269670,Africa,10,334,31
2020-05-29T00:00:00Z,29,5,2020,0,0,Mauritius,MU,MUS,1269670,Africa,10,334,32
2020-05-30T00:00:00Z,30,5,2020,1,0,Mauritius,MU,MUS,1269670,Africa,10,335,33
2020-05-31T00:00:00Z,31,5,2020,0,0,Mauritius,MU,MUS,1269670,Africa,10,335,34
2020-06-01T00:00:00Z,1,6,2020,0,0,Mauritius,MU,MUS,1269670,Africa,10,335,35
2020-06-02T00:00:00Z,2,6,2020,0,0,Mauritius,MU,MUS,1269670,Africa,10,335,36
2020-06-03T00:00:00Z,3,6,2020,0,0,Mauritius,MU,MUS,1269670,Africa,10,335,37
2020-06-04T00:00:00Z,4,6,2020,0,0,Mauritius,MU,MUS,1269670,Africa,10,335,38
2020-06-05T00:00:00Z,5,6,2020,0,0,Mauritius,MU,MUS,1269670,Africa,10,335,39
2020-06-06T00:00:00Z,6,6,2020,2,0,Mauritius,MU,MUS,1269670,Africa,10,337,40
2020-06-07T00:00:00Z,7,6,2020,0,0,Mauritius,MU,MUS,1269670,Africa,10,337,41
2020-06-08T00:00:00Z,8,6,2020,0,0,Mauritius,MU,MUS,1269670,Africa,10,337,42
2020-06-09T00:00:00Z,9,6,2020,0,0,Mauritius,MU,MUS,1269670,Africa,10,337,43
2020-06-10T00:00:00Z,10,6,2020,0,0,Mauritius,MU,MUS,1269670,Africa,10,337,44
2020-06-11T00:00:00Z,11,6,2020,0,0,Mauritius,MU,MUS,1269670,Africa,10,337,45
2020-06-12T00:00:00Z,12,6,2020,0,0,Mauritius,MU,MUS,1269670,Africa,10,337,46
2020-06-13T00:00:00Z,13,6,2020,0,0,Mauritius,MU,MUS,1269670,Africa,10,337,47
2020-06-14T00:00:00Z,14,6,2020,0,0,Mauritius,MU,MUS,1269670,Africa,10,337,48
2020-06-15T00:00:00Z,15,6,2020,0,0,Mauritius,MU,MUS,1269670,Africa,10,337,49
2020-06-16T00:00:00Z,16,6,2020,0,0,Mauritius,MU,MUS,1269670,Africa,10,337,50
2020-06-17T00:00:00Z,17,6,2020,0,0,Mauritius,MU,MUS,1269670,Africa,10,337,51
2020-06-18T00:00:00Z,18,6,2020,0,0,Mauritius,MU,MUS,1269670,Africa,10,337,52
2020-06-19T00:00:00Z,19,6,2020,0,0,Mauritius,MU,MUS,1269670,Africa,10,337,53
2020-06-20T00:00:00Z,20,6,2020,0,0,Mauritius,MU,MUS,1269670,Africa,10,337,54
2020-06-21T00:00:00Z,21,6,2020,0,0,Mauritius,MU,MUS,1269670,Africa,10,337,55
2020-06-22T00:00:00Z,22,6,2020,0,0,Mauritius,MU,MUS,1269670,Africa,10,337,56
2020-06-23T00:00:00Z,23,6,2020,3,0,Mauritius,MU,MUS,1269670,Africa,10,340,57
2020-06-24T00:00:00Z,24,6,2020,0,0,Mauritius,MU,MUS,1269670,Africa,10,340,58
2020-06-25T00:00:00Z,25,6,2020,1,0,Mauritius,MU,MUS,1269670,Africa,10,341,59
2020-03-28T00:00:00Z,28,3,2020,132,4,Mexico,MX,MEX,127575529,America,12,717,1
2020-03-29T00:00:00Z,29,3,2020,131,4,Mexico,MX,MEX,127575529,America,16,848,2
2020-03-30T00:00:00Z,30,3,2020,145,4,Mexico,MX,MEX,127575529,America,20,993,3
2020-03-31T00:00:00Z,31,3,2020,101,8,Mexico,MX,MEX,127575529,America,28,1094,4
2020-04-01T00:00:00Z,1,4,2020,121,1,Mexico,MX,MEX,127575529,America,29,1215,5
2020-04-02T00:00:00Z,2,4,2020,163,8,Mexico,MX,MEX,127575529,America,37,1378,6
2020-04-03T00:00:00Z,3,4,2020,132,13,Mexico,MX,MEX,127575529,America,50,1510,7
2020-04-04T00:00:00Z,4,4,2020,178,10,Mexico,MX,MEX,127575529,America,60,1688,8
2020-04-05T00:00:00Z,5,4,2020,202,19,Mexico,MX,MEX,127575529,America,79,1890,9
2020-04-06T00:00:00Z,6,4,2020,253,15,Mexico,MX,MEX,127575529,America,94,2143,10
2020-04-07T00:00:00Z,7,4,2020,296,31,Mexico,MX,MEX,127575529,America,125,2439,11
2020-04-08T00:00:00Z,8,4,2020,346,16,Mexico,MX,MEX,127575529,America,141,2785,12
2020-04-09T00:00:00Z,9,4,2020,396,33,Mexico,MX,MEX,127575529,America,174,3181,13
2020-04-10T00:00:00Z,10,4,2020,260,20,Mexico,MX,MEX,127575529,America,194,3441,14
2020-04-11T00:00:00Z,11,4,2020,403,39,Mexico,MX,MEX,127575529,America,233,3844,15
2020-04-12T00:00:00Z,12,4,2020,375,40,Mexico,MX,MEX,127575529,America,273,4219,16
2020-04-13T00:00:00Z,13,4,2020,442,23,Mexico,MX,MEX,127575529,America,296,4661,17
2020-04-14T00:00:00Z,14,4,2020,353,36,Mexico,MX,MEX,127575529,America,332,5014,18
2020-04-15T00:00:00Z,15,4,2020,385,74,Mexico,MX,MEX,127575529,America,406,5399,19
2020-04-16T00:00:00Z,16,4,2020,448,43,Mexico,MX,MEX,127575529,America,449,5847,20
2020-04-17T00:00:00Z,17,4,2020,450,37,Mexico,MX,MEX,127575529,America,486,6297,21
2020-04-18T00:00:00Z,18,4,2020,578,60,Mexico,MX,MEX,127575529,America,546,6875,22
2020-04-19T00:00:00Z,19,4,2020,622,104,Mexico,MX,MEX,127575529,America,650,7497,23
2020-04-20T00:00:00Z,20,4,2020,764,36,Mexico,MX,MEX,127575529,America,686,8261,24
2020-04-21T00:00:00Z,21,4,2020,511,26,Mexico,MX,MEX,127575529,America,712,8772,25
2020-04-22T00:00:00Z,22,4,2020,729,145,Mexico,MX,MEX,127575529,America,857,9501,26
2020-04-23T00:00:00Z,23,4,2020,1043,113,Mexico,MX,MEX,127575529,America,970,10544,27
2020-04-24T00:00:00Z,24,4,2020,1089,99,Mexico,MX,MEX,127575529,America,1069,11633,28
2020-04-25T00:00:00Z,25,4,2020,1239,152,Mexico,MX,MEX,127575529,America,1221,12872,29
2020-04-26T00:00:00Z,26,4,2020,970,84,Mexico,MX,MEX,127575529,America,1305,13842,30
2020-04-27T00:00:00Z,27,4,2020,835,46,Mexico,MX,MEX,127575529,America,1351,14677,31
2020-04-28T00:00:00Z,28,4,2020,852,83,Mexico,MX,MEX,127575529,America,1434,15529,32
2020-04-29T00:00:00Z,29,4,2020,1223,135,Mexico,MX,MEX,127575529,America,1569,16752,33
2020-04-30T00:00:00Z,30,4,2020,1047,163,Mexico,MX,MEX,127575529,America,1732,17799,34
2020-05-01T00:00:00Z,1,5,2020,1425,127,Mexico,MX,MEX,127575529,America,1859,19224,35
2020-05-02T00:00:00Z,2,5,2020,1515,113,Mexico,MX,MEX,127575529,America,1972,20739,36
2020-05-03T00:00:00Z,3,5,2020,1349,89,Mexico,MX,MEX,127575529,America,2061,22088,37
2020-05-04T00:00:00Z,4,5,2020,1383,93,Mexico,MX,MEX,127575529,America,2154,23471,38
2020-05-05T00:00:00Z,5,5,2020,1434,117,Mexico,MX,MEX,127575529,America,2271,24905,39
2020-05-06T00:00:00Z,6,5,2020,1120,236,Mexico,MX,MEX,127575529,America,2507,26025,40
2020-05-07T00:00:00Z,7,5,2020,1609,197,Mexico,MX,MEX,127575529,America,2704,27634,41
2020-05-08T00:00:00Z,8,5,2020,1982,257,Mexico,MX,MEX,127575529,America,2961,29616,42
2020-05-09T00:00:00Z,9,5,2020,1906,199,Mexico,MX,MEX,127575529,America,3160,31522,43
2020-05-10T00:00:00Z,10,5,2020,1938,193,Mexico,MX,MEX,127575529,America,3353,33460,44
2020-05-11T00:00:00Z,11,5,2020,1562,112,Mexico,MX,MEX,127575529,America,3465,35022,45
2020-05-12T00:00:00Z,12,5,2020,1305,108,Mexico,MX,MEX,127575529,America,3573,36327,46
2020-05-13T00:00:00Z,13,5,2020,1997,353,Mexico,MX,MEX,127575529,America,3926,38324,47
2020-05-14T00:00:00Z,14,5,2020,1862,294,Mexico,MX,MEX,127575529,America,4220,40186,48
2020-05-15T00:00:00Z,15,5,2020,2409,257,Mexico,MX,MEX,127575529,America,4477,42595,49
2020-05-16T00:00:00Z,16,5,2020,2437,290,Mexico,MX,MEX,127575529,America,4767,45032,50
2020-05-17T00:00:00Z,17,5,2020,2112,278,Mexico,MX,MEX,127575529,America,5045,47144,51
2020-05-18T00:00:00Z,18,5,2020,2075,132,Mexico,MX,MEX,127575529,America,5177,49219,52
2020-05-19T00:00:00Z,19,5,2020,2414,155,Mexico,MX,MEX,127575529,America,5332,51633,53
2020-05-20T00:00:00Z,20,5,2020,2713,334,Mexico,MX,MEX,127575529,America,5666,54346,54
2020-05-21T00:00:00Z,21,5,2020,2248,424,Mexico,MX,MEX,127575529,America,6090,56594,55
2020-05-22T00:00:00Z,22,5,2020,2973,420,Mexico,MX,MEX,127575529,America,6510,59567,56
2020-05-23T00:00:00Z,23,5,2020,2960,479,Mexico,MX,MEX,127575529,America,6989,62527,57
2020-05-24T00:00:00Z,24,5,2020,3329,190,Mexico,MX,MEX,127575529,America,7179,65856,58
2020-05-25T00:00:00Z,25,5,2020,2764,215,Mexico,MX,MEX,127575529,America,7394,68620,59
2020-05-26T00:00:00Z,26,5,2020,2485,239,Mexico,MX,MEX,127575529,America,7633,71105,60
2020-05-27T00:00:00Z,27,5,2020,3455,501,Mexico,MX,MEX,127575529,America,8134,74560,61
2020-05-28T00:00:00Z,28,5,2020,3463,463,Mexico,MX,MEX,127575529,America,8597,78023,62
2020-05-29T00:00:00Z,29,5,2020,3377,447,Mexico,MX,MEX,127575529,America,9044,81400,63
2020-05-30T00:00:00Z,30,5,2020,3227,371,Mexico,MX,MEX,127575529,America,9415,84627,64
2020-05-31T00:00:00Z,31,5,2020,2885,364,Mexico,MX,MEX,127575529,America,9779,87512,65
2020-06-01T00:00:00Z,1,6,2020,3152,151,Mexico,MX,MEX,127575529,America,9930,90664,66
2020-06-02T00:00:00Z,2,6,2020,2771,237,Mexico,MX,MEX,127575529,America,10167,93435,67
2020-06-03T00:00:00Z,3,6,2020,3891,470,Mexico,MX,MEX,127575529,America,10637,97326,68
2020-06-04T00:00:00Z,4,6,2020,3912,1091,Mexico,MX,MEX,127575529,America,11728,101238,69
2020-06-05T00:00:00Z,5,6,2020,4442,817,Mexico,MX,MEX,127575529,America,12545,105680,70
2020-06-06T00:00:00Z,6,6,2020,4346,625,Mexico,MX,MEX,127575529,America,13170,110026,71
2020-06-07T00:00:00Z,7,6,2020,3593,341,Mexico,MX,MEX,127575529,America,13511,113619,72
2020-06-08T00:00:00Z,8,6,2020,3484,188,Mexico,MX,MEX,127575529,America,13699,117103,73
2020-06-09T00:00:00Z,9,6,2020,2999,354,Mexico,MX,MEX,127575529,America,14053,120102,74
2020-06-10T00:00:00Z,10,6,2020,4199,596,Mexico,MX,MEX,127575529,America,14649,124301,75
2020-06-11T00:00:00Z,11,6,2020,4883,708,Mexico,MX,MEX,127575529,America,15357,129184,76
2020-06-12T00:00:00Z,12,6,2020,4790,587,Mexico,MX,MEX,127575529,America,15944,133974,77
2020-06-13T00:00:00Z,13,6,2020,5222,504,Mexico,MX,MEX,127575529,America,16448,139196,78
2020-06-14T00:00:00Z,14,6,2020,3494,424,Mexico,MX,MEX,127575529,America,16872,142690,79
2020-06-15T00:00:00Z,15,6,2020,4147,269,Mexico,MX,MEX,127575529,America,17141,146837,80
2020-06-16T00:00:00Z,16,6,2020,3427,439,Mexico,MX,MEX,127575529,America,17580,150264,81
2020-06-17T00:00:00Z,17,6,2020,4599,730,Mexico,MX,MEX,127575529,America,18310,154863,82
2020-06-18T00:00:00Z,18,6,2020,4930,770,Mexico,MX,MEX,127575529,America,19080,159793,83
2020-06-19T00:00:00Z,19,6,2020,5662,667,Mexico,MX,MEX,127575529,America,19747,165455,84
2020-06-20T00:00:00Z,20,6,2020,5030,647,Mexico,MX,MEX,127575529,America,20394,170485,85
2020-06-21T00:00:00Z,21,6,2020,4717,387,Mexico,MX,MEX,127575529,America,20781,175202,86
2020-06-22T00:00:00Z,22,6,2020,5343,1044,Mexico,MX,MEX,127575529,America,21825,180545,87
2020-06-23T00:00:00Z,23,6,2020,4577,759,Mexico,MX,MEX,127575529,America,22584,185122,88
2020-06-24T00:00:00Z,24,6,2020,6288,793,Mexico,MX,MEX,127575529,America,23377,191410,89
2020-06-25T00:00:00Z,25,6,2020,5437,965,Mexico,MX,MEX,127575529,America,24342,196847,90
2020-04-05T00:00:00Z,5,4,2020,161,4,Moldova,MD,MDA,4043258,Europe,12,752,1
2020-04-06T00:00:00Z,6,4,2020,112,3,Moldova,MD,MDA,4043258,Europe,15,864,2
2020-04-07T00:00:00Z,7,4,2020,101,4,Moldova,MD,MDA,4043258,Europe,19,965,3
2020-04-08T00:00:00Z,8,4,2020,91,3,Moldova,MD,MDA,4043258,Europe,22,1056,4
2020-04-09T00:00:00Z,9,4,2020,118,5,Moldova,MD,MDA,4043258,Europe,27,1174,5
2020-04-10T00:00:00Z,10,4,2020,115,2,Moldova,MD,MDA,4043258,Europe,29,1289,6
2020-04-11T00:00:00Z,11,4,2020,149,0,Moldova,MD,MDA,4043258,Europe,29,1438,7
2020-04-12T00:00:00Z,12,4,2020,122,1,Moldova,MD,MDA,4043258,Europe,30,1560,8
2020-04-13T00:00:00Z,13,4,2020,102,2,Moldova,MD,MDA,4043258,Europe,32,1662,9
2020-04-14T00:00:00Z,14,4,2020,50,4,Moldova,MD,MDA,4043258,Europe,36,1712,10
2020-04-15T00:00:00Z,15,4,2020,222,4,Moldova,MD,MDA,4043258,Europe,40,1934,11
2020-04-16T00:00:00Z,16,4,2020,115,6,Moldova,MD,MDA,4043258,Europe,46,2049,12
2020-04-17T00:00:00Z,17,4,2020,105,8,Moldova,MD,MDA,4043258,Europe,54,2154,13
2020-04-18T00:00:00Z,18,4,2020,110,2,Moldova,MD,MDA,4043258,Europe,56,2264,14
2020-04-19T00:00:00Z,19,4,2020,87,4,Moldova,MD,MDA,4043258,Europe,60,2351,15
2020-04-20T00:00:00Z,20,4,2020,121,7,Moldova,MD,MDA,4043258,Europe,67,2472,16
2020-04-21T00:00:00Z,21,4,2020,76,3,Moldova,MD,MDA,4043258,Europe,70,2548,17
2020-04-22T00:00:00Z,22,4,2020,66,3,Moldova,MD,MDA,4043258,Europe,73,2614,18
2020-04-23T00:00:00Z,23,4,2020,164,3,Moldova,MD,MDA,4043258,Europe,76,2778,19
2020-04-24T00:00:00Z,24,4,2020,148,4,Moldova,MD,MDA,4043258,Europe,80,2926,20
2020-04-25T00:00:00Z,25,4,2020,184,7,Moldova,MD,MDA,4043258,Europe,87,3110,21
2020-04-26T00:00:00Z,26,4,2020,194,7,Moldova,MD,MDA,4043258,Europe,94,3304,22
2020-04-27T00:00:00Z,27,4,2020,104,2,Moldova,MD,MDA,4043258,Europe,96,3408,23
2020-04-28T00:00:00Z,28,4,2020,73,6,Moldova,MD,MDA,4043258,Europe,102,3481,24
2020-04-29T00:00:00Z,29,4,2020,157,5,Moldova,MD,MDA,4043258,Europe,107,3638,25
2020-04-30T00:00:00Z,30,4,2020,133,4,Moldova,MD,MDA,4043258,Europe,111,3771,26
2020-05-01T00:00:00Z,1,5,2020,126,8,Moldova,MD,MDA,4043258,Europe,119,3897,27
2020-05-02T00:00:00Z,2,5,2020,83,3,Moldova,MD,MDA,4043258,Europe,122,3980,28
2020-05-03T00:00:00Z,3,5,2020,72,2,Moldova,MD,MDA,4043258,Europe,124,4052,29
2020-05-04T00:00:00Z,4,5,2020,69,1,Moldova,MD,MDA,4043258,Europe,125,4121,30
2020-05-05T00:00:00Z,5,5,2020,127,7,Moldova,MD,MDA,4043258,Europe,132,4248,31
2020-05-06T00:00:00Z,6,5,2020,115,4,Moldova,MD,MDA,4043258,Europe,136,4363,32
2020-05-07T00:00:00Z,7,5,2020,113,7,Moldova,MD,MDA,4043258,Europe,143,4476,33
2020-05-08T00:00:00Z,8,5,2020,129,2,Moldova,MD,MDA,4043258,Europe,145,4605,34
2020-05-09T00:00:00Z,9,5,2020,123,7,Moldova,MD,MDA,4043258,Europe,152,4728,35
2020-05-10T00:00:00Z,10,5,2020,139,9,Moldova,MD,MDA,4043258,Europe,161,4867,36
2020-05-11T00:00:00Z,11,5,2020,60,8,Moldova,MD,MDA,4043258,Europe,169,4927,37
2020-05-12T00:00:00Z,12,5,2020,68,6,Moldova,MD,MDA,4043258,Europe,175,4995,38
2020-05-13T00:00:00Z,13,5,2020,159,7,Moldova,MD,MDA,4043258,Europe,182,5154,39
2020-05-14T00:00:00Z,14,5,2020,252,3,Moldova,MD,MDA,4043258,Europe,185,5406,40
2020-05-15T00:00:00Z,15,5,2020,147,9,Moldova,MD,MDA,4043258,Europe,194,5553,41
2020-05-16T00:00:00Z,16,5,2020,192,3,Moldova,MD,MDA,4043258,Europe,197,5745,42
2020-05-17T00:00:00Z,17,5,2020,189,10,Moldova,MD,MDA,4043258,Europe,207,5934,43
2020-05-18T00:00:00Z,18,5,2020,126,4,Moldova,MD,MDA,4043258,Europe,211,6060,44
2020-05-19T00:00:00Z,19,5,2020,78,4,Moldova,MD,MDA,4043258,Europe,215,6138,45
2020-05-20T00:00:00Z,20,5,2020,202,6,Moldova,MD,MDA,4043258,Europe,221,6340,46
2020-05-21T00:00:00Z,21,5,2020,213,7,Moldova,MD,MDA,4043258,Europe,228,6553,47
2020-05-22T00:00:00Z,22,5,2020,151,5,Moldova,MD,MDA,4043258,Europe,233,6704,48
2020-05-23T00:00:00Z,23,5,2020,143,4,Moldova,MD,MDA,4043258,Europe,237,6847,49
2020-05-24T00:00:00Z,24,5,2020,147,5,Moldova,MD,MDA,4043258,Europe,242,6994,50
2020-05-25T00:00:00Z,25,5,2020,99,8,Moldova,MD,MDA,4043258,Europe,250,7093,51
2020-05-26T00:00:00Z,26,5,2020,54,11,Moldova,MD,MDA,4043258,Europe,261,7147,52
2020-05-27T00:00:00Z,27,5,2020,158,6,Moldova,MD,MDA,4043258,Europe,267,7305,53
2020-05-28T00:00:00Z,28,5,2020,232,7,Moldova,MD,MDA,4043258,Europe,274,7537,54
2020-05-29T00:00:00Z,29,5,2020,188,8,Moldova,MD,MDA,4043258,Europe,282,7725,55
2020-05-30T00:00:00Z,30,5,2020,171,6,Moldova,MD,MDA,4043258,Europe,288,7896,56
2020-05-31T00:00:00Z,31,5,2020,202,3,Moldova,MD,MDA,4043258,Europe,291,8098,57
2020-06-01T00:00:00Z,1,6,2020,153,4,Moldova,MD,MDA,4043258,Europe,295,8251,58
2020-06-02T00:00:00Z,2,6,2020,109,12,Moldova,MD,MDA,4043258,Europe,307,8360,59
2020-06-03T00:00:00Z,3,6,2020,188,0,Moldova,MD,MDA,4043258,Europe,307,8548,60
2020-06-04T00:00:00Z,4,6,2020,247,3,Moldova,MD,MDA,4043258,Europe,310,8795,61
2020-06-05T00:00:00Z,5,6,2020,223,5,Moldova,MD,MDA,4043258,Europe,315,9018,62
2020-06-06T00:00:00Z,6,6,2020,229,8,Moldova,MD,MDA,4043258,Europe,323,9247,63
2020-06-07T00:00:00Z,7,6,2020,264,8,Moldova,MD,MDA,4043258,Europe,331,9511,64
2020-06-08T00:00:00Z,8,6,2020,189,10,Moldova,MD,MDA,4043258,Europe,341,9700,65
2020-06-09T00:00:00Z,9,6,2020,107,12,Moldova,MD,MDA,4043258,Europe,353,9807,66
2020-06-10T00:00:00Z,10,6,2020,218,12,Moldova,MD,MDA,4043258,Europe,365,10025,67
2020-06-11T00:00:00Z,11,6,2020,296,6,Moldova,MD,MDA,4043258,Europe,371,10321,68
2020-06-12T00:00:00Z,12,6,2020,406,4,Moldova,MD,MDA,4043258,Europe,375,10727,69
2020-06-13T00:00:00Z,13,6,2020,366,10,Moldova,MD,MDA,4043258,Europe,385,11093,70
2020-06-14T00:00:00Z,14,6,2020,366,13,Moldova,MD,MDA,4043258,Europe,398,11459,71
2020-06-15T00:00:00Z,15,6,2020,281,8,Moldova,MD,MDA,4043258,Europe,406,11740,72
2020-06-16T00:00:00Z,16,6,2020,139,5,Moldova,MD,MDA,4043258,Europe,411,11879,73
2020-06-17T00:00:00Z,17,6,2020,375,12,Moldova,MD,MDA,4043258,Europe,423,12254,74
2020-06-18T00:00:00Z,18,6,2020,478,10,Moldova,MD,MDA,4043258,Europe,433,12732,75
2020-06-19T00:00:00Z,19,6,2020,374,11,Moldova,MD,MDA,4043258,Europe,444,13106,76
2020-06-20T00:00:00Z,20,6,2020,450,6,Moldova,MD,MDA,4043258,Europe,450,13556,77
2020-06-21T00:00:00Z,21,6,2020,397,14,Moldova,MD,MDA,4043258,Europe,464,13953,78
2020-06-22T00:00:00Z,22,6,2020,247,9,Moldova,MD,MDA,4043258,Europe,473,14200,79
2020-06-23T00:00:00Z,23,6,2020,163,7,Moldova,MD,MDA,4043258,Europe,480,14363,80
2020-06-24T00:00:00Z,24,6,2020,351,10,Moldova,MD,MDA,4043258,Europe,490,14714,81
2020-06-25T00:00:00Z,25,6,2020,364,5,Moldova,MD,MDA,4043258,Europe,495,15078,82
2020-03-27T00:00:00Z,27,3,2020,50,4,Morocco,MA,MAR,36471766,Africa,10,275,1
2020-03-28T00:00:00Z,28,3,2020,70,13,Morocco,MA,MAR,36471766,Africa,23,345,2
2020-03-29T00:00:00Z,29,3,2020,13,0,Morocco,MA,MAR,36471766,Africa,23,358,3
2020-03-30T00:00:00Z,30,3,2020,121,3,Morocco,MA,MAR,36471766,Africa,26,479,4
2020-03-31T00:00:00Z,31,3,2020,77,7,Morocco,MA,MAR,36471766,Africa,33,556,5
2020-04-01T00:00:00Z,1,4,2020,61,3,Morocco,MA,MAR,36471766,Africa,36,617,6
2020-04-02T00:00:00Z,2,4,2020,37,3,Morocco,MA,MAR,36471766,Africa,39,654,7
2020-04-03T00:00:00Z,3,4,2020,54,5,Morocco,MA,MAR,36471766,Africa,44,708,8
2020-04-04T00:00:00Z,4,4,2020,0,0,Morocco,MA,MAR,36471766,Africa,44,708,9
2020-04-05T00:00:00Z,5,4,2020,211,15,Morocco,MA,MAR,36471766,Africa,59,919,10
2020-04-06T00:00:00Z,6,4,2020,102,11,Morocco,MA,MAR,36471766,Africa,70,1021,11
2020-04-07T00:00:00Z,7,4,2020,99,10,Morocco,MA,MAR,36471766,Africa,80,1120,12
2020-04-08T00:00:00Z,8,4,2020,64,10,Morocco,MA,MAR,36471766,Africa,90,1184,13
2020-04-09T00:00:00Z,9,4,2020,91,3,Morocco,MA,MAR,36471766,Africa,93,1275,14
2020-04-10T00:00:00Z,10,4,2020,99,4,Morocco,MA,MAR,36471766,Africa,97,1374,15
2020-04-11T00:00:00Z,11,4,2020,74,10,Morocco,MA,MAR,36471766,Africa,107,1448,16
2020-04-12T00:00:00Z,12,4,2020,97,4,Morocco,MA,MAR,36471766,Africa,111,1545,17
2020-04-13T00:00:00Z,13,4,2020,116,7,Morocco,MA,MAR,36471766,Africa,118,1661,18
2020-04-14T00:00:00Z,14,4,2020,102,8,Morocco,MA,MAR,36471766,Africa,126,1763,19
2020-04-15T00:00:00Z,15,4,2020,125,0,Morocco,MA,MAR,36471766,Africa,126,1888,20
2020-04-16T00:00:00Z,16,4,2020,136,1,Morocco,MA,MAR,36471766,Africa,127,2024,21
2020-04-17T00:00:00Z,17,4,2020,259,3,Morocco,MA,MAR,36471766,Africa,130,2283,22
2020-04-18T00:00:00Z,18,4,2020,281,5,Morocco,MA,MAR,36471766,Africa,135,2564,23
2020-04-19T00:00:00Z,19,4,2020,121,2,Morocco,MA,MAR,36471766,Africa,137,2685,24
2020-04-20T00:00:00Z,20,4,2020,170,4,Morocco,MA,MAR,36471766,Africa,141,2855,25
2020-04-21T00:00:00Z,21,4,2020,191,2,Morocco,MA,MAR,36471766,Africa,143,3046,26
2020-04-22T00:00:00Z,22,4,2020,163,2,Morocco,MA,MAR,36471766,Africa,145,3209,27
2020-04-23T00:00:00Z,23,4,2020,168,4,Morocco,MA,MAR,36471766,Africa,149,3377,28
2020-04-24T00:00:00Z,24,4,2020,191,6,Morocco,MA,MAR,36471766,Africa,155,3568,29
2020-04-25T00:00:00Z,25,4,2020,190,3,Morocco,MA,MAR,36471766,Africa,158,3758,30
2020-04-26T00:00:00Z,26,4,2020,139,1,Morocco,MA,MAR,36471766,Africa,159,3897,31
2020-04-27T00:00:00Z,27,4,2020,168,2,Morocco,MA,MAR,36471766,Africa,161,4065,32
2020-04-28T00:00:00Z,28,4,2020,55,1,Morocco,MA,MAR,36471766,Africa,162,4120,33
2020-04-29T00:00:00Z,29,4,2020,132,3,Morocco,MA,MAR,36471766,Africa,165,4252,34
2020-04-30T00:00:00Z,30,4,2020,69,3,Morocco,MA,MAR,36471766,Africa,168,4321,35
2020-05-01T00:00:00Z,1,5,2020,102,2,Morocco,MA,MAR,36471766,Africa,170,4423,36
2020-05-02T00:00:00Z,2,5,2020,146,1,Morocco,MA,MAR,36471766,Africa,171,4569,37
2020-05-03T00:00:00Z,3,5,2020,160,2,Morocco,MA,MAR,36471766,Africa,173,4729,38
2020-05-04T00:00:00Z,4,5,2020,174,1,Morocco,MA,MAR,36471766,Africa,174,4903,39
2020-05-05T00:00:00Z,5,5,2020,140,5,Morocco,MA,MAR,36471766,Africa,179,5043,40
2020-05-06T00:00:00Z,6,5,2020,176,2,Morocco,MA,MAR,36471766,Africa,181,5219,41
2020-05-07T00:00:00Z,7,5,2020,189,2,Morocco,MA,MAR,36471766,Africa,183,5408,42
2020-05-08T00:00:00Z,8,5,2020,140,0,Morocco,MA,MAR,36471766,Africa,183,5548,43
2020-05-09T00:00:00Z,9,5,2020,163,3,Morocco,MA,MAR,36471766,Africa,186,5711,44
2020-05-10T00:00:00Z,10,5,2020,199,0,Morocco,MA,MAR,36471766,Africa,186,5910,45
2020-05-11T00:00:00Z,11,5,2020,153,2,Morocco,MA,MAR,36471766,Africa,188,6063,46
2020-05-12T00:00:00Z,12,5,2020,218,0,Morocco,MA,MAR,36471766,Africa,188,6281,47
2020-05-13T00:00:00Z,13,5,2020,137,0,Morocco,MA,MAR,36471766,Africa,188,6418,48
2020-05-14T00:00:00Z,14,5,2020,94,0,Morocco,MA,MAR,36471766,Africa,188,6512,49
2020-05-15T00:00:00Z,15,5,2020,95,2,Morocco,MA,MAR,36471766,Africa,190,6607,50
2020-05-16T00:00:00Z,16,5,2020,45,0,Morocco,MA,MAR,36471766,Africa,190,6652,51
2020-05-17T00:00:00Z,17,5,2020,89,2,Morocco,MA,MAR,36471766,Africa,192,6741,52
2020-05-18T00:00:00Z,18,5,2020,129,0,Morocco,MA,MAR,36471766,Africa,192,6870,53
2020-05-19T00:00:00Z,19,5,2020,82,0,Morocco,MA,MAR,36471766,Africa,192,6952,54
2020-05-20T00:00:00Z,20,5,2020,71,1,Morocco,MA,MAR,36471766,Africa,193,7023,55
2020-05-21T00:00:00Z,21,5,2020,110,1,Morocco,MA,MAR,36471766,Africa,194,7133,56
2020-05-22T00:00:00Z,22,5,2020,78,2,Morocco,MA,MAR,36471766,Africa,196,7211,57
2020-05-23T00:00:00Z,23,5,2020,121,1,Morocco,MA,MAR,36471766,Africa,197,7332,58
2020-05-24T00:00:00Z,24,5,2020,74,1,Morocco,MA,MAR,36471766,Africa,198,7406,59
2020-05-25T00:00:00Z,25,5,2020,27,1,Morocco,MA,MAR,36471766,Africa,199,7433,60
2020-05-26T00:00:00Z,26,5,2020,99,1,Morocco,MA,MAR,36471766,Africa,200,7532,61
2020-05-27T00:00:00Z,27,5,2020,45,2,Morocco,MA,MAR,36471766,Africa,202,7577,62
2020-05-28T00:00:00Z,28,5,2020,24,0,Morocco,MA,MAR,36471766,Africa,202,7601,63
2020-05-29T00:00:00Z,29,5,2020,42,0,Morocco,MA,MAR,36471766,Africa,202,7643,64
2020-05-30T00:00:00Z,30,5,2020,71,0,Morocco,MA,MAR,36471766,Africa,202,7714,65
2020-05-31T00:00:00Z,31,5,2020,66,2,Morocco,MA,MAR,36471766,Africa,204,7780,66
2020-06-01T00:00:00Z,1,6,2020,27,1,Morocco,MA,MAR,36471766,Africa,205,7807,67
2020-06-02T00:00:00Z,2,6,2020,26,0,Morocco,MA,MAR,36471766,Africa,205,7833,68
2020-06-03T00:00:00Z,3,6,2020,33,1,Morocco,MA,MAR,36471766,Africa,206,7866,69
2020-06-04T00:00:00Z,4,6,2020,56,0,Morocco,MA,MAR,36471766,Africa,206,7922,70
2020-06-05T00:00:00Z,5,6,2020,81,2,Morocco,MA,MAR,36471766,Africa,208,8003,71
2020-06-06T00:00:00Z,6,6,2020,68,0,Morocco,MA,MAR,36471766,Africa,208,8071,72
2020-06-07T00:00:00Z,7,6,2020,61,0,Morocco,MA,MAR,36471766,Africa,208,8132,73
2020-06-08T00:00:00Z,8,6,2020,92,0,Morocco,MA,MAR,36471766,Africa,208,8224,74
2020-06-09T00:00:00Z,9,6,2020,78,0,Morocco,MA,MAR,36471766,Africa,208,8302,75
2020-06-10T00:00:00Z,10,6,2020,135,2,Morocco,MA,MAR,36471766,Africa,210,8437,76
2020-06-11T00:00:00Z,11,6,2020,18,0,Morocco,MA,MAR,36471766,Africa,210,8455,77
2020-06-12T00:00:00Z,12,6,2020,82,1,Morocco,MA,MAR,36471766,Africa,211,8537,78
2020-06-13T00:00:00Z,13,6,2020,73,1,Morocco,MA,MAR,36471766,Africa,212,8610,79
2020-06-14T00:00:00Z,14,6,2020,82,0,Morocco,MA,MAR,36471766,Africa,212,8692,80
2020-06-15T00:00:00Z,15,6,2020,42,0,Morocco,MA,MAR,36471766,Africa,212,8734,81
2020-06-16T00:00:00Z,16,6,2020,104,0,Morocco,MA,MAR,36471766,Africa,212,8838,82
2020-06-17T00:00:00Z,17,6,2020,83,0,Morocco,MA,MAR,36471766,Africa,212,8921,83
2020-06-18T00:00:00Z,18,6,2020,76,1,Morocco,MA,MAR,36471766,Africa,213,8997,84
2020-06-19T00:00:00Z,19,6,2020,77,0,Morocco,MA,MAR,36471766,Africa,213,9074,85
2020-06-20T00:00:00Z,20,6,2020,539,0,Morocco,MA,MAR,36471766,Africa,213,9613,86
2020-06-21T00:00:00Z,21,6,2020,188,0,Morocco,MA,MAR,36471766,Africa,213,9801,87
2020-06-22T00:00:00Z,22,6,2020,176,1,Morocco,MA,MAR,36471766,Africa,214,9977,88
2020-06-23T00:00:00Z,23,6,2020,195,0,Morocco,MA,MAR,36471766,Africa,214,10172,89
2020-06-24T00:00:00Z,24,6,2020,92,0,Morocco,MA,MAR,36471766,Africa,214,10264,90
2020-06-25T00:00:00Z,25,6,2020,643,2,Morocco,MA,MAR,36471766,Africa,216,10907,91
2020-06-05T00:00:00Z,5,6,2020,334,1,Nepal,NP,NPL,28608715,Asia,10,2634,1
2020-06-06T00:00:00Z,6,6,2020,278,1,Nepal,NP,NPL,28608715,Asia,11,2912,2
2020-06-07T00:00:00Z,7,6,2020,0,0,Nepal,NP,NPL,28608715,Asia,11,2912,3
2020-06-08T00:00:00Z,8,6,2020,536,2,Nepal,NP,NPL,28608715,Asia,13,3448,4
2020-06-09T00:00:00Z,9,6,2020,314,1,Nepal,NP,NPL,28608715,Asia,14,3762,5
2020-06-10T00:00:00Z,10,6,2020,323,1,Nepal,NP,NPL,28608715,Asia,15,4085,6
2020-06-11T00:00:00Z,11,6,2020,279,0,Nepal,NP,NPL,28608715,Asia,15,4364,7
2020-06-12T00:00:00Z,12,6,2020,250,0,Nepal,NP,NPL,28608715,Asia,15,4614,8
2020-06-13T00:00:00Z,13,6,2020,448,1,Nepal,NP,NPL,28608715,Asia,16,5062,9
2020-06-14T00:00:00Z,14,6,2020,273,2,Nepal,NP,NPL,28608715,Asia,18,5335,10
2020-06-15T00:00:00Z,15,6,2020,425,1,Nepal,NP,NPL,28608715,Asia,19,5760,11
2020-06-16T00:00:00Z,16,6,2020,451,0,Nepal,NP,NPL,28608715,Asia,19,6211,12
2020-06-17T00:00:00Z,17,6,2020,380,0,Nepal,NP,NPL,28608715,Asia,19,6591,13
2020-06-18T00:00:00Z,18,6,2020,586,1,Nepal,NP,NPL,28608715,Asia,20,7177,14
2020-06-19T00:00:00Z,19,6,2020,671,2,Nepal,NP,NPL,28608715,Asia,22,7848,15
2020-06-20T00:00:00Z,20,6,2020,426,0,Nepal,NP,NPL,28608715,Asia,22,8274,16
2020-06-21T00:00:00Z,21,6,2020,331,0,Nepal,NP,NPL,28608715,Asia,22,8605,17
2020-06-22T00:00:00Z,22,6,2020,421,1,Nepal,NP,NPL,28608715,Asia,23,9026,18
2020-06-23T00:00:00Z,23,6,2020,0,0,Nepal,NP,NPL,28608715,Asia,23,9026,19
2020-06-24T00:00:00Z,24,6,2020,0,0,Nepal,NP,NPL,28608715,Asia,23,9026,20
2020-06-25T00:00:00Z,25,6,2020,1702,0,Nepal,NP,NPL,28608715,Asia,23,10728,21
2020-03-15T00:00:00Z,15,3,2020,155,7,Netherlands,NL,NLD,17282163,Europe,12,959,1
2020-03-16T00:00:00Z,16,3,2020,176,8,Netherlands,NL,NLD,17282163,Europe,20,1135,2
2020-03-17T00:00:00Z,17,3,2020,278,4,Netherlands,NL,NLD,17282163,Europe,24,1413,3
2020-03-18T00:00:00Z,18,3,2020,292,19,Netherlands,NL,NLD,17282163,Europe,43,1705,4
2020-03-19T00:00:00Z,19,3,2020,346,15,Netherlands,NL,NLD,17282163,Europe,58,2051,5
2020-03-20T00:00:00Z,20,3,2020,409,18,Netherlands,NL,NLD,17282163,Europe,76,2460,6
2020-03-21T00:00:00Z,21,3,2020,534,30,Netherlands,NL,NLD,17282163,Europe,106,2994,7
2020-03-22T00:00:00Z,22,3,2020,637,30,Netherlands,NL,NLD,17282163,Europe,136,3631,8
2020-03-23T00:00:00Z,23,3,2020,573,43,Netherlands,NL,NLD,17282163,Europe,179,4204,9
2020-03-24T00:00:00Z,24,3,2020,545,34,Netherlands,NL,NLD,17282163,Europe,213,4749,10
2020-03-25T00:00:00Z,25,3,2020,811,63,Netherlands,NL,NLD,17282163,Europe,276,5560,11
2020-03-26T00:00:00Z,26,3,2020,852,80,Netherlands,NL,NLD,17282163,Europe,356,6412,12
2020-03-27T00:00:00Z,27,3,2020,1019,78,Netherlands,NL,NLD,17282163,Europe,434,7431,13
2020-03-28T00:00:00Z,28,3,2020,1172,112,Netherlands,NL,NLD,17282163,Europe,546,8603,14
2020-03-29T00:00:00Z,29,3,2020,1159,93,Netherlands,NL,NLD,17282163,Europe,639,9762,15
2020-03-30T00:00:00Z,30,3,2020,1104,132,Netherlands,NL,NLD,17282163,Europe,771,10866,16
2020-03-31T00:00:00Z,31,3,2020,884,93,Netherlands,NL,NLD,17282163,Europe,864,11750,17
2020-04-01T00:00:00Z,1,4,2020,845,175,Netherlands,NL,NLD,17282163,Europe,1039,12595,18
2020-04-02T00:00:00Z,2,4,2020,1019,134,Netherlands,NL,NLD,17282163,Europe,1173,13614,19
2020-04-03T00:00:00Z,3,4,2020,1083,166,Netherlands,NL,NLD,17282163,Europe,1339,14697,20
2020-04-04T00:00:00Z,4,4,2020,1026,148,Netherlands,NL,NLD,17282163,Europe,1487,15723,21
2020-04-05T00:00:00Z,5,4,2020,904,164,Netherlands,NL,NLD,17282163,Europe,1651,16627,22
2020-04-06T00:00:00Z,6,4,2020,1224,115,Netherlands,NL,NLD,17282163,Europe,1766,17851,23
2020-04-07T00:00:00Z,7,4,2020,952,101,Netherlands,NL,NLD,17282163,Europe,1867,18803,24
2020-04-08T00:00:00Z,8,4,2020,777,234,Netherlands,NL,NLD,17282163,Europe,2101,19580,25
2020-04-09T00:00:00Z,9,4,2020,969,147,Netherlands,NL,NLD,17282163,Europe,2248,20549,26
2020-04-10T00:00:00Z,10,4,2020,1213,148,Netherlands,NL,NLD,17282163,Europe,2396,21762,27
2020-04-11T00:00:00Z,11,4,2020,1335,115,Netherlands,NL,NLD,17282163,Europe,2511,23097,28
2020-04-12T00:00:00Z,12,4,2020,1316,132,Netherlands,NL,NLD,17282163,Europe,2643,24413,29
2020-04-13T00:00:00Z,13,4,2020,1174,94,Netherlands,NL,NLD,17282163,Europe,2737,25587,30
2020-04-14T00:00:00Z,14,4,2020,964,86,Netherlands,NL,NLD,17282163,Europe,2823,26551,31
2020-04-15T00:00:00Z,15,4,2020,868,122,Netherlands,NL,NLD,17282163,Europe,2945,27419,32
2020-04-16T00:00:00Z,16,4,2020,734,189,Netherlands,NL,NLD,17282163,Europe,3134,28153,33
2020-04-17T00:00:00Z,17,4,2020,1061,181,Netherlands,NL,NLD,17282163,Europe,3315,29214,34
2020-04-18T00:00:00Z,18,4,2020,1235,144,Netherlands,NL,NLD,17282163,Europe,3459,30449,35
2020-04-19T00:00:00Z,19,4,2020,1140,142,Netherlands,NL,NLD,17282163,Europe,3601,31589,36
2020-04-20T00:00:00Z,20,4,2020,1066,83,Netherlands,NL,NLD,17282163,Europe,3684,32655,37
2020-04-21T00:00:00Z,21,4,2020,750,67,Netherlands,NL,NLD,17282163,Europe,3751,33405,38
2020-04-22T00:00:00Z,22,4,2020,729,165,Netherlands,NL,NLD,17282163,Europe,3916,34134,39
2020-04-23T00:00:00Z,23,4,2020,708,138,Netherlands,NL,NLD,17282163,Europe,4054,34842,40
2020-04-24T00:00:00Z,24,4,2020,887,123,Netherlands,NL,NLD,17282163,Europe,4177,35729,41
2020-04-25T00:00:00Z,25,4,2020,806,112,Netherlands,NL,NLD,17282163,Europe,4289,36535,42
2020-04-26T00:00:00Z,26,4,2020,655,120,Netherlands,NL,NLD,17282163,Europe,4409,37190,43
2020-04-27T00:00:00Z,27,4,2020,655,66,Netherlands,NL,NLD,17282163,Europe,4475,37845,44
2020-04-28T00:00:00Z,28,4,2020,400,43,Netherlands,NL,NLD,17282163,Europe,4518,38245,45
2020-04-29T00:00:00Z,29,4,2020,171,48,Netherlands,NL,NLD,17282163,Europe,4566,38416,46
2020-04-30T00:00:00Z,30,4,2020,386,145,Netherlands,NL,NLD,17282163,Europe,4711,38802,47
2020-05-01T00:00:00Z,1,5,2020,514,84,Netherlands,NL,NLD,17282163,Europe,4795,39316,48
2020-05-02T00:00:00Z,2,5,2020,475,98,Netherlands,NL,NLD,17282163,Europe,4893,39791,49
2020-05-03T00:00:00Z,3,5,2020,445,94,Netherlands,NL,NLD,17282163,Europe,4987,40236,50
2020-05-04T00:00:00Z,4,5,2020,335,69,Netherlands,NL,NLD,17282163,Europe,5056,40571,51
2020-05-05T00:00:00Z,5,5,2020,199,26,Netherlands,NL,NLD,17282163,Europe,5082,40770,52
2020-05-06T00:00:00Z,6,5,2020,317,86,Netherlands,NL,NLD,17282163,Europe,5168,41087,53
2020-05-07T00:00:00Z,7,5,2020,232,36,Netherlands,NL,NLD,17282163,Europe,5204,41319,54
2020-05-08T00:00:00Z,8,5,2020,455,84,Netherlands,NL,NLD,17282163,Europe,5288,41774,55
2020-05-09T00:00:00Z,9,5,2020,319,71,Netherlands,NL,NLD,17282163,Europe,5359,42093,56
2020-05-10T00:00:00Z,10,5,2020,289,63,Netherlands,NL,NLD,17282163,Europe,5422,42382,57
2020-05-11T00:00:00Z,11,5,2020,245,18,Netherlands,NL,NLD,17282163,Europe,5440,42627,58
2020-05-12T00:00:00Z,12,5,2020,161,16,Netherlands,NL,NLD,17282163,Europe,5456,42788,59
2020-05-13T00:00:00Z,13,5,2020,196,54,Netherlands,NL,NLD,17282163,Europe,5510,42984,60
2020-05-14T00:00:00Z,14,5,2020,227,52,Netherlands,NL,NLD,17282163,Europe,5562,43211,61
2020-05-15T00:00:00Z,15,5,2020,270,28,Netherlands,NL,NLD,17282163,Europe,5590,43481,62
2020-05-16T00:00:00Z,16,5,2020,200,53,Netherlands,NL,NLD,17282163,Europe,5643,43681,63
2020-05-17T00:00:00Z,17,5,2020,189,27,Netherlands,NL,NLD,17282163,Europe,5670,43870,64
2020-05-18T00:00:00Z,18,5,2020,125,10,Netherlands,NL,NLD,17282163,Europe,5680,43995,65
2020-05-19T00:00:00Z,19,5,2020,146,14,Netherlands,NL,NLD,17282163,Europe,5694,44141,66
2020-05-20T00:00:00Z,20,5,2020,108,21,Netherlands,NL,NLD,17282163,Europe,5715,44249,67
2020-05-21T00:00:00Z,21,5,2020,198,33,Netherlands,NL,NLD,17282163,Europe,5748,44447,68
2020-05-22T00:00:00Z,22,5,2020,253,27,Netherlands,NL,NLD,17282163,Europe,5775,44700,69
2020-05-23T00:00:00Z,23,5,2020,188,13,Netherlands,NL,NLD,17282163,Europe,5788,44888,70
2020-05-24T00:00:00Z,24,5,2020,176,23,Netherlands,NL,NLD,17282163,Europe,5811,45064,71
2020-05-25T00:00:00Z,25,5,2020,172,11,Netherlands,NL,NLD,17282163,Europe,5822,45236,72
2020-05-26T00:00:00Z,26,5,2020,209,8,Netherlands,NL,NLD,17282163,Europe,5830,45445,73
2020-05-27T00:00:00Z,27,5,2020,133,26,Netherlands,NL,NLD,17282163,Europe,5856,45578,74
2020-05-28T00:00:00Z,28,5,2020,190,15,Netherlands,NL,NLD,17282163,Europe,5871,45768,75
2020-05-29T00:00:00Z,29,5,2020,182,32,Netherlands,NL,NLD,17282163,Europe,5903,45950,76
2020-05-30T00:00:00Z,30,5,2020,176,28,Netherlands,NL,NLD,17282163,Europe,5931,46126,77
2020-05-31T00:00:00Z,31,5,2020,131,20,Netherlands,NL,NLD,17282163,Europe,5951,46257,78
2020-06-01T00:00:00Z,1,6,2020,185,5,Netherlands,NL,NLD,17282163,Europe,5956,46442,79
2020-06-02T00:00:00Z,2,6,2020,103,6,Netherlands,NL,NLD,17282163,Europe,5962,46545,80
2020-06-03T00:00:00Z,3,6,2020,102,5,Netherlands,NL,NLD,17282163,Europe,5967,46647,81
2020-06-04T00:00:00Z,4,6,2020,86,10,Netherlands,NL,NLD,17282163,Europe,5977,46733,82
2020-06-05T00:00:00Z,5,6,2020,209,13,Netherlands,NL,NLD,17282163,Europe,5990,46942,83
2020-06-06T00:00:00Z,6,6,2020,210,15,Netherlands,NL,NLD,17282163,Europe,6005,47152,84
2020-06-07T00:00:00Z,7,6,2020,183,6,Netherlands,NL,NLD,17282163,Europe,6011,47335,85
2020-06-08T00:00:00Z,8,6,2020,239,2,Netherlands,NL,NLD,17282163,Europe,6013,47574,86
2020-06-09T00:00:00Z,9,6,2020,165,3,Netherlands,NL,NLD,17282163,Europe,6016,47739,87
2020-06-10T00:00:00Z,10,6,2020,164,15,Netherlands,NL,NLD,17282163,Europe,6031,47903,88
2020-06-11T00:00:00Z,11,6,2020,184,11,Netherlands,NL,NLD,17282163,Europe,6042,48087,89
2020-06-12T00:00:00Z,12,6,2020,164,2,Netherlands,NL,NLD,17282163,Europe,6044,48251,90
2020-06-13T00:00:00Z,13,6,2020,210,9,Netherlands,NL,NLD,17282163,Europe,6053,48461,91
2020-06-14T00:00:00Z,14,6,2020,179,4,Netherlands,NL,NLD,17282163,Europe,6057,48640,92
2020-06-15T00:00:00Z,15,6,2020,143,2,Netherlands,NL,NLD,17282163,Europe,6059,48783,93
2020-06-16T00:00:00Z,16,6,2020,0,0,Netherlands,NL,NLD,17282163,Europe,6059,48783,94
2020-06-17T00:00:00Z,17,6,2020,304,11,Netherlands,NL,NLD,17282163,Europe,6070,49087,95
2020-06-18T00:00:00Z,18,6,2020,117,4,Netherlands,NL,NLD,17282163,Europe,6074,49204,96
2020-06-19T00:00:00Z,19,6,2020,115,4,Netherlands,NL,NLD,17282163,Europe,6078,49319,97
2020-06-20T00:00:00Z,20,6,2020,107,3,Netherlands,NL,NLD,17282163,Europe,6081,49426,98
2020-06-21T00:00:00Z,21,6,2020,76,8,Netherlands,NL,NLD,17282163,Europe,6089,49502,99
2020-06-22T00:00:00Z,22,6,2020,91,1,Netherlands,NL,NLD,17282163,Europe,6090,49593,100
2020-06-23T00:00:00Z,23,6,2020,65,0,Netherlands,NL,NLD,17282163,Europe,6090,49658,101
2020-06-24T00:00:00Z,24,6,2020,64,5,Netherlands,NL,NLD,17282163,Europe,6095,49722,102
2020-06-25T00:00:00Z,25,6,2020,82,2,Netherlands,NL,NLD,17282163,Europe,6097,49804,103
2020-04-17T00:00:00Z,17,4,2020,2,2,New_Zealand,NZ,NZL,4783062,Oceania,11,1086,1
2020-04-18T00:00:00Z,18,4,2020,8,0,New_Zealand,NZ,NZL,4783062,Oceania,11,1094,2
2020-04-19T00:00:00Z,19,4,2020,4,1,New_Zealand,NZ,NZL,4783062,Oceania,12,1098,3
2020-04-20T00:00:00Z,20,4,2020,7,0,New_Zealand,NZ,NZL,4783062,Oceania,12,1105,4
2020-04-21T00:00:00Z,21,4,2020,2,1,New_Zealand,NZ,NZL,4783062,Oceania,13,1107,5
2020-04-22T00:00:00Z,22,4,2020,5,1,New_Zealand,NZ,NZL,4783062,Oceania,14,1112,6
2020-04-23T00:00:00Z,23,4,2020,0,2,New_Zealand,NZ,NZL,4783062,Oceania,16,1112,7
2020-04-24T00:00:00Z,24,4,2020,2,1,New_Zealand,NZ,NZL,4783062,Oceania,17,1114,8
2020-04-25T00:00:00Z,25,4,2020,3,1,New_Zealand,NZ,NZL,4783062,Oceania,18,1117,9
2020-04-26T00:00:00Z,26,4,2020,4,0,New_Zealand,NZ,NZL,4783062,Oceania,18,1121,10
2020-04-27T00:00:00Z,27,4,2020,1,1,New_Zealand,NZ,NZL,4783062,Oceania,19,1122,11
2020-04-28T00:00:00Z,28,4,2020,2,0,New_Zealand,NZ,NZL,4783062,Oceania,19,1124,12
2020-04-29T00:00:00Z,29,4,2020,2,0,New_Zealand,NZ,NZL,4783062,Oceania,19,1126,13
2020-04-30T00:00:00Z,30,4,2020,3,0,New_Zealand,NZ,NZL,4783062,Oceania,19,1129,14
2020-05-01T00:00:00Z,1,5,2020,3,0,New_Zealand,NZ,NZL,4783062,Oceania,19,1132,15
2020-05-02T00:00:00Z,2,5,2020,2,1,New_Zealand,NZ,NZL,4783062,Oceania,20,1134,16
2020-05-03T00:00:00Z,3,5,2020,2,0,New_Zealand,NZ,NZL,4783062,Oceania,20,1136,17
2020-05-04T00:00:00Z,4,5,2020,1,0,New_Zealand,NZ,NZL,4783062,Oceania,20,1137,18
2020-05-05T00:00:00Z,5,5,2020,0,0,New_Zealand,NZ,NZL,4783062,Oceania,20,1137,19
2020-05-06T00:00:00Z,6,5,2020,1,1,New_Zealand,NZ,NZL,4783062,Oceania,21,1138,20
2020-05-07T00:00:00Z,7,5,2020,1,0,New_Zealand,NZ,NZL,4783062,Oceania,21,1139,21
2020-05-08T00:00:00Z,8,5,2020,2,0,New_Zealand,NZ,NZL,4783062,Oceania,21,1141,22
2020-05-09T00:00:00Z,9,5,2020,1,0,New_Zealand,NZ,NZL,4783062,Oceania,21,1142,23
2020-05-10T00:00:00Z,10,5,2020,2,0,New_Zealand,NZ,NZL,4783062,Oceania,21,1144,24
2020-05-11T00:00:00Z,11,5,2020,3,0,New_Zealand,NZ,NZL,4783062,Oceania,21,1147,25
2020-05-12T00:00:00Z,12,5,2020,0,0,New_Zealand,NZ,NZL,4783062,Oceania,21,1147,26
2020-05-13T00:00:00Z,13,5,2020,0,0,New_Zealand,NZ,NZL,4783062,Oceania,21,1147,27
2020-05-14T00:00:00Z,14,5,2020,0,0,New_Zealand,NZ,NZL,4783062,Oceania,21,1147,28
2020-05-15T00:00:00Z,15,5,2020,1,0,New_Zealand,NZ,NZL,4783062,Oceania,21,1148,29
2020-05-16T00:00:00Z,16,5,2020,0,0,New_Zealand,NZ,NZL,4783062,Oceania,21,1148,30
2020-05-17T00:00:00Z,17,5,2020,1,0,New_Zealand,NZ,NZL,4783062,Oceania,21,1149,31
2020-05-18T00:00:00Z,18,5,2020,0,0,New_Zealand,NZ,NZL,4783062,Oceania,21,1149,32
2020-05-19T00:00:00Z,19,5,2020,4,0,New_Zealand,NZ,NZL,4783062,Oceania,21,1153,33
2020-05-20T00:00:00Z,20,5,2020,0,0,New_Zealand,NZ,NZL,4783062,Oceania,21,1153,34
2020-05-21T00:00:00Z,21,5,2020,0,0,New_Zealand,NZ,NZL,4783062,Oceania,21,1153,35
2020-05-22T00:00:00Z,22,5,2020,1,0,New_Zealand,NZ,NZL,4783062,Oceania,21,1154,36
2020-05-23T00:00:00Z,23,5,2020,0,0,New_Zealand,NZ,NZL,4783062,Oceania,21,1154,37
2020-05-24T00:00:00Z,24,5,2020,0,0,New_Zealand,NZ,NZL,4783062,Oceania,21,1154,38
2020-05-25T00:00:00Z,25,5,2020,0,0,New_Zealand,NZ,NZL,4783062,Oceania,21,1154,39
2020-05-26T00:00:00Z,26,5,2020,0,0,New_Zealand,NZ,NZL,4783062,Oceania,21,1154,40
2020-05-27T00:00:00Z,27,5,2020,0,0,New_Zealand,NZ,NZL,4783062,Oceania,21,1154,41
2020-05-28T00:00:00Z,28,5,2020,0,1,New_Zealand,NZ,NZL,4783062,Oceania,22,1154,42
2020-05-29T00:00:00Z,29,5,2020,0,0,New_Zealand,NZ,NZL,4783062,Oceania,22,1154,43
2020-05-30T00:00:00Z,30,5,2020,0,0,New_Zealand,NZ,NZL,4783062,Oceania,22,1154,44
2020-05-31T00:00:00Z,31,5,2020,0,0,New_Zealand,NZ,NZL,4783062,Oceania,22,1154,45
2020-06-01T00:00:00Z,1,6,2020,0,0,New_Zealand,NZ,NZL,4783062,Oceania,22,1154,46
2020-06-02T00:00:00Z,2,6,2020,0,0,New_Zealand,NZ,NZL,4783062,Oceania,22,1154,47
2020-06-03T00:00:00Z,3,6,2020,0,0,New_Zealand,NZ,NZL,4783062,Oceania,22,1154,48
2020-06-04T00:00:00Z,4,6,2020,0,0,New_Zealand,NZ,NZL,4783062,Oceania,22,1154,49
2020-06-05T00:00:00Z,5,6,2020,0,0,New_Zealand,NZ,NZL,4783062,Oceania,22,1154,50
2020-06-06T00:00:00Z,6,6,2020,0,0,New_Zealand,NZ,NZL,4783062,Oceania,22,1154,51
2020-06-07T00:00:00Z,7,6,2020,0,0,New_Zealand,NZ,NZL,4783062,Oceania,22,1154,52
2020-06-08T00:00:00Z,8,6,2020,0,0,New_Zealand,NZ,NZL,4783062,Oceania,22,1154,53
2020-06-09T00:00:00Z,9,6,2020,0,0,New_Zealand,NZ,NZL,4783062,Oceania,22,1154,54
2020-06-10T00:00:00Z,10,6,2020,0,0,New_Zealand,NZ,NZL,4783062,Oceania,22,1154,55
2020-06-11T00:00:00Z,11,6,2020,0,0,New_Zealand,NZ,NZL,4783062,Oceania,22,1154,56
2020-06-12T00:00:00Z,12,6,2020,0,0,New_Zealand,NZ,NZL,4783062,Oceania,22,1154,57
2020-06-13T00:00:00Z,13,6,2020,0,0,New_Zealand,NZ,NZL,4783062,Oceania,22,1154,58
2020-06-14T00:00:00Z,14,6,2020,0,0,New_Zealand,NZ,NZL,4783062,Oceania,22,1154,59
2020-06-15T00:00:00Z,15,6,2020,0,0,New_Zealand,NZ,NZL,4783062,Oceania,22,1154,60
2020-06-16T00:00:00Z,16,6,2020,2,0,New_Zealand,NZ,NZL,4783062,Oceania,22,1156,61
2020-06-17T00:00:00Z,17,6,2020,0,0,New_Zealand,NZ,NZL,4783062,Oceania,22,1156,62
2020-06-18T00:00:00Z,18,6,2020,1,0,New_Zealand,NZ,NZL,4783062,Oceania,22,1157,63
2020-06-19T00:00:00Z,19,6,2020,0,0,New_Zealand,NZ,NZL,4783062,Oceania,22,1157,64
2020-06-20T00:00:00Z,20,6,2020,2,0,New_Zealand,NZ,NZL,4783062,Oceania,22,1159,65
2020-06-21T00:00:00Z,21,6,2020,2,0,New_Zealand,NZ,NZL,4783062,Oceania,22,1161,66
2020-06-22T00:00:00Z,22,6,2020,2,0,New_Zealand,NZ,NZL,4783062,Oceania,22,1163,67
2020-06-23T00:00:00Z,23,6,2020,2,0,New_Zealand,NZ,NZL,4783062,Oceania,22,1165,68
2020-06-24T00:00:00Z,24,6,2020,1,0,New_Zealand,NZ,NZL,4783062,Oceania,22,1166,69
2020-06-25T00:00:00Z,25,6,2020,3,0,New_Zealand,NZ,NZL,4783062,Oceania,22,1169,70
2020-05-23T00:00:00Z,23,5,2020,254,9,Nicaragua,NI,NIC,6545503,America,17,279,1
2020-05-24T00:00:00Z,24,5,2020,0,0,Nicaragua,NI,NIC,6545503,America,17,279,2
2020-05-25T00:00:00Z,25,5,2020,0,0,Nicaragua,NI,NIC,6545503,America,17,279,3
2020-05-26T00:00:00Z,26,5,2020,0,0,Nicaragua,NI,NIC,6545503,America,17,279,4
2020-05-27T00:00:00Z,27,5,2020,480,18,Nicaragua,NI,NIC,6545503,America,35,759,5
2020-05-28T00:00:00Z,28,5,2020,0,0,Nicaragua,NI,NIC,6545503,America,35,759,6
2020-05-29T00:00:00Z,29,5,2020,0,0,Nicaragua,NI,NIC,6545503,America,35,759,7
2020-05-30T00:00:00Z,30,5,2020,0,0,Nicaragua,NI,NIC,6545503,America,35,759,8
2020-05-31T00:00:00Z,31,5,2020,0,0,Nicaragua,NI,NIC,6545503,America,35,759,9
2020-06-01T00:00:00Z,1,6,2020,0,0,Nicaragua,NI,NIC,6545503,America,35,759,10
2020-06-02T00:00:00Z,2,6,2020,0,0,Nicaragua,NI,NIC,6545503,America,35,759,11
2020-06-03T00:00:00Z,3,6,2020,359,11,Nicaragua,NI,NIC,6545503,America,46,1118,12
2020-06-04T00:00:00Z,4,6,2020,0,0,Nicaragua,NI,NIC,6545503,America,46,1118,13
2020-06-05T00:00:00Z,5,6,2020,0,0,Nicaragua,NI,NIC,6545503,America,46,1118,14
2020-06-06T00:00:00Z,6,6,2020,0,0,Nicaragua,NI,NIC,6545503,America,46,1118,15
2020-06-07T00:00:00Z,7,6,2020,191,0,Nicaragua,NI,NIC,6545503,America,46,1309,16
2020-06-08T00:00:00Z,8,6,2020,0,0,Nicaragua,NI,NIC,6545503,America,46,1309,17
2020-06-09T00:00:00Z,9,6,2020,0,0,Nicaragua,NI,NIC,6545503,America,46,1309,18
2020-06-10T00:00:00Z,10,6,2020,0,0,Nicaragua,NI,NIC,6545503,America,46,1309,19
2020-06-11T00:00:00Z,11,6,2020,155,9,Nicaragua,NI,NIC,6545503,America,55,1464,20
2020-06-12T00:00:00Z,12,6,2020,0,0,Nicaragua,NI,NIC,6545503,America,55,1464,21
2020-06-13T00:00:00Z,13,6,2020,191,0,Nicaragua,NI,NIC,6545503,America,55,1655,22
2020-06-14T00:00:00Z,14,6,2020,0,0,Nicaragua,NI,NIC,6545503,America,55,1655,23
2020-06-15T00:00:00Z,15,6,2020,0,0,Nicaragua,NI,NIC,6545503,America,55,1655,24
2020-06-16T00:00:00Z,16,6,2020,0,0,Nicaragua,NI,NIC,6545503,America,55,1655,25
2020-06-17T00:00:00Z,17,6,2020,168,9,Nicaragua,NI,NIC,6545503,America,64,1823,26
2020-06-18T00:00:00Z,18,6,2020,191,0,Nicaragua,NI,NIC,6545503,America,64,2014,27
2020-06-19T00:00:00Z,19,6,2020,0,0,Nicaragua,NI,NIC,6545503,America,64,2014,28
2020-06-20T00:00:00Z,20,6,2020,0,0,Nicaragua,NI,NIC,6545503,America,64,2014,29
2020-06-21T00:00:00Z,21,6,2020,0,0,Nicaragua,NI,NIC,6545503,America,64,2014,30
2020-06-22T00:00:00Z,22,6,2020,0,0,Nicaragua,NI,NIC,6545503,America,64,2014,31
2020-06-23T00:00:00Z,23,6,2020,0,0,Nicaragua,NI,NIC,6545503,America,64,2014,32
2020-06-24T00:00:00Z,24,6,2020,156,10,Nicaragua,NI,NIC,6545503,America,74,2170,33
2020-06-25T00:00:00Z,25,6,2020,0,0,Nicaragua,NI,NIC,6545503,America,74,2170,34
2020-04-06T00:00:00Z,6,4,2020,64,5,Niger,NE,NER,23310719,Africa,10,184,1
2020-04-07T00:00:00Z,7,4,2020,69,0,Niger,NE,NER,23310719,Africa,10,253,2
2020-04-08T00:00:00Z,8,4,2020,25,1,Niger,NE,NER,23310719,Africa,11,278,3
2020-04-09T00:00:00Z,9,4,2020,64,0,Niger,NE,NER,23310719,Africa,11,342,4
2020-04-10T00:00:00Z,10,4,2020,68,0,Niger,NE,NER,23310719,Africa,11,410,5
2020-04-11T00:00:00Z,11,4,2020,28,0,Niger,NE,NER,23310719,Africa,11,438,6
2020-04-12T00:00:00Z,12,4,2020,53,0,Niger,NE,NER,23310719,Africa,11,491,7
2020-04-13T00:00:00Z,13,4,2020,38,1,Niger,NE,NER,23310719,Africa,12,529,8
2020-04-14T00:00:00Z,14,4,2020,19,1,Niger,NE,NER,23310719,Africa,13,548,9
2020-04-15T00:00:00Z,15,4,2020,22,1,Niger,NE,NER,23310719,Africa,14,570,10
2020-04-16T00:00:00Z,16,4,2020,14,0,Niger,NE,NER,23310719,Africa,14,584,11
2020-04-17T00:00:00Z,17,4,2020,25,1,Niger,NE,NER,23310719,Africa,15,609,12
2020-04-18T00:00:00Z,18,4,2020,18,3,Niger,NE,NER,23310719,Africa,18,627,13
2020-04-19T00:00:00Z,19,4,2020,12,1,Niger,NE,NER,23310719,Africa,19,639,14
2020-04-20T00:00:00Z,20,4,2020,9,1,Niger,NE,NER,23310719,Africa,20,648,15
2020-04-21T00:00:00Z,21,4,2020,7,0,Niger,NE,NER,23310719,Africa,20,655,16
2020-04-22T00:00:00Z,22,4,2020,0,0,Niger,NE,NER,23310719,Africa,20,655,17
2020-04-23T00:00:00Z,23,4,2020,7,2,Niger,NE,NER,23310719,Africa,22,662,18
2020-04-24T00:00:00Z,24,4,2020,9,2,Niger,NE,NER,23310719,Africa,24,671,19
2020-04-25T00:00:00Z,25,4,2020,10,0,Niger,NE,NER,23310719,Africa,24,681,20
2020-04-26T00:00:00Z,26,4,2020,3,3,Niger,NE,NER,23310719,Africa,27,684,21
2020-04-27T00:00:00Z,27,4,2020,12,2,Niger,NE,NER,23310719,Africa,29,696,22
2020-04-28T00:00:00Z,28,4,2020,5,0,Niger,NE,NER,23310719,Africa,29,701,23
2020-04-29T00:00:00Z,29,4,2020,8,2,Niger,NE,NER,23310719,Africa,31,709,24
2020-04-30T00:00:00Z,30,4,2020,4,1,Niger,NE,NER,23310719,Africa,32,713,25
2020-05-01T00:00:00Z,1,5,2020,6,0,Niger,NE,NER,23310719,Africa,32,719,26
2020-05-02T00:00:00Z,2,5,2020,9,1,Niger,NE,NER,23310719,Africa,33,728,27
2020-05-03T00:00:00Z,3,5,2020,8,2,Niger,NE,NER,23310719,Africa,35,736,28
2020-05-04T00:00:00Z,4,5,2020,14,1,Niger,NE,NER,23310719,Africa,36,750,29
2020-05-05T00:00:00Z,5,5,2020,5,1,Niger,NE,NER,23310719,Africa,37,755,30
2020-05-06T00:00:00Z,6,5,2020,8,1,Niger,NE,NER,23310719,Africa,38,763,31
2020-05-07T00:00:00Z,7,5,2020,7,0,Niger,NE,NER,23310719,Africa,38,770,32
2020-05-08T00:00:00Z,8,5,2020,11,4,Niger,NE,NER,23310719,Africa,42,781,33
2020-05-09T00:00:00Z,9,5,2020,14,2,Niger,NE,NER,23310719,Africa,44,795,34
2020-05-10T00:00:00Z,10,5,2020,20,1,Niger,NE,NER,23310719,Africa,45,815,35
2020-05-11T00:00:00Z,11,5,2020,6,1,Niger,NE,NER,23310719,Africa,46,821,36
2020-05-12T00:00:00Z,12,5,2020,11,0,Niger,NE,NER,23310719,Africa,46,832,37
2020-05-13T00:00:00Z,13,5,2020,22,1,Niger,NE,NER,23310719,Africa,47,854,38
2020-05-14T00:00:00Z,14,5,2020,6,2,Niger,NE,NER,23310719,Africa,49,860,39
2020-05-15T00:00:00Z,15,5,2020,16,1,Niger,NE,NER,23310719,Africa,50,876,40
2020-05-16T00:00:00Z,16,5,2020,9,1,Niger,NE,NER,23310719,Africa,51,885,41
2020-05-17T00:00:00Z,17,5,2020,4,0,Niger,NE,NER,23310719,Africa,51,889,42
2020-05-18T00:00:00Z,18,5,2020,15,3,Niger,NE,NER,23310719,Africa,54,904,43
2020-05-19T00:00:00Z,19,5,2020,5,1,Niger,NE,NER,23310719,Africa,55,909,44
2020-05-20T00:00:00Z,20,5,2020,5,0,Niger,NE,NER,23310719,Africa,55,914,45
2020-05-21T00:00:00Z,21,5,2020,6,3,Niger,NE,NER,23310719,Africa,58,920,46
2020-05-22T00:00:00Z,22,5,2020,4,2,Niger,NE,NER,23310719,Africa,60,924,47
2020-05-23T00:00:00Z,23,5,2020,13,0,Niger,NE,NER,23310719,Africa,60,937,48
2020-05-24T00:00:00Z,24,5,2020,6,1,Niger,NE,NER,23310719,Africa,61,943,49
2020-05-25T00:00:00Z,25,5,2020,2,0,Niger,NE,NER,23310719,Africa,61,945,50
2020-05-26T00:00:00Z,26,5,2020,6,1,Niger,NE,NER,23310719,Africa,62,951,51
2020-05-27T00:00:00Z,27,5,2020,1,1,Niger,NE,NER,23310719,Africa,63,952,52
2020-05-28T00:00:00Z,28,5,2020,3,1,Niger,NE,NER,23310719,Africa,64,955,53
2020-05-29T00:00:00Z,29,5,2020,0,0,Niger,NE,NER,23310719,Africa,64,955,54
2020-05-30T00:00:00Z,30,5,2020,0,0,Niger,NE,NER,23310719,Africa,64,955,55
2020-05-31T00:00:00Z,31,5,2020,1,0,Niger,NE,NER,23310719,Africa,64,956,56
2020-06-01T00:00:00Z,1,6,2020,2,0,Niger,NE,NER,23310719,Africa,64,958,57
2020-06-02T00:00:00Z,2,6,2020,0,1,Niger,NE,NER,23310719,Africa,65,958,58
2020-06-03T00:00:00Z,3,6,2020,2,0,Niger,NE,NER,23310719,Africa,65,960,59
2020-06-04T00:00:00Z,4,6,2020,1,0,Niger,NE,NER,23310719,Africa,65,961,60
2020-06-05T00:00:00Z,5,6,2020,2,0,Niger,NE,NER,23310719,Africa,65,963,61
2020-06-06T00:00:00Z,6,6,2020,3,0,Niger,NE,NER,23310719,Africa,65,966,62
2020-06-07T00:00:00Z,7,6,2020,4,0,Niger,NE,NER,23310719,Africa,65,970,63
2020-06-08T00:00:00Z,8,6,2020,3,0,Niger,NE,NER,23310719,Africa,65,973,64
2020-06-09T00:00:00Z,9,6,2020,0,0,Niger,NE,NER,23310719,Africa,65,973,65
2020-06-10T00:00:00Z,10,6,2020,1,0,Niger,NE,NER,23310719,Africa,65,974,66
2020-06-11T00:00:00Z,11,6,2020,0,0,Niger,NE,NER,23310719,Africa,65,974,67
2020-06-12T00:00:00Z,12,6,2020,0,0,Niger,NE,NER,23310719,Africa,65,974,68
2020-06-13T00:00:00Z,13,6,2020,4,0,Niger,NE,NER,23310719,Africa,65,978,69
2020-06-14T00:00:00Z,14,6,2020,2,1,Niger,NE,NER,23310719,Africa,66,980,70
2020-06-15T00:00:00Z,15,6,2020,0,0,Niger,NE,NER,23310719,Africa,66,980,71
2020-06-16T00:00:00Z,16,6,2020,0,0,Niger,NE,NER,23310719,Africa,66,980,72
2020-06-17T00:00:00Z,17,6,2020,36,0,Niger,NE,NER,23310719,Africa,66,1016,73
2020-06-18T00:00:00Z,18,6,2020,4,1,Niger,NE,NER,23310719,Africa,67,1020,74
2020-06-19T00:00:00Z,19,6,2020,0,0,Niger,NE,NER,23310719,Africa,67,1020,75
2020-06-20T00:00:00Z,20,6,2020,0,0,Niger,NE,NER,23310719,Africa,67,1020,76
2020-06-21T00:00:00Z,21,6,2020,15,0,Niger,NE,NER,23310719,Africa,67,1035,77
2020-06-22T00:00:00Z,22,6,2020,1,0,Niger,NE,NER,23310719,Africa,67,1036,78
2020-06-23T00:00:00Z,23,6,2020,10,0,Niger,NE,NER,23310719,Africa,67,1046,79
2020-06-24T00:00:00Z,24,6,2020,5,0,Niger,NE,NER,23310719,Africa,67,1051,80
2020-06-25T00:00:00Z,25,6,2020,5,0,Niger,NE,NER,23310719,Africa,67,1056,81
2020-04-12T00:00:00Z,12,4,2020,13,3,Nigeria,NG,NGA,200963603,Africa,10,318,1
2020-04-13T00:00:00Z,13,4,2020,5,0,Nigeria,NG,NGA,200963603,Africa,10,323,2
2020-04-14T00:00:00Z,14,4,2020,20,0,Nigeria,NG,NGA,200963603,Africa,10,343,3
2020-04-15T00:00:00Z,15,4,2020,30,1,Nigeria,NG,NGA,200963603,Africa,11,373,4
2020-04-16T00:00:00Z,16,4,2020,34,1,Nigeria,NG,NGA,200963603,Africa,12,407,5
2020-04-17T00:00:00Z,17,4,2020,35,1,Nigeria,NG,NGA,200963603,Africa,13,442,6
2020-04-18T00:00:00Z,18,4,2020,51,4,Nigeria,NG,NGA,200963603,Africa,17,493,7
2020-04-19T00:00:00Z,19,4,2020,49,2,Nigeria,NG,NGA,200963603,Africa,19,542,8
2020-04-20T00:00:00Z,20,4,2020,85,2,Nigeria,NG,NGA,200963603,Africa,21,627,9
2020-04-21T00:00:00Z,21,4,2020,38,1,Nigeria,NG,NGA,200963603,Africa,22,665,10
2020-04-22T00:00:00Z,22,4,2020,117,3,Nigeria,NG,NGA,200963603,Africa,25,782,11
2020-04-23T00:00:00Z,23,4,2020,91,3,Nigeria,NG,NGA,200963603,Africa,28,873,12
2020-04-24T00:00:00Z,24,4,2020,108,3,Nigeria,NG,NGA,200963603,Africa,31,981,13
2020-04-25T00:00:00Z,25,4,2020,114,1,Nigeria,NG,NGA,200963603,Africa,32,1095,14
2020-04-26T00:00:00Z,26,4,2020,87,3,Nigeria,NG,NGA,200963603,Africa,35,1182,15
2020-04-27T00:00:00Z,27,4,2020,91,5,Nigeria,NG,NGA,200963603,Africa,40,1273,16
2020-04-28T00:00:00Z,28,4,2020,64,0,Nigeria,NG,NGA,200963603,Africa,40,1337,17
2020-04-29T00:00:00Z,29,4,2020,195,4,Nigeria,NG,NGA,200963603,Africa,44,1532,18
2020-04-30T00:00:00Z,30,4,2020,196,7,Nigeria,NG,NGA,200963603,Africa,51,1728,19
2020-05-01T00:00:00Z,1,5,2020,204,7,Nigeria,NG,NGA,200963603,Africa,58,1932,20
2020-05-02T00:00:00Z,2,5,2020,238,10,Nigeria,NG,NGA,200963603,Africa,68,2170,21
2020-05-03T00:00:00Z,3,5,2020,218,17,Nigeria,NG,NGA,200963603,Africa,85,2388,22
2020-05-04T00:00:00Z,4,5,2020,170,2,Nigeria,NG,NGA,200963603,Africa,87,2558,23
2020-05-05T00:00:00Z,5,5,2020,244,6,Nigeria,NG,NGA,200963603,Africa,93,2802,24
2020-05-06T00:00:00Z,6,5,2020,148,5,Nigeria,NG,NGA,200963603,Africa,98,2950,25
2020-05-07T00:00:00Z,7,5,2020,195,5,Nigeria,NG,NGA,200963603,Africa,103,3145,26
2020-05-08T00:00:00Z,8,5,2020,381,4,Nigeria,NG,NGA,200963603,Africa,107,3526,27
2020-05-09T00:00:00Z,9,5,2020,386,10,Nigeria,NG,NGA,200963603,Africa,117,3912,28
2020-05-10T00:00:00Z,10,5,2020,239,11,Nigeria,NG,NGA,200963603,Africa,128,4151,29
2020-05-11T00:00:00Z,11,5,2020,248,15,Nigeria,NG,NGA,200963603,Africa,143,4399,30
2020-05-12T00:00:00Z,12,5,2020,242,7,Nigeria,NG,NGA,200963603,Africa,150,4641,31
2020-05-13T00:00:00Z,13,5,2020,146,8,Nigeria,NG,NGA,200963603,Africa,158,4787,32
2020-05-14T00:00:00Z,14,5,2020,184,6,Nigeria,NG,NGA,200963603,Africa,164,4971,33
2020-05-15T00:00:00Z,15,5,2020,191,3,Nigeria,NG,NGA,200963603,Africa,167,5162,34
2020-05-16T00:00:00Z,16,5,2020,283,4,Nigeria,NG,NGA,200963603,Africa,171,5445,35
2020-05-17T00:00:00Z,17,5,2020,176,5,Nigeria,NG,NGA,200963603,Africa,176,5621,36
2020-05-18T00:00:00Z,18,5,2020,338,6,Nigeria,NG,NGA,200963603,Africa,182,5959,37
2020-05-19T00:00:00Z,19,5,2020,216,9,Nigeria,NG,NGA,200963603,Africa,191,6175,38
2020-05-20T00:00:00Z,20,5,2020,226,1,Nigeria,NG,NGA,200963603,Africa,192,6401,39
2020-05-21T00:00:00Z,21,5,2020,276,8,Nigeria,NG,NGA,200963603,Africa,200,6677,40
2020-05-22T00:00:00Z,22,5,2020,339,11,Nigeria,NG,NGA,200963603,Africa,211,7016,41
2020-05-23T00:00:00Z,23,5,2020,245,10,Nigeria,NG,NGA,200963603,Africa,221,7261,42
2020-05-24T00:00:00Z,24,5,2020,265,0,Nigeria,NG,NGA,200963603,Africa,221,7526,43
2020-05-25T00:00:00Z,25,5,2020,313,5,Nigeria,NG,NGA,200963603,Africa,226,7839,44
2020-05-26T00:00:00Z,26,5,2020,229,7,Nigeria,NG,NGA,200963603,Africa,233,8068,45
2020-05-27T00:00:00Z,27,5,2020,276,16,Nigeria,NG,NGA,200963603,Africa,249,8344,46
2020-05-28T00:00:00Z,28,5,2020,389,5,Nigeria,NG,NGA,200963603,Africa,254,8733,47
2020-05-29T00:00:00Z,29,5,2020,182,5,Nigeria,NG,NGA,200963603,Africa,259,8915,48
2020-05-30T00:00:00Z,30,5,2020,387,2,Nigeria,NG,NGA,200963603,Africa,261,9302,49
2020-05-31T00:00:00Z,31,5,2020,553,12,Nigeria,NG,NGA,200963603,Africa,273,9855,50
2020-06-01T00:00:00Z,1,6,2020,307,14,Nigeria,NG,NGA,200963603,Africa,287,10162,51
2020-06-02T00:00:00Z,2,6,2020,416,12,Nigeria,NG,NGA,200963603,Africa,299,10578,52
2020-06-03T00:00:00Z,3,6,2020,241,15,Nigeria,NG,NGA,200963603,Africa,314,10819,53
2020-06-04T00:00:00Z,4,6,2020,347,1,Nigeria,NG,NGA,200963603,Africa,315,11166,54
2020-06-05T00:00:00Z,5,6,2020,350,8,Nigeria,NG,NGA,200963603,Africa,323,11516,55
2020-06-06T00:00:00Z,6,6,2020,328,10,Nigeria,NG,NGA,200963603,Africa,333,11844,56
2020-06-07T00:00:00Z,7,6,2020,389,9,Nigeria,NG,NGA,200963603,Africa,342,12233,57
2020-06-08T00:00:00Z,8,6,2020,253,12,Nigeria,NG,NGA,200963603,Africa,354,12486,58
2020-06-09T00:00:00Z,9,6,2020,315,7,Nigeria,NG,NGA,200963603,Africa,361,12801,59
2020-06-10T00:00:00Z,10,6,2020,663,4,Nigeria,NG,NGA,200963603,Africa,365,13464,60
2020-06-11T00:00:00Z,11,6,2020,409,17,Nigeria,NG,NGA,200963603,Africa,382,13873,61
2020-06-12T00:00:00Z,12,6,2020,681,5,Nigeria,NG,NGA,200963603,Africa,387,14554,62
2020-06-13T00:00:00Z,13,6,2020,627,12,Nigeria,NG,NGA,200963603,Africa,399,15181,63
2020-06-14T00:00:00Z,14,6,2020,501,8,Nigeria,NG,NGA,200963603,Africa,407,15682,64
2020-06-15T00:00:00Z,15,6,2020,403,13,Nigeria,NG,NGA,200963603,Africa,420,16085,65
2020-06-16T00:00:00Z,16,6,2020,573,4,Nigeria,NG,NGA,200963603,Africa,424,16658,66
2020-06-17T00:00:00Z,17,6,2020,490,31,Nigeria,NG,NGA,200963603,Africa,455,17148,67
2020-06-18T00:00:00Z,18,6,2020,587,14,Nigeria,NG,NGA,200963603,Africa,469,17735,68
2020-06-19T00:00:00Z,19,6,2020,745,6,Nigeria,NG,NGA,200963603,Africa,475,18480,69
2020-06-20T00:00:00Z,20,6,2020,667,12,Nigeria,NG,NGA,200963603,Africa,487,19147,70
2020-06-21T00:00:00Z,21,6,2020,661,19,Nigeria,NG,NGA,200963603,Africa,506,19808,71
2020-06-22T00:00:00Z,22,6,2020,436,12,Nigeria,NG,NGA,200963603,Africa,518,20244,72
2020-06-23T00:00:00Z,23,6,2020,675,7,Nigeria,NG,NGA,200963603,Africa,525,20919,73
2020-06-24T00:00:00Z,24,6,2020,452,8,Nigeria,NG,NGA,200963603,Africa,533,21371,74
2020-06-25T00:00:00Z,25,6,2020,649,9,Nigeria,NG,NGA,200963603,Africa,542,22020,75
2020-04-02T00:00:00Z,2,4,2020,25,1,North_Macedonia,MK,MKD,2077132,Europe,10,354,1
2020-04-03T00:00:00Z,3,4,2020,0,1,North_Macedonia,MK,MKD,2077132,Europe,11,354,2
2020-04-04T00:00:00Z,4,4,2020,76,1,North_Macedonia,MK,MKD,2077132,Europe,12,430,3
2020-04-05T00:00:00Z,5,4,2020,53,5,North_Macedonia,MK,MKD,2077132,Europe,17,483,4
2020-04-06T00:00:00Z,6,4,2020,0,0,North_Macedonia,MK,MKD,2077132,Europe,17,483,5
2020-04-07T00:00:00Z,7,4,2020,87,4,North_Macedonia,MK,MKD,2077132,Europe,21,570,6
2020-04-08T00:00:00Z,8,4,2020,29,5,North_Macedonia,MK,MKD,2077132,Europe,26,599,7
2020-04-09T00:00:00Z,9,4,2020,18,4,North_Macedonia,MK,MKD,2077132,Europe,30,617,8
2020-04-10T00:00:00Z,10,4,2020,46,2,North_Macedonia,MK,MKD,2077132,Europe,32,663,9
2020-04-11T00:00:00Z,11,4,2020,48,0,North_Macedonia,MK,MKD,2077132,Europe,32,711,10
2020-04-12T00:00:00Z,12,4,2020,49,2,North_Macedonia,MK,MKD,2077132,Europe,34,760,11
2020-04-13T00:00:00Z,13,4,2020,68,0,North_Macedonia,MK,MKD,2077132,Europe,34,828,12
2020-04-14T00:00:00Z,14,4,2020,26,4,North_Macedonia,MK,MKD,2077132,Europe,38,854,13
2020-04-15T00:00:00Z,15,4,2020,54,6,North_Macedonia,MK,MKD,2077132,Europe,44,908,14
2020-04-16T00:00:00Z,16,4,2020,66,1,North_Macedonia,MK,MKD,2077132,Europe,45,974,15
2020-04-17T00:00:00Z,17,4,2020,107,1,North_Macedonia,MK,MKD,2077132,Europe,46,1081,16
2020-04-18T00:00:00Z,18,4,2020,36,3,North_Macedonia,MK,MKD,2077132,Europe,49,1117,17
2020-04-19T00:00:00Z,19,4,2020,53,0,North_Macedonia,MK,MKD,2077132,Europe,49,1170,18
2020-04-20T00:00:00Z,20,4,2020,37,2,North_Macedonia,MK,MKD,2077132,Europe,51,1207,19
2020-04-21T00:00:00Z,21,4,2020,18,3,North_Macedonia,MK,MKD,2077132,Europe,54,1225,20
2020-04-22T00:00:00Z,22,4,2020,6,1,North_Macedonia,MK,MKD,2077132,Europe,55,1231,21
2020-04-23T00:00:00Z,23,4,2020,28,1,North_Macedonia,MK,MKD,2077132,Europe,56,1259,22
2020-04-24T00:00:00Z,24,4,2020,41,0,North_Macedonia,MK,MKD,2077132,Europe,56,1300,23
2020-04-25T00:00:00Z,25,4,2020,26,1,North_Macedonia,MK,MKD,2077132,Europe,57,1326,24
2020-04-26T00:00:00Z,26,4,2020,41,2,North_Macedonia,MK,MKD,2077132,Europe,59,1367,25
2020-04-27T00:00:00Z,27,4,2020,19,2,North_Macedonia,MK,MKD,2077132,Europe,61,1386,26
2020-04-28T00:00:00Z,28,4,2020,13,4,North_Macedonia,MK,MKD,2077132,Europe,65,1399,27
2020-04-29T00:00:00Z,29,4,2020,22,6,North_Macedonia,MK,MKD,2077132,Europe,71,1421,28
2020-04-30T00:00:00Z,30,4,2020,21,2,North_Macedonia,MK,MKD,2077132,Europe,73,1442,29
2020-05-01T00:00:00Z,1,5,2020,23,4,North_Macedonia,MK,MKD,2077132,Europe,77,1465,30
2020-05-02T00:00:00Z,2,5,2020,29,4,North_Macedonia,MK,MKD,2077132,Europe,81,1494,31
2020-05-03T00:00:00Z,3,5,2020,12,1,North_Macedonia,MK,MKD,2077132,Europe,82,1506,32
2020-05-04T00:00:00Z,4,5,2020,5,2,North_Macedonia,MK,MKD,2077132,Europe,84,1511,33
2020-05-05T00:00:00Z,5,5,2020,7,1,North_Macedonia,MK,MKD,2077132,Europe,85,1518,34
2020-05-06T00:00:00Z,6,5,2020,8,1,North_Macedonia,MK,MKD,2077132,Europe,86,1526,35
2020-05-07T00:00:00Z,7,5,2020,13,2,North_Macedonia,MK,MKD,2077132,Europe,88,1539,36
2020-05-08T00:00:00Z,8,5,2020,33,1,North_Macedonia,MK,MKD,2077132,Europe,89,1572,37
2020-05-09T00:00:00Z,9,5,2020,14,1,North_Macedonia,MK,MKD,2077132,Europe,90,1586,38
2020-05-10T00:00:00Z,10,5,2020,36,1,North_Macedonia,MK,MKD,2077132,Europe,91,1622,39
2020-05-11T00:00:00Z,11,5,2020,20,0,North_Macedonia,MK,MKD,2077132,Europe,91,1642,40
2020-05-12T00:00:00Z,12,5,2020,22,0,North_Macedonia,MK,MKD,2077132,Europe,91,1664,41
2020-05-13T00:00:00Z,13,5,2020,10,1,North_Macedonia,MK,MKD,2077132,Europe,92,1674,42
2020-05-14T00:00:00Z,14,5,2020,20,3,North_Macedonia,MK,MKD,2077132,Europe,95,1694,43
2020-05-15T00:00:00Z,15,5,2020,29,0,North_Macedonia,MK,MKD,2077132,Europe,95,1723,44
2020-05-16T00:00:00Z,16,5,2020,17,2,North_Macedonia,MK,MKD,2077132,Europe,97,1740,45
2020-05-17T00:00:00Z,17,5,2020,22,1,North_Macedonia,MK,MKD,2077132,Europe,98,1762,46
2020-05-18T00:00:00Z,18,5,2020,30,3,North_Macedonia,MK,MKD,2077132,Europe,101,1792,47
2020-05-19T00:00:00Z,19,5,2020,25,3,North_Macedonia,MK,MKD,2077132,Europe,104,1817,48
2020-05-20T00:00:00Z,20,5,2020,22,2,North_Macedonia,MK,MKD,2077132,Europe,106,1839,49
2020-05-21T00:00:00Z,21,5,2020,19,4,North_Macedonia,MK,MKD,2077132,Europe,110,1858,50
2020-05-22T00:00:00Z,22,5,2020,40,1,North_Macedonia,MK,MKD,2077132,Europe,111,1898,51
2020-05-23T00:00:00Z,23,5,2020,23,1,North_Macedonia,MK,MKD,2077132,Europe,112,1921,52
2020-05-24T00:00:00Z,24,5,2020,20,1,North_Macedonia,MK,MKD,2077132,Europe,113,1941,53
2020-05-25T00:00:00Z,25,5,2020,37,0,North_Macedonia,MK,MKD,2077132,Europe,113,1978,54
2020-05-26T00:00:00Z,26,5,2020,21,0,North_Macedonia,MK,MKD,2077132,Europe,113,1999,55
2020-05-27T00:00:00Z,27,5,2020,16,3,North_Macedonia,MK,MKD,2077132,Europe,116,2015,56
2020-05-28T00:00:00Z,28,5,2020,25,3,North_Macedonia,MK,MKD,2077132,Europe,119,2040,57
2020-05-29T00:00:00Z,29,5,2020,38,3,North_Macedonia,MK,MKD,2077132,Europe,122,2078,58
2020-05-30T00:00:00Z,30,5,2020,52,4,North_Macedonia,MK,MKD,2077132,Europe,126,2130,59
2020-05-31T00:00:00Z,31,5,2020,34,5,North_Macedonia,MK,MKD,2077132,Europe,131,2164,60
2020-06-01T00:00:00Z,1,6,2020,62,2,North_Macedonia,MK,MKD,2077132,Europe,133,2226,61
2020-06-02T00:00:00Z,2,6,2020,89,7,North_Macedonia,MK,MKD,2077132,Europe,140,2315,62
2020-06-03T00:00:00Z,3,6,2020,76,1,North_Macedonia,MK,MKD,2077132,Europe,141,2391,63
2020-06-04T00:00:00Z,4,6,2020,101,4,North_Macedonia,MK,MKD,2077132,Europe,145,2492,64
2020-06-05T00:00:00Z,5,6,2020,120,2,North_Macedonia,MK,MKD,2077132,Europe,147,2612,65
2020-06-06T00:00:00Z,6,6,2020,180,2,North_Macedonia,MK,MKD,2077132,Europe,149,2792,66
2020-06-07T00:00:00Z,7,6,2020,125,2,North_Macedonia,MK,MKD,2077132,Europe,151,2917,67
2020-06-08T00:00:00Z,8,6,2020,111,2,North_Macedonia,MK,MKD,2077132,Europe,153,3028,68
2020-06-09T00:00:00Z,9,6,2020,127,3,North_Macedonia,MK,MKD,2077132,Europe,156,3155,69
2020-06-10T00:00:00Z,10,6,2020,87,1,North_Macedonia,MK,MKD,2077132,Europe,157,3242,70
2020-06-11T00:00:00Z,11,6,2020,125,7,North_Macedonia,MK,MKD,2077132,Europe,164,3367,71
2020-06-12T00:00:00Z,12,6,2020,175,5,North_Macedonia,MK,MKD,2077132,Europe,169,3542,72
2020-06-13T00:00:00Z,13,6,2020,164,2,North_Macedonia,MK,MKD,2077132,Europe,171,3706,73
2020-06-14T00:00:00Z,14,6,2020,196,8,North_Macedonia,MK,MKD,2077132,Europe,179,3902,74
2020-06-15T00:00:00Z,15,6,2020,155,9,North_Macedonia,MK,MKD,2077132,Europe,188,4057,75
2020-06-16T00:00:00Z,16,6,2020,100,5,North_Macedonia,MK,MKD,2077132,Europe,193,4157,76
2020-06-17T00:00:00Z,17,6,2020,132,8,North_Macedonia,MK,MKD,2077132,Europe,201,4289,77
2020-06-18T00:00:00Z,18,6,2020,193,9,North_Macedonia,MK,MKD,2077132,Europe,210,4482,78
2020-06-19T00:00:00Z,19,6,2020,182,6,North_Macedonia,MK,MKD,2077132,Europe,216,4664,79
2020-06-20T00:00:00Z,20,6,2020,156,6,North_Macedonia,MK,MKD,2077132,Europe,222,4820,80
2020-06-21T00:00:00Z,21,6,2020,185,11,North_Macedonia,MK,MKD,2077132,Europe,233,5005,81
2020-06-22T00:00:00Z,22,6,2020,101,5,North_Macedonia,MK,MKD,2077132,Europe,238,5106,82
2020-06-23T00:00:00Z,23,6,2020,90,9,North_Macedonia,MK,MKD,2077132,Europe,247,5196,83
2020-06-24T00:00:00Z,24,6,2020,118,4,North_Macedonia,MK,MKD,2077132,Europe,251,5314,84
2020-06-25T00:00:00Z,25,6,2020,136,8,North_Macedonia,MK,MKD,2077132,Europe,259,5450,85
2020-03-25T00:00:00Z,25,3,2020,195,2,Norway,NO,NOR,5328212,Europe,10,2566,1
2020-03-26T00:00:00Z,26,3,2020,350,2,Norway,NO,NOR,5328212,Europe,12,2916,2
2020-03-27T00:00:00Z,27,3,2020,240,2,Norway,NO,NOR,5328212,Europe,14,3156,3
2020-03-28T00:00:00Z,28,3,2020,425,2,Norway,NO,NOR,5328212,Europe,16,3581,4
2020-03-29T00:00:00Z,29,3,2020,264,4,Norway,NO,NOR,5328212,Europe,20,3845,5
2020-03-30T00:00:00Z,30,3,2020,257,2,Norway,NO,NOR,5328212,Europe,22,4102,6
2020-03-31T00:00:00Z,31,3,2020,124,4,Norway,NO,NOR,5328212,Europe,26,4226,7
2020-04-01T00:00:00Z,1,4,2020,221,2,Norway,NO,NOR,5328212,Europe,28,4447,8
2020-04-02T00:00:00Z,2,4,2020,218,4,Norway,NO,NOR,5328212,Europe,32,4665,9
2020-04-03T00:00:00Z,3,4,2020,270,10,Norway,NO,NOR,5328212,Europe,42,4935,10
2020-04-04T00:00:00Z,4,4,2020,273,2,Norway,NO,NOR,5328212,Europe,44,5208,11
2020-04-05T00:00:00Z,5,4,2020,302,6,Norway,NO,NOR,5328212,Europe,50,5510,12
2020-04-06T00:00:00Z,6,4,2020,130,8,Norway,NO,NOR,5328212,Europe,58,5640,13
2020-04-07T00:00:00Z,7,4,2020,115,1,Norway,NO,NOR,5328212,Europe,59,5755,14
2020-04-08T00:00:00Z,8,4,2020,108,10,Norway,NO,NOR,5328212,Europe,69,5863,15
2020-04-09T00:00:00Z,9,4,2020,147,11,Norway,NO,NOR,5328212,Europe,80,6010,16
2020-04-10T00:00:00Z,10,4,2020,150,8,Norway,NO,NOR,5328212,Europe,88,6160,17
2020-04-11T00:00:00Z,11,4,2020,84,4,Norway,NO,NOR,5328212,Europe,92,6244,18
2020-04-12T00:00:00Z,12,4,2020,76,6,Norway,NO,NOR,5328212,Europe,98,6320,19
2020-04-13T00:00:00Z,13,4,2020,95,5,Norway,NO,NOR,5328212,Europe,103,6415,20
2020-04-14T00:00:00Z,14,4,2020,73,11,Norway,NO,NOR,5328212,Europe,114,6488,21
2020-04-15T00:00:00Z,15,4,2020,78,13,Norway,NO,NOR,5328212,Europe,127,6566,22
2020-04-16T00:00:00Z,16,4,2020,111,3,Norway,NO,NOR,5328212,Europe,130,6677,23
2020-04-17T00:00:00Z,17,4,2020,114,6,Norway,NO,NOR,5328212,Europe,136,6791,24
2020-04-18T00:00:00Z,18,4,2020,0,0,Norway,NO,NOR,5328212,Europe,136,6791,25
2020-04-19T00:00:00Z,19,4,2020,193,12,Norway,NO,NOR,5328212,Europe,148,6984,26
2020-04-20T00:00:00Z,20,4,2020,84,6,Norway,NO,NOR,5328212,Europe,154,7068,27
2020-04-21T00:00:00Z,21,4,2020,45,0,Norway,NO,NOR,5328212,Europe,154,7113,28
2020-04-22T00:00:00Z,22,4,2020,53,9,Norway,NO,NOR,5328212,Europe,163,7166,29
2020-04-23T00:00:00Z,23,4,2020,84,6,Norway,NO,NOR,5328212,Europe,169,7250,30
2020-04-24T00:00:00Z,24,4,2020,95,11,Norway,NO,NOR,5328212,Europe,180,7345,31
2020-04-25T00:00:00Z,25,4,2020,63,11,Norway,NO,NOR,5328212,Europe,191,7408,32
2020-04-26T00:00:00Z,26,4,2020,59,2,Norway,NO,NOR,5328212,Europe,193,7467,33
2020-04-27T00:00:00Z,27,4,2020,38,0,Norway,NO,NOR,5328212,Europe,193,7505,34
2020-04-28T00:00:00Z,28,4,2020,28,0,Norway,NO,NOR,5328212,Europe,193,7533,35
2020-04-29T00:00:00Z,29,4,2020,72,2,Norway,NO,NOR,5328212,Europe,195,7605,36
2020-04-30T00:00:00Z,30,4,2020,62,7,Norway,NO,NOR,5328212,Europe,202,7667,37
2020-05-01T00:00:00Z,1,5,2020,43,2,Norway,NO,NOR,5328212,Europe,204,7710,38
2020-05-02T00:00:00Z,2,5,2020,49,0,Norway,NO,NOR,5328212,Europe,204,7759,39
2020-05-03T00:00:00Z,3,5,2020,0,0,Norway,NO,NOR,5328212,Europe,204,7759,40
2020-05-04T00:00:00Z,4,5,2020,50,4,Norway,NO,NOR,5328212,Europe,208,7809,41
2020-05-05T00:00:00Z,5,5,2020,38,0,Norway,NO,NOR,5328212,Europe,208,7847,42
2020-05-06T00:00:00Z,6,5,2020,56,1,Norway,NO,NOR,5328212,Europe,209,7903,43
2020-05-07T00:00:00Z,7,5,2020,50,0,Norway,NO,NOR,5328212,Europe,209,7953,44
2020-05-08T00:00:00Z,8,5,2020,42,0,Norway,NO,NOR,5328212,Europe,209,7995,45
2020-05-09T00:00:00Z,9,5,2020,39,4,Norway,NO,NOR,5328212,Europe,213,8034,46
2020-05-10T00:00:00Z,10,5,2020,35,0,Norway,NO,NOR,5328212,Europe,213,8069,47
2020-05-11T00:00:00Z,11,5,2020,30,4,Norway,NO,NOR,5328212,Europe,217,8099,48
2020-05-12T00:00:00Z,12,5,2020,7,7,Norway,NO,NOR,5328212,Europe,224,8106,49
2020-05-13T00:00:00Z,13,5,2020,29,4,Norway,NO,NOR,5328212,Europe,228,8135,50
2020-05-14T00:00:00Z,14,5,2020,23,1,Norway,NO,NOR,5328212,Europe,229,8158,51
2020-05-15T00:00:00Z,15,5,2020,17,3,Norway,NO,NOR,5328212,Europe,232,8175,52
2020-05-16T00:00:00Z,16,5,2020,22,0,Norway,NO,NOR,5328212,Europe,232,8197,53
2020-05-17T00:00:00Z,17,5,2020,0,0,Norway,NO,NOR,5328212,Europe,232,8197,54
2020-05-18T00:00:00Z,18,5,2020,0,0,Norway,NO,NOR,5328212,Europe,232,8197,55
2020-05-19T00:00:00Z,19,5,2020,52,1,Norway,NO,NOR,5328212,Europe,233,8249,56
2020-05-20T00:00:00Z,20,5,2020,8,0,Norway,NO,NOR,5328212,Europe,233,8257,57
2020-05-21T00:00:00Z,21,5,2020,11,1,Norway,NO,NOR,5328212,Europe,234,8268,58
2020-05-22T00:00:00Z,22,5,2020,0,0,Norway,NO,NOR,5328212,Europe,234,8268,59
2020-05-23T00:00:00Z,23,5,2020,41,1,Norway,NO,NOR,5328212,Europe,235,8309,60
2020-05-24T00:00:00Z,24,5,2020,0,0,Norway,NO,NOR,5328212,Europe,235,8309,61
2020-05-25T00:00:00Z,25,5,2020,0,0,Norway,NO,NOR,5328212,Europe,235,8309,62
2020-05-26T00:00:00Z,26,5,2020,43,0,Norway,NO,NOR,5328212,Europe,235,8352,63
2020-05-27T00:00:00Z,27,5,2020,12,0,Norway,NO,NOR,5328212,Europe,235,8364,64
2020-05-28T00:00:00Z,28,5,2020,19,0,Norway,NO,NOR,5328212,Europe,235,8383,65
2020-05-29T00:00:00Z,29,5,2020,18,1,Norway,NO,NOR,5328212,Europe,236,8401,66
2020-05-30T00:00:00Z,30,5,2020,10,0,Norway,NO,NOR,5328212,Europe,236,8411,67
2020-05-31T00:00:00Z,31,5,2020,0,0,Norway,NO,NOR,5328212,Europe,236,8411,68
2020-06-01T00:00:00Z,1,6,2020,0,0,Norway,NO,NOR,5328212,Europe,236,8411,69
2020-06-02T00:00:00Z,2,6,2020,0,0,Norway,NO,NOR,5328212,Europe,236,8411,70
2020-06-03T00:00:00Z,3,6,2020,35,1,Norway,NO,NOR,5328212,Europe,237,8446,71
2020-06-04T00:00:00Z,4,6,2020,0,0,Norway,NO,NOR,5328212,Europe,237,8446,72
2020-06-05T00:00:00Z,5,6,2020,31,1,Norway,NO,NOR,5328212,Europe,238,8477,73
2020-06-06T00:00:00Z,6,6,2020,27,0,Norway,NO,NOR,5328212,Europe,238,8504,74
2020-06-07T00:00:00Z,7,6,2020,0,0,Norway,NO,NOR,5328212,Europe,238,8504,75
2020-06-08T00:00:00Z,8,6,2020,0,0,Norway,NO,NOR,5328212,Europe,238,8504,76
2020-06-09T00:00:00Z,9,6,2020,43,1,Norway,NO,NOR,5328212,Europe,239,8547,77
2020-06-10T00:00:00Z,10,6,2020,16,0,Norway,NO,NOR,5328212,Europe,239,8563,78
2020-06-11T00:00:00Z,11,6,2020,13,0,Norway,NO,NOR,5328212,Europe,239,8576,79
2020-06-12T00:00:00Z,12,6,2020,18,3,Norway,NO,NOR,5328212,Europe,242,8594,80
2020-06-13T00:00:00Z,13,6,2020,12,0,Norway,NO,NOR,5328212,Europe,242,8606,81
2020-06-14T00:00:00Z,14,6,2020,0,0,Norway,NO,NOR,5328212,Europe,242,8606,82
2020-06-15T00:00:00Z,15,6,2020,0,0,Norway,NO,NOR,5328212,Europe,242,8606,83
2020-06-16T00:00:00Z,16,6,2020,25,0,Norway,NO,NOR,5328212,Europe,242,8631,84
2020-06-17T00:00:00Z,17,6,2020,0,0,Norway,NO,NOR,5328212,Europe,242,8631,85
2020-06-18T00:00:00Z,18,6,2020,29,1,Norway,NO,NOR,5328212,Europe,243,8660,86
2020-06-19T00:00:00Z,19,6,2020,32,1,Norway,NO,NOR,5328212,Europe,244,8692,87
2020-06-20T00:00:00Z,20,6,2020,0,0,Norway,NO,NOR,5328212,Europe,244,8692,88
2020-06-21T00:00:00Z,21,6,2020,16,0,Norway,NO,NOR,5328212,Europe,244,8708,89
2020-06-22T00:00:00Z,22,6,2020,0,0,Norway,NO,NOR,5328212,Europe,244,8708,90
2020-06-23T00:00:00Z,23,6,2020,37,4,Norway,NO,NOR,5328212,Europe,248,8745,91
2020-06-24T00:00:00Z,24,6,2020,6,0,Norway,NO,NOR,5328212,Europe,248,8751,92
2020-06-25T00:00:00Z,25,6,2020,26,1,Norway,NO,NOR,5328212,Europe,249,8777,93
2020-04-25T00:00:00Z,25,4,2020,74,1,Oman,OM,OMN,4974992,Asia,10,1790,1
2020-04-26T00:00:00Z,26,4,2020,115,0,Oman,OM,OMN,4974992,Asia,10,1905,2
2020-04-27T00:00:00Z,27,4,2020,93,0,Oman,OM,OMN,4974992,Asia,10,1998,3
2020-04-28T00:00:00Z,28,4,2020,51,0,Oman,OM,OMN,4974992,Asia,10,2049,4
2020-04-29T00:00:00Z,29,4,2020,82,0,Oman,OM,OMN,4974992,Asia,10,2131,5
2020-04-30T00:00:00Z,30,4,2020,143,0,Oman,OM,OMN,4974992,Asia,10,2274,6
2020-05-01T00:00:00Z,1,5,2020,74,1,Oman,OM,OMN,4974992,Asia,11,2348,7
2020-05-02T00:00:00Z,2,5,2020,99,0,Oman,OM,OMN,4974992,Asia,11,2447,8
2020-05-03T00:00:00Z,3,5,2020,36,1,Oman,OM,OMN,4974992,Asia,12,2483,9
2020-05-04T00:00:00Z,4,5,2020,85,0,Oman,OM,OMN,4974992,Asia,12,2568,10
2020-05-05T00:00:00Z,5,5,2020,69,0,Oman,OM,OMN,4974992,Asia,12,2637,11
2020-05-06T00:00:00Z,6,5,2020,98,0,Oman,OM,OMN,4974992,Asia,12,2735,12
2020-05-07T00:00:00Z,7,5,2020,168,1,Oman,OM,OMN,4974992,Asia,13,2903,13
2020-05-08T00:00:00Z,8,5,2020,55,1,Oman,OM,OMN,4974992,Asia,14,2958,14
2020-05-09T00:00:00Z,9,5,2020,154,1,Oman,OM,OMN,4974992,Asia,15,3112,15
2020-05-10T00:00:00Z,10,5,2020,112,2,Oman,OM,OMN,4974992,Asia,17,3224,16
2020-05-11T00:00:00Z,11,5,2020,175,0,Oman,OM,OMN,4974992,Asia,17,3399,17
2020-05-12T00:00:00Z,12,5,2020,175,0,Oman,OM,OMN,4974992,Asia,17,3574,18
2020-05-13T00:00:00Z,13,5,2020,147,0,Oman,OM,OMN,4974992,Asia,17,3721,19
2020-05-14T00:00:00Z,14,5,2020,298,0,Oman,OM,OMN,4974992,Asia,17,4019,20
2020-05-15T00:00:00Z,15,5,2020,322,2,Oman,OM,OMN,4974992,Asia,19,4341,21
2020-05-16T00:00:00Z,16,5,2020,284,0,Oman,OM,OMN,4974992,Asia,19,4625,22
2020-05-17T00:00:00Z,17,5,2020,404,2,Oman,OM,OMN,4974992,Asia,21,5029,23
2020-05-18T00:00:00Z,18,5,2020,157,1,Oman,OM,OMN,4974992,Asia,22,5186,24
2020-05-19T00:00:00Z,19,5,2020,193,4,Oman,OM,OMN,4974992,Asia,26,5379,25
2020-05-20T00:00:00Z,20,5,2020,292,1,Oman,OM,OMN,4974992,Asia,27,5671,26
2020-05-21T00:00:00Z,21,5,2020,372,3,Oman,OM,OMN,4974992,Asia,30,6043,27
2020-05-22T00:00:00Z,22,5,2020,327,1,Oman,OM,OMN,4974992,Asia,31,6370,28
2020-05-23T00:00:00Z,23,5,2020,424,1,Oman,OM,OMN,4974992,Asia,32,6794,29
2020-05-24T00:00:00Z,24,5,2020,463,4,Oman,OM,OMN,4974992,Asia,36,7257,30
2020-05-25T00:00:00Z,25,5,2020,513,1,Oman,OM,OMN,4974992,Asia,37,7770,31
2020-05-26T00:00:00Z,26,5,2020,0,0,Oman,OM,OMN,4974992,Asia,37,7770,32
2020-05-27T00:00:00Z,27,5,2020,348,0,Oman,OM,OMN,4974992,Asia,37,8118,33
2020-05-28T00:00:00Z,28,5,2020,255,1,Oman,OM,OMN,4974992,Asia,38,8373,34
2020-05-29T00:00:00Z,29,5,2020,636,2,Oman,OM,OMN,4974992,Asia,40,9009,35
2020-05-30T00:00:00Z,30,5,2020,811,0,Oman,OM,OMN,4974992,Asia,40,9820,36
2020-05-31T00:00:00Z,31,5,2020,603,2,Oman,OM,OMN,4974992,Asia,42,10423,37
2020-06-01T00:00:00Z,1,6,2020,1014,5,Oman,OM,OMN,4974992,Asia,47,11437,38
2020-06-02T00:00:00Z,2,6,2020,786,3,Oman,OM,OMN,4974992,Asia,50,12223,39
2020-06-03T00:00:00Z,3,6,2020,576,9,Oman,OM,OMN,4974992,Asia,59,12799,40
2020-06-04T00:00:00Z,4,6,2020,738,8,Oman,OM,OMN,4974992,Asia,67,13537,41
2020-06-05T00:00:00Z,5,6,2020,779,0,Oman,OM,OMN,4974992,Asia,67,14316,42
2020-06-06T00:00:00Z,6,6,2020,770,5,Oman,OM,OMN,4974992,Asia,72,15086,43
2020-06-07T00:00:00Z,7,6,2020,930,0,Oman,OM,OMN,4974992,Asia,72,16016,44
2020-06-08T00:00:00Z,8,6,2020,866,3,Oman,OM,OMN,4974992,Asia,75,16882,45
2020-06-09T00:00:00Z,9,6,2020,604,6,Oman,OM,OMN,4974992,Asia,81,17486,46
2020-06-10T00:00:00Z,10,6,2020,712,2,Oman,OM,OMN,4974992,Asia,83,18198,47
2020-06-11T00:00:00Z,11,6,2020,689,1,Oman,OM,OMN,4974992,Asia,84,18887,48
2020-06-12T00:00:00Z,12,6,2020,1067,5,Oman,OM,OMN,4974992,Asia,89,19954,49
2020-06-13T00:00:00Z,13,6,2020,1117,7,Oman,OM,OMN,4974992,Asia,96,21071,50
2020-06-14T00:00:00Z,14,6,2020,1006,3,Oman,OM,OMN,4974992,Asia,99,22077,51
2020-06-15T00:00:00Z,15,6,2020,1404,5,Oman,OM,OMN,4974992,Asia,104,23481,52
2020-06-16T00:00:00Z,16,6,2020,1043,4,Oman,OM,OMN,4974992,Asia,108,24524,53
2020-06-17T00:00:00Z,17,6,2020,745,6,Oman,OM,OMN,4974992,Asia,114,25269,54
2020-06-18T00:00:00Z,18,6,2020,810,2,Oman,OM,OMN,4974992,Asia,116,26079,55
2020-06-19T00:00:00Z,19,6,2020,739,3,Oman,OM,OMN,4974992,Asia,119,26818,56
2020-06-20T00:00:00Z,20,6,2020,852,6,Oman,OM,OMN,4974992,Asia,125,27670,57
2020-06-21T00:00:00Z,21,6,2020,896,3,Oman,OM,OMN,4974992,Asia,128,28566,58
2020-06-22T00:00:00Z,22,6,2020,905,3,Oman,OM,OMN,4974992,Asia,131,29471,59
2020-06-23T00:00:00Z,23,6,2020,1605,6,Oman,OM,OMN,4974992,Asia,137,31076,60
2020-06-24T00:00:00Z,24,6,2020,1318,3,Oman,OM,OMN,4974992,Asia,140,32394,61
2020-06-25T00:00:00Z,25,6,2020,1142,2,Oman,OM,OMN,4974992,Asia,142,33536,62
2020-03-29T00:00:00Z,29,3,2020,211,2,Pakistan,PK,PAK,216565317,Asia,11,1408,1
2020-03-30T00:00:00Z,30,3,2020,118,2,Pakistan,PK,PAK,216565317,Asia,13,1526,2
2020-03-31T00:00:00Z,31,3,2020,99,5,Pakistan,PK,PAK,216565317,Asia,18,1625,3
2020-04-01T00:00:00Z,1,4,2020,414,8,Pakistan,PK,PAK,216565317,Asia,26,2039,4
2020-04-02T00:00:00Z,2,4,2020,252,5,Pakistan,PK,PAK,216565317,Asia,31,2291,5
2020-04-03T00:00:00Z,3,4,2020,0,0,Pakistan,PK,PAK,216565317,Asia,31,2291,6
2020-04-04T00:00:00Z,4,4,2020,0,0,Pakistan,PK,PAK,216565317,Asia,31,2291,7
2020-04-05T00:00:00Z,5,4,2020,159,4,Pakistan,PK,PAK,216565317,Asia,35,2450,8
2020-04-06T00:00:00Z,6,4,2020,827,15,Pakistan,PK,PAK,216565317,Asia,50,3277,9
2020-04-07T00:00:00Z,7,4,2020,587,4,Pakistan,PK,PAK,216565317,Asia,54,3864,10
2020-04-08T00:00:00Z,8,4,2020,208,4,Pakistan,PK,PAK,216565317,Asia,58,4072,11
2020-04-09T00:00:00Z,9,4,2020,250,5,Pakistan,PK,PAK,216565317,Asia,63,4322,12
2020-04-10T00:00:00Z,10,4,2020,279,3,Pakistan,PK,PAK,216565317,Asia,66,4601,13
2020-04-11T00:00:00Z,11,4,2020,187,5,Pakistan,PK,PAK,216565317,Asia,71,4788,14
2020-04-12T00:00:00Z,12,4,2020,250,15,Pakistan,PK,PAK,216565317,Asia,86,5038,15
2020-04-13T00:00:00Z,13,4,2020,336,7,Pakistan,PK,PAK,216565317,Asia,93,5374,16
2020-04-14T00:00:00Z,14,4,2020,342,3,Pakistan,PK,PAK,216565317,Asia,96,5716,17
2020-04-15T00:00:00Z,15,4,2020,272,11,Pakistan,PK,PAK,216565317,Asia,107,5988,18
2020-04-16T00:00:00Z,16,4,2020,517,17,Pakistan,PK,PAK,216565317,Asia,124,6505,19
2020-04-17T00:00:00Z,17,4,2020,520,11,Pakistan,PK,PAK,216565317,Asia,135,7025,20
2020-04-18T00:00:00Z,18,4,2020,456,8,Pakistan,PK,PAK,216565317,Asia,143,7481,21
2020-04-19T00:00:00Z,19,4,2020,512,16,Pakistan,PK,PAK,216565317,Asia,159,7993,22
2020-04-20T00:00:00Z,20,4,2020,425,17,Pakistan,PK,PAK,216565317,Asia,176,8418,23
2020-04-21T00:00:00Z,21,4,2020,798,16,Pakistan,PK,PAK,216565317,Asia,192,9216,24
2020-04-22T00:00:00Z,22,4,2020,533,17,Pakistan,PK,PAK,216565317,Asia,209,9749,25
2020-04-23T00:00:00Z,23,4,2020,0,0,Pakistan,PK,PAK,216565317,Asia,209,9749,26
2020-04-24T00:00:00Z,24,4,2020,1406,28,Pakistan,PK,PAK,216565317,Asia,237,11155,27
2020-04-25T00:00:00Z,25,4,2020,785,16,Pakistan,PK,PAK,216565317,Asia,253,11940,28
2020-04-26T00:00:00Z,26,4,2020,783,16,Pakistan,PK,PAK,216565317,Asia,269,12723,29
2020-04-27T00:00:00Z,27,4,2020,605,12,Pakistan,PK,PAK,216565317,Asia,281,13328,30
2020-04-28T00:00:00Z,28,4,2020,751,20,Pakistan,PK,PAK,216565317,Asia,301,14079,31
2020-04-29T00:00:00Z,29,4,2020,806,26,Pakistan,PK,PAK,216565317,Asia,327,14885,32
2020-04-30T00:00:00Z,30,4,2020,874,19,Pakistan,PK,PAK,216565317,Asia,346,15759,33
2020-05-01T00:00:00Z,1,5,2020,1058,39,Pakistan,PK,PAK,216565317,Asia,385,16817,34
2020-05-02T00:00:00Z,2,5,2020,1297,32,Pakistan,PK,PAK,216565317,Asia,417,18114,35
2020-05-03T00:00:00Z,3,5,2020,989,23,Pakistan,PK,PAK,216565317,Asia,440,19103,36
2020-05-04T00:00:00Z,4,5,2020,1083,22,Pakistan,PK,PAK,216565317,Asia,462,20186,37
2020-05-05T00:00:00Z,5,5,2020,1315,24,Pakistan,PK,PAK,216565317,Asia,486,21501,38
2020-05-06T00:00:00Z,6,5,2020,1049,40,Pakistan,PK,PAK,216565317,Asia,526,22550,39
2020-05-07T00:00:00Z,7,5,2020,1523,38,Pakistan,PK,PAK,216565317,Asia,564,24073,40
2020-05-08T00:00:00Z,8,5,2020,1764,30,Pakistan,PK,PAK,216565317,Asia,594,25837,41
2020-05-09T00:00:00Z,9,5,2020,1637,24,Pakistan,PK,PAK,216565317,Asia,618,27474,42
2020-05-10T00:00:00Z,10,5,2020,1991,21,Pakistan,PK,PAK,216565317,Asia,639,29465,43
2020-05-11T00:00:00Z,11,5,2020,1476,28,Pakistan,PK,PAK,216565317,Asia,667,30941,44
2020-05-12T00:00:00Z,12,5,2020,1140,39,Pakistan,PK,PAK,216565317,Asia,706,32081,45
2020-05-13T00:00:00Z,13,5,2020,2255,31,Pakistan,PK,PAK,216565317,Asia,737,34336,46
2020-05-14T00:00:00Z,14,5,2020,1452,33,Pakistan,PK,PAK,216565317,Asia,770,35788,47
2020-05-15T00:00:00Z,15,5,2020,1430,33,Pakistan,PK,PAK,216565317,Asia,803,37218,48
2020-05-16T00:00:00Z,16,5,2020,1581,31,Pakistan,PK,PAK,216565317,Asia,834,38799,49
2020-05-17T00:00:00Z,17,5,2020,1352,39,Pakistan,PK,PAK,216565317,Asia,873,40151,50
2020-05-18T00:00:00Z,18,5,2020,1974,30,Pakistan,PK,PAK,216565317,Asia,903,42125,51
2020-05-19T00:00:00Z,19,5,2020,1841,36,Pakistan,PK,PAK,216565317,Asia,939,43966,52
2020-05-20T00:00:00Z,20,5,2020,1932,46,Pakistan,PK,PAK,216565317,Asia,985,45898,53
2020-05-21T00:00:00Z,21,5,2020,2193,32,Pakistan,PK,PAK,216565317,Asia,1017,48091,54
2020-05-22T00:00:00Z,22,5,2020,2603,50,Pakistan,PK,PAK,216565317,Asia,1067,50694,55
2020-05-23T00:00:00Z,23,5,2020,1743,34,Pakistan,PK,PAK,216565317,Asia,1101,52437,56
2020-05-24T00:00:00Z,24,5,2020,2164,32,Pakistan,PK,PAK,216565317,Asia,1133,54601,57
2020-05-25T00:00:00Z,25,5,2020,1748,34,Pakistan,PK,PAK,216565317,Asia,1167,56349,58
2020-05-26T00:00:00Z,26,5,2020,1356,30,Pakistan,PK,PAK,216565317,Asia,1197,57705,59
2020-05-27T00:00:00Z,27,5,2020,1446,28,Pakistan,PK,PAK,216565317,Asia,1225,59151,60
2020-05-28T00:00:00Z,28,5,2020,2076,35,Pakistan,PK,PAK,216565317,Asia,1260,61227,61
2020-05-29T00:00:00Z,29,5,2020,2801,57,Pakistan,PK,PAK,216565317,Asia,1317,64028,62
2020-05-30T00:00:00Z,30,5,2020,2429,78,Pakistan,PK,PAK,216565317,Asia,1395,66457,63
2020-05-31T00:00:00Z,31,5,2020,3039,88,Pakistan,PK,PAK,216565317,Asia,1483,69496,64
2020-06-01T00:00:00Z,1,6,2020,2964,60,Pakistan,PK,PAK,216565317,Asia,1543,72460,65
2020-06-02T00:00:00Z,2,6,2020,3938,78,Pakistan,PK,PAK,216565317,Asia,1621,76398,66
2020-06-03T00:00:00Z,3,6,2020,4065,67,Pakistan,PK,PAK,216565317,Asia,1688,80463,67
2020-06-04T00:00:00Z,4,6,2020,4801,82,Pakistan,PK,PAK,216565317,Asia,1770,85264,68
2020-06-05T00:00:00Z,5,6,2020,3985,68,Pakistan,PK,PAK,216565317,Asia,1838,89249,69
2020-06-06T00:00:00Z,6,6,2020,4734,97,Pakistan,PK,PAK,216565317,Asia,1935,93983,70
2020-06-07T00:00:00Z,7,6,2020,4960,67,Pakistan,PK,PAK,216565317,Asia,2002,98943,71
2020-06-08T00:00:00Z,8,6,2020,4728,65,Pakistan,PK,PAK,216565317,Asia,2067,103671,72
2020-06-09T00:00:00Z,9,6,2020,4646,105,Pakistan,PK,PAK,216565317,Asia,2172,108317,73
2020-06-10T00:00:00Z,10,6,2020,5385,83,Pakistan,PK,PAK,216565317,Asia,2255,113702,74
2020-06-11T00:00:00Z,11,6,2020,5834,101,Pakistan,PK,PAK,216565317,Asia,2356,119536,75
2020-06-12T00:00:00Z,12,6,2020,6397,107,Pakistan,PK,PAK,216565317,Asia,2463,125933,76
2020-06-13T00:00:00Z,13,6,2020,6472,88,Pakistan,PK,PAK,216565317,Asia,2551,132405,77
2020-06-14T00:00:00Z,14,6,2020,6825,81,Pakistan,PK,PAK,216565317,Asia,2632,139230,78
2020-06-15T00:00:00Z,15,6,2020,5248,97,Pakistan,PK,PAK,216565317,Asia,2729,144478,79
2020-06-16T00:00:00Z,16,6,2020,4443,110,Pakistan,PK,PAK,216565317,Asia,2839,148921,80
2020-06-17T00:00:00Z,17,6,2020,5839,136,Pakistan,PK,PAK,216565317,Asia,2975,154760,81
2020-06-18T00:00:00Z,18,6,2020,5358,118,Pakistan,PK,PAK,216565317,Asia,3093,160118,82
2020-06-19T00:00:00Z,19,6,2020,4944,136,Pakistan,PK,PAK,216565317,Asia,3229,165062,83
2020-06-20T00:00:00Z,20,6,2020,6604,153,Pakistan,PK,PAK,216565317,Asia,3382,171666,84
2020-06-21T00:00:00Z,21,6,2020,4951,119,Pakistan,PK,PAK,216565317,Asia,3501,176617,85
2020-06-22T00:00:00Z,22,6,2020,4471,89,Pakistan,PK,PAK,216565317,Asia,3590,181088,86
2020-06-23T00:00:00Z,23,6,2020,3946,105,Pakistan,PK,PAK,216565317,Asia,3695,185034,87
2020-06-24T00:00:00Z,24,6,2020,3892,60,Pakistan,PK,PAK,216565317,Asia,3755,188926,88
2020-06-25T00:00:00Z,25,6,2020,4044,148,Pakistan,PK,PAK,216565317,Asia,3903,192970,89
2020-03-28T00:00:00Z,28,3,2020,112,5,Panama,PA,PAN,4246440,America,14,786,1
2020-03-29T00:00:00Z,29,3,2020,115,3,Panama,PA,PAN,4246440,America,17,901,2
2020-03-30T00:00:00Z,30,3,2020,88,7,Panama,PA,PAN,4246440,America,24,989,3
2020-03-31T00:00:00Z,31,3,2020,86,2,Panama,PA,PAN,4246440,America,26,1075,4
2020-04-01T00:00:00Z,1,4,2020,106,4,Panama,PA,PAN,4246440,America,30,1181,5
2020-04-02T00:00:00Z,2,4,2020,136,2,Panama,PA,PAN,4246440,America,32,1317,6
2020-04-03T00:00:00Z,3,4,2020,158,5,Panama,PA,PAN,4246440,America,37,1475,7
2020-04-04T00:00:00Z,4,4,2020,198,4,Panama,PA,PAN,4246440,America,41,1673,8
2020-04-05T00:00:00Z,5,4,2020,128,5,Panama,PA,PAN,4246440,America,46,1801,9
2020-04-06T00:00:00Z,6,4,2020,187,8,Panama,PA,PAN,4246440,America,54,1988,10
2020-04-07T00:00:00Z,7,4,2020,112,1,Panama,PA,PAN,4246440,America,55,2100,11
2020-04-08T00:00:00Z,8,4,2020,149,4,Panama,PA,PAN,4246440,America,59,2249,12
2020-04-09T00:00:00Z,9,4,2020,279,4,Panama,PA,PAN,4246440,America,63,2528,13
2020-04-10T00:00:00Z,10,4,2020,224,3,Panama,PA,PAN,4246440,America,66,2752,14
2020-04-11T00:00:00Z,11,4,2020,222,8,Panama,PA,PAN,4246440,America,74,2974,15
2020-04-12T00:00:00Z,12,4,2020,260,5,Panama,PA,PAN,4246440,America,79,3234,16
2020-04-13T00:00:00Z,13,4,2020,166,8,Panama,PA,PAN,4246440,America,87,3400,17
2020-04-14T00:00:00Z,14,4,2020,72,7,Panama,PA,PAN,4246440,America,94,3472,18
2020-04-15T00:00:00Z,15,4,2020,102,1,Panama,PA,PAN,4246440,America,95,3574,19
2020-04-16T00:00:00Z,16,4,2020,177,8,Panama,PA,PAN,4246440,America,103,3751,20
2020-04-17T00:00:00Z,17,4,2020,265,6,Panama,PA,PAN,4246440,America,109,4016,21
2020-04-18T00:00:00Z,18,4,2020,194,7,Panama,PA,PAN,4246440,America,116,4210,22
2020-04-19T00:00:00Z,19,4,2020,63,4,Panama,PA,PAN,4246440,America,120,4273,23
2020-04-20T00:00:00Z,20,4,2020,194,6,Panama,PA,PAN,4246440,America,126,4467,24
2020-04-21T00:00:00Z,21,4,2020,191,10,Panama,PA,PAN,4246440,America,136,4658,25
2020-04-22T00:00:00Z,22,4,2020,163,5,Panama,PA,PAN,4246440,America,141,4821,26
2020-04-23T00:00:00Z,23,4,2020,171,3,Panama,PA,PAN,4246440,America,144,4992,27
2020-04-24T00:00:00Z,24,4,2020,174,2,Panama,PA,PAN,4246440,America,146,5166,28
2020-04-25T00:00:00Z,25,4,2020,172,8,Panama,PA,PAN,4246440,America,154,5338,29
2020-04-26T00:00:00Z,26,4,2020,200,5,Panama,PA,PAN,4246440,America,159,5538,30
2020-04-27T00:00:00Z,27,4,2020,241,6,Panama,PA,PAN,4246440,America,165,5779,31
2020-04-28T00:00:00Z,28,4,2020,242,2,Panama,PA,PAN,4246440,America,167,6021,32
2020-04-29T00:00:00Z,29,4,2020,179,9,Panama,PA,PAN,4246440,America,176,6200,33
2020-04-30T00:00:00Z,30,4,2020,178,2,Panama,PA,PAN,4246440,America,178,6378,34
2020-05-01T00:00:00Z,1,5,2020,154,10,Panama,PA,PAN,4246440,America,188,6532,35
2020-05-02T00:00:00Z,2,5,2020,188,4,Panama,PA,PAN,4246440,America,192,6720,36
2020-05-03T00:00:00Z,3,5,2020,370,5,Panama,PA,PAN,4246440,America,197,7090,37
2020-05-04T00:00:00Z,4,5,2020,107,3,Panama,PA,PAN,4246440,America,200,7197,38
2020-05-05T00:00:00Z,5,5,2020,190,3,Panama,PA,PAN,4246440,America,203,7387,39
2020-05-06T00:00:00Z,6,5,2020,136,7,Panama,PA,PAN,4246440,America,210,7523,40
2020-05-07T00:00:00Z,7,5,2020,208,8,Panama,PA,PAN,4246440,America,218,7731,41
2020-05-08T00:00:00Z,8,5,2020,137,7,Panama,PA,PAN,4246440,America,225,7868,42
2020-05-09T00:00:00Z,9,5,2020,202,6,Panama,PA,PAN,4246440,America,231,8070,43
2020-05-10T00:00:00Z,10,5,2020,212,6,Panama,PA,PAN,4246440,America,237,8282,44
2020-05-11T00:00:00Z,11,5,2020,166,7,Panama,PA,PAN,4246440,America,244,8448,45
2020-05-12T00:00:00Z,12,5,2020,168,5,Panama,PA,PAN,4246440,America,249,8616,46
2020-05-13T00:00:00Z,13,5,2020,167,3,Panama,PA,PAN,4246440,America,252,8783,47
2020-05-14T00:00:00Z,14,5,2020,161,4,Panama,PA,PAN,4246440,America,256,8944,48
2020-05-15T00:00:00Z,15,5,2020,174,4,Panama,PA,PAN,4246440,America,260,9118,49
2020-05-16T00:00:00Z,16,5,2020,150,6,Panama,PA,PAN,4246440,America,266,9268,50
2020-05-17T00:00:00Z,17,5,2020,181,3,Panama,PA,PAN,4246440,America,269,9449,51
2020-05-18T00:00:00Z,18,5,2020,157,6,Panama,PA,PAN,4246440,America,275,9606,52
2020-05-19T00:00:00Z,19,5,2020,120,4,Panama,PA,PAN,4246440,America,279,9726,53
2020-05-20T00:00:00Z,20,5,2020,141,2,Panama,PA,PAN,4246440,America,281,9867,54
2020-05-21T00:00:00Z,21,5,2020,110,6,Panama,PA,PAN,4246440,America,287,9977,55
2020-05-22T00:00:00Z,22,5,2020,139,4,Panama,PA,PAN,4246440,America,291,10116,56
2020-05-23T00:00:00Z,23,5,2020,151,4,Panama,PA,PAN,4246440,America,295,10267,57
2020-05-24T00:00:00Z,24,5,2020,310,4,Panama,PA,PAN,4246440,America,299,10577,58
2020-05-25T00:00:00Z,25,5,2020,349,7,Panama,PA,PAN,4246440,America,306,10926,59
2020-05-26T00:00:00Z,26,5,2020,257,4,Panama,PA,PAN,4246440,America,310,11183,60
2020-05-27T00:00:00Z,27,5,2020,264,3,Panama,PA,PAN,4246440,America,313,11447,61
2020-05-28T00:00:00Z,28,5,2020,281,2,Panama,PA,PAN,4246440,America,315,11728,62
2020-05-29T00:00:00Z,29,5,2020,403,5,Panama,PA,PAN,4246440,America,320,12131,63
2020-05-30T00:00:00Z,30,5,2020,400,6,Panama,PA,PAN,4246440,America,326,12531,64
2020-05-31T00:00:00Z,31,5,2020,487,4,Panama,PA,PAN,4246440,America,330,13018,65
2020-06-01T00:00:00Z,1,6,2020,445,6,Panama,PA,PAN,4246440,America,336,13463,66
2020-06-02T00:00:00Z,2,6,2020,374,8,Panama,PA,PAN,4246440,America,344,13837,67
2020-06-03T00:00:00Z,3,6,2020,258,8,Panama,PA,PAN,4246440,America,352,14095,68
2020-06-04T00:00:00Z,4,6,2020,514,5,Panama,PA,PAN,4246440,America,357,14609,69
2020-06-05T00:00:00Z,5,6,2020,435,6,Panama,PA,PAN,4246440,America,363,15044,70
2020-06-06T00:00:00Z,6,6,2020,419,7,Panama,PA,PAN,4246440,America,370,15463,71
2020-06-07T00:00:00Z,7,6,2020,541,16,Panama,PA,PAN,4246440,America,386,16004,72
2020-06-08T00:00:00Z,8,6,2020,421,7,Panama,PA,PAN,4246440,America,393,16425,73
2020-06-09T00:00:00Z,9,6,2020,429,5,Panama,PA,PAN,4246440,America,398,16854,74
2020-06-10T00:00:00Z,10,6,2020,379,5,Panama,PA,PAN,4246440,America,403,17233,75
2020-06-11T00:00:00Z,11,6,2020,656,10,Panama,PA,PAN,4246440,America,413,17889,76
2020-06-12T00:00:00Z,12,6,2020,697,5,Panama,PA,PAN,4246440,America,418,18586,77
2020-06-13T00:00:00Z,13,6,2020,625,3,Panama,PA,PAN,4246440,America,421,19211,78
2020-06-14T00:00:00Z,14,6,2020,848,8,Panama,PA,PAN,4246440,America,429,20059,79
2020-06-15T00:00:00Z,15,6,2020,627,8,Panama,PA,PAN,4246440,America,437,20686,80
2020-06-16T00:00:00Z,16,6,2020,736,11,Panama,PA,PAN,4246440,America,448,21422,81
2020-06-17T00:00:00Z,17,6,2020,540,9,Panama,PA,PAN,4246440,America,457,21962,82
2020-06-18T00:00:00Z,18,6,2020,635,13,Panama,PA,PAN,4246440,America,470,22597,83
2020-06-19T00:00:00Z,19,6,2020,754,5,Panama,PA,PAN,4246440,America,475,23351,84
2020-06-20T00:00:00Z,20,6,2020,923,10,Panama,PA,PAN,4246440,America,485,24274,85
2020-06-21T00:00:00Z,21,6,2020,948,8,Panama,PA,PAN,4246440,America,493,25222,86
2020-06-22T00:00:00Z,22,6,2020,808,8,Panama,PA,PAN,4246440,America,501,26030,87
2020-06-23T00:00:00Z,23,6,2020,722,20,Panama,PA,PAN,4246440,America,521,26752,88
2020-06-24T00:00:00Z,24,6,2020,562,15,Panama,PA,PAN,4246440,America,536,27314,89
2020-06-25T00:00:00Z,25,6,2020,716,11,Panama,PA,PAN,4246440,America,547,28030,90
2020-05-01T00:00:00Z,1,5,2020,17,1,Paraguay,PY,PRY,7044639,America,10,266,1
2020-05-02T00:00:00Z,2,5,2020,67,0,Paraguay,PY,PRY,7044639,America,10,333,2
2020-05-03T00:00:00Z,3,5,2020,37,0,Paraguay,PY,PRY,7044639,America,10,370,3
2020-05-04T00:00:00Z,4,5,2020,26,0,Paraguay,PY,PRY,7044639,America,10,396,4
2020-05-05T00:00:00Z,5,5,2020,19,0,Paraguay,PY,PRY,7044639,America,10,415,5
2020-05-06T00:00:00Z,6,5,2020,16,0,Paraguay,PY,PRY,7044639,America,10,431,6
2020-05-07T00:00:00Z,7,5,2020,9,0,Paraguay,PY,PRY,7044639,America,10,440,7
2020-05-08T00:00:00Z,8,5,2020,22,0,Paraguay,PY,PRY,7044639,America,10,462,8
2020-05-09T00:00:00Z,9,5,2020,101,0,Paraguay,PY,PRY,7044639,America,10,563,9
2020-05-10T00:00:00Z,10,5,2020,126,0,Paraguay,PY,PRY,7044639,America,10,689,10
2020-05-11T00:00:00Z,11,5,2020,24,0,Paraguay,PY,PRY,7044639,America,10,713,11
2020-05-12T00:00:00Z,12,5,2020,11,0,Paraguay,PY,PRY,7044639,America,10,724,12
2020-05-13T00:00:00Z,13,5,2020,13,0,Paraguay,PY,PRY,7044639,America,10,737,13
2020-05-14T00:00:00Z,14,5,2020,3,1,Paraguay,PY,PRY,7044639,America,11,740,14
2020-05-15T00:00:00Z,15,5,2020,14,0,Paraguay,PY,PRY,7044639,America,11,754,15
2020-05-16T00:00:00Z,16,5,2020,5,0,Paraguay,PY,PRY,7044639,America,11,759,16
2020-05-17T00:00:00Z,17,5,2020,19,0,Paraguay,PY,PRY,7044639,America,11,778,17
2020-05-18T00:00:00Z,18,5,2020,8,0,Paraguay,PY,PRY,7044639,America,11,786,18
2020-05-19T00:00:00Z,19,5,2020,2,0,Paraguay,PY,PRY,7044639,America,11,788,19
2020-05-20T00:00:00Z,20,5,2020,41,0,Paraguay,PY,PRY,7044639,America,11,829,20
2020-05-21T00:00:00Z,21,5,2020,4,0,Paraguay,PY,PRY,7044639,America,11,833,21
2020-05-22T00:00:00Z,22,5,2020,3,0,Paraguay,PY,PRY,7044639,America,11,836,22
2020-05-23T00:00:00Z,23,5,2020,2,0,Paraguay,PY,PRY,7044639,America,11,838,23
2020-05-24T00:00:00Z,24,5,2020,12,0,Paraguay,PY,PRY,7044639,America,11,850,24
2020-05-25T00:00:00Z,25,5,2020,12,0,Paraguay,PY,PRY,7044639,America,11,862,25
2020-05-26T00:00:00Z,26,5,2020,3,0,Paraguay,PY,PRY,7044639,America,11,865,26
2020-05-27T00:00:00Z,27,5,2020,12,0,Paraguay,PY,PRY,7044639,America,11,877,27
2020-05-28T00:00:00Z,28,5,2020,7,0,Paraguay,PY,PRY,7044639,America,11,884,28
2020-05-29T00:00:00Z,29,5,2020,16,0,Paraguay,PY,PRY,7044639,America,11,900,29
2020-05-30T00:00:00Z,30,5,2020,17,0,Paraguay,PY,PRY,7044639,America,11,917,30
2020-05-31T00:00:00Z,31,5,2020,47,0,Paraguay,PY,PRY,7044639,America,11,964,31
2020-06-01T00:00:00Z,1,6,2020,22,0,Paraguay,PY,PRY,7044639,America,11,986,32
2020-06-02T00:00:00Z,2,6,2020,9,0,Paraguay,PY,PRY,7044639,America,11,995,33
2020-06-03T00:00:00Z,3,6,2020,18,0,Paraguay,PY,PRY,7044639,America,11,1013,34
2020-06-04T00:00:00Z,4,6,2020,57,0,Paraguay,PY,PRY,7044639,America,11,1070,35
2020-06-05T00:00:00Z,5,6,2020,16,0,Paraguay,PY,PRY,7044639,America,11,1086,36
2020-06-06T00:00:00Z,6,6,2020,1,0,Paraguay,PY,PRY,7044639,America,11,1087,37
2020-06-07T00:00:00Z,7,6,2020,3,0,Paraguay,PY,PRY,7044639,America,11,1090,38
2020-06-08T00:00:00Z,8,6,2020,45,0,Paraguay,PY,PRY,7044639,America,11,1135,39
2020-06-09T00:00:00Z,9,6,2020,10,0,Paraguay,PY,PRY,7044639,America,11,1145,40
2020-06-10T00:00:00Z,10,6,2020,42,0,Paraguay,PY,PRY,7044639,America,11,1187,41
2020-06-11T00:00:00Z,11,6,2020,15,0,Paraguay,PY,PRY,7044639,America,11,1202,42
2020-06-12T00:00:00Z,12,6,2020,28,0,Paraguay,PY,PRY,7044639,America,11,1230,43
2020-06-13T00:00:00Z,13,6,2020,24,0,Paraguay,PY,PRY,7044639,America,11,1254,44
2020-06-14T00:00:00Z,14,6,2020,7,0,Paraguay,PY,PRY,7044639,America,11,1261,45
2020-06-15T00:00:00Z,15,6,2020,28,0,Paraguay,PY,PRY,7044639,America,11,1289,46
2020-06-16T00:00:00Z,16,6,2020,0,1,Paraguay,PY,PRY,7044639,America,12,1289,47
2020-06-17T00:00:00Z,17,6,2020,14,1,Paraguay,PY,PRY,7044639,America,13,1303,48
2020-06-18T00:00:00Z,18,6,2020,5,0,Paraguay,PY,PRY,7044639,America,13,1308,49
2020-06-19T00:00:00Z,19,6,2020,22,0,Paraguay,PY,PRY,7044639,America,13,1330,50
2020-06-20T00:00:00Z,20,6,2020,6,0,Paraguay,PY,PRY,7044639,America,13,1336,51
2020-06-21T00:00:00Z,21,6,2020,26,0,Paraguay,PY,PRY,7044639,America,13,1362,52
2020-06-22T00:00:00Z,22,6,2020,17,0,Paraguay,PY,PRY,7044639,America,13,1379,53
2020-06-23T00:00:00Z,23,6,2020,13,0,Paraguay,PY,PRY,7044639,America,13,1392,54
2020-06-24T00:00:00Z,24,6,2020,30,0,Paraguay,PY,PRY,7044639,America,13,1422,55
2020-06-25T00:00:00Z,25,6,2020,106,0,Paraguay,PY,PRY,7044639,America,13,1528,56
2020-03-28T00:00:00Z,28,3,2020,55,2,Peru,PE,PER,32510462,America,11,635,1
2020-03-29T00:00:00Z,29,3,2020,36,5,Peru,PE,PER,32510462,America,16,671,2
2020-03-30T00:00:00Z,30,3,2020,181,2,Peru,PE,PER,32510462,America,18,852,3
2020-03-31T00:00:00Z,31,3,2020,98,6,Peru,PE,PER,32510462,America,24,950,4
2020-04-01T00:00:00Z,1,4,2020,115,6,Peru,PE,PER,32510462,America,30,1065,5
2020-04-02T00:00:00Z,2,4,2020,258,17,Peru,PE,PER,32510462,America,47,1323,6
2020-04-03T00:00:00Z,3,4,2020,91,8,Peru,PE,PER,32510462,America,55,1414,7
2020-04-04T00:00:00Z,4,4,2020,181,6,Peru,PE,PER,32510462,America,61,1595,8
2020-04-05T00:00:00Z,5,4,2020,151,12,Peru,PE,PER,32510462,America,73,1746,9
2020-04-06T00:00:00Z,6,4,2020,535,10,Peru,PE,PER,32510462,America,83,2281,10
2020-04-07T00:00:00Z,7,4,2020,280,9,Peru,PE,PER,32510462,America,92,2561,11
2020-04-08T00:00:00Z,8,4,2020,393,15,Peru,PE,PER,32510462,America,107,2954,12
2020-04-09T00:00:00Z,9,4,2020,1388,14,Peru,PE,PER,32510462,America,121,4342,13
2020-04-10T00:00:00Z,10,4,2020,914,17,Peru,PE,PER,32510462,America,138,5256,14
2020-04-11T00:00:00Z,11,4,2020,641,31,Peru,PE,PER,32510462,America,169,5897,15
2020-04-12T00:00:00Z,12,4,2020,951,12,Peru,PE,PER,32510462,America,181,6848,16
2020-04-13T00:00:00Z,13,4,2020,671,12,Peru,PE,PER,32510462,America,193,7519,17
2020-04-14T00:00:00Z,14,4,2020,0,0,Peru,PE,PER,32510462,America,193,7519,18
2020-04-15T00:00:00Z,15,4,2020,2784,37,Peru,PE,PER,32510462,America,230,10303,19
2020-04-16T00:00:00Z,16,4,2020,1172,24,Peru,PE,PER,32510462,America,254,11475,20
2020-04-17T00:00:00Z,17,4,2020,1016,20,Peru,PE,PER,32510462,America,274,12491,21
2020-04-18T00:00:00Z,18,4,2020,998,26,Peru,PE,PER,32510462,America,300,13489,22
2020-04-19T00:00:00Z,19,4,2020,931,48,Peru,PE,PER,32510462,America,348,14420,23
2020-04-20T00:00:00Z,20,4,2020,1208,52,Peru,PE,PER,32510462,America,400,15628,24
2020-04-21T00:00:00Z,21,4,2020,697,45,Peru,PE,PER,32510462,America,445,16325,25
2020-04-22T00:00:00Z,22,4,2020,1512,39,Peru,PE,PER,32510462,America,484,17837,26
2020-04-23T00:00:00Z,23,4,2020,1413,46,Peru,PE,PER,32510462,America,530,19250,27
2020-04-24T00:00:00Z,24,4,2020,1664,42,Peru,PE,PER,32510462,America,572,20914,28
2020-04-25T00:00:00Z,25,4,2020,734,62,Peru,PE,PER,32510462,America,634,21648,29
2020-04-26T00:00:00Z,26,4,2020,3683,66,Peru,PE,PER,32510462,America,700,25331,30
2020-04-27T00:00:00Z,27,4,2020,2186,28,Peru,PE,PER,32510462,America,728,27517,31
2020-04-28T00:00:00Z,28,4,2020,1182,54,Peru,PE,PER,32510462,America,782,28699,32
2020-04-29T00:00:00Z,29,4,2020,2491,72,Peru,PE,PER,32510462,America,854,31190,33
2020-04-30T00:00:00Z,30,4,2020,2741,89,Peru,PE,PER,32510462,America,943,33931,34
2020-05-01T00:00:00Z,1,5,2020,3045,108,Peru,PE,PER,32510462,America,1051,36976,35
2020-05-02T00:00:00Z,2,5,2020,3483,73,Peru,PE,PER,32510462,America,1124,40459,36
2020-05-03T00:00:00Z,3,5,2020,2075,76,Peru,PE,PER,32510462,America,1200,42534,37
2020-05-04T00:00:00Z,4,5,2020,3394,86,Peru,PE,PER,32510462,America,1286,45928,38
2020-05-05T00:00:00Z,5,5,2020,1444,58,Peru,PE,PER,32510462,America,1344,47372,39
2020-05-06T00:00:00Z,6,5,2020,3817,100,Peru,PE,PER,32510462,America,1444,51189,40
2020-05-07T00:00:00Z,7,5,2020,3628,89,Peru,PE,PER,32510462,America,1533,54817,41
2020-05-08T00:00:00Z,8,5,2020,3709,94,Peru,PE,PER,32510462,America,1627,58526,42
2020-05-09T00:00:00Z,9,5,2020,3321,87,Peru,PE,PER,32510462,America,1714,61847,43
2020-05-10T00:00:00Z,10,5,2020,3168,100,Peru,PE,PER,32510462,America,1814,65015,44
2020-05-11T00:00:00Z,11,5,2020,2292,75,Peru,PE,PER,32510462,America,1889,67307,45
2020-05-12T00:00:00Z,12,5,2020,1515,72,Peru,PE,PER,32510462,America,1961,68822,46
2020-05-13T00:00:00Z,13,5,2020,3237,96,Peru,PE,PER,32510462,America,2057,72059,47
2020-05-14T00:00:00Z,14,5,2020,4247,112,Peru,PE,PER,32510462,America,2169,76306,48
2020-05-15T00:00:00Z,15,5,2020,4298,98,Peru,PE,PER,32510462,America,2267,80604,49
2020-05-16T00:00:00Z,16,5,2020,3891,126,Peru,PE,PER,32510462,America,2393,84495,50
2020-05-17T00:00:00Z,17,5,2020,4046,130,Peru,PE,PER,32510462,America,2523,88541,51
2020-05-18T00:00:00Z,18,5,2020,3732,125,Peru,PE,PER,32510462,America,2648,92273,52
2020-05-19T00:00:00Z,19,5,2020,2660,141,Peru,PE,PER,32510462,America,2789,94933,53
2020-05-20T00:00:00Z,20,5,2020,4550,125,Peru,PE,PER,32510462,America,2914,99483,54
2020-05-21T00:00:00Z,21,5,2020,4537,110,Peru,PE,PER,32510462,America,3024,104020,55
2020-05-22T00:00:00Z,22,5,2020,4749,124,Peru,PE,PER,32510462,America,3148,108769,56
2020-05-23T00:00:00Z,23,5,2020,2929,96,Peru,PE,PER,32510462,America,3244,111698,57
2020-05-24T00:00:00Z,24,5,2020,4056,129,Peru,PE,PER,32510462,America,3373,115754,58
2020-05-25T00:00:00Z,25,5,2020,4205,83,Peru,PE,PER,32510462,America,3456,119959,59
2020-05-26T00:00:00Z,26,5,2020,4020,173,Peru,PE,PER,32510462,America,3629,123979,60
2020-05-27T00:00:00Z,27,5,2020,5772,159,Peru,PE,PER,32510462,America,3788,129751,61
2020-05-28T00:00:00Z,28,5,2020,6154,195,Peru,PE,PER,32510462,America,3983,135905,62
2020-05-29T00:00:00Z,29,5,2020,5874,116,Peru,PE,PER,32510462,America,4099,141779,63
2020-05-30T00:00:00Z,30,5,2020,6506,131,Peru,PE,PER,32510462,America,4230,148285,64
2020-05-31T00:00:00Z,31,5,2020,7386,141,Peru,PE,PER,32510462,America,4371,155671,65
2020-06-01T00:00:00Z,1,6,2020,8805,135,Peru,PE,PER,32510462,America,4506,164476,66
2020-06-02T00:00:00Z,2,6,2020,5563,128,Peru,PE,PER,32510462,America,4634,170039,67
2020-06-03T00:00:00Z,3,6,2020,0,0,Peru,PE,PER,32510462,America,4634,170039,68
2020-06-04T00:00:00Z,4,6,2020,8875,260,Peru,PE,PER,32510462,America,4894,178914,69
2020-06-05T00:00:00Z,5,6,2020,4284,137,Peru,PE,PER,32510462,America,5031,183198,70
2020-06-06T00:00:00Z,6,6,2020,4202,131,Peru,PE,PER,32510462,America,5162,187400,71
2020-06-07T00:00:00Z,7,6,2020,4358,139,Peru,PE,PER,32510462,America,5301,191758,72
2020-06-08T00:00:00Z,8,6,2020,4757,164,Peru,PE,PER,32510462,America,5465,196515,73
2020-06-09T00:00:00Z,9,6,2020,3181,106,Peru,PE,PER,32510462,America,5571,199696,74
2020-06-10T00:00:00Z,10,6,2020,4040,167,Peru,PE,PER,32510462,America,5738,203736,75
2020-06-11T00:00:00Z,11,6,2020,5087,165,Peru,PE,PER,32510462,America,5903,208823,76
2020-06-12T00:00:00Z,12,6,2020,5965,206,Peru,PE,PER,32510462,America,6109,214788,77
2020-06-13T00:00:00Z,13,6,2020,5961,199,Peru,PE,PER,32510462,America,6308,220749,78
2020-06-14T00:00:00Z,14,6,2020,4383,190,Peru,PE,PER,32510462,America,6498,225132,79
2020-06-15T00:00:00Z,15,6,2020,4604,190,Peru,PE,PER,32510462,America,6688,229736,80
2020-06-16T00:00:00Z,16,6,2020,3256,172,Peru,PE,PER,32510462,America,6860,232992,81
2020-06-17T00:00:00Z,17,6,2020,4164,196,Peru,PE,PER,32510462,America,7056,237156,82
2020-06-18T00:00:00Z,18,6,2020,3752,201,Peru,PE,PER,32510462,America,7257,240908,83
2020-06-19T00:00:00Z,19,6,2020,3480,204,Peru,PE,PER,32510462,America,7461,244388,84
2020-06-20T00:00:00Z,20,6,2020,3537,199,Peru,PE,PER,32510462,America,7660,247925,85
2020-06-21T00:00:00Z,21,6,2020,3413,201,Peru,PE,PER,32510462,America,7861,251338,86
2020-06-22T00:00:00Z,22,6,2020,3598,184,Peru,PE,PER,32510462,America,8045,254936,87
2020-06-23T00:00:00Z,23,6,2020,0,0,Peru,PE,PER,32510462,America,8045,254936,88
2020-06-24T00:00:00Z,24,6,2020,5874,359,Peru,PE,PER,32510462,America,8404,260810,89
2020-06-25T00:00:00Z,25,6,2020,3879,182,Peru,PE,PER,32510462,America,8586,264689,90
2020-03-16T00:00:00Z,16,3,2020,29,6,Philippines,PH,PHL,108116622,Asia,12,140,1
2020-03-17T00:00:00Z,17,3,2020,2,0,Philippines,PH,PHL,108116622,Asia,12,142,2
2020-03-18T00:00:00Z,18,3,2020,45,2,Philippines,PH,PHL,108116622,Asia,14,187,3
2020-03-19T00:00:00Z,19,3,2020,15,3,Philippines,PH,PHL,108116622,Asia,17,202,4
2020-03-20T00:00:00Z,20,3,2020,28,1,Philippines,PH,PHL,108116622,Asia,18,230,5
2020-03-21T00:00:00Z,21,3,2020,0,0,Philippines,PH,PHL,108116622,Asia,18,230,6
2020-03-22T00:00:00Z,22,3,2020,150,7,Philippines,PH,PHL,108116622,Asia,25,380,7
2020-03-23T00:00:00Z,23,3,2020,0,0,Philippines,PH,PHL,108116622,Asia,25,380,8
2020-03-24T00:00:00Z,24,3,2020,82,8,Philippines,PH,PHL,108116622,Asia,33,462,9
2020-03-25T00:00:00Z,25,3,2020,90,2,Philippines,PH,PHL,108116622,Asia,35,552,10
2020-03-26T00:00:00Z,26,3,2020,84,3,Philippines,PH,PHL,108116622,Asia,38,636,11
2020-03-27T00:00:00Z,27,3,2020,71,7,Philippines,PH,PHL,108116622,Asia,45,707,12
2020-03-28T00:00:00Z,28,3,2020,96,9,Philippines,PH,PHL,108116622,Asia,54,803,13
2020-03-29T00:00:00Z,29,3,2020,272,14,Philippines,PH,PHL,108116622,Asia,68,1075,14
2020-03-30T00:00:00Z,30,3,2020,343,3,Philippines,PH,PHL,108116622,Asia,71,1418,15
2020-03-31T00:00:00Z,31,3,2020,666,17,Philippines,PH,PHL,108116622,Asia,88,2084,16
2020-04-01T00:00:00Z,1,4,2020,0,0,Philippines,PH,PHL,108116622,Asia,88,2084,17
2020-04-02T00:00:00Z,2,4,2020,227,8,Philippines,PH,PHL,108116622,Asia,96,2311,18
2020-04-03T00:00:00Z,3,4,2020,322,11,Philippines,PH,PHL,108116622,Asia,107,2633,19
2020-04-04T00:00:00Z,4,4,2020,385,29,Philippines,PH,PHL,108116622,Asia,136,3018,20
2020-04-05T00:00:00Z,5,4,2020,76,8,Philippines,PH,PHL,108116622,Asia,144,3094,21
2020-04-06T00:00:00Z,6,4,2020,152,8,Philippines,PH,PHL,108116622,Asia,152,3246,22
2020-04-07T00:00:00Z,7,4,2020,414,11,Philippines,PH,PHL,108116622,Asia,163,3660,23
2020-04-08T00:00:00Z,8,4,2020,104,14,Philippines,PH,PHL,108116622,Asia,177,3764,24
2020-04-09T00:00:00Z,9,4,2020,106,5,Philippines,PH,PHL,108116622,Asia,182,3870,25
2020-04-10T00:00:00Z,10,4,2020,206,21,Philippines,PH,PHL,108116622,Asia,203,4076,26
2020-04-11T00:00:00Z,11,4,2020,0,0,Philippines,PH,PHL,108116622,Asia,203,4076,27
2020-04-12T00:00:00Z,12,4,2020,352,44,Philippines,PH,PHL,108116622,Asia,247,4428,28
2020-04-13T00:00:00Z,13,4,2020,220,50,Philippines,PH,PHL,108116622,Asia,297,4648,29
2020-04-14T00:00:00Z,14,4,2020,284,18,Philippines,PH,PHL,108116622,Asia,315,4932,30
2020-04-15T00:00:00Z,15,4,2020,291,20,Philippines,PH,PHL,108116622,Asia,335,5223,31
2020-04-16T00:00:00Z,16,4,2020,230,14,Philippines,PH,PHL,108116622,Asia,349,5453,32
2020-04-17T00:00:00Z,17,4,2020,207,13,Philippines,PH,PHL,108116622,Asia,362,5660,33
2020-04-18T00:00:00Z,18,4,2020,218,25,Philippines,PH,PHL,108116622,Asia,387,5878,34
2020-04-19T00:00:00Z,19,4,2020,209,10,Philippines,PH,PHL,108116622,Asia,397,6087,35
2020-04-20T00:00:00Z,20,4,2020,172,12,Philippines,PH,PHL,108116622,Asia,409,6259,36
2020-04-21T00:00:00Z,21,4,2020,200,19,Philippines,PH,PHL,108116622,Asia,428,6459,37
2020-04-22T00:00:00Z,22,4,2020,140,9,Philippines,PH,PHL,108116622,Asia,437,6599,38
2020-04-23T00:00:00Z,23,4,2020,111,9,Philippines,PH,PHL,108116622,Asia,446,6710,39
2020-04-24T00:00:00Z,24,4,2020,271,16,Philippines,PH,PHL,108116622,Asia,462,6981,40
2020-04-25T00:00:00Z,25,4,2020,211,15,Philippines,PH,PHL,108116622,Asia,477,7192,41
2020-04-26T00:00:00Z,26,4,2020,102,17,Philippines,PH,PHL,108116622,Asia,494,7294,42
2020-04-27T00:00:00Z,27,4,2020,285,7,Philippines,PH,PHL,108116622,Asia,501,7579,43
2020-04-28T00:00:00Z,28,4,2020,198,10,Philippines,PH,PHL,108116622,Asia,511,7777,44
2020-04-29T00:00:00Z,29,4,2020,181,19,Philippines,PH,PHL,108116622,Asia,530,7958,45
2020-04-30T00:00:00Z,30,4,2020,254,28,Philippines,PH,PHL,108116622,Asia,558,8212,46
2020-05-01T00:00:00Z,1,5,2020,276,10,Philippines,PH,PHL,108116622,Asia,568,8488,47
2020-05-02T00:00:00Z,2,5,2020,284,11,Philippines,PH,PHL,108116622,Asia,579,8772,48
2020-05-03T00:00:00Z,3,5,2020,156,24,Philippines,PH,PHL,108116622,Asia,603,8928,49
2020-05-04T00:00:00Z,4,5,2020,295,4,Philippines,PH,PHL,108116622,Asia,607,9223,50
2020-05-05T00:00:00Z,5,5,2020,262,16,Philippines,PH,PHL,108116622,Asia,623,9485,51
2020-05-06T00:00:00Z,6,5,2020,199,14,Philippines,PH,PHL,108116622,Asia,637,9684,52
2020-05-07T00:00:00Z,7,5,2020,320,21,Philippines,PH,PHL,108116622,Asia,658,10004,53
2020-05-08T00:00:00Z,8,5,2020,339,27,Philippines,PH,PHL,108116622,Asia,685,10343,54
2020-05-09T00:00:00Z,9,5,2020,120,11,Philippines,PH,PHL,108116622,Asia,696,10463,55
2020-05-10T00:00:00Z,10,5,2020,147,8,Philippines,PH,PHL,108116622,Asia,704,10610,56
2020-05-11T00:00:00Z,11,5,2020,184,15,Philippines,PH,PHL,108116622,Asia,719,10794,57
2020-05-12T00:00:00Z,12,5,2020,292,7,Philippines,PH,PHL,108116622,Asia,726,11086,58
2020-05-13T00:00:00Z,13,5,2020,264,25,Philippines,PH,PHL,108116622,Asia,751,11350,59
2020-05-14T00:00:00Z,14,5,2020,268,21,Philippines,PH,PHL,108116622,Asia,772,11618,60
2020-05-15T00:00:00Z,15,5,2020,258,18,Philippines,PH,PHL,108116622,Asia,790,11876,61
2020-05-16T00:00:00Z,16,5,2020,215,16,Philippines,PH,PHL,108116622,Asia,806,12091,62
2020-05-17T00:00:00Z,17,5,2020,214,11,Philippines,PH,PHL,108116622,Asia,817,12305,63
2020-05-18T00:00:00Z,18,5,2020,208,7,Philippines,PH,PHL,108116622,Asia,824,12513,64
2020-05-19T00:00:00Z,19,5,2020,205,7,Philippines,PH,PHL,108116622,Asia,831,12718,65
2020-05-20T00:00:00Z,20,5,2020,224,6,Philippines,PH,PHL,108116622,Asia,837,12942,66
2020-05-21T00:00:00Z,21,5,2020,279,5,Philippines,PH,PHL,108116622,Asia,842,13221,67
2020-05-22T00:00:00Z,22,5,2020,213,4,Philippines,PH,PHL,108116622,Asia,846,13434,68
2020-05-23T00:00:00Z,23,5,2020,163,11,Philippines,PH,PHL,108116622,Asia,857,13597,69
2020-05-24T00:00:00Z,24,5,2020,180,6,Philippines,PH,PHL,108116622,Asia,863,13777,70
2020-05-25T00:00:00Z,25,5,2020,258,5,Philippines,PH,PHL,108116622,Asia,868,14035,71
2020-05-26T00:00:00Z,26,5,2020,284,5,Philippines,PH,PHL,108116622,Asia,873,14319,72
2020-05-27T00:00:00Z,27,5,2020,350,13,Philippines,PH,PHL,108116622,Asia,886,14669,73
2020-05-28T00:00:00Z,28,5,2020,380,18,Philippines,PH,PHL,108116622,Asia,904,15049,74
2020-05-29T00:00:00Z,29,5,2020,539,17,Philippines,PH,PHL,108116622,Asia,921,15588,75
2020-05-30T00:00:00Z,30,5,2020,1046,21,Philippines,PH,PHL,108116622,Asia,942,16634,76
2020-05-31T00:00:00Z,31,5,2020,590,8,Philippines,PH,PHL,108116622,Asia,950,17224,77
2020-06-01T00:00:00Z,1,6,2020,862,7,Philippines,PH,PHL,108116622,Asia,957,18086,78
2020-06-02T00:00:00Z,2,6,2020,552,3,Philippines,PH,PHL,108116622,Asia,960,18638,79
2020-06-03T00:00:00Z,3,6,2020,359,6,Philippines,PH,PHL,108116622,Asia,966,18997,80
2020-06-04T00:00:00Z,4,6,2020,751,8,Philippines,PH,PHL,108116622,Asia,974,19748,81
2020-06-05T00:00:00Z,5,6,2020,634,10,Philippines,PH,PHL,108116622,Asia,984,20382,82
2020-06-06T00:00:00Z,6,6,2020,244,3,Philippines,PH,PHL,108116622,Asia,987,20626,83
2020-06-07T00:00:00Z,7,6,2020,714,7,Philippines,PH,PHL,108116622,Asia,994,21340,84
2020-06-08T00:00:00Z,8,6,2020,555,9,Philippines,PH,PHL,108116622,Asia,1003,21895,85
2020-06-09T00:00:00Z,9,6,2020,579,8,Philippines,PH,PHL,108116622,Asia,1011,22474,86
2020-06-10T00:00:00Z,10,6,2020,518,6,Philippines,PH,PHL,108116622,Asia,1017,22992,87
2020-06-11T00:00:00Z,11,6,2020,740,10,Philippines,PH,PHL,108116622,Asia,1027,23732,88
2020-06-12T00:00:00Z,12,6,2020,443,9,Philippines,PH,PHL,108116622,Asia,1036,24175,89
2020-06-13T00:00:00Z,13,6,2020,612,16,Philippines,PH,PHL,108116622,Asia,1052,24787,90
2020-06-14T00:00:00Z,14,6,2020,605,22,Philippines,PH,PHL,108116622,Asia,1074,25392,91
2020-06-15T00:00:00Z,15,6,2020,538,14,Philippines,PH,PHL,108116622,Asia,1088,25930,92
2020-06-16T00:00:00Z,16,6,2020,490,10,Philippines,PH,PHL,108116622,Asia,1098,26420,93
2020-06-17T00:00:00Z,17,6,2020,361,5,Philippines,PH,PHL,108116622,Asia,1103,26781,94
2020-06-18T00:00:00Z,18,6,2020,457,5,Philippines,PH,PHL,108116622,Asia,1108,27238,95
2020-06-19T00:00:00Z,19,6,2020,561,8,Philippines,PH,PHL,108116622,Asia,1116,27799,96
2020-06-20T00:00:00Z,20,6,2020,660,14,Philippines,PH,PHL,108116622,Asia,1130,28459,97
2020-06-21T00:00:00Z,21,6,2020,941,20,Philippines,PH,PHL,108116622,Asia,1150,29400,98
2020-06-22T00:00:00Z,22,6,2020,652,19,Philippines,PH,PHL,108116622,Asia,1169,30052,99
2020-06-23T00:00:00Z,23,6,2020,630,8,Philippines,PH,PHL,108116622,Asia,1177,30682,100
2020-06-24T00:00:00Z,24,6,2020,1143,9,Philippines,PH,PHL,108116622,Asia,1186,31825,101
2020-06-25T00:00:00Z,25,6,2020,470,18,Philippines,PH,PHL,108116622,Asia,1204,32295,102
2020-03-25T00:00:00Z,25,3,2020,152,2,Poland,PL,POL,37972812,Europe,10,901,1
2020-03-26T00:00:00Z,26,3,2020,150,4,Poland,PL,POL,37972812,Europe,14,1051,2
2020-03-27T00:00:00Z,27,3,2020,170,2,Poland,PL,POL,37972812,Europe,16,1221,3
2020-03-28T00:00:00Z,28,3,2020,168,0,Poland,PL,POL,37972812,Europe,16,1389,4
2020-03-29T00:00:00Z,29,3,2020,249,2,Poland,PL,POL,37972812,Europe,18,1638,5
2020-03-30T00:00:00Z,30,3,2020,224,4,Poland,PL,POL,37972812,Europe,22,1862,6
2020-03-31T00:00:00Z,31,3,2020,193,9,Poland,PL,POL,37972812,Europe,31,2055,7
2020-04-01T00:00:00Z,1,4,2020,256,2,Poland,PL,POL,37972812,Europe,33,2311,8
2020-04-02T00:00:00Z,2,4,2020,243,10,Poland,PL,POL,37972812,Europe,43,2554,9
2020-04-03T00:00:00Z,3,4,2020,392,14,Poland,PL,POL,37972812,Europe,57,2946,10
2020-04-04T00:00:00Z,4,4,2020,437,14,Poland,PL,POL,37972812,Europe,71,3383,11
2020-04-05T00:00:00Z,5,4,2020,244,8,Poland,PL,POL,37972812,Europe,79,3627,12
2020-04-06T00:00:00Z,6,4,2020,475,15,Poland,PL,POL,37972812,Europe,94,4102,13
2020-04-07T00:00:00Z,7,4,2020,311,13,Poland,PL,POL,37972812,Europe,107,4413,14
2020-04-08T00:00:00Z,8,4,2020,435,22,Poland,PL,POL,37972812,Europe,129,4848,15
2020-04-09T00:00:00Z,9,4,2020,357,30,Poland,PL,POL,37972812,Europe,159,5205,16
2020-04-10T00:00:00Z,10,4,2020,370,15,Poland,PL,POL,37972812,Europe,174,5575,17
2020-04-11T00:00:00Z,11,4,2020,380,7,Poland,PL,POL,37972812,Europe,181,5955,18
2020-04-12T00:00:00Z,12,4,2020,401,27,Poland,PL,POL,37972812,Europe,208,6356,19
2020-04-13T00:00:00Z,13,4,2020,318,24,Poland,PL,POL,37972812,Europe,232,6674,20
2020-04-14T00:00:00Z,14,4,2020,260,13,Poland,PL,POL,37972812,Europe,245,6934,21
2020-04-15T00:00:00Z,15,4,2020,268,18,Poland,PL,POL,37972812,Europe,263,7202,22
2020-04-16T00:00:00Z,16,4,2020,380,23,Poland,PL,POL,37972812,Europe,286,7582,23
2020-04-17T00:00:00Z,17,4,2020,336,28,Poland,PL,POL,37972812,Europe,314,7918,24
2020-04-18T00:00:00Z,18,4,2020,461,18,Poland,PL,POL,37972812,Europe,332,8379,25
2020-04-19T00:00:00Z,19,4,2020,363,15,Poland,PL,POL,37972812,Europe,347,8742,26
2020-04-20T00:00:00Z,20,4,2020,545,13,Poland,PL,POL,37972812,Europe,360,9287,27
2020-04-21T00:00:00Z,21,4,2020,306,20,Poland,PL,POL,37972812,Europe,380,9593,28
2020-04-22T00:00:00Z,22,4,2020,263,21,Poland,PL,POL,37972812,Europe,401,9856,29
2020-04-23T00:00:00Z,23,4,2020,313,25,Poland,PL,POL,37972812,Europe,426,10169,30
2020-04-24T00:00:00Z,24,4,2020,342,28,Poland,PL,POL,37972812,Europe,454,10511,31
2020-04-25T00:00:00Z,25,4,2020,381,40,Poland,PL,POL,37972812,Europe,494,10892,32
2020-04-26T00:00:00Z,26,4,2020,381,30,Poland,PL,POL,37972812,Europe,524,11273,33
2020-04-27T00:00:00Z,27,4,2020,344,11,Poland,PL,POL,37972812,Europe,535,11617,34
2020-04-28T00:00:00Z,28,4,2020,285,27,Poland,PL,POL,37972812,Europe,562,11902,35
2020-04-29T00:00:00Z,29,4,2020,316,34,Poland,PL,POL,37972812,Europe,596,12218,36
2020-04-30T00:00:00Z,30,4,2020,422,28,Poland,PL,POL,37972812,Europe,624,12640,37
2020-05-01T00:00:00Z,1,5,2020,237,20,Poland,PL,POL,37972812,Europe,644,12877,38
2020-05-02T00:00:00Z,2,5,2020,228,7,Poland,PL,POL,37972812,Europe,651,13105,39
2020-05-03T00:00:00Z,3,5,2020,270,13,Poland,PL,POL,37972812,Europe,664,13375,40
2020-05-04T00:00:00Z,4,5,2020,318,14,Poland,PL,POL,37972812,Europe,678,13693,41
2020-05-05T00:00:00Z,5,5,2020,313,20,Poland,PL,POL,37972812,Europe,698,14006,42
2020-05-06T00:00:00Z,6,5,2020,425,18,Poland,PL,POL,37972812,Europe,716,14431,43
2020-05-07T00:00:00Z,7,5,2020,309,17,Poland,PL,POL,37972812,Europe,733,14740,44
2020-05-08T00:00:00Z,8,5,2020,307,22,Poland,PL,POL,37972812,Europe,755,15047,45
2020-05-09T00:00:00Z,9,5,2020,319,21,Poland,PL,POL,37972812,Europe,776,15366,46
2020-05-10T00:00:00Z,10,5,2020,285,9,Poland,PL,POL,37972812,Europe,785,15651,47
2020-05-11T00:00:00Z,11,5,2020,345,15,Poland,PL,POL,37972812,Europe,800,15996,48
2020-05-12T00:00:00Z,12,5,2020,330,11,Poland,PL,POL,37972812,Europe,811,16326,49
2020-05-13T00:00:00Z,13,5,2020,595,28,Poland,PL,POL,37972812,Europe,839,16921,50
2020-05-14T00:00:00Z,14,5,2020,283,22,Poland,PL,POL,37972812,Europe,861,17204,51
2020-05-15T00:00:00Z,15,5,2020,411,22,Poland,PL,POL,37972812,Europe,883,17615,52
2020-05-16T00:00:00Z,16,5,2020,401,24,Poland,PL,POL,37972812,Europe,907,18016,53
2020-05-17T00:00:00Z,17,5,2020,241,8,Poland,PL,POL,37972812,Europe,915,18257,54
2020-05-18T00:00:00Z,18,5,2020,272,10,Poland,PL,POL,37972812,Europe,925,18529,55
2020-05-19T00:00:00Z,19,5,2020,356,11,Poland,PL,POL,37972812,Europe,936,18885,56
2020-05-20T00:00:00Z,20,5,2020,383,12,Poland,PL,POL,37972812,Europe,948,19268,57
2020-05-21T00:00:00Z,21,5,2020,471,14,Poland,PL,POL,37972812,Europe,962,19739,58
2020-05-22T00:00:00Z,22,5,2020,404,10,Poland,PL,POL,37972812,Europe,972,20143,59
2020-05-23T00:00:00Z,23,5,2020,476,10,Poland,PL,POL,37972812,Europe,982,20619,60
2020-05-24T00:00:00Z,24,5,2020,312,11,Poland,PL,POL,37972812,Europe,993,20931,61
2020-05-25T00:00:00Z,25,5,2020,395,3,Poland,PL,POL,37972812,Europe,996,21326,62
2020-05-26T00:00:00Z,26,5,2020,305,11,Poland,PL,POL,37972812,Europe,1007,21631,63
2020-05-27T00:00:00Z,27,5,2020,443,17,Poland,PL,POL,37972812,Europe,1024,22074,64
2020-05-28T00:00:00Z,28,5,2020,399,4,Poland,PL,POL,37972812,Europe,1028,22473,65
2020-05-29T00:00:00Z,29,5,2020,352,10,Poland,PL,POL,37972812,Europe,1038,22825,66
2020-05-30T00:00:00Z,30,5,2020,330,13,Poland,PL,POL,37972812,Europe,1051,23155,67
2020-05-31T00:00:00Z,31,5,2020,416,10,Poland,PL,POL,37972812,Europe,1061,23571,68
2020-06-01T00:00:00Z,1,6,2020,215,3,Poland,PL,POL,37972812,Europe,1064,23786,69
2020-06-02T00:00:00Z,2,6,2020,379,10,Poland,PL,POL,37972812,Europe,1074,24165,70
2020-06-03T00:00:00Z,3,6,2020,230,18,Poland,PL,POL,37972812,Europe,1092,24395,71
2020-06-04T00:00:00Z,4,6,2020,0,0,Poland,PL,POL,37972812,Europe,1092,24395,72
2020-06-05T00:00:00Z,5,6,2020,653,25,Poland,PL,POL,37972812,Europe,1117,25048,73
2020-06-06T00:00:00Z,6,6,2020,371,20,Poland,PL,POL,37972812,Europe,1137,25419,74
2020-06-07T00:00:00Z,7,6,2020,567,16,Poland,PL,POL,37972812,Europe,1153,25986,75
2020-06-08T00:00:00Z,8,6,2020,575,4,Poland,PL,POL,37972812,Europe,1157,26561,76
2020-06-09T00:00:00Z,9,6,2020,599,9,Poland,PL,POL,37972812,Europe,1166,27160,77
2020-06-10T00:00:00Z,10,6,2020,400,17,Poland,PL,POL,37972812,Europe,1183,27560,78
2020-06-11T00:00:00Z,11,6,2020,197,23,Poland,PL,POL,37972812,Europe,1206,27757,79
2020-06-12T00:00:00Z,12,6,2020,444,9,Poland,PL,POL,37972812,Europe,1215,28201,80
2020-06-13T00:00:00Z,13,6,2020,376,7,Poland,PL,POL,37972812,Europe,1222,28577,81
2020-06-14T00:00:00Z,14,6,2020,440,15,Poland,PL,POL,37972812,Europe,1237,29017,82
2020-06-15T00:00:00Z,15,6,2020,375,10,Poland,PL,POL,37972812,Europe,1247,29392,83
2020-06-16T00:00:00Z,16,6,2020,396,9,Poland,PL,POL,37972812,Europe,1256,29788,84
2020-06-17T00:00:00Z,17,6,2020,407,16,Poland,PL,POL,37972812,Europe,1272,30195,85
2020-06-18T00:00:00Z,18,6,2020,506,14,Poland,PL,POL,37972812,Europe,1286,30701,86
2020-06-19T00:00:00Z,19,6,2020,314,30,Poland,PL,POL,37972812,Europe,1316,31015,87
2020-06-20T00:00:00Z,20,6,2020,301,18,Poland,PL,POL,37972812,Europe,1334,31316,88
2020-06-21T00:00:00Z,21,6,2020,304,12,Poland,PL,POL,37972812,Europe,1346,31620,89
2020-06-22T00:00:00Z,22,6,2020,311,10,Poland,PL,POL,37972812,Europe,1356,31931,90
2020-06-23T00:00:00Z,23,6,2020,296,3,Poland,PL,POL,37972812,Europe,1359,32227,91
2020-06-24T00:00:00Z,24,6,2020,300,16,Poland,PL,POL,37972812,Europe,1375,32527,92
2020-06-25T00:00:00Z,25,6,2020,294,21,Poland,PL,POL,37972812,Europe,1396,32821,93
2020-03-22T00:00:00Z,22,3,2020,260,6,Portugal,PT,PRT,10276617,Europe,12,1280,1
2020-03-23T00:00:00Z,23,3,2020,320,2,Portugal,PT,PRT,10276617,Europe,14,1600,2
2020-03-24T00:00:00Z,24,3,2020,460,9,Portugal,PT,PRT,10276617,Europe,23,2060,3
2020-03-25T00:00:00Z,25,3,2020,302,10,Portugal,PT,PRT,10276617,Europe,33,2362,4
2020-03-26T00:00:00Z,26,3,2020,633,10,Portugal,PT,PRT,10276617,Europe,43,2995,5
2020-03-27T00:00:00Z,27,3,2020,549,17,Portugal,PT,PRT,10276617,Europe,60,3544,6
2020-03-28T00:00:00Z,28,3,2020,724,16,Portugal,PT,PRT,10276617,Europe,76,4268,7
2020-03-29T00:00:00Z,29,3,2020,902,24,Portugal,PT,PRT,10276617,Europe,100,5170,8
2020-03-30T00:00:00Z,30,3,2020,792,19,Portugal,PT,PRT,10276617,Europe,119,5962,9
2020-03-31T00:00:00Z,31,3,2020,446,21,Portugal,PT,PRT,10276617,Europe,140,6408,10
2020-04-01T00:00:00Z,1,4,2020,1035,20,Portugal,PT,PRT,10276617,Europe,160,7443,11
2020-04-02T00:00:00Z,2,4,2020,808,27,Portugal,PT,PRT,10276617,Europe,187,8251,12
2020-04-03T00:00:00Z,3,4,2020,783,22,Portugal,PT,PRT,10276617,Europe,209,9034,13
2020-04-04T00:00:00Z,4,4,2020,852,37,Portugal,PT,PRT,10276617,Europe,246,9886,14
2020-04-05T00:00:00Z,5,4,2020,638,20,Portugal,PT,PRT,10276617,Europe,266,10524,15
2020-04-06T00:00:00Z,6,4,2020,754,29,Portugal,PT,PRT,10276617,Europe,295,11278,16
2020-04-07T00:00:00Z,7,4,2020,452,16,Portugal,PT,PRT,10276617,Europe,311,11730,17
2020-04-08T00:00:00Z,8,4,2020,712,34,Portugal,PT,PRT,10276617,Europe,345,12442,18
2020-04-09T00:00:00Z,9,4,2020,699,35,Portugal,PT,PRT,10276617,Europe,380,13141,19
2020-04-10T00:00:00Z,10,4,2020,815,29,Portugal,PT,PRT,10276617,Europe,409,13956,20
2020-04-11T00:00:00Z,11,4,2020,1516,26,Portugal,PT,PRT,10276617,Europe,435,15472,21
2020-04-12T00:00:00Z,12,4,2020,515,35,Portugal,PT,PRT,10276617,Europe,470,15987,22
2020-04-13T00:00:00Z,13,4,2020,598,34,Portugal,PT,PRT,10276617,Europe,504,16585,23
2020-04-14T00:00:00Z,14,4,2020,349,31,Portugal,PT,PRT,10276617,Europe,535,16934,24
2020-04-15T00:00:00Z,15,4,2020,514,32,Portugal,PT,PRT,10276617,Europe,567,17448,25
2020-04-16T00:00:00Z,16,4,2020,643,32,Portugal,PT,PRT,10276617,Europe,599,18091,26
2020-04-17T00:00:00Z,17,4,2020,750,30,Portugal,PT,PRT,10276617,Europe,629,18841,27
2020-04-18T00:00:00Z,18,4,2020,181,28,Portugal,PT,PRT,10276617,Europe,657,19022,28
2020-04-19T00:00:00Z,19,4,2020,663,30,Portugal,PT,PRT,10276617,Europe,687,19685,29
2020-04-20T00:00:00Z,20,4,2020,521,27,Portugal,PT,PRT,10276617,Europe,714,20206,30
2020-04-21T00:00:00Z,21,4,2020,657,21,Portugal,PT,PRT,10276617,Europe,735,20863,31
2020-04-22T00:00:00Z,22,4,2020,516,27,Portugal,PT,PRT,10276617,Europe,762,21379,32
2020-04-23T00:00:00Z,23,4,2020,603,23,Portugal,PT,PRT,10276617,Europe,785,21982,33
2020-04-24T00:00:00Z,24,4,2020,371,35,Portugal,PT,PRT,10276617,Europe,820,22353,34
2020-04-25T00:00:00Z,25,4,2020,918,60,Portugal,PT,PRT,10276617,Europe,880,23271,35
2020-04-26T00:00:00Z,26,4,2020,412,23,Portugal,PT,PRT,10276617,Europe,903,23683,36
2020-04-27T00:00:00Z,27,4,2020,163,25,Portugal,PT,PRT,10276617,Europe,928,23846,37
2020-04-28T00:00:00Z,28,4,2020,298,20,Portugal,PT,PRT,10276617,Europe,948,24144,38
2020-04-29T00:00:00Z,29,4,2020,180,25,Portugal,PT,PRT,10276617,Europe,973,24324,39
2020-04-30T00:00:00Z,30,4,2020,368,16,Portugal,PT,PRT,10276617,Europe,989,24692,40
2020-05-01T00:00:00Z,1,5,2020,295,18,Portugal,PT,PRT,10276617,Europe,1007,24987,41
2020-05-02T00:00:00Z,2,5,2020,364,0,Portugal,PT,PRT,10276617,Europe,1007,25351,42
2020-05-03T00:00:00Z,3,5,2020,-161,16,Portugal,PT,PRT,10276617,Europe,1023,25190,43
2020-05-04T00:00:00Z,4,5,2020,334,40,Portugal,PT,PRT,10276617,Europe,1063,25524,44
2020-05-05T00:00:00Z,5,5,2020,0,0,Portugal,PT,PRT,10276617,Europe,1063,25524,45
2020-05-06T00:00:00Z,6,5,2020,178,11,Portugal,PT,PRT,10276617,Europe,1074,25702,46
2020-05-07T00:00:00Z,7,5,2020,480,15,Portugal,PT,PRT,10276617,Europe,1089,26182,47
2020-05-08T00:00:00Z,8,5,2020,533,16,Portugal,PT,PRT,10276617,Europe,1105,26715,48
2020-05-09T00:00:00Z,9,5,2020,553,9,Portugal,PT,PRT,10276617,Europe,1114,27268,49
2020-05-10T00:00:00Z,10,5,2020,138,12,Portugal,PT,PRT,10276617,Europe,1126,27406,50
2020-05-11T00:00:00Z,11,5,2020,175,9,Portugal,PT,PRT,10276617,Europe,1135,27581,51
2020-05-12T00:00:00Z,12,5,2020,98,9,Portugal,PT,PRT,10276617,Europe,1144,27679,52
2020-05-13T00:00:00Z,13,5,2020,234,19,Portugal,PT,PRT,10276617,Europe,1163,27913,53
2020-05-14T00:00:00Z,14,5,2020,219,12,Portugal,PT,PRT,10276617,Europe,1175,28132,54
2020-05-15T00:00:00Z,15,5,2020,187,9,Portugal,PT,PRT,10276617,Europe,1184,28319,55
2020-05-16T00:00:00Z,16,5,2020,264,6,Portugal,PT,PRT,10276617,Europe,1190,28583,56
2020-05-17T00:00:00Z,17,5,2020,227,13,Portugal,PT,PRT,10276617,Europe,1203,28810,57
2020-05-18T00:00:00Z,18,5,2020,226,15,Portugal,PT,PRT,10276617,Europe,1218,29036,58
2020-05-19T00:00:00Z,19,5,2020,173,13,Portugal,PT,PRT,10276617,Europe,1231,29209,59
2020-05-20T00:00:00Z,20,5,2020,223,16,Portugal,PT,PRT,10276617,Europe,1247,29432,60
2020-05-21T00:00:00Z,21,5,2020,228,16,Portugal,PT,PRT,10276617,Europe,1263,29660,61
2020-05-22T00:00:00Z,22,5,2020,252,14,Portugal,PT,PRT,10276617,Europe,1277,29912,62
2020-05-23T00:00:00Z,23,5,2020,288,12,Portugal,PT,PRT,10276617,Europe,1289,30200,63
2020-05-24T00:00:00Z,24,5,2020,271,13,Portugal,PT,PRT,10276617,Europe,1302,30471,64
2020-05-25T00:00:00Z,25,5,2020,152,14,Portugal,PT,PRT,10276617,Europe,1316,30623,65
2020-05-26T00:00:00Z,26,5,2020,165,14,Portugal,PT,PRT,10276617,Europe,1330,30788,66
2020-05-27T00:00:00Z,27,5,2020,219,12,Portugal,PT,PRT,10276617,Europe,1342,31007,67
2020-05-28T00:00:00Z,28,5,2020,285,14,Portugal,PT,PRT,10276617,Europe,1356,31292,68
2020-05-29T00:00:00Z,29,5,2020,304,13,Portugal,PT,PRT,10276617,Europe,1369,31596,69
2020-05-30T00:00:00Z,30,5,2020,350,14,Portugal,PT,PRT,10276617,Europe,1383,31946,70
2020-05-31T00:00:00Z,31,5,2020,257,13,Portugal,PT,PRT,10276617,Europe,1396,32203,71
2020-06-01T00:00:00Z,1,6,2020,297,14,Portugal,PT,PRT,10276617,Europe,1410,32500,72
2020-06-02T00:00:00Z,2,6,2020,200,14,Portugal,PT,PRT,10276617,Europe,1424,32700,73
2020-06-03T00:00:00Z,3,6,2020,195,12,Portugal,PT,PRT,10276617,Europe,1436,32895,74
2020-06-04T00:00:00Z,4,6,2020,366,11,Portugal,PT,PRT,10276617,Europe,1447,33261,75
2020-06-05T00:00:00Z,5,6,2020,331,8,Portugal,PT,PRT,10276617,Europe,1455,33592,76
2020-06-06T00:00:00Z,6,6,2020,377,10,Portugal,PT,PRT,10276617,Europe,1465,33969,77
2020-06-07T00:00:00Z,7,6,2020,382,9,Portugal,PT,PRT,10276617,Europe,1474,34351,78
2020-06-08T00:00:00Z,8,6,2020,142,5,Portugal,PT,PRT,10276617,Europe,1479,34493,79
2020-06-09T00:00:00Z,9,6,2020,392,6,Portugal,PT,PRT,10276617,Europe,1485,34885,80
2020-06-10T00:00:00Z,10,6,2020,421,7,Portugal,PT,PRT,10276617,Europe,1492,35306,81
2020-06-11T00:00:00Z,11,6,2020,294,3,Portugal,PT,PRT,10276617,Europe,1495,35600,82
2020-06-12T00:00:00Z,12,6,2020,310,9,Portugal,PT,PRT,10276617,Europe,1504,35910,83
2020-06-13T00:00:00Z,13,6,2020,270,1,Portugal,PT,PRT,10276617,Europe,1505,36180,84
2020-06-14T00:00:00Z,14,6,2020,283,7,Portugal,PT,PRT,10276617,Europe,1512,36463,85
2020-06-15T00:00:00Z,15,6,2020,227,5,Portugal,PT,PRT,10276617,Europe,1517,36690,86
2020-06-16T00:00:00Z,16,6,2020,346,3,Portugal,PT,PRT,10276617,Europe,1520,37036,87
2020-06-17T00:00:00Z,17,6,2020,300,2,Portugal,PT,PRT,10276617,Europe,1522,37336,88
2020-06-18T00:00:00Z,18,6,2020,336,1,Portugal,PT,PRT,10276617,Europe,1523,37672,89
2020-06-19T00:00:00Z,19,6,2020,417,1,Portugal,PT,PRT,10276617,Europe,1524,38089,90
2020-06-20T00:00:00Z,20,6,2020,375,3,Portugal,PT,PRT,10276617,Europe,1527,38464,91
2020-06-21T00:00:00Z,21,6,2020,377,1,Portugal,PT,PRT,10276617,Europe,1528,38841,92
2020-06-22T00:00:00Z,22,6,2020,292,2,Portugal,PT,PRT,10276617,Europe,1530,39133,93
2020-06-23T00:00:00Z,23,6,2020,259,4,Portugal,PT,PRT,10276617,Europe,1534,39392,94
2020-06-24T00:00:00Z,24,6,2020,345,6,Portugal,PT,PRT,10276617,Europe,1540,39737,95
2020-06-25T00:00:00Z,25,6,2020,367,3,Portugal,PT,PRT,10276617,Europe,1543,40104,96
2020-04-02T00:00:00Z,2,4,2020,47,3,Puerto_Rico,PR,PRI,2933404,America,11,286,1
2020-04-03T00:00:00Z,3,4,2020,30,1,Puerto_Rico,PR,PRI,2933404,America,12,316,2
2020-04-04T00:00:00Z,4,4,2020,62,3,Puerto_Rico,PR,PRI,2933404,America,15,378,3
2020-04-05T00:00:00Z,5,4,2020,74,3,Puerto_Rico,PR,PRI,2933404,America,18,452,4
2020-04-06T00:00:00Z,6,4,2020,23,2,Puerto_Rico,PR,PRI,2933404,America,20,475,5
2020-04-07T00:00:00Z,7,4,2020,38,1,Puerto_Rico,PR,PRI,2933404,America,21,513,6
2020-04-08T00:00:00Z,8,4,2020,60,2,Puerto_Rico,PR,PRI,2933404,America,23,573,7
2020-04-09T00:00:00Z,9,4,2020,47,1,Puerto_Rico,PR,PRI,2933404,America,24,620,8
2020-04-10T00:00:00Z,10,4,2020,63,9,Puerto_Rico,PR,PRI,2933404,America,33,683,9
2020-04-11T00:00:00Z,11,4,2020,42,6,Puerto_Rico,PR,PRI,2933404,America,39,725,10
2020-04-12T00:00:00Z,12,4,2020,63,3,Puerto_Rico,PR,PRI,2933404,America,42,788,11
2020-04-13T00:00:00Z,13,4,2020,109,2,Puerto_Rico,PR,PRI,2933404,America,44,897,12
2020-04-14T00:00:00Z,14,4,2020,6,1,Puerto_Rico,PR,PRI,2933404,America,45,903,13
2020-04-15T00:00:00Z,15,4,2020,20,0,Puerto_Rico,PR,PRI,2933404,America,45,923,14
2020-04-16T00:00:00Z,16,4,2020,51,6,Puerto_Rico,PR,PRI,2933404,America,51,974,15
2020-04-17T00:00:00Z,17,4,2020,69,5,Puerto_Rico,PR,PRI,2933404,America,56,1043,16
2020-04-18T00:00:00Z,18,4,2020,25,2,Puerto_Rico,PR,PRI,2933404,America,58,1068,17
2020-04-19T00:00:00Z,19,4,2020,50,2,Puerto_Rico,PR,PRI,2933404,America,60,1118,18
2020-04-20T00:00:00Z,20,4,2020,95,2,Puerto_Rico,PR,PRI,2933404,America,62,1213,19
2020-04-21T00:00:00Z,21,4,2020,39,1,Puerto_Rico,PR,PRI,2933404,America,63,1252,20
2020-04-22T00:00:00Z,22,4,2020,0,0,Puerto_Rico,PR,PRI,2933404,America,63,1252,21
2020-04-23T00:00:00Z,23,4,2020,0,1,Puerto_Rico,PR,PRI,2933404,America,64,1252,22
2020-04-24T00:00:00Z,24,4,2020,0,5,Puerto_Rico,PR,PRI,2933404,America,69,1252,23
2020-04-25T00:00:00Z,25,4,2020,24,8,Puerto_Rico,PR,PRI,2933404,America,77,1276,24
2020-04-26T00:00:00Z,26,4,2020,31,6,Puerto_Rico,PR,PRI,2933404,America,83,1307,25
2020-04-27T00:00:00Z,27,4,2020,64,1,Puerto_Rico,PR,PRI,2933404,America,84,1371,26
2020-04-28T00:00:00Z,28,4,2020,18,0,Puerto_Rico,PR,PRI,2933404,America,84,1389,27
2020-04-29T00:00:00Z,29,4,2020,11,2,Puerto_Rico,PR,PRI,2933404,America,86,1400,28
2020-04-30T00:00:00Z,30,4,2020,33,0,Puerto_Rico,PR,PRI,2933404,America,86,1433,29
2020-05-01T00:00:00Z,1,5,2020,106,6,Puerto_Rico,PR,PRI,2933404,America,92,1539,30
2020-05-02T00:00:00Z,2,5,2020,36,2,Puerto_Rico,PR,PRI,2933404,America,94,1575,31
2020-05-03T00:00:00Z,3,5,2020,182,1,Puerto_Rico,PR,PRI,2933404,America,95,1757,32
2020-05-04T00:00:00Z,4,5,2020,51,2,Puerto_Rico,PR,PRI,2933404,America,97,1808,33
2020-05-05T00:00:00Z,5,5,2020,35,0,Puerto_Rico,PR,PRI,2933404,America,97,1843,34
2020-05-06T00:00:00Z,6,5,2020,81,2,Puerto_Rico,PR,PRI,2933404,America,99,1924,35
2020-05-07T00:00:00Z,7,5,2020,44,0,Puerto_Rico,PR,PRI,2933404,America,99,1968,36
2020-05-08T00:00:00Z,8,5,2020,63,3,Puerto_Rico,PR,PRI,2933404,America,102,2031,37
2020-05-09T00:00:00Z,9,5,2020,125,5,Puerto_Rico,PR,PRI,2933404,America,107,2156,38
2020-05-10T00:00:00Z,10,5,2020,17,1,Puerto_Rico,PR,PRI,2933404,America,108,2173,39
2020-05-11T00:00:00Z,11,5,2020,25,3,Puerto_Rico,PR,PRI,2933404,America,111,2198,40
2020-05-12T00:00:00Z,12,5,2020,58,2,Puerto_Rico,PR,PRI,2933404,America,113,2256,41
2020-05-13T00:00:00Z,13,5,2020,43,1,Puerto_Rico,PR,PRI,2933404,America,114,2299,42
2020-05-14T00:00:00Z,14,5,2020,30,1,Puerto_Rico,PR,PRI,2933404,America,115,2329,43
2020-05-15T00:00:00Z,15,5,2020,98,2,Puerto_Rico,PR,PRI,2933404,America,117,2427,44
2020-05-16T00:00:00Z,16,5,2020,115,5,Puerto_Rico,PR,PRI,2933404,America,122,2542,45
2020-05-17T00:00:00Z,17,5,2020,47,0,Puerto_Rico,PR,PRI,2933404,America,122,2589,46
2020-05-18T00:00:00Z,18,5,2020,57,1,Puerto_Rico,PR,PRI,2933404,America,123,2646,47
2020-05-19T00:00:00Z,19,5,2020,64,1,Puerto_Rico,PR,PRI,2933404,America,124,2710,48
2020-05-20T00:00:00Z,20,5,2020,95,0,Puerto_Rico,PR,PRI,2933404,America,124,2805,49
2020-05-21T00:00:00Z,21,5,2020,61,1,Puerto_Rico,PR,PRI,2933404,America,125,2866,50
2020-05-22T00:00:00Z,22,5,2020,47,1,Puerto_Rico,PR,PRI,2933404,America,126,2913,51
2020-05-23T00:00:00Z,23,5,2020,117,0,Puerto_Rico,PR,PRI,2933404,America,126,3030,52
2020-05-24T00:00:00Z,24,5,2020,70,1,Puerto_Rico,PR,PRI,2933404,America,127,3100,53
2020-05-25T00:00:00Z,25,5,2020,89,0,Puerto_Rico,PR,PRI,2933404,America,127,3189,54
2020-05-26T00:00:00Z,26,5,2020,71,2,Puerto_Rico,PR,PRI,2933404,America,129,3260,55
2020-05-27T00:00:00Z,27,5,2020,64,0,Puerto_Rico,PR,PRI,2933404,America,129,3324,56
2020-05-28T00:00:00Z,28,5,2020,73,0,Puerto_Rico,PR,PRI,2933404,America,129,3397,57
2020-05-29T00:00:00Z,29,5,2020,89,2,Puerto_Rico,PR,PRI,2933404,America,131,3486,58
2020-05-30T00:00:00Z,30,5,2020,161,1,Puerto_Rico,PR,PRI,2933404,America,132,3647,59
2020-05-31T00:00:00Z,31,5,2020,71,1,Puerto_Rico,PR,PRI,2933404,America,133,3718,60
2020-06-01T00:00:00Z,1,6,2020,58,3,Puerto_Rico,PR,PRI,2933404,America,136,3776,61
2020-06-02T00:00:00Z,2,6,2020,97,0,Puerto_Rico,PR,PRI,2933404,America,136,3873,62
2020-06-03T00:00:00Z,3,6,2020,62,2,Puerto_Rico,PR,PRI,2933404,America,138,3935,63
2020-06-04T00:00:00Z,4,6,2020,88,2,Puerto_Rico,PR,PRI,2933404,America,140,4023,64
2020-06-05T00:00:00Z,5,6,2020,485,0,Puerto_Rico,PR,PRI,2933404,America,140,4508,65
2020-06-06T00:00:00Z,6,6,2020,112,1,Puerto_Rico,PR,PRI,2933404,America,141,4620,66
2020-06-07T00:00:00Z,7,6,2020,295,1,Puerto_Rico,PR,PRI,2933404,America,142,4915,67
2020-06-08T00:00:00Z,8,6,2020,70,0,Puerto_Rico,PR,PRI,2933404,America,142,4985,68
2020-06-09T00:00:00Z,9,6,2020,61,0,Puerto_Rico,PR,PRI,2933404,America,142,5046,69
2020-06-10T00:00:00Z,10,6,2020,139,0,Puerto_Rico,PR,PRI,2933404,America,142,5185,70
2020-06-11T00:00:00Z,11,6,2020,144,1,Puerto_Rico,PR,PRI,2933404,America,143,5329,71
2020-06-12T00:00:00Z,12,6,2020,23,1,Puerto_Rico,PR,PRI,2933404,America,144,5352,72
2020-06-13T00:00:00Z,13,6,2020,184,2,Puerto_Rico,PR,PRI,2933404,America,146,5536,73
2020-06-14T00:00:00Z,14,6,2020,154,0,Puerto_Rico,PR,PRI,2933404,America,146,5690,74
2020-06-15T00:00:00Z,15,6,2020,121,1,Puerto_Rico,PR,PRI,2933404,America,147,5811,75
2020-06-16T00:00:00Z,16,6,2020,79,0,Puerto_Rico,PR,PRI,2933404,America,147,5890,76
2020-06-17T00:00:00Z,17,6,2020,61,0,Puerto_Rico,PR,PRI,2933404,America,147,5951,77
2020-06-18T00:00:00Z,18,6,2020,52,0,Puerto_Rico,PR,PRI,2933404,America,147,6003,78
2020-06-19T00:00:00Z,19,6,2020,108,0,Puerto_Rico,PR,PRI,2933404,America,147,6111,79
2020-06-20T00:00:00Z,20,6,2020,0,0,Puerto_Rico,PR,PRI,2933404,America,147,6111,80
2020-06-21T00:00:00Z,21,6,2020,352,0,Puerto_Rico,PR,PRI,2933404,America,147,6463,81
2020-06-22T00:00:00Z,22,6,2020,62,2,Puerto_Rico,PR,PRI,2933404,America,149,6525,82
2020-06-23T00:00:00Z,23,6,2020,39,0,Puerto_Rico,PR,PRI,2933404,America,149,6564,83
2020-06-24T00:00:00Z,24,6,2020,121,0,Puerto_Rico,PR,PRI,2933404,America,149,6685,84
2020-06-25T00:00:00Z,25,6,2020,135,0,Puerto_Rico,PR,PRI,2933404,America,149,6820,85
2020-04-23T00:00:00Z,23,4,2020,608,1,Qatar,QA,QAT,2832071,Asia,10,7141,1
2020-04-24T00:00:00Z,24,4,2020,623,0,Qatar,QA,QAT,2832071,Asia,10,7764,2
2020-04-25T00:00:00Z,25,4,2020,761,0,Qatar,QA,QAT,2832071,Asia,10,8525,3
2020-04-26T00:00:00Z,26,4,2020,833,0,Qatar,QA,QAT,2832071,Asia,10,9358,4
2020-04-27T00:00:00Z,27,4,2020,929,0,Qatar,QA,QAT,2832071,Asia,10,10287,5
2020-04-28T00:00:00Z,28,4,2020,957,0,Qatar,QA,QAT,2832071,Asia,10,11244,6
2020-04-29T00:00:00Z,29,4,2020,677,0,Qatar,QA,QAT,2832071,Asia,10,11921,7
2020-04-30T00:00:00Z,30,4,2020,643,0,Qatar,QA,QAT,2832071,Asia,10,12564,8
2020-05-01T00:00:00Z,1,5,2020,845,0,Qatar,QA,QAT,2832071,Asia,10,13409,9
2020-05-02T00:00:00Z,2,5,2020,687,2,Qatar,QA,QAT,2832071,Asia,12,14096,10
2020-05-03T00:00:00Z,3,5,2020,776,0,Qatar,QA,QAT,2832071,Asia,12,14872,11
2020-05-04T00:00:00Z,4,5,2020,679,0,Qatar,QA,QAT,2832071,Asia,12,15551,12
2020-05-05T00:00:00Z,5,5,2020,640,0,Qatar,QA,QAT,2832071,Asia,12,16191,13
2020-05-06T00:00:00Z,6,5,2020,951,0,Qatar,QA,QAT,2832071,Asia,12,17142,14
2020-05-07T00:00:00Z,7,5,2020,830,0,Qatar,QA,QAT,2832071,Asia,12,17972,15
2020-05-08T00:00:00Z,8,5,2020,918,0,Qatar,QA,QAT,2832071,Asia,12,18890,16
2020-05-09T00:00:00Z,9,5,2020,1311,0,Qatar,QA,QAT,2832071,Asia,12,20201,17
2020-05-10T00:00:00Z,10,5,2020,1130,1,Qatar,QA,QAT,2832071,Asia,13,21331,18
2020-05-11T00:00:00Z,11,5,2020,1189,1,Qatar,QA,QAT,2832071,Asia,14,22520,19
2020-05-12T00:00:00Z,12,5,2020,1103,0,Qatar,QA,QAT,2832071,Asia,14,23623,20
2020-05-13T00:00:00Z,13,5,2020,1526,0,Qatar,QA,QAT,2832071,Asia,14,25149,21
2020-05-14T00:00:00Z,14,5,2020,1390,0,Qatar,QA,QAT,2832071,Asia,14,26539,22
2020-05-15T00:00:00Z,15,5,2020,1733,0,Qatar,QA,QAT,2832071,Asia,14,28272,23
2020-05-16T00:00:00Z,16,5,2020,1153,0,Qatar,QA,QAT,2832071,Asia,14,29425,24
2020-05-17T00:00:00Z,17,5,2020,1547,1,Qatar,QA,QAT,2832071,Asia,15,30972,25
2020-05-18T00:00:00Z,18,5,2020,1632,0,Qatar,QA,QAT,2832071,Asia,15,32604,26
2020-05-19T00:00:00Z,19,5,2020,1365,0,Qatar,QA,QAT,2832071,Asia,15,33969,27
2020-05-20T00:00:00Z,20,5,2020,1637,0,Qatar,QA,QAT,2832071,Asia,15,35606,28
2020-05-21T00:00:00Z,21,5,2020,1491,1,Qatar,QA,QAT,2832071,Asia,16,37097,29
2020-05-22T00:00:00Z,22,5,2020,1554,1,Qatar,QA,QAT,2832071,Asia,17,38651,30
2020-05-23T00:00:00Z,23,5,2020,1830,2,Qatar,QA,QAT,2832071,Asia,19,40481,31
2020-05-24T00:00:00Z,24,5,2020,1732,2,Qatar,QA,QAT,2832071,Asia,21,42213,32
2020-05-25T00:00:00Z,25,5,2020,1501,2,Qatar,QA,QAT,2832071,Asia,23,43714,33
2020-05-26T00:00:00Z,26,5,2020,1751,3,Qatar,QA,QAT,2832071,Asia,26,45465,34
2020-05-27T00:00:00Z,27,5,2020,1742,2,Qatar,QA,QAT,2832071,Asia,28,47207,35
2020-05-28T00:00:00Z,28,5,2020,1740,2,Qatar,QA,QAT,2832071,Asia,30,48947,36
2020-05-29T00:00:00Z,29,5,2020,1967,3,Qatar,QA,QAT,2832071,Asia,33,50914,37
2020-05-30T00:00:00Z,30,5,2020,1993,3,Qatar,QA,QAT,2832071,Asia,36,52907,38
2020-05-31T00:00:00Z,31,5,2020,2355,0,Qatar,QA,QAT,2832071,Asia,36,55262,39
2020-06-01T00:00:00Z,1,6,2020,1648,2,Qatar,QA,QAT,2832071,Asia,38,56910,40
2020-06-02T00:00:00Z,2,6,2020,1523,2,Qatar,QA,QAT,2832071,Asia,40,58433,41
2020-06-03T00:00:00Z,3,6,2020,1826,3,Qatar,QA,QAT,2832071,Asia,43,60259,42
2020-06-04T00:00:00Z,4,6,2020,1901,2,Qatar,QA,QAT,2832071,Asia,45,62160,43
2020-06-05T00:00:00Z,5,6,2020,1581,0,Qatar,QA,QAT,2832071,Asia,45,63741,44
2020-06-06T00:00:00Z,6,6,2020,1754,4,Qatar,QA,QAT,2832071,Asia,49,65495,45
2020-06-07T00:00:00Z,7,6,2020,1700,2,Qatar,QA,QAT,2832071,Asia,51,67195,46
2020-06-08T00:00:00Z,8,6,2020,1595,3,Qatar,QA,QAT,2832071,Asia,54,68790,47
2020-06-09T00:00:00Z,9,6,2020,1368,3,Qatar,QA,QAT,2832071,Asia,57,70158,48
2020-06-10T00:00:00Z,10,6,2020,1721,5,Qatar,QA,QAT,2832071,Asia,62,71879,49
2020-06-11T00:00:00Z,11,6,2020,1716,4,Qatar,QA,QAT,2832071,Asia,66,73595,50
2020-06-12T00:00:00Z,12,6,2020,1476,3,Qatar,QA,QAT,2832071,Asia,69,75071,51
2020-06-13T00:00:00Z,13,6,2020,1517,1,Qatar,QA,QAT,2832071,Asia,70,76588,52
2020-06-14T00:00:00Z,14,6,2020,1828,0,Qatar,QA,QAT,2832071,Asia,70,78416,53
2020-06-15T00:00:00Z,15,6,2020,1186,3,Qatar,QA,QAT,2832071,Asia,73,79602,54
2020-06-16T00:00:00Z,16,6,2020,1274,3,Qatar,QA,QAT,2832071,Asia,76,80876,55
2020-06-17T00:00:00Z,17,6,2020,1201,4,Qatar,QA,QAT,2832071,Asia,80,82077,56
2020-06-18T00:00:00Z,18,6,2020,1097,2,Qatar,QA,QAT,2832071,Asia,82,83174,57
2020-06-19T00:00:00Z,19,6,2020,1267,4,Qatar,QA,QAT,2832071,Asia,86,84441,58
2020-06-20T00:00:00Z,20,6,2020,1021,7,Qatar,QA,QAT,2832071,Asia,93,85462,59
2020-06-21T00:00:00Z,21,6,2020,1026,1,Qatar,QA,QAT,2832071,Asia,94,86488,60
2020-06-22T00:00:00Z,22,6,2020,881,4,Qatar,QA,QAT,2832071,Asia,98,87369,61
2020-06-23T00:00:00Z,23,6,2020,1034,1,Qatar,QA,QAT,2832071,Asia,99,88403,62
2020-06-24T00:00:00Z,24,6,2020,1176,0,Qatar,QA,QAT,2832071,Asia,99,89579,63
2020-06-25T00:00:00Z,25,6,2020,1199,5,Qatar,QA,QAT,2832071,Asia,104,90778,64
2020-03-25T00:00:00Z,25,3,2020,186,4,Romania,RO,ROU,19414458,Europe,11,762,1
2020-03-26T00:00:00Z,26,3,2020,144,2,Romania,RO,ROU,19414458,Europe,13,906,2
2020-03-27T00:00:00Z,27,3,2020,123,4,Romania,RO,ROU,19414458,Europe,17,1029,3
2020-03-28T00:00:00Z,28,3,2020,263,7,Romania,RO,ROU,19414458,Europe,24,1292,4
2020-03-29T00:00:00Z,29,3,2020,160,5,Romania,RO,ROU,19414458,Europe,29,1452,5
2020-03-30T00:00:00Z,30,3,2020,308,11,Romania,RO,ROU,19414458,Europe,40,1760,6
2020-03-31T00:00:00Z,31,3,2020,192,4,Romania,RO,ROU,19414458,Europe,44,1952,7
2020-04-01T00:00:00Z,1,4,2020,293,25,Romania,RO,ROU,19414458,Europe,69,2245,8
2020-04-02T00:00:00Z,2,4,2020,215,16,Romania,RO,ROU,19414458,Europe,85,2460,9
2020-04-03T00:00:00Z,3,4,2020,278,9,Romania,RO,ROU,19414458,Europe,94,2738,10
2020-04-04T00:00:00Z,4,4,2020,445,39,Romania,RO,ROU,19414458,Europe,133,3183,11
2020-04-05T00:00:00Z,5,4,2020,430,8,Romania,RO,ROU,19414458,Europe,141,3613,12
2020-04-06T00:00:00Z,6,4,2020,251,7,Romania,RO,ROU,19414458,Europe,148,3864,13
2020-04-07T00:00:00Z,7,4,2020,193,9,Romania,RO,ROU,19414458,Europe,157,4057,14
2020-04-08T00:00:00Z,8,4,2020,360,25,Romania,RO,ROU,19414458,Europe,182,4417,15
2020-04-09T00:00:00Z,9,4,2020,344,27,Romania,RO,ROU,19414458,Europe,209,4761,16
2020-04-10T00:00:00Z,10,4,2020,441,20,Romania,RO,ROU,19414458,Europe,229,5202,17
2020-04-11T00:00:00Z,11,4,2020,265,28,Romania,RO,ROU,19414458,Europe,257,5467,18
2020-04-12T00:00:00Z,12,4,2020,523,25,Romania,RO,ROU,19414458,Europe,282,5990,19
2020-04-13T00:00:00Z,13,4,2020,310,24,Romania,RO,ROU,19414458,Europe,306,6300,20
2020-04-14T00:00:00Z,14,4,2020,333,12,Romania,RO,ROU,19414458,Europe,318,6633,21
2020-04-15T00:00:00Z,15,4,2020,246,26,Romania,RO,ROU,19414458,Europe,344,6879,22
2020-04-16T00:00:00Z,16,4,2020,337,28,Romania,RO,ROU,19414458,Europe,372,7216,23
2020-04-17T00:00:00Z,17,4,2020,491,15,Romania,RO,ROU,19414458,Europe,387,7707,24
2020-04-18T00:00:00Z,18,4,2020,360,13,Romania,RO,ROU,19414458,Europe,400,8067,25
2020-04-19T00:00:00Z,19,4,2020,351,17,Romania,RO,ROU,19414458,Europe,417,8418,26
2020-04-20T00:00:00Z,20,4,2020,328,17,Romania,RO,ROU,19414458,Europe,434,8746,27
2020-04-21T00:00:00Z,21,4,2020,190,17,Romania,RO,ROU,19414458,Europe,451,8936,28
2020-04-22T00:00:00Z,22,4,2020,306,32,Romania,RO,ROU,19414458,Europe,483,9242,29
2020-04-23T00:00:00Z,23,4,2020,468,25,Romania,RO,ROU,19414458,Europe,508,9710,30
2020-04-24T00:00:00Z,24,4,2020,386,19,Romania,RO,ROU,19414458,Europe,527,10096,31
2020-04-25T00:00:00Z,25,4,2020,321,25,Romania,RO,ROU,19414458,Europe,552,10417,32
2020-04-26T00:00:00Z,26,4,2020,218,23,Romania,RO,ROU,19414458,Europe,575,10635,33
2020-04-27T00:00:00Z,27,4,2020,401,33,Romania,RO,ROU,19414458,Europe,608,11036,34
2020-04-28T00:00:00Z,28,4,2020,303,23,Romania,RO,ROU,19414458,Europe,631,11339,35
2020-04-29T00:00:00Z,29,4,2020,277,19,Romania,RO,ROU,19414458,Europe,650,11616,36
2020-04-30T00:00:00Z,30,4,2020,362,25,Romania,RO,ROU,19414458,Europe,675,11978,37
2020-05-01T00:00:00Z,1,5,2020,262,42,Romania,RO,ROU,19414458,Europe,717,12240,38
2020-05-02T00:00:00Z,2,5,2020,327,27,Romania,RO,ROU,19414458,Europe,744,12567,39
2020-05-03T00:00:00Z,3,5,2020,165,27,Romania,RO,ROU,19414458,Europe,771,12732,40
2020-05-04T00:00:00Z,4,5,2020,431,9,Romania,RO,ROU,19414458,Europe,780,13163,41
2020-05-05T00:00:00Z,5,5,2020,349,23,Romania,RO,ROU,19414458,Europe,803,13512,42
2020-05-06T00:00:00Z,6,5,2020,325,24,Romania,RO,ROU,19414458,Europe,827,13837,43
2020-05-07T00:00:00Z,7,5,2020,270,31,Romania,RO,ROU,19414458,Europe,858,14107,44
2020-05-08T00:00:00Z,8,5,2020,392,18,Romania,RO,ROU,19414458,Europe,876,14499,45
2020-05-09T00:00:00Z,9,5,2020,312,22,Romania,RO,ROU,19414458,Europe,898,14811,46
2020-05-10T00:00:00Z,10,5,2020,320,28,Romania,RO,ROU,19414458,Europe,926,15131,47
2020-05-11T00:00:00Z,11,5,2020,231,26,Romania,RO,ROU,19414458,Europe,952,15362,48
2020-05-12T00:00:00Z,12,5,2020,226,20,Romania,RO,ROU,19414458,Europe,972,15588,49
2020-05-13T00:00:00Z,13,5,2020,190,30,Romania,RO,ROU,19414458,Europe,1002,15778,50
2020-05-14T00:00:00Z,14,5,2020,224,14,Romania,RO,ROU,19414458,Europe,1016,16002,51
2020-05-15T00:00:00Z,15,5,2020,245,30,Romania,RO,ROU,19414458,Europe,1046,16247,52
2020-05-16T00:00:00Z,16,5,2020,190,10,Romania,RO,ROU,19414458,Europe,1056,16437,53
2020-05-17T00:00:00Z,17,5,2020,267,25,Romania,RO,ROU,19414458,Europe,1081,16704,54
2020-05-18T00:00:00Z,18,5,2020,167,16,Romania,RO,ROU,19414458,Europe,1097,16871,55
2020-05-19T00:00:00Z,19,5,2020,165,10,Romania,RO,ROU,19414458,Europe,1107,17036,56
2020-05-20T00:00:00Z,20,5,2020,155,19,Romania,RO,ROU,19414458,Europe,1126,17191,57
2020-05-21T00:00:00Z,21,5,2020,196,15,Romania,RO,ROU,19414458,Europe,1141,17387,58
2020-05-22T00:00:00Z,22,5,2020,198,10,Romania,RO,ROU,19414458,Europe,1151,17585,59
2020-05-23T00:00:00Z,23,5,2020,127,8,Romania,RO,ROU,19414458,Europe,1159,17712,60
2020-05-24T00:00:00Z,24,5,2020,145,11,Romania,RO,ROU,19414458,Europe,1170,17857,61
2020-05-25T00:00:00Z,25,5,2020,213,9,Romania,RO,ROU,19414458,Europe,1179,18070,62
2020-05-26T00:00:00Z,26,5,2020,213,18,Romania,RO,ROU,19414458,Europe,1197,18283,63
2020-05-27T00:00:00Z,27,5,2020,146,13,Romania,RO,ROU,19414458,Europe,1210,18429,64
2020-05-28T00:00:00Z,28,5,2020,165,9,Romania,RO,ROU,19414458,Europe,1219,18594,65
2020-05-29T00:00:00Z,29,5,2020,197,10,Romania,RO,ROU,19414458,Europe,1229,18791,66
2020-05-30T00:00:00Z,30,5,2020,191,11,Romania,RO,ROU,19414458,Europe,1240,18982,67
2020-05-31T00:00:00Z,31,5,2020,151,13,Romania,RO,ROU,19414458,Europe,1253,19133,68
2020-06-01T00:00:00Z,1,6,2020,124,9,Romania,RO,ROU,19414458,Europe,1262,19257,69
2020-06-02T00:00:00Z,2,6,2020,141,17,Romania,RO,ROU,19414458,Europe,1279,19398,70
2020-06-03T00:00:00Z,3,6,2020,119,0,Romania,RO,ROU,19414458,Europe,1279,19517,71
2020-06-04T00:00:00Z,4,6,2020,152,9,Romania,RO,ROU,19414458,Europe,1288,19669,72
2020-06-05T00:00:00Z,5,6,2020,238,11,Romania,RO,ROU,19414458,Europe,1299,19907,73
2020-06-06T00:00:00Z,6,6,2020,196,9,Romania,RO,ROU,19414458,Europe,1308,20103,74
2020-06-07T00:00:00Z,7,6,2020,187,10,Romania,RO,ROU,19414458,Europe,1318,20290,75
2020-06-08T00:00:00Z,8,6,2020,189,8,Romania,RO,ROU,19414458,Europe,1326,20479,76
2020-06-09T00:00:00Z,9,6,2020,125,8,Romania,RO,ROU,19414458,Europe,1334,20604,77
2020-06-10T00:00:00Z,10,6,2020,145,11,Romania,RO,ROU,19414458,Europe,1345,20749,78
2020-06-11T00:00:00Z,11,6,2020,196,15,Romania,RO,ROU,19414458,Europe,1360,20945,79
2020-06-12T00:00:00Z,12,6,2020,237,9,Romania,RO,ROU,19414458,Europe,1369,21182,80
2020-06-13T00:00:00Z,13,6,2020,222,11,Romania,RO,ROU,19414458,Europe,1380,21404,81
2020-06-14T00:00:00Z,14,6,2020,275,11,Romania,RO,ROU,19414458,Europe,1391,21679,82
2020-06-15T00:00:00Z,15,6,2020,320,19,Romania,RO,ROU,19414458,Europe,1410,21999,83
2020-06-16T00:00:00Z,16,6,2020,166,17,Romania,RO,ROU,19414458,Europe,1427,22165,84
2020-06-17T00:00:00Z,17,6,2020,250,10,Romania,RO,ROU,19414458,Europe,1437,22415,85
2020-06-18T00:00:00Z,18,6,2020,345,14,Romania,RO,ROU,19414458,Europe,1451,22760,86
2020-06-19T00:00:00Z,19,6,2020,320,22,Romania,RO,ROU,19414458,Europe,1473,23080,87
2020-06-20T00:00:00Z,20,6,2020,320,11,Romania,RO,ROU,19414458,Europe,1484,23400,88
2020-06-21T00:00:00Z,21,6,2020,330,16,Romania,RO,ROU,19414458,Europe,1500,23730,89
2020-06-22T00:00:00Z,22,6,2020,315,12,Romania,RO,ROU,19414458,Europe,1512,24045,90
2020-06-23T00:00:00Z,23,6,2020,246,11,Romania,RO,ROU,19414458,Europe,1523,24291,91
2020-06-24T00:00:00Z,24,6,2020,214,16,Romania,RO,ROU,19414458,Europe,1539,24505,92
2020-06-25T00:00:00Z,25,6,2020,321,16,Romania,RO,ROU,19414458,Europe,1555,24826,93
2020-03-31T00:00:00Z,31,3,2020,302,2,Russia,RU,RUS,145872260,Europe,10,1836,1
2020-04-01T00:00:00Z,1,4,2020,501,7,Russia,RU,RUS,145872260,Europe,17,2337,2
2020-04-02T00:00:00Z,2,4,2020,440,7,Russia,RU,RUS,145872260,Europe,24,2777,3
2020-04-03T00:00:00Z,3,4,2020,771,6,Russia,RU,RUS,145872260,Europe,30,3548,4
2020-04-04T00:00:00Z,4,4,2020,601,4,Russia,RU,RUS,145872260,Europe,34,4149,5
2020-04-05T00:00:00Z,5,4,2020,582,9,Russia,RU,RUS,145872260,Europe,43,4731,6
2020-04-06T00:00:00Z,6,4,2020,658,2,Russia,RU,RUS,145872260,Europe,45,5389,7
2020-04-07T00:00:00Z,7,4,2020,954,2,Russia,RU,RUS,145872260,Europe,47,6343,8
2020-04-08T00:00:00Z,8,4,2020,1154,11,Russia,RU,RUS,145872260,Europe,58,7497,9
2020-04-09T00:00:00Z,9,4,2020,1175,5,Russia,RU,RUS,145872260,Europe,63,8672,10
2020-04-10T00:00:00Z,10,4,2020,1459,13,Russia,RU,RUS,145872260,Europe,76,10131,11
2020-04-11T00:00:00Z,11,4,2020,1786,18,Russia,RU,RUS,145872260,Europe,94,11917,12
2020-04-12T00:00:00Z,12,4,2020,1667,12,Russia,RU,RUS,145872260,Europe,106,13584,13
2020-04-13T00:00:00Z,13,4,2020,2186,24,Russia,RU,RUS,145872260,Europe,130,15770,14
2020-04-14T00:00:00Z,14,4,2020,2558,18,Russia,RU,RUS,145872260,Europe,148,18328,15
2020-04-15T00:00:00Z,15,4,2020,2774,22,Russia,RU,RUS,145872260,Europe,170,21102,16
2020-04-16T00:00:00Z,16,4,2020,3388,28,Russia,RU,RUS,145872260,Europe,198,24490,17
2020-04-17T00:00:00Z,17,4,2020,3448,34,Russia,RU,RUS,145872260,Europe,232,27938,18
2020-04-18T00:00:00Z,18,4,2020,4070,41,Russia,RU,RUS,145872260,Europe,273,32008,19
2020-04-19T00:00:00Z,19,4,2020,4785,40,Russia,RU,RUS,145872260,Europe,313,36793,20
2020-04-20T00:00:00Z,20,4,2020,6060,48,Russia,RU,RUS,145872260,Europe,361,42853,21
2020-04-21T00:00:00Z,21,4,2020,4268,44,Russia,RU,RUS,145872260,Europe,405,47121,22
2020-04-22T00:00:00Z,22,4,2020,5642,51,Russia,RU,RUS,145872260,Europe,456,52763,23
2020-04-23T00:00:00Z,23,4,2020,5236,57,Russia,RU,RUS,145872260,Europe,513,57999,24
2020-04-24T00:00:00Z,24,4,2020,4774,42,Russia,RU,RUS,145872260,Europe,555,62773,25
2020-04-25T00:00:00Z,25,4,2020,5849,60,Russia,RU,RUS,145872260,Europe,615,68622,26
2020-04-26T00:00:00Z,26,4,2020,5966,66,Russia,RU,RUS,145872260,Europe,681,74588,27
2020-04-27T00:00:00Z,27,4,2020,6361,66,Russia,RU,RUS,145872260,Europe,747,80949,28
2020-04-28T00:00:00Z,28,4,2020,6198,48,Russia,RU,RUS,145872260,Europe,795,87147,29
2020-04-29T00:00:00Z,29,4,2020,6411,72,Russia,RU,RUS,145872260,Europe,867,93558,30
2020-04-30T00:00:00Z,30,4,2020,5841,105,Russia,RU,RUS,145872260,Europe,972,99399,31
2020-05-01T00:00:00Z,1,5,2020,7099,101,Russia,RU,RUS,145872260,Europe,1073,106498,32
2020-05-02T00:00:00Z,2,5,2020,7933,96,Russia,RU,RUS,145872260,Europe,1169,114431,33
2020-05-03T00:00:00Z,3,5,2020,9623,53,Russia,RU,RUS,145872260,Europe,1222,124054,34
2020-05-04T00:00:00Z,4,5,2020,10633,58,Russia,RU,RUS,145872260,Europe,1280,134687,35
2020-05-05T00:00:00Z,5,5,2020,10581,76,Russia,RU,RUS,145872260,Europe,1356,145268,36
2020-05-06T00:00:00Z,6,5,2020,10102,95,Russia,RU,RUS,145872260,Europe,1451,155370,37
2020-05-07T00:00:00Z,7,5,2020,10559,86,Russia,RU,RUS,145872260,Europe,1537,165929,38
2020-05-08T00:00:00Z,8,5,2020,11231,88,Russia,RU,RUS,145872260,Europe,1625,177160,39
2020-05-09T00:00:00Z,9,5,2020,10699,98,Russia,RU,RUS,145872260,Europe,1723,187859,40
2020-05-10T00:00:00Z,10,5,2020,10817,104,Russia,RU,RUS,145872260,Europe,1827,198676,41
2020-05-11T00:00:00Z,11,5,2020,11012,88,Russia,RU,RUS,145872260,Europe,1915,209688,42
2020-05-12T00:00:00Z,12,5,2020,11656,94,Russia,RU,RUS,145872260,Europe,2009,221344,43
2020-05-13T00:00:00Z,13,5,2020,10899,107,Russia,RU,RUS,145872260,Europe,2116,232243,44
2020-05-14T00:00:00Z,14,5,2020,10028,96,Russia,RU,RUS,145872260,Europe,2212,242271,45
2020-05-15T00:00:00Z,15,5,2020,9974,93,Russia,RU,RUS,145872260,Europe,2305,252245,46
2020-05-16T00:00:00Z,16,5,2020,10598,113,Russia,RU,RUS,145872260,Europe,2418,262843,47
2020-05-17T00:00:00Z,17,5,2020,9200,119,Russia,RU,RUS,145872260,Europe,2537,272043,48
2020-05-18T00:00:00Z,18,5,2020,9709,94,Russia,RU,RUS,145872260,Europe,2631,281752,49
2020-05-19T00:00:00Z,19,5,2020,8926,91,Russia,RU,RUS,145872260,Europe,2722,290678,50
2020-05-20T00:00:00Z,20,5,2020,9263,115,Russia,RU,RUS,145872260,Europe,2837,299941,51
2020-05-21T00:00:00Z,21,5,2020,8764,135,Russia,RU,RUS,145872260,Europe,2972,308705,52
2020-05-22T00:00:00Z,22,5,2020,8849,127,Russia,RU,RUS,145872260,Europe,3099,317554,53
2020-05-23T00:00:00Z,23,5,2020,8894,150,Russia,RU,RUS,145872260,Europe,3249,326448,54
2020-05-24T00:00:00Z,24,5,2020,9434,139,Russia,RU,RUS,145872260,Europe,3388,335882,55
2020-05-25T00:00:00Z,25,5,2020,8599,153,Russia,RU,RUS,145872260,Europe,3541,344481,56
2020-05-26T00:00:00Z,26,5,2020,8946,92,Russia,RU,RUS,145872260,Europe,3633,353427,57
2020-05-27T00:00:00Z,27,5,2020,8915,174,Russia,RU,RUS,145872260,Europe,3807,362342,58
2020-05-28T00:00:00Z,28,5,2020,8338,161,Russia,RU,RUS,145872260,Europe,3968,370680,59
2020-05-29T00:00:00Z,29,5,2020,8371,174,Russia,RU,RUS,145872260,Europe,4142,379051,60
2020-05-30T00:00:00Z,30,5,2020,8572,232,Russia,RU,RUS,145872260,Europe,4374,387623,61
2020-05-31T00:00:00Z,31,5,2020,8952,181,Russia,RU,RUS,145872260,Europe,4555,396575,62
2020-06-01T00:00:00Z,1,6,2020,9268,138,Russia,RU,RUS,145872260,Europe,4693,405843,63
2020-06-02T00:00:00Z,2,6,2020,9035,162,Russia,RU,RUS,145872260,Europe,4855,414878,64
2020-06-03T00:00:00Z,3,6,2020,8863,182,Russia,RU,RUS,145872260,Europe,5037,423741,65
2020-06-04T00:00:00Z,4,6,2020,8536,178,Russia,RU,RUS,145872260,Europe,5215,432277,66
2020-06-05T00:00:00Z,5,6,2020,8831,169,Russia,RU,RUS,145872260,Europe,5384,441108,67
2020-06-06T00:00:00Z,6,6,2020,8726,144,Russia,RU,RUS,145872260,Europe,5528,449834,68
2020-06-07T00:00:00Z,7,6,2020,8855,197,Russia,RU,RUS,145872260,Europe,5725,458689,69
2020-06-08T00:00:00Z,8,6,2020,8984,134,Russia,RU,RUS,145872260,Europe,5859,467673,70
2020-06-09T00:00:00Z,9,6,2020,8985,112,Russia,RU,RUS,145872260,Europe,5971,476658,71
2020-06-10T00:00:00Z,10,6,2020,8595,170,Russia,RU,RUS,145872260,Europe,6141,485253,72
2020-06-11T00:00:00Z,11,6,2020,8404,217,Russia,RU,RUS,145872260,Europe,6358,493657,73
2020-06-12T00:00:00Z,12,6,2020,8779,174,Russia,RU,RUS,145872260,Europe,6532,502436,74
2020-06-13T00:00:00Z,13,6,2020,8987,183,Russia,RU,RUS,145872260,Europe,6715,511423,75
2020-06-14T00:00:00Z,14,6,2020,8706,114,Russia,RU,RUS,145872260,Europe,6829,520129,76
2020-06-15T00:00:00Z,15,6,2020,8835,119,Russia,RU,RUS,145872260,Europe,6948,528964,77
2020-06-16T00:00:00Z,16,6,2020,8246,143,Russia,RU,RUS,145872260,Europe,7091,537210,78
2020-06-17T00:00:00Z,17,6,2020,8248,193,Russia,RU,RUS,145872260,Europe,7284,545458,79
2020-06-18T00:00:00Z,18,6,2020,7843,194,Russia,RU,RUS,145872260,Europe,7478,553301,80
2020-06-19T00:00:00Z,19,6,2020,7790,312,Russia,RU,RUS,145872260,Europe,7790,561091,81
2020-06-20T00:00:00Z,20,6,2020,7972,182,Russia,RU,RUS,145872260,Europe,7972,569063,82
2020-06-21T00:00:00Z,21,6,2020,7889,30,Russia,RU,RUS,145872260,Europe,8002,576952,83
2020-06-22T00:00:00Z,22,6,2020,7728,109,Russia,RU,RUS,145872260,Europe,8111,584680,84
2020-06-23T00:00:00Z,23,6,2020,7600,95,Russia,RU,RUS,145872260,Europe,8206,592280,85
2020-06-24T00:00:00Z,24,6,2020,7425,153,Russia,RU,RUS,145872260,Europe,8359,599705,86
2020-06-25T00:00:00Z,25,6,2020,7176,154,Russia,RU,RUS,145872260,Europe,8513,606881,87
2020-03-18T00:00:00Z,18,3,2020,2,2,San_Marino,SM,SMR,34453,Europe,11,104,1
2020-03-19T00:00:00Z,19,3,2020,5,3,San_Marino,SM,SMR,34453,Europe,14,109,2
2020-03-20T00:00:00Z,20,3,2020,17,0,San_Marino,SM,SMR,34453,Europe,14,126,3
2020-03-21T00:00:00Z,21,3,2020,25,0,San_Marino,SM,SMR,34453,Europe,14,151,4
2020-03-22T00:00:00Z,22,3,2020,0,6,San_Marino,SM,SMR,34453,Europe,20,151,5
2020-03-23T00:00:00Z,23,3,2020,0,0,San_Marino,SM,SMR,34453,Europe,20,151,6
2020-03-24T00:00:00Z,24,3,2020,36,0,San_Marino,SM,SMR,34453,Europe,20,187,7
2020-03-25T00:00:00Z,25,3,2020,0,1,San_Marino,SM,SMR,34453,Europe,21,187,8
2020-03-26T00:00:00Z,26,3,2020,21,0,San_Marino,SM,SMR,34453,Europe,21,208,9
2020-03-27T00:00:00Z,27,3,2020,10,0,San_Marino,SM,SMR,34453,Europe,21,218,10
2020-03-28T00:00:00Z,28,3,2020,5,0,San_Marino,SM,SMR,34453,Europe,21,223,11
2020-03-29T00:00:00Z,29,3,2020,1,1,San_Marino,SM,SMR,34453,Europe,22,224,12
2020-03-30T00:00:00Z,30,3,2020,5,2,San_Marino,SM,SMR,34453,Europe,24,229,13
2020-03-31T00:00:00Z,31,3,2020,0,1,San_Marino,SM,SMR,34453,Europe,25,229,14
2020-04-01T00:00:00Z,1,4,2020,1,1,San_Marino,SM,SMR,34453,Europe,26,230,15
2020-04-02T00:00:00Z,2,4,2020,6,0,San_Marino,SM,SMR,34453,Europe,26,236,16
2020-04-03T00:00:00Z,3,4,2020,9,4,San_Marino,SM,SMR,34453,Europe,30,245,17
2020-04-04T00:00:00Z,4,4,2020,6,2,San_Marino,SM,SMR,34453,Europe,32,251,18
2020-04-05T00:00:00Z,5,4,2020,8,0,San_Marino,SM,SMR,34453,Europe,32,259,19
2020-04-06T00:00:00Z,6,4,2020,7,0,San_Marino,SM,SMR,34453,Europe,32,266,20
2020-04-07T00:00:00Z,7,4,2020,11,0,San_Marino,SM,SMR,34453,Europe,32,277,21
2020-04-08T00:00:00Z,8,4,2020,2,2,San_Marino,SM,SMR,34453,Europe,34,279,22
2020-04-09T00:00:00Z,9,4,2020,29,0,San_Marino,SM,SMR,34453,Europe,34,308,23
2020-04-10T00:00:00Z,10,4,2020,25,0,San_Marino,SM,SMR,34453,Europe,34,333,24
2020-04-11T00:00:00Z,11,4,2020,11,0,San_Marino,SM,SMR,34453,Europe,34,344,25
2020-04-12T00:00:00Z,12,4,2020,12,1,San_Marino,SM,SMR,34453,Europe,35,356,26
2020-04-13T00:00:00Z,13,4,2020,0,0,San_Marino,SM,SMR,34453,Europe,35,356,27
2020-04-14T00:00:00Z,14,4,2020,0,1,San_Marino,SM,SMR,34453,Europe,36,356,28
2020-04-15T00:00:00Z,15,4,2020,16,0,San_Marino,SM,SMR,34453,Europe,36,372,29
2020-04-16T00:00:00Z,16,4,2020,20,0,San_Marino,SM,SMR,34453,Europe,36,392,30
2020-04-17T00:00:00Z,17,4,2020,34,2,San_Marino,SM,SMR,34453,Europe,38,426,31
2020-04-18T00:00:00Z,18,4,2020,9,1,San_Marino,SM,SMR,34453,Europe,39,435,32
2020-04-19T00:00:00Z,19,4,2020,20,0,San_Marino,SM,SMR,34453,Europe,39,455,33
2020-04-20T00:00:00Z,20,4,2020,6,0,San_Marino,SM,SMR,34453,Europe,39,461,34
2020-04-21T00:00:00Z,21,4,2020,1,0,San_Marino,SM,SMR,34453,Europe,39,462,35
2020-04-22T00:00:00Z,22,4,2020,14,1,San_Marino,SM,SMR,34453,Europe,40,476,36
2020-04-23T00:00:00Z,23,4,2020,12,0,San_Marino,SM,SMR,34453,Europe,40,488,37
2020-04-24T00:00:00Z,24,4,2020,13,0,San_Marino,SM,SMR,34453,Europe,40,501,38
2020-04-25T00:00:00Z,25,4,2020,12,0,San_Marino,SM,SMR,34453,Europe,40,513,39
2020-04-26T00:00:00Z,26,4,2020,0,0,San_Marino,SM,SMR,34453,Europe,40,513,40
2020-04-27T00:00:00Z,27,4,2020,25,1,San_Marino,SM,SMR,34453,Europe,41,538,41
2020-04-28T00:00:00Z,28,4,2020,0,0,San_Marino,SM,SMR,34453,Europe,41,538,42
2020-04-29T00:00:00Z,29,4,2020,15,0,San_Marino,SM,SMR,34453,Europe,41,553,43
2020-04-30T00:00:00Z,30,4,2020,10,0,San_Marino,SM,SMR,34453,Europe,41,563,44
2020-05-01T00:00:00Z,1,5,2020,6,0,San_Marino,SM,SMR,34453,Europe,41,569,45
2020-05-02T00:00:00Z,2,5,2020,11,0,San_Marino,SM,SMR,34453,Europe,41,580,46
2020-05-03T00:00:00Z,3,5,2020,0,0,San_Marino,SM,SMR,34453,Europe,41,580,47
2020-05-04T00:00:00Z,4,5,2020,2,0,San_Marino,SM,SMR,34453,Europe,41,582,48
2020-05-05T00:00:00Z,5,5,2020,0,0,San_Marino,SM,SMR,34453,Europe,41,582,49
2020-05-06T00:00:00Z,6,5,2020,7,0,San_Marino,SM,SMR,34453,Europe,41,589,50
2020-05-07T00:00:00Z,7,5,2020,19,0,San_Marino,SM,SMR,34453,Europe,41,608,51
2020-05-08T00:00:00Z,8,5,2020,14,0,San_Marino,SM,SMR,34453,Europe,41,622,52
2020-05-09T00:00:00Z,9,5,2020,1,0,San_Marino,SM,SMR,34453,Europe,41,623,53
2020-05-10T00:00:00Z,10,5,2020,14,0,San_Marino,SM,SMR,34453,Europe,41,637,54
2020-05-11T00:00:00Z,11,5,2020,-9,0,San_Marino,SM,SMR,34453,Europe,41,628,55
2020-05-12T00:00:00Z,12,5,2020,0,0,San_Marino,SM,SMR,34453,Europe,41,628,56
2020-05-13T00:00:00Z,13,5,2020,10,0,San_Marino,SM,SMR,34453,Europe,41,638,57
2020-05-14T00:00:00Z,14,5,2020,5,0,San_Marino,SM,SMR,34453,Europe,41,643,58
2020-05-15T00:00:00Z,15,5,2020,5,0,San_Marino,SM,SMR,34453,Europe,41,648,59
2020-05-16T00:00:00Z,16,5,2020,4,0,San_Marino,SM,SMR,34453,Europe,41,652,60
2020-05-17T00:00:00Z,17,5,2020,1,0,San_Marino,SM,SMR,34453,Europe,41,653,61
2020-05-18T00:00:00Z,18,5,2020,1,0,San_Marino,SM,SMR,34453,Europe,41,654,62
2020-05-19T00:00:00Z,19,5,2020,0,0,San_Marino,SM,SMR,34453,Europe,41,654,63
2020-05-20T00:00:00Z,20,5,2020,1,0,San_Marino,SM,SMR,34453,Europe,41,655,64
2020-05-21T00:00:00Z,21,5,2020,1,0,San_Marino,SM,SMR,34453,Europe,41,656,65
2020-05-22T00:00:00Z,22,5,2020,2,0,San_Marino,SM,SMR,34453,Europe,41,658,66
2020-05-23T00:00:00Z,23,5,2020,3,0,San_Marino,SM,SMR,34453,Europe,41,661,67
2020-05-24T00:00:00Z,24,5,2020,4,1,San_Marino,SM,SMR,34453,Europe,42,665,68
2020-05-25T00:00:00Z,25,5,2020,0,0,San_Marino,SM,SMR,34453,Europe,42,665,69
2020-05-26T00:00:00Z,26,5,2020,1,0,San_Marino,SM,SMR,34453,Europe,42,666,70
2020-05-27T00:00:00Z,27,5,2020,0,0,San_Marino,SM,SMR,34453,Europe,42,666,71
2020-05-28T00:00:00Z,28,5,2020,1,0,San_Marino,SM,SMR,34453,Europe,42,667,72
2020-05-29T00:00:00Z,29,5,2020,3,0,San_Marino,SM,SMR,34453,Europe,42,670,73
2020-05-30T00:00:00Z,30,5,2020,1,0,San_Marino,SM,SMR,34453,Europe,42,671,74
2020-05-31T00:00:00Z,31,5,2020,0,0,San_Marino,SM,SMR,34453,Europe,42,671,75
2020-06-01T00:00:00Z,1,6,2020,0,0,San_Marino,SM,SMR,34453,Europe,42,671,76
2020-06-02T00:00:00Z,2,6,2020,16,0,San_Marino,SM,SMR,34453,Europe,42,687,77
2020-06-03T00:00:00Z,3,6,2020,0,0,San_Marino,SM,SMR,34453,Europe,42,687,78
2020-06-04T00:00:00Z,4,6,2020,0,0,San_Marino,SM,SMR,34453,Europe,42,687,79
2020-06-05T00:00:00Z,5,6,2020,0,0,San_Marino,SM,SMR,34453,Europe,42,687,80
2020-06-06T00:00:00Z,6,6,2020,0,0,San_Marino,SM,SMR,34453,Europe,42,687,81
2020-06-07T00:00:00Z,7,6,2020,0,0,San_Marino,SM,SMR,34453,Europe,42,687,82
2020-06-08T00:00:00Z,8,6,2020,0,0,San_Marino,SM,SMR,34453,Europe,42,687,83
2020-06-09T00:00:00Z,9,6,2020,0,0,San_Marino,SM,SMR,34453,Europe,42,687,84
2020-06-10T00:00:00Z,10,6,2020,1,0,San_Marino,SM,SMR,34453,Europe,42,688,85
2020-06-11T00:00:00Z,11,6,2020,3,0,San_Marino,SM,SMR,34453,Europe,42,691,86
2020-06-12T00:00:00Z,12,6,2020,0,0,San_Marino,SM,SMR,34453,Europe,42,691,87
2020-06-13T00:00:00Z,13,6,2020,3,0,San_Marino,SM,SMR,34453,Europe,42,694,88
2020-06-14T00:00:00Z,14,6,2020,0,0,San_Marino,SM,SMR,34453,Europe,42,694,89
2020-06-15T00:00:00Z,15,6,2020,0,0,San_Marino,SM,SMR,34453,Europe,42,694,90
2020-06-16T00:00:00Z,16,6,2020,0,0,San_Marino,SM,SMR,34453,Europe,42,694,91
2020-06-17T00:00:00Z,17,6,2020,0,0,San_Marino,SM,SMR,34453,Europe,42,694,92
2020-06-18T00:00:00Z,18,6,2020,2,0,San_Marino,SM,SMR,34453,Europe,42,696,93
2020-06-19T00:00:00Z,19,6,2020,0,0,San_Marino,SM,SMR,34453,Europe,42,696,94
2020-06-20T00:00:00Z,20,6,2020,0,0,San_Marino,SM,SMR,34453,Europe,42,696,95
2020-06-21T00:00:00Z,21,6,2020,0,0,San_Marino,SM,SMR,34453,Europe,42,696,96
2020-06-22T00:00:00Z,22,6,2020,0,0,San_Marino,SM,SMR,34453,Europe,42,696,97
2020-06-23T00:00:00Z,23,6,2020,2,0,San_Marino,SM,SMR,34453,Europe,42,698,98
2020-06-24T00:00:00Z,24,6,2020,0,0,San_Marino,SM,SMR,34453,Europe,42,698,99
2020-06-25T00:00:00Z,25,6,2020,0,0,San_Marino,SM,SMR,34453,Europe,42,698,100
2020-05-26T00:00:00Z,26,5,2020,0,2,Sao_Tome_and_Principe,ST,STP,215048,Africa,11,299,1
2020-05-27T00:00:00Z,27,5,2020,142,1,Sao_Tome_and_Principe,ST,STP,215048,Africa,12,441,2
2020-05-28T00:00:00Z,28,5,2020,2,0,Sao_Tome_and_Principe,ST,STP,215048,Africa,12,443,3
2020-05-29T00:00:00Z,29,5,2020,15,0,Sao_Tome_and_Principe,ST,STP,215048,Africa,12,458,4
2020-05-30T00:00:00Z,30,5,2020,5,0,Sao_Tome_and_Principe,ST,STP,215048,Africa,12,463,5
2020-05-31T00:00:00Z,31,5,2020,16,0,Sao_Tome_and_Principe,ST,STP,215048,Africa,12,479,6
2020-06-01T00:00:00Z,1,6,2020,4,0,Sao_Tome_and_Principe,ST,STP,215048,Africa,12,483,7
2020-06-02T00:00:00Z,2,6,2020,1,0,Sao_Tome_and_Principe,ST,STP,215048,Africa,12,484,8
2020-06-03T00:00:00Z,3,6,2020,0,0,Sao_Tome_and_Principe,ST,STP,215048,Africa,12,484,9
2020-06-04T00:00:00Z,4,6,2020,0,0,Sao_Tome_and_Principe,ST,STP,215048,Africa,12,484,10
2020-06-05T00:00:00Z,5,6,2020,15,0,Sao_Tome_and_Principe,ST,STP,215048,Africa,12,499,11
2020-06-06T00:00:00Z,6,6,2020,10,0,Sao_Tome_and_Principe,ST,STP,215048,Africa,12,509,12
2020-06-07T00:00:00Z,7,6,2020,4,0,Sao_Tome_and_Principe,ST,STP,215048,Africa,12,513,13
2020-06-08T00:00:00Z,8,6,2020,1,0,Sao_Tome_and_Principe,ST,STP,215048,Africa,12,514,14
2020-06-09T00:00:00Z,9,6,2020,0,0,Sao_Tome_and_Principe,ST,STP,215048,Africa,12,514,15
2020-06-10T00:00:00Z,10,6,2020,0,0,Sao_Tome_and_Principe,ST,STP,215048,Africa,12,514,16
2020-06-11T00:00:00Z,11,6,2020,118,0,Sao_Tome_and_Principe,ST,STP,215048,Africa,12,632,17
2020-06-12T00:00:00Z,12,6,2020,7,0,Sao_Tome_and_Principe,ST,STP,215048,Africa,12,639,18
2020-06-13T00:00:00Z,13,6,2020,11,0,Sao_Tome_and_Principe,ST,STP,215048,Africa,12,650,19
2020-06-14T00:00:00Z,14,6,2020,9,0,Sao_Tome_and_Principe,ST,STP,215048,Africa,12,659,20
2020-06-15T00:00:00Z,15,6,2020,2,0,Sao_Tome_and_Principe,ST,STP,215048,Africa,12,661,21
2020-06-16T00:00:00Z,16,6,2020,0,0,Sao_Tome_and_Principe,ST,STP,215048,Africa,12,661,22
2020-06-17T00:00:00Z,17,6,2020,10,0,Sao_Tome_and_Principe,ST,STP,215048,Africa,12,671,23
2020-06-18T00:00:00Z,18,6,2020,12,0,Sao_Tome_and_Principe,ST,STP,215048,Africa,12,683,24
2020-06-19T00:00:00Z,19,6,2020,5,0,Sao_Tome_and_Principe,ST,STP,215048,Africa,12,688,25
2020-06-20T00:00:00Z,20,6,2020,5,0,Sao_Tome_and_Principe,ST,STP,215048,Africa,12,693,26
2020-06-21T00:00:00Z,21,6,2020,5,0,Sao_Tome_and_Principe,ST,STP,215048,Africa,12,698,27
2020-06-22T00:00:00Z,22,6,2020,0,0,Sao_Tome_and_Principe,ST,STP,215048,Africa,12,698,28
2020-06-23T00:00:00Z,23,6,2020,4,0,Sao_Tome_and_Principe,ST,STP,215048,Africa,12,702,29
2020-06-24T00:00:00Z,24,6,2020,5,0,Sao_Tome_and_Principe,ST,STP,215048,Africa,12,707,30
2020-06-25T00:00:00Z,25,6,2020,3,1,Sao_Tome_and_Principe,ST,STP,215048,Africa,13,710,31
2020-04-01T00:00:00Z,1,4,2020,110,2,Saudi_Arabia,SA,SAU,34268529,Asia,10,1563,1
2020-04-02T00:00:00Z,2,4,2020,157,6,Saudi_Arabia,SA,SAU,34268529,Asia,16,1720,2
2020-04-03T00:00:00Z,3,4,2020,165,5,Saudi_Arabia,SA,SAU,34268529,Asia,21,1885,3
2020-04-04T00:00:00Z,4,4,2020,0,0,Saudi_Arabia,SA,SAU,34268529,Asia,21,1885,4
2020-04-05T00:00:00Z,5,4,2020,294,8,Saudi_Arabia,SA,SAU,34268529,Asia,29,2179,5
2020-04-06T00:00:00Z,6,4,2020,206,5,Saudi_Arabia,SA,SAU,34268529,Asia,34,2385,6
2020-04-07T00:00:00Z,7,4,2020,138,4,Saudi_Arabia,SA,SAU,34268529,Asia,38,2523,7
2020-04-08T00:00:00Z,8,4,2020,272,3,Saudi_Arabia,SA,SAU,34268529,Asia,41,2795,8
2020-04-09T00:00:00Z,9,4,2020,137,0,Saudi_Arabia,SA,SAU,34268529,Asia,41,2932,9
2020-04-10T00:00:00Z,10,4,2020,355,3,Saudi_Arabia,SA,SAU,34268529,Asia,44,3287,10
2020-04-11T00:00:00Z,11,4,2020,364,3,Saudi_Arabia,SA,SAU,34268529,Asia,47,3651,11
2020-04-12T00:00:00Z,12,4,2020,382,5,Saudi_Arabia,SA,SAU,34268529,Asia,52,4033,12
2020-04-13T00:00:00Z,13,4,2020,429,7,Saudi_Arabia,SA,SAU,34268529,Asia,59,4462,13
2020-04-14T00:00:00Z,14,4,2020,472,6,Saudi_Arabia,SA,SAU,34268529,Asia,65,4934,14
2020-04-15T00:00:00Z,15,4,2020,435,8,Saudi_Arabia,SA,SAU,34268529,Asia,73,5369,15
2020-04-16T00:00:00Z,16,4,2020,493,6,Saudi_Arabia,SA,SAU,34268529,Asia,79,5862,16
2020-04-17T00:00:00Z,17,4,2020,518,4,Saudi_Arabia,SA,SAU,34268529,Asia,83,6380,17
2020-04-18T00:00:00Z,18,4,2020,762,4,Saudi_Arabia,SA,SAU,34268529,Asia,87,7142,18
2020-04-19T00:00:00Z,19,4,2020,1132,5,Saudi_Arabia,SA,SAU,34268529,Asia,92,8274,19
2020-04-20T00:00:00Z,20,4,2020,1088,5,Saudi_Arabia,SA,SAU,34268529,Asia,97,9362,20
2020-04-21T00:00:00Z,21,4,2020,1122,6,Saudi_Arabia,SA,SAU,34268529,Asia,103,10484,21
2020-04-22T00:00:00Z,22,4,2020,1147,6,Saudi_Arabia,SA,SAU,34268529,Asia,109,11631,22
2020-04-23T00:00:00Z,23,4,2020,1141,5,Saudi_Arabia,SA,SAU,34268529,Asia,114,12772,23
2020-04-24T00:00:00Z,24,4,2020,1158,7,Saudi_Arabia,SA,SAU,34268529,Asia,121,13930,24
2020-04-25T00:00:00Z,25,4,2020,1172,6,Saudi_Arabia,SA,SAU,34268529,Asia,127,15102,25
2020-04-26T00:00:00Z,26,4,2020,1197,9,Saudi_Arabia,SA,SAU,34268529,Asia,136,16299,26
2020-04-27T00:00:00Z,27,4,2020,1223,3,Saudi_Arabia,SA,SAU,34268529,Asia,139,17522,27
2020-04-28T00:00:00Z,28,4,2020,1289,5,Saudi_Arabia,SA,SAU,34268529,Asia,144,18811,28
2020-04-29T00:00:00Z,29,4,2020,1266,8,Saudi_Arabia,SA,SAU,34268529,Asia,152,20077,29
2020-04-30T00:00:00Z,30,4,2020,1325,5,Saudi_Arabia,SA,SAU,34268529,Asia,157,21402,30
2020-05-01T00:00:00Z,1,5,2020,1351,5,Saudi_Arabia,SA,SAU,34268529,Asia,162,22753,31
2020-05-02T00:00:00Z,2,5,2020,1344,7,Saudi_Arabia,SA,SAU,34268529,Asia,169,24097,32
2020-05-03T00:00:00Z,3,5,2020,1362,7,Saudi_Arabia,SA,SAU,34268529,Asia,176,25459,33
2020-05-04T00:00:00Z,4,5,2020,1552,8,Saudi_Arabia,SA,SAU,34268529,Asia,184,27011,34
2020-05-05T00:00:00Z,5,5,2020,1645,7,Saudi_Arabia,SA,SAU,34268529,Asia,191,28656,35
2020-05-06T00:00:00Z,6,5,2020,1595,9,Saudi_Arabia,SA,SAU,34268529,Asia,200,30251,36
2020-05-07T00:00:00Z,7,5,2020,1687,9,Saudi_Arabia,SA,SAU,34268529,Asia,209,31938,37
2020-05-08T00:00:00Z,8,5,2020,1793,10,Saudi_Arabia,SA,SAU,34268529,Asia,219,33731,38
2020-05-09T00:00:00Z,9,5,2020,1701,10,Saudi_Arabia,SA,SAU,34268529,Asia,229,35432,39
2020-05-10T00:00:00Z,10,5,2020,1704,10,Saudi_Arabia,SA,SAU,34268529,Asia,239,37136,40
2020-05-11T00:00:00Z,11,5,2020,1912,7,Saudi_Arabia,SA,SAU,34268529,Asia,246,39048,41
2020-05-12T00:00:00Z,12,5,2020,1966,9,Saudi_Arabia,SA,SAU,34268529,Asia,255,41014,42
2020-05-13T00:00:00Z,13,5,2020,1911,9,Saudi_Arabia,SA,SAU,34268529,Asia,264,42925,43
2020-05-14T00:00:00Z,14,5,2020,1905,9,Saudi_Arabia,SA,SAU,34268529,Asia,273,44830,44
2020-05-15T00:00:00Z,15,5,2020,2039,10,Saudi_Arabia,SA,SAU,34268529,Asia,283,46869,45
2020-05-16T00:00:00Z,16,5,2020,2307,9,Saudi_Arabia,SA,SAU,34268529,Asia,292,49176,46
2020-05-17T00:00:00Z,17,5,2020,2840,10,Saudi_Arabia,SA,SAU,34268529,Asia,302,52016,47
2020-05-18T00:00:00Z,18,5,2020,2736,10,Saudi_Arabia,SA,SAU,34268529,Asia,312,54752,48
2020-05-19T00:00:00Z,19,5,2020,2593,8,Saudi_Arabia,SA,SAU,34268529,Asia,320,57345,49
2020-05-20T00:00:00Z,20,5,2020,2509,9,Saudi_Arabia,SA,SAU,34268529,Asia,329,59854,50
2020-05-21T00:00:00Z,21,5,2020,2691,10,Saudi_Arabia,SA,SAU,34268529,Asia,339,62545,51
2020-05-22T00:00:00Z,22,5,2020,2532,12,Saudi_Arabia,SA,SAU,34268529,Asia,351,65077,52
2020-05-23T00:00:00Z,23,5,2020,2642,13,Saudi_Arabia,SA,SAU,34268529,Asia,364,67719,53
2020-05-24T00:00:00Z,24,5,2020,2442,15,Saudi_Arabia,SA,SAU,34268529,Asia,379,70161,54
2020-05-25T00:00:00Z,25,5,2020,2399,11,Saudi_Arabia,SA,SAU,34268529,Asia,390,72560,55
2020-05-26T00:00:00Z,26,5,2020,2235,9,Saudi_Arabia,SA,SAU,34268529,Asia,399,74795,56
2020-05-27T00:00:00Z,27,5,2020,1931,12,Saudi_Arabia,SA,SAU,34268529,Asia,411,76726,57
2020-05-28T00:00:00Z,28,5,2020,1815,14,Saudi_Arabia,SA,SAU,34268529,Asia,425,78541,58
2020-05-29T00:00:00Z,29,5,2020,1644,16,Saudi_Arabia,SA,SAU,34268529,Asia,441,80185,59
2020-05-30T00:00:00Z,30,5,2020,1581,17,Saudi_Arabia,SA,SAU,34268529,Asia,458,81766,60
2020-05-31T00:00:00Z,31,5,2020,1618,22,Saudi_Arabia,SA,SAU,34268529,Asia,480,83384,61
2020-06-01T00:00:00Z,1,6,2020,1877,23,Saudi_Arabia,SA,SAU,34268529,Asia,503,85261,62
2020-06-02T00:00:00Z,2,6,2020,1881,22,Saudi_Arabia,SA,SAU,34268529,Asia,525,87142,63
2020-06-03T00:00:00Z,3,6,2020,1869,24,Saudi_Arabia,SA,SAU,34268529,Asia,549,89011,64
2020-06-04T00:00:00Z,4,6,2020,2171,30,Saudi_Arabia,SA,SAU,34268529,Asia,579,91182,65
2020-06-05T00:00:00Z,5,6,2020,1975,32,Saudi_Arabia,SA,SAU,34268529,Asia,611,93157,66
2020-06-06T00:00:00Z,6,6,2020,2591,31,Saudi_Arabia,SA,SAU,34268529,Asia,642,95748,67
2020-06-07T00:00:00Z,7,6,2020,3121,34,Saudi_Arabia,SA,SAU,34268529,Asia,676,98869,68
2020-06-08T00:00:00Z,8,6,2020,3045,36,Saudi_Arabia,SA,SAU,34268529,Asia,712,101914,69
2020-06-09T00:00:00Z,9,6,2020,3369,34,Saudi_Arabia,SA,SAU,34268529,Asia,746,105283,70
2020-06-10T00:00:00Z,10,6,2020,3288,37,Saudi_Arabia,SA,SAU,34268529,Asia,783,108571,71
2020-06-11T00:00:00Z,11,6,2020,3717,36,Saudi_Arabia,SA,SAU,34268529,Asia,819,112288,72
2020-06-12T00:00:00Z,12,6,2020,3733,38,Saudi_Arabia,SA,SAU,34268529,Asia,857,116021,73
2020-06-13T00:00:00Z,13,6,2020,3921,36,Saudi_Arabia,SA,SAU,34268529,Asia,893,119942,74
2020-06-14T00:00:00Z,14,6,2020,3366,39,Saudi_Arabia,SA,SAU,34268529,Asia,932,123308,75
2020-06-15T00:00:00Z,15,6,2020,4233,40,Saudi_Arabia,SA,SAU,34268529,Asia,972,127541,76
2020-06-16T00:00:00Z,16,6,2020,4507,39,Saudi_Arabia,SA,SAU,34268529,Asia,1011,132048,77
2020-06-17T00:00:00Z,17,6,2020,4267,41,Saudi_Arabia,SA,SAU,34268529,Asia,1052,136315,78
2020-06-18T00:00:00Z,18,6,2020,4919,39,Saudi_Arabia,SA,SAU,34268529,Asia,1091,141234,79
2020-06-19T00:00:00Z,19,6,2020,4757,48,Saudi_Arabia,SA,SAU,34268529,Asia,1139,145991,80
2020-06-20T00:00:00Z,20,6,2020,4301,45,Saudi_Arabia,SA,SAU,34268529,Asia,1184,150292,81
2020-06-21T00:00:00Z,21,6,2020,3941,46,Saudi_Arabia,SA,SAU,34268529,Asia,1230,154233,82
2020-06-22T00:00:00Z,22,6,2020,3379,37,Saudi_Arabia,SA,SAU,34268529,Asia,1267,157612,83
2020-06-23T00:00:00Z,23,6,2020,3393,40,Saudi_Arabia,SA,SAU,34268529,Asia,1307,161005,84
2020-06-24T00:00:00Z,24,6,2020,3139,39,Saudi_Arabia,SA,SAU,34268529,Asia,1346,164144,85
2020-06-25T00:00:00Z,25,6,2020,3123,41,Saudi_Arabia,SA,SAU,34268529,Asia,1387,167267,86
2020-05-05T00:00:00Z,5,5,2020,89,1,Senegal,SN,SEN,16296362,Africa,10,1271,1
2020-05-06T00:00:00Z,6,5,2020,58,1,Senegal,SN,SEN,16296362,Africa,11,1329,2
2020-05-07T00:00:00Z,7,5,2020,104,1,Senegal,SN,SEN,16296362,Africa,12,1433,3
2020-05-08T00:00:00Z,8,5,2020,59,1,Senegal,SN,SEN,16296362,Africa,13,1492,4
2020-05-09T00:00:00Z,9,5,2020,59,1,Senegal,SN,SEN,16296362,Africa,14,1551,5
2020-05-10T00:00:00Z,10,5,2020,83,3,Senegal,SN,SEN,16296362,Africa,17,1634,6
2020-05-11T00:00:00Z,11,5,2020,75,2,Senegal,SN,SEN,16296362,Africa,19,1709,7
2020-05-12T00:00:00Z,12,5,2020,177,0,Senegal,SN,SEN,16296362,Africa,19,1886,8
2020-05-13T00:00:00Z,13,5,2020,109,0,Senegal,SN,SEN,16296362,Africa,19,1995,9
2020-05-14T00:00:00Z,14,5,2020,110,3,Senegal,SN,SEN,16296362,Africa,22,2105,10
2020-05-15T00:00:00Z,15,5,2020,84,1,Senegal,SN,SEN,16296362,Africa,23,2189,11
2020-05-16T00:00:00Z,16,5,2020,121,2,Senegal,SN,SEN,16296362,Africa,25,2310,12
2020-05-17T00:00:00Z,17,5,2020,119,0,Senegal,SN,SEN,16296362,Africa,25,2429,13
2020-05-18T00:00:00Z,18,5,2020,51,1,Senegal,SN,SEN,16296362,Africa,26,2480,14
2020-05-19T00:00:00Z,19,5,2020,64,0,Senegal,SN,SEN,16296362,Africa,26,2544,15
2020-05-20T00:00:00Z,20,5,2020,73,4,Senegal,SN,SEN,16296362,Africa,30,2617,16
2020-05-21T00:00:00Z,21,5,2020,97,0,Senegal,SN,SEN,16296362,Africa,30,2714,17
2020-05-22T00:00:00Z,22,5,2020,98,3,Senegal,SN,SEN,16296362,Africa,33,2812,18
2020-05-23T00:00:00Z,23,5,2020,97,0,Senegal,SN,SEN,16296362,Africa,33,2909,19
2020-05-24T00:00:00Z,24,5,2020,67,2,Senegal,SN,SEN,16296362,Africa,35,2976,20
2020-05-25T00:00:00Z,25,5,2020,71,0,Senegal,SN,SEN,16296362,Africa,35,3047,21
2020-05-26T00:00:00Z,26,5,2020,83,1,Senegal,SN,SEN,16296362,Africa,36,3130,22
2020-05-27T00:00:00Z,27,5,2020,31,1,Senegal,SN,SEN,16296362,Africa,37,3161,23
2020-05-28T00:00:00Z,28,5,2020,92,2,Senegal,SN,SEN,16296362,Africa,39,3253,24
2020-05-29T00:00:00Z,29,5,2020,95,2,Senegal,SN,SEN,16296362,Africa,41,3348,25
2020-05-30T00:00:00Z,30,5,2020,81,0,Senegal,SN,SEN,16296362,Africa,41,3429,26
2020-05-31T00:00:00Z,31,5,2020,106,1,Senegal,SN,SEN,16296362,Africa,42,3535,27
2020-06-01T00:00:00Z,1,6,2020,110,0,Senegal,SN,SEN,16296362,Africa,42,3645,28
2020-06-02T00:00:00Z,2,6,2020,94,0,Senegal,SN,SEN,16296362,Africa,42,3739,29
2020-06-03T00:00:00Z,3,6,2020,97,1,Senegal,SN,SEN,16296362,Africa,43,3836,30
2020-06-04T00:00:00Z,4,6,2020,96,2,Senegal,SN,SEN,16296362,Africa,45,3932,31
2020-06-05T00:00:00Z,5,6,2020,89,0,Senegal,SN,SEN,16296362,Africa,45,4021,32
2020-06-06T00:00:00Z,6,6,2020,134,0,Senegal,SN,SEN,16296362,Africa,45,4155,33
2020-06-07T00:00:00Z,7,6,2020,94,2,Senegal,SN,SEN,16296362,Africa,47,4249,34
2020-06-08T00:00:00Z,8,6,2020,79,2,Senegal,SN,SEN,16296362,Africa,49,4328,35
2020-06-09T00:00:00Z,9,6,2020,99,3,Senegal,SN,SEN,16296362,Africa,52,4427,36
2020-06-10T00:00:00Z,10,6,2020,89,0,Senegal,SN,SEN,16296362,Africa,52,4516,37
2020-06-11T00:00:00Z,11,6,2020,124,2,Senegal,SN,SEN,16296362,Africa,54,4640,38
2020-06-12T00:00:00Z,12,6,2020,119,2,Senegal,SN,SEN,16296362,Africa,56,4759,39
2020-06-13T00:00:00Z,13,6,2020,92,0,Senegal,SN,SEN,16296362,Africa,56,4851,40
2020-06-14T00:00:00Z,14,6,2020,145,4,Senegal,SN,SEN,16296362,Africa,60,4996,41
2020-06-15T00:00:00Z,15,6,2020,94,0,Senegal,SN,SEN,16296362,Africa,60,5090,42
2020-06-16T00:00:00Z,16,6,2020,83,4,Senegal,SN,SEN,16296362,Africa,64,5173,43
2020-06-17T00:00:00Z,17,6,2020,74,6,Senegal,SN,SEN,16296362,Africa,70,5247,44
2020-06-18T00:00:00Z,18,6,2020,122,3,Senegal,SN,SEN,16296362,Africa,73,5369,45
2020-06-19T00:00:00Z,19,6,2020,106,3,Senegal,SN,SEN,16296362,Africa,76,5475,46
2020-06-20T00:00:00Z,20,6,2020,164,3,Senegal,SN,SEN,16296362,Africa,79,5639,47
2020-06-21T00:00:00Z,21,6,2020,99,3,Senegal,SN,SEN,16296362,Africa,82,5738,48
2020-06-22T00:00:00Z,22,6,2020,150,2,Senegal,SN,SEN,16296362,Africa,84,5888,49
2020-06-23T00:00:00Z,23,6,2020,82,2,Senegal,SN,SEN,16296362,Africa,86,5970,50
2020-06-24T00:00:00Z,24,6,2020,64,3,Senegal,SN,SEN,16296362,Africa,89,6034,51
2020-06-25T00:00:00Z,25,6,2020,95,4,Senegal,SN,SEN,16296362,Africa,93,6129,52
2020-03-29T00:00:00Z,29,3,2020,202,4,Serbia,RS,SRB,6963764,Europe,10,659,1
2020-03-30T00:00:00Z,30,3,2020,82,3,Serbia,RS,SRB,6963764,Europe,13,741,2
2020-03-31T00:00:00Z,31,3,2020,0,0,Serbia,RS,SRB,6963764,Europe,13,741,3
2020-04-01T00:00:00Z,1,4,2020,159,10,Serbia,RS,SRB,6963764,Europe,23,900,4
2020-04-02T00:00:00Z,2,4,2020,160,0,Serbia,RS,SRB,6963764,Europe,23,1060,5
2020-04-03T00:00:00Z,3,4,2020,111,8,Serbia,RS,SRB,6963764,Europe,31,1171,6
2020-04-04T00:00:00Z,4,4,2020,305,8,Serbia,RS,SRB,6963764,Europe,39,1476,7
2020-04-05T00:00:00Z,5,4,2020,148,5,Serbia,RS,SRB,6963764,Europe,44,1624,8
2020-04-06T00:00:00Z,6,4,2020,284,7,Serbia,RS,SRB,6963764,Europe,51,1908,9
2020-04-07T00:00:00Z,7,4,2020,292,7,Serbia,RS,SRB,6963764,Europe,58,2200,10
2020-04-08T00:00:00Z,8,4,2020,247,3,Serbia,RS,SRB,6963764,Europe,61,2447,11
2020-04-09T00:00:00Z,9,4,2020,219,4,Serbia,RS,SRB,6963764,Europe,65,2666,12
2020-04-10T00:00:00Z,10,4,2020,201,1,Serbia,RS,SRB,6963764,Europe,66,2867,13
2020-04-11T00:00:00Z,11,4,2020,238,5,Serbia,RS,SRB,6963764,Europe,71,3105,14
2020-04-12T00:00:00Z,12,4,2020,275,3,Serbia,RS,SRB,6963764,Europe,74,3380,15
2020-04-13T00:00:00Z,13,4,2020,250,6,Serbia,RS,SRB,6963764,Europe,80,3630,16
2020-04-14T00:00:00Z,14,4,2020,424,5,Serbia,RS,SRB,6963764,Europe,85,4054,17
2020-04-15T00:00:00Z,15,4,2020,411,9,Serbia,RS,SRB,6963764,Europe,94,4465,18
2020-04-16T00:00:00Z,16,4,2020,408,5,Serbia,RS,SRB,6963764,Europe,99,4873,19
2020-04-17T00:00:00Z,17,4,2020,445,4,Serbia,RS,SRB,6963764,Europe,103,5318,20
2020-04-18T00:00:00Z,18,4,2020,372,7,Serbia,RS,SRB,6963764,Europe,110,5690,21
2020-04-19T00:00:00Z,19,4,2020,304,7,Serbia,RS,SRB,6963764,Europe,117,5994,22
2020-04-20T00:00:00Z,20,4,2020,324,5,Serbia,RS,SRB,6963764,Europe,122,6318,23
2020-04-21T00:00:00Z,21,4,2020,312,3,Serbia,RS,SRB,6963764,Europe,125,6630,24
2020-04-22T00:00:00Z,22,4,2020,260,0,Serbia,RS,SRB,6963764,Europe,125,6890,25
2020-04-23T00:00:00Z,23,4,2020,224,9,Serbia,RS,SRB,6963764,Europe,134,7114,26
2020-04-24T00:00:00Z,24,4,2020,162,5,Serbia,RS,SRB,6963764,Europe,139,7276,27
2020-04-25T00:00:00Z,25,4,2020,207,5,Serbia,RS,SRB,6963764,Europe,144,7483,28
2020-04-26T00:00:00Z,26,4,2020,296,7,Serbia,RS,SRB,6963764,Europe,151,7779,29
2020-04-27T00:00:00Z,27,4,2020,263,5,Serbia,RS,SRB,6963764,Europe,156,8042,30
2020-04-28T00:00:00Z,28,4,2020,233,6,Serbia,RS,SRB,6963764,Europe,162,8275,31
2020-04-29T00:00:00Z,29,4,2020,222,6,Serbia,RS,SRB,6963764,Europe,168,8497,32
2020-04-30T00:00:00Z,30,4,2020,227,5,Serbia,RS,SRB,6963764,Europe,173,8724,33
2020-05-01T00:00:00Z,1,5,2020,285,6,Serbia,RS,SRB,6963764,Europe,179,9009,34
2020-05-02T00:00:00Z,2,5,2020,196,6,Serbia,RS,SRB,6963764,Europe,185,9205,35
2020-05-03T00:00:00Z,3,5,2020,157,4,Serbia,RS,SRB,6963764,Europe,189,9362,36
2020-05-04T00:00:00Z,4,5,2020,102,4,Serbia,RS,SRB,6963764,Europe,193,9464,37
2020-05-05T00:00:00Z,5,5,2020,93,4,Serbia,RS,SRB,6963764,Europe,197,9557,38
2020-05-06T00:00:00Z,6,5,2020,120,3,Serbia,RS,SRB,6963764,Europe,200,9677,39
2020-05-07T00:00:00Z,7,5,2020,114,3,Serbia,RS,SRB,6963764,Europe,203,9791,40
2020-05-08T00:00:00Z,8,5,2020,57,3,Serbia,RS,SRB,6963764,Europe,206,9848,41
2020-05-09T00:00:00Z,9,5,2020,95,3,Serbia,RS,SRB,6963764,Europe,209,9943,42
2020-05-10T00:00:00Z,10,5,2020,89,4,Serbia,RS,SRB,6963764,Europe,213,10032,43
2020-05-11T00:00:00Z,11,5,2020,82,2,Serbia,RS,SRB,6963764,Europe,215,10114,44
2020-05-12T00:00:00Z,12,5,2020,62,3,Serbia,RS,SRB,6963764,Europe,218,10176,45
2020-05-13T00:00:00Z,13,5,2020,67,2,Serbia,RS,SRB,6963764,Europe,220,10243,46
2020-05-14T00:00:00Z,14,5,2020,52,2,Serbia,RS,SRB,6963764,Europe,222,10295,47
2020-05-15T00:00:00Z,15,5,2020,79,2,Serbia,RS,SRB,6963764,Europe,224,10374,48
2020-05-16T00:00:00Z,16,5,2020,64,1,Serbia,RS,SRB,6963764,Europe,225,10438,49
2020-05-17T00:00:00Z,17,5,2020,58,3,Serbia,RS,SRB,6963764,Europe,228,10496,50
2020-05-18T00:00:00Z,18,5,2020,114,2,Serbia,RS,SRB,6963764,Europe,230,10610,51
2020-05-19T00:00:00Z,19,5,2020,89,1,Serbia,RS,SRB,6963764,Europe,231,10699,52
2020-05-20T00:00:00Z,20,5,2020,34,3,Serbia,RS,SRB,6963764,Europe,234,10733,53
2020-05-21T00:00:00Z,21,5,2020,100,1,Serbia,RS,SRB,6963764,Europe,235,10833,54
2020-05-22T00:00:00Z,22,5,2020,86,2,Serbia,RS,SRB,6963764,Europe,237,10919,55
2020-05-23T00:00:00Z,23,5,2020,105,0,Serbia,RS,SRB,6963764,Europe,237,11024,56
2020-05-24T00:00:00Z,24,5,2020,68,1,Serbia,RS,SRB,6963764,Europe,238,11092,57
2020-05-25T00:00:00Z,25,5,2020,67,0,Serbia,RS,SRB,6963764,Europe,238,11159,58
2020-05-26T00:00:00Z,26,5,2020,34,1,Serbia,RS,SRB,6963764,Europe,239,11193,59
2020-05-27T00:00:00Z,27,5,2020,34,0,Serbia,RS,SRB,6963764,Europe,239,11227,60
2020-05-28T00:00:00Z,28,5,2020,48,1,Serbia,RS,SRB,6963764,Europe,240,11275,61
2020-05-29T00:00:00Z,29,5,2020,25,1,Serbia,RS,SRB,6963764,Europe,241,11300,62
2020-05-30T00:00:00Z,30,5,2020,54,1,Serbia,RS,SRB,6963764,Europe,242,11354,63
2020-05-31T00:00:00Z,31,5,2020,27,0,Serbia,RS,SRB,6963764,Europe,242,11381,64
2020-06-01T00:00:00Z,1,6,2020,31,1,Serbia,RS,SRB,6963764,Europe,243,11412,65
2020-06-02T00:00:00Z,2,6,2020,18,1,Serbia,RS,SRB,6963764,Europe,244,11430,66
2020-06-03T00:00:00Z,3,6,2020,24,1,Serbia,RS,SRB,6963764,Europe,245,11454,67
2020-06-04T00:00:00Z,4,6,2020,69,0,Serbia,RS,SRB,6963764,Europe,245,11523,68
2020-06-05T00:00:00Z,5,6,2020,48,1,Serbia,RS,SRB,6963764,Europe,246,11571,69
2020-06-06T00:00:00Z,6,6,2020,96,1,Serbia,RS,SRB,6963764,Europe,247,11667,70
2020-06-07T00:00:00Z,7,6,2020,74,1,Serbia,RS,SRB,6963764,Europe,248,11741,71
2020-06-08T00:00:00Z,8,6,2020,82,1,Serbia,RS,SRB,6963764,Europe,249,11823,72
2020-06-09T00:00:00Z,9,6,2020,73,1,Serbia,RS,SRB,6963764,Europe,250,11896,73
2020-06-10T00:00:00Z,10,6,2020,69,0,Serbia,RS,SRB,6963764,Europe,250,11965,74
2020-06-11T00:00:00Z,11,6,2020,66,1,Serbia,RS,SRB,6963764,Europe,251,12031,75
2020-06-12T00:00:00Z,12,6,2020,71,1,Serbia,RS,SRB,6963764,Europe,252,12102,76
2020-06-13T00:00:00Z,13,6,2020,73,0,Serbia,RS,SRB,6963764,Europe,252,12175,77
2020-06-14T00:00:00Z,14,6,2020,76,1,Serbia,RS,SRB,6963764,Europe,253,12251,78
2020-06-15T00:00:00Z,15,6,2020,59,1,Serbia,RS,SRB,6963764,Europe,254,12310,79
2020-06-16T00:00:00Z,16,6,2020,57,1,Serbia,RS,SRB,6963764,Europe,255,12367,80
2020-06-17T00:00:00Z,17,6,2020,59,1,Serbia,RS,SRB,6963764,Europe,256,12426,81
2020-06-18T00:00:00Z,18,6,2020,96,1,Serbia,RS,SRB,6963764,Europe,257,12522,82
2020-06-19T00:00:00Z,19,6,2020,94,1,Serbia,RS,SRB,6963764,Europe,258,12616,83
2020-06-20T00:00:00Z,20,6,2020,93,1,Serbia,RS,SRB,6963764,Europe,259,12709,84
2020-06-21T00:00:00Z,21,6,2020,94,1,Serbia,RS,SRB,6963764,Europe,260,12803,85
2020-06-22T00:00:00Z,22,6,2020,91,1,Serbia,RS,SRB,6963764,Europe,261,12894,86
2020-06-23T00:00:00Z,23,6,2020,96,1,Serbia,RS,SRB,6963764,Europe,262,12990,87
2020-06-24T00:00:00Z,24,6,2020,102,1,Serbia,RS,SRB,6963764,Europe,263,13092,88
2020-06-25T00:00:00Z,25,6,2020,143,0,Serbia,RS,SRB,6963764,Europe,263,13235,89
2020-05-06T00:00:00Z,6,5,2020,21,2,Sierra_Leone,SL,SLE,7813207,Africa,11,199,1
2020-05-07T00:00:00Z,7,5,2020,26,3,Sierra_Leone,SL,SLE,7813207,Africa,14,225,2
2020-05-08T00:00:00Z,8,5,2020,6,2,Sierra_Leone,SL,SLE,7813207,Africa,16,231,3
2020-05-09T00:00:00Z,9,5,2020,26,1,Sierra_Leone,SL,SLE,7813207,Africa,17,257,4
2020-05-10T00:00:00Z,10,5,2020,34,1,Sierra_Leone,SL,SLE,7813207,Africa,18,291,5
2020-05-11T00:00:00Z,11,5,2020,16,0,Sierra_Leone,SL,SLE,7813207,Africa,18,307,6
2020-05-12T00:00:00Z,12,5,2020,31,1,Sierra_Leone,SL,SLE,7813207,Africa,19,338,7
2020-05-13T00:00:00Z,13,5,2020,0,1,Sierra_Leone,SL,SLE,7813207,Africa,20,338,8
2020-05-14T00:00:00Z,14,5,2020,49,1,Sierra_Leone,SL,SLE,7813207,Africa,21,387,9
2020-05-15T00:00:00Z,15,5,2020,21,5,Sierra_Leone,SL,SLE,7813207,Africa,26,408,10
2020-05-16T00:00:00Z,16,5,2020,39,1,Sierra_Leone,SL,SLE,7813207,Africa,27,447,11
2020-05-17T00:00:00Z,17,5,2020,15,2,Sierra_Leone,SL,SLE,7813207,Africa,29,462,12
2020-05-18T00:00:00Z,18,5,2020,43,3,Sierra_Leone,SL,SLE,7813207,Africa,32,505,13
2020-05-19T00:00:00Z,19,5,2020,14,1,Sierra_Leone,SL,SLE,7813207,Africa,33,519,14
2020-05-20T00:00:00Z,20,5,2020,15,0,Sierra_Leone,SL,SLE,7813207,Africa,33,534,15
2020-05-21T00:00:00Z,21,5,2020,36,1,Sierra_Leone,SL,SLE,7813207,Africa,34,570,16
2020-05-22T00:00:00Z,22,5,2020,15,1,Sierra_Leone,SL,SLE,7813207,Africa,35,585,17
2020-05-23T00:00:00Z,23,5,2020,21,3,Sierra_Leone,SL,SLE,7813207,Africa,38,606,18
2020-05-24T00:00:00Z,24,5,2020,15,1,Sierra_Leone,SL,SLE,7813207,Africa,39,621,19
2020-05-25T00:00:00Z,25,5,2020,86,1,Sierra_Leone,SL,SLE,7813207,Africa,40,707,20
2020-05-26T00:00:00Z,26,5,2020,28,2,Sierra_Leone,SL,SLE,7813207,Africa,42,735,21
2020-05-27T00:00:00Z,27,5,2020,19,2,Sierra_Leone,SL,SLE,7813207,Africa,44,754,22
2020-05-28T00:00:00Z,28,5,2020,28,1,Sierra_Leone,SL,SLE,7813207,Africa,45,782,23
2020-05-29T00:00:00Z,29,5,2020,30,0,Sierra_Leone,SL,SLE,7813207,Africa,45,812,24
2020-05-30T00:00:00Z,30,5,2020,17,0,Sierra_Leone,SL,SLE,7813207,Africa,45,829,25
2020-05-31T00:00:00Z,31,5,2020,23,1,Sierra_Leone,SL,SLE,7813207,Africa,46,852,26
2020-06-01T00:00:00Z,1,6,2020,9,0,Sierra_Leone,SL,SLE,7813207,Africa,46,861,27
2020-06-02T00:00:00Z,2,6,2020,0,0,Sierra_Leone,SL,SLE,7813207,Africa,46,861,28
2020-06-03T00:00:00Z,3,6,2020,35,0,Sierra_Leone,SL,SLE,7813207,Africa,46,896,29
2020-06-04T00:00:00Z,4,6,2020,13,1,Sierra_Leone,SL,SLE,7813207,Africa,47,909,30
2020-06-05T00:00:00Z,5,6,2020,5,0,Sierra_Leone,SL,SLE,7813207,Africa,47,914,31
2020-06-06T00:00:00Z,6,6,2020,15,0,Sierra_Leone,SL,SLE,7813207,Africa,47,929,32
2020-06-07T00:00:00Z,7,6,2020,17,1,Sierra_Leone,SL,SLE,7813207,Africa,48,946,33
2020-06-08T00:00:00Z,8,6,2020,23,0,Sierra_Leone,SL,SLE,7813207,Africa,48,969,34
2020-06-09T00:00:00Z,9,6,2020,32,1,Sierra_Leone,SL,SLE,7813207,Africa,49,1001,35
2020-06-10T00:00:00Z,10,6,2020,24,1,Sierra_Leone,SL,SLE,7813207,Africa,50,1025,36
2020-06-11T00:00:00Z,11,6,2020,37,0,Sierra_Leone,SL,SLE,7813207,Africa,50,1062,37
2020-06-12T00:00:00Z,12,6,2020,23,0,Sierra_Leone,SL,SLE,7813207,Africa,50,1085,38
2020-06-13T00:00:00Z,13,6,2020,18,1,Sierra_Leone,SL,SLE,7813207,Africa,51,1103,39
2020-06-14T00:00:00Z,14,6,2020,29,0,Sierra_Leone,SL,SLE,7813207,Africa,51,1132,40
2020-06-15T00:00:00Z,15,6,2020,37,0,Sierra_Leone,SL,SLE,7813207,Africa,51,1169,41
2020-06-16T00:00:00Z,16,6,2020,7,0,Sierra_Leone,SL,SLE,7813207,Africa,51,1176,42
2020-06-17T00:00:00Z,17,6,2020,49,0,Sierra_Leone,SL,SLE,7813207,Africa,51,1225,43
2020-06-18T00:00:00Z,18,6,2020,24,0,Sierra_Leone,SL,SLE,7813207,Africa,51,1249,44
2020-06-19T00:00:00Z,19,6,2020,23,0,Sierra_Leone,SL,SLE,7813207,Africa,51,1272,45
2020-06-20T00:00:00Z,20,6,2020,26,2,Sierra_Leone,SL,SLE,7813207,Africa,53,1298,46
2020-06-21T00:00:00Z,21,6,2020,11,0,Sierra_Leone,SL,SLE,7813207,Africa,53,1309,47
2020-06-22T00:00:00Z,22,6,2020,18,2,Sierra_Leone,SL,SLE,7813207,Africa,55,1327,48
2020-06-23T00:00:00Z,23,6,2020,13,0,Sierra_Leone,SL,SLE,7813207,Africa,55,1340,49
2020-06-24T00:00:00Z,24,6,2020,7,0,Sierra_Leone,SL,SLE,7813207,Africa,55,1347,50
2020-06-25T00:00:00Z,25,6,2020,7,1,Sierra_Leone,SL,SLE,7813207,Africa,56,1354,51
2020-04-15T00:00:00Z,15,4,2020,334,1,Singapore,SG,SGP,5804343,Asia,10,3252,1
2020-04-16T00:00:00Z,16,4,2020,447,0,Singapore,SG,SGP,5804343,Asia,10,3699,2
2020-04-17T00:00:00Z,17,4,2020,728,0,Singapore,SG,SGP,5804343,Asia,10,4427,3
2020-04-18T00:00:00Z,18,4,2020,623,1,Singapore,SG,SGP,5804343,Asia,11,5050,4
2020-04-19T00:00:00Z,19,4,2020,942,0,Singapore,SG,SGP,5804343,Asia,11,5992,5
2020-04-20T00:00:00Z,20,4,2020,596,0,Singapore,SG,SGP,5804343,Asia,11,6588,6
2020-04-21T00:00:00Z,21,4,2020,1426,0,Singapore,SG,SGP,5804343,Asia,11,8014,7
2020-04-22T00:00:00Z,22,4,2020,1111,0,Singapore,SG,SGP,5804343,Asia,11,9125,8
2020-04-23T00:00:00Z,23,4,2020,1016,1,Singapore,SG,SGP,5804343,Asia,12,10141,9
2020-04-24T00:00:00Z,24,4,2020,1037,0,Singapore,SG,SGP,5804343,Asia,12,11178,10
2020-04-25T00:00:00Z,25,4,2020,897,0,Singapore,SG,SGP,5804343,Asia,12,12075,11
2020-04-26T00:00:00Z,26,4,2020,618,0,Singapore,SG,SGP,5804343,Asia,12,12693,12
2020-04-27T00:00:00Z,27,4,2020,931,0,Singapore,SG,SGP,5804343,Asia,12,13624,13
2020-04-28T00:00:00Z,28,4,2020,799,2,Singapore,SG,SGP,5804343,Asia,14,14423,14
2020-04-29T00:00:00Z,29,4,2020,528,0,Singapore,SG,SGP,5804343,Asia,14,14951,15
2020-04-30T00:00:00Z,30,4,2020,690,0,Singapore,SG,SGP,5804343,Asia,14,15641,16
2020-05-01T00:00:00Z,1,5,2020,528,1,Singapore,SG,SGP,5804343,Asia,15,16169,17
2020-05-02T00:00:00Z,2,5,2020,932,1,Singapore,SG,SGP,5804343,Asia,16,17101,18
2020-05-03T00:00:00Z,3,5,2020,447,1,Singapore,SG,SGP,5804343,Asia,17,17548,19
2020-05-04T00:00:00Z,4,5,2020,657,1,Singapore,SG,SGP,5804343,Asia,18,18205,20
2020-05-05T00:00:00Z,5,5,2020,573,0,Singapore,SG,SGP,5804343,Asia,18,18778,21
2020-05-06T00:00:00Z,6,5,2020,632,0,Singapore,SG,SGP,5804343,Asia,18,19410,22
2020-05-07T00:00:00Z,7,5,2020,788,2,Singapore,SG,SGP,5804343,Asia,20,20198,23
2020-05-08T00:00:00Z,8,5,2020,741,0,Singapore,SG,SGP,5804343,Asia,20,20939,24
2020-05-09T00:00:00Z,9,5,2020,768,0,Singapore,SG,SGP,5804343,Asia,20,21707,25
2020-05-10T00:00:00Z,10,5,2020,753,0,Singapore,SG,SGP,5804343,Asia,20,22460,26
2020-05-11T00:00:00Z,11,5,2020,876,0,Singapore,SG,SGP,5804343,Asia,20,23336,27
2020-05-12T00:00:00Z,12,5,2020,451,1,Singapore,SG,SGP,5804343,Asia,21,23787,28
2020-05-13T00:00:00Z,13,5,2020,884,0,Singapore,SG,SGP,5804343,Asia,21,24671,29
2020-05-14T00:00:00Z,14,5,2020,675,0,Singapore,SG,SGP,5804343,Asia,21,25346,30
2020-05-15T00:00:00Z,15,5,2020,752,0,Singapore,SG,SGP,5804343,Asia,21,26098,31
2020-05-16T00:00:00Z,16,5,2020,793,0,Singapore,SG,SGP,5804343,Asia,21,26891,32
2020-05-17T00:00:00Z,17,5,2020,465,1,Singapore,SG,SGP,5804343,Asia,22,27356,33
2020-05-18T00:00:00Z,18,5,2020,682,0,Singapore,SG,SGP,5804343,Asia,22,28038,34
2020-05-19T00:00:00Z,19,5,2020,305,0,Singapore,SG,SGP,5804343,Asia,22,28343,35
2020-05-20T00:00:00Z,20,5,2020,451,0,Singapore,SG,SGP,5804343,Asia,22,28794,36
2020-05-21T00:00:00Z,21,5,2020,570,0,Singapore,SG,SGP,5804343,Asia,22,29364,37
2020-05-22T00:00:00Z,22,5,2020,448,1,Singapore,SG,SGP,5804343,Asia,23,29812,38
2020-05-23T00:00:00Z,23,5,2020,614,0,Singapore,SG,SGP,5804343,Asia,23,30426,39
2020-05-24T00:00:00Z,24,5,2020,642,0,Singapore,SG,SGP,5804343,Asia,23,31068,40
2020-05-25T00:00:00Z,25,5,2020,548,0,Singapore,SG,SGP,5804343,Asia,23,31616,41
2020-05-26T00:00:00Z,26,5,2020,344,0,Singapore,SG,SGP,5804343,Asia,23,31960,42
2020-05-27T00:00:00Z,27,5,2020,383,0,Singapore,SG,SGP,5804343,Asia,23,32343,43
2020-05-28T00:00:00Z,28,5,2020,533,0,Singapore,SG,SGP,5804343,Asia,23,32876,44
2020-05-29T00:00:00Z,29,5,2020,373,0,Singapore,SG,SGP,5804343,Asia,23,33249,45
2020-05-30T00:00:00Z,30,5,2020,611,0,Singapore,SG,SGP,5804343,Asia,23,33860,46
2020-05-31T00:00:00Z,31,5,2020,506,0,Singapore,SG,SGP,5804343,Asia,23,34366,47
2020-06-01T00:00:00Z,1,6,2020,518,0,Singapore,SG,SGP,5804343,Asia,23,34884,48
2020-06-02T00:00:00Z,2,6,2020,408,1,Singapore,SG,SGP,5804343,Asia,24,35292,49
2020-06-03T00:00:00Z,3,6,2020,544,0,Singapore,SG,SGP,5804343,Asia,24,35836,50
2020-06-04T00:00:00Z,4,6,2020,569,0,Singapore,SG,SGP,5804343,Asia,24,36405,51
2020-06-05T00:00:00Z,5,6,2020,517,0,Singapore,SG,SGP,5804343,Asia,24,36922,52
2020-06-06T00:00:00Z,6,6,2020,261,0,Singapore,SG,SGP,5804343,Asia,24,37183,53
2020-06-07T00:00:00Z,7,6,2020,344,1,Singapore,SG,SGP,5804343,Asia,25,37527,54
2020-06-08T00:00:00Z,8,6,2020,383,0,Singapore,SG,SGP,5804343,Asia,25,37910,55
2020-06-09T00:00:00Z,9,6,2020,386,0,Singapore,SG,SGP,5804343,Asia,25,38296,56
2020-06-10T00:00:00Z,10,6,2020,218,0,Singapore,SG,SGP,5804343,Asia,25,38514,57
2020-06-11T00:00:00Z,11,6,2020,451,0,Singapore,SG,SGP,5804343,Asia,25,38965,58
2020-06-12T00:00:00Z,12,6,2020,422,0,Singapore,SG,SGP,5804343,Asia,25,39387,59
2020-06-13T00:00:00Z,13,6,2020,463,0,Singapore,SG,SGP,5804343,Asia,25,39850,60
2020-06-14T00:00:00Z,14,6,2020,347,1,Singapore,SG,SGP,5804343,Asia,26,40197,61
2020-06-15T00:00:00Z,15,6,2020,407,0,Singapore,SG,SGP,5804343,Asia,26,40604,62
2020-06-16T00:00:00Z,16,6,2020,214,0,Singapore,SG,SGP,5804343,Asia,26,40818,63
2020-06-17T00:00:00Z,17,6,2020,151,0,Singapore,SG,SGP,5804343,Asia,26,40969,64
2020-06-18T00:00:00Z,18,6,2020,247,0,Singapore,SG,SGP,5804343,Asia,26,41216,65
2020-06-19T00:00:00Z,19,6,2020,257,0,Singapore,SG,SGP,5804343,Asia,26,41473,66
2020-06-20T00:00:00Z,20,6,2020,142,0,Singapore,SG,SGP,5804343,Asia,26,41615,67
2020-06-21T00:00:00Z,21,6,2020,218,0,Singapore,SG,SGP,5804343,Asia,26,41833,68
2020-06-22T00:00:00Z,22,6,2020,262,0,Singapore,SG,SGP,5804343,Asia,26,42095,69
2020-06-23T00:00:00Z,23,6,2020,218,0,Singapore,SG,SGP,5804343,Asia,26,42313,70
2020-06-24T00:00:00Z,24,6,2020,119,0,Singapore,SG,SGP,5804343,Asia,26,42432,71
2020-06-25T00:00:00Z,25,6,2020,191,0,Singapore,SG,SGP,5804343,Asia,26,42623,72
2020-04-20T00:00:00Z,20,4,2020,3,1,Sint_Maarten,SX,SXM,42389,America,10,67,1
2020-04-21T00:00:00Z,21,4,2020,1,0,Sint_Maarten,SX,SXM,42389,America,10,68,2
2020-04-22T00:00:00Z,22,4,2020,0,0,Sint_Maarten,SX,SXM,42389,America,10,68,3
2020-04-23T00:00:00Z,23,4,2020,5,2,Sint_Maarten,SX,SXM,42389,America,12,73,4
2020-04-24T00:00:00Z,24,4,2020,0,0,Sint_Maarten,SX,SXM,42389,America,12,73,5
2020-04-25T00:00:00Z,25,4,2020,0,0,Sint_Maarten,SX,SXM,42389,America,12,73,6
2020-04-26T00:00:00Z,26,4,2020,0,0,Sint_Maarten,SX,SXM,42389,America,12,73,7
2020-04-27T00:00:00Z,27,4,2020,1,1,Sint_Maarten,SX,SXM,42389,America,13,74,8
2020-04-28T00:00:00Z,28,4,2020,1,0,Sint_Maarten,SX,SXM,42389,America,13,75,9
2020-04-29T00:00:00Z,29,4,2020,0,0,Sint_Maarten,SX,SXM,42389,America,13,75,10
2020-04-30T00:00:00Z,30,4,2020,1,0,Sint_Maarten,SX,SXM,42389,America,13,76,11
2020-05-01T00:00:00Z,1,5,2020,0,0,Sint_Maarten,SX,SXM,42389,America,13,76,12
2020-05-02T00:00:00Z,2,5,2020,0,0,Sint_Maarten,SX,SXM,42389,America,13,76,13
2020-05-03T00:00:00Z,3,5,2020,0,0,Sint_Maarten,SX,SXM,42389,America,13,76,14
2020-05-04T00:00:00Z,4,5,2020,0,0,Sint_Maarten,SX,SXM,42389,America,13,76,15
2020-05-05T00:00:00Z,5,5,2020,0,0,Sint_Maarten,SX,SXM,42389,America,13,76,16
2020-05-06T00:00:00Z,6,5,2020,0,1,Sint_Maarten,SX,SXM,42389,America,14,76,17
2020-05-07T00:00:00Z,7,5,2020,0,0,Sint_Maarten,SX,SXM,42389,America,14,76,18
2020-05-08T00:00:00Z,8,5,2020,0,0,Sint_Maarten,SX,SXM,42389,America,14,76,19
2020-05-09T00:00:00Z,9,5,2020,0,1,Sint_Maarten,SX,SXM,42389,America,15,76,20
2020-05-10T00:00:00Z,10,5,2020,0,0,Sint_Maarten,SX,SXM,42389,America,15,76,21
2020-05-11T00:00:00Z,11,5,2020,0,0,Sint_Maarten,SX,SXM,42389,America,15,76,22
2020-05-12T00:00:00Z,12,5,2020,0,0,Sint_Maarten,SX,SXM,42389,America,15,76,23
2020-05-13T00:00:00Z,13,5,2020,1,0,Sint_Maarten,SX,SXM,42389,America,15,77,24
2020-05-14T00:00:00Z,14,5,2020,0,0,Sint_Maarten,SX,SXM,42389,America,15,77,25
2020-05-15T00:00:00Z,15,5,2020,0,0,Sint_Maarten,SX,SXM,42389,America,15,77,26
2020-05-16T00:00:00Z,16,5,2020,0,0,Sint_Maarten,SX,SXM,42389,America,15,77,27
2020-05-17T00:00:00Z,17,5,2020,0,0,Sint_Maarten,SX,SXM,42389,America,15,77,28
2020-05-18T00:00:00Z,18,5,2020,0,0,Sint_Maarten,SX,SXM,42389,America,15,77,29
2020-05-19T00:00:00Z,19,5,2020,0,0,Sint_Maarten,SX,SXM,42389,America,15,77,30
2020-05-20T00:00:00Z,20,5,2020,0,0,Sint_Maarten,SX,SXM,42389,America,15,77,31
2020-05-21T00:00:00Z,21,5,2020,0,0,Sint_Maarten,SX,SXM,42389,America,15,77,32
2020-05-22T00:00:00Z,22,5,2020,0,0,Sint_Maarten,SX,SXM,42389,America,15,77,33
2020-05-23T00:00:00Z,23,5,2020,0,0,Sint_Maarten,SX,SXM,42389,America,15,77,34
2020-05-24T00:00:00Z,24,5,2020,0,0,Sint_Maarten,SX,SXM,42389,America,15,77,35
2020-05-25T00:00:00Z,25,5,2020,0,0,Sint_Maarten,SX,SXM,42389,America,15,77,36
2020-05-26T00:00:00Z,26,5,2020,0,0,Sint_Maarten,SX,SXM,42389,America,15,77,37
2020-05-27T00:00:00Z,27,5,2020,0,0,Sint_Maarten,SX,SXM,42389,America,15,77,38
2020-05-28T00:00:00Z,28,5,2020,0,0,Sint_Maarten,SX,SXM,42389,America,15,77,39
2020-05-29T00:00:00Z,29,5,2020,0,0,Sint_Maarten,SX,SXM,42389,America,15,77,40
2020-05-30T00:00:00Z,30,5,2020,0,0,Sint_Maarten,SX,SXM,42389,America,15,77,41
2020-05-31T00:00:00Z,31,5,2020,0,0,Sint_Maarten,SX,SXM,42389,America,15,77,42
2020-06-01T00:00:00Z,1,6,2020,0,0,Sint_Maarten,SX,SXM,42389,America,15,77,43
2020-06-02T00:00:00Z,2,6,2020,0,0,Sint_Maarten,SX,SXM,42389,America,15,77,44
2020-06-03T00:00:00Z,3,6,2020,0,0,Sint_Maarten,SX,SXM,42389,America,15,77,45
2020-06-04T00:00:00Z,4,6,2020,0,0,Sint_Maarten,SX,SXM,42389,America,15,77,46
2020-06-05T00:00:00Z,5,6,2020,0,0,Sint_Maarten,SX,SXM,42389,America,15,77,47
2020-06-06T00:00:00Z,6,6,2020,0,0,Sint_Maarten,SX,SXM,42389,America,15,77,48
2020-06-07T00:00:00Z,7,6,2020,0,0,Sint_Maarten,SX,SXM,42389,America,15,77,49
2020-06-08T00:00:00Z,8,6,2020,0,0,Sint_Maarten,SX,SXM,42389,America,15,77,50
2020-06-09T00:00:00Z,9,6,2020,0,0,Sint_Maarten,SX,SXM,42389,America,15,77,51
2020-06-10T00:00:00Z,10,6,2020,0,0,Sint_Maarten,SX,SXM,42389,America,15,77,52
2020-06-11T00:00:00Z,11,6,2020,0,0,Sint_Maarten,SX,SXM,42389,America,15,77,53
2020-06-12T00:00:00Z,12,6,2020,0,0,Sint_Maarten,SX,SXM,42389,America,15,77,54
2020-06-13T00:00:00Z,13,6,2020,0,0,Sint_Maarten,SX,SXM,42389,America,15,77,55
2020-06-14T00:00:00Z,14,6,2020,0,0,Sint_Maarten,SX,SXM,42389,America,15,77,56
2020-06-15T00:00:00Z,15,6,2020,0,0,Sint_Maarten,SX,SXM,42389,America,15,77,57
2020-06-16T00:00:00Z,16,6,2020,0,0,Sint_Maarten,SX,SXM,42389,America,15,77,58
2020-06-17T00:00:00Z,17,6,2020,0,0,Sint_Maarten,SX,SXM,42389,America,15,77,59
2020-06-18T00:00:00Z,18,6,2020,0,0,Sint_Maarten,SX,SXM,42389,America,15,77,60
2020-06-19T00:00:00Z,19,6,2020,0,0,Sint_Maarten,SX,SXM,42389,America,15,77,61
2020-06-20T00:00:00Z,20,6,2020,0,0,Sint_Maarten,SX,SXM,42389,America,15,77,62
2020-06-21T00:00:00Z,21,6,2020,0,0,Sint_Maarten,SX,SXM,42389,America,15,77,63
2020-06-22T00:00:00Z,22,6,2020,0,0,Sint_Maarten,SX,SXM,42389,America,15,77,64
2020-06-23T00:00:00Z,23,6,2020,0,0,Sint_Maarten,SX,SXM,42389,America,15,77,65
2020-06-24T00:00:00Z,24,6,2020,0,0,Sint_Maarten,SX,SXM,42389,America,15,77,66
2020-06-25T00:00:00Z,25,6,2020,0,0,Sint_Maarten,SX,SXM,42389,America,15,77,67
2020-04-19T00:00:00Z,19,4,2020,40,2,Slovakia,SK,SVK,5450421,Europe,11,1089,1
2020-04-20T00:00:00Z,20,4,2020,72,1,Slovakia,SK,SVK,5450421,Europe,12,1161,2
2020-04-21T00:00:00Z,21,4,2020,12,1,Slovakia,SK,SVK,5450421,Europe,13,1173,3
2020-04-22T00:00:00Z,22,4,2020,26,1,Slovakia,SK,SVK,5450421,Europe,14,1199,4
2020-04-23T00:00:00Z,23,4,2020,45,0,Slovakia,SK,SVK,5450421,Europe,14,1244,5
2020-04-24T00:00:00Z,24,4,2020,81,1,Slovakia,SK,SVK,5450421,Europe,15,1325,6
2020-04-25T00:00:00Z,25,4,2020,35,2,Slovakia,SK,SVK,5450421,Europe,17,1360,7
2020-04-26T00:00:00Z,26,4,2020,13,0,Slovakia,SK,SVK,5450421,Europe,17,1373,8
2020-04-27T00:00:00Z,27,4,2020,6,1,Slovakia,SK,SVK,5450421,Europe,18,1379,9
2020-04-28T00:00:00Z,28,4,2020,2,0,Slovakia,SK,SVK,5450421,Europe,18,1381,10
2020-04-29T00:00:00Z,29,4,2020,3,2,Slovakia,SK,SVK,5450421,Europe,20,1384,11
2020-04-30T00:00:00Z,30,4,2020,7,2,Slovakia,SK,SVK,5450421,Europe,22,1391,12
2020-05-01T00:00:00Z,1,5,2020,5,1,Slovakia,SK,SVK,5450421,Europe,23,1396,13
2020-05-02T00:00:00Z,2,5,2020,7,0,Slovakia,SK,SVK,5450421,Europe,23,1403,14
2020-05-03T00:00:00Z,3,5,2020,4,1,Slovakia,SK,SVK,5450421,Europe,24,1407,15
2020-05-04T00:00:00Z,4,5,2020,1,0,Slovakia,SK,SVK,5450421,Europe,24,1408,16
2020-05-05T00:00:00Z,5,5,2020,5,1,Slovakia,SK,SVK,5450421,Europe,25,1413,17
2020-05-06T00:00:00Z,6,5,2020,8,0,Slovakia,SK,SVK,5450421,Europe,25,1421,18
2020-05-07T00:00:00Z,7,5,2020,8,0,Slovakia,SK,SVK,5450421,Europe,25,1429,19
2020-05-08T00:00:00Z,8,5,2020,16,1,Slovakia,SK,SVK,5450421,Europe,26,1445,20
2020-05-09T00:00:00Z,9,5,2020,10,0,Slovakia,SK,SVK,5450421,Europe,26,1455,21
2020-05-10T00:00:00Z,10,5,2020,0,0,Slovakia,SK,SVK,5450421,Europe,26,1455,22
2020-05-11T00:00:00Z,11,5,2020,2,0,Slovakia,SK,SVK,5450421,Europe,26,1457,23
2020-05-12T00:00:00Z,12,5,2020,0,0,Slovakia,SK,SVK,5450421,Europe,26,1457,24
2020-05-13T00:00:00Z,13,5,2020,8,1,Slovakia,SK,SVK,5450421,Europe,27,1465,25
2020-05-14T00:00:00Z,14,5,2020,4,0,Slovakia,SK,SVK,5450421,Europe,27,1469,26
2020-05-15T00:00:00Z,15,5,2020,8,0,Slovakia,SK,SVK,5450421,Europe,27,1477,27
2020-05-16T00:00:00Z,16,5,2020,3,0,Slovakia,SK,SVK,5450421,Europe,27,1480,28
2020-05-17T00:00:00Z,17,5,2020,13,1,Slovakia,SK,SVK,5450421,Europe,28,1493,29
2020-05-18T00:00:00Z,18,5,2020,1,0,Slovakia,SK,SVK,5450421,Europe,28,1494,30
2020-05-19T00:00:00Z,19,5,2020,1,0,Slovakia,SK,SVK,5450421,Europe,28,1495,31
2020-05-20T00:00:00Z,20,5,2020,0,0,Slovakia,SK,SVK,5450421,Europe,28,1495,32
2020-05-21T00:00:00Z,21,5,2020,1,0,Slovakia,SK,SVK,5450421,Europe,28,1496,33
2020-05-22T00:00:00Z,22,5,2020,6,0,Slovakia,SK,SVK,5450421,Europe,28,1502,34
2020-05-23T00:00:00Z,23,5,2020,1,0,Slovakia,SK,SVK,5450421,Europe,28,1503,35
2020-05-24T00:00:00Z,24,5,2020,1,0,Slovakia,SK,SVK,5450421,Europe,28,1504,36
2020-05-25T00:00:00Z,25,5,2020,5,0,Slovakia,SK,SVK,5450421,Europe,28,1509,37
2020-05-26T00:00:00Z,26,5,2020,2,0,Slovakia,SK,SVK,5450421,Europe,28,1511,38
2020-05-27T00:00:00Z,27,5,2020,2,0,Slovakia,SK,SVK,5450421,Europe,28,1513,39
2020-05-28T00:00:00Z,28,5,2020,2,0,Slovakia,SK,SVK,5450421,Europe,28,1515,40
2020-05-29T00:00:00Z,29,5,2020,5,0,Slovakia,SK,SVK,5450421,Europe,28,1520,41
2020-05-30T00:00:00Z,30,5,2020,0,0,Slovakia,SK,SVK,5450421,Europe,28,1520,42
2020-05-31T00:00:00Z,31,5,2020,1,0,Slovakia,SK,SVK,5450421,Europe,28,1521,43
2020-06-01T00:00:00Z,1,6,2020,1,0,Slovakia,SK,SVK,5450421,Europe,28,1522,44
2020-06-02T00:00:00Z,2,6,2020,0,0,Slovakia,SK,SVK,5450421,Europe,28,1522,45
2020-06-03T00:00:00Z,3,6,2020,0,0,Slovakia,SK,SVK,5450421,Europe,28,1522,46
2020-06-04T00:00:00Z,4,6,2020,3,0,Slovakia,SK,SVK,5450421,Europe,28,1525,47
2020-06-05T00:00:00Z,5,6,2020,1,0,Slovakia,SK,SVK,5450421,Europe,28,1526,48
2020-06-06T00:00:00Z,6,6,2020,0,0,Slovakia,SK,SVK,5450421,Europe,28,1526,49
2020-06-07T00:00:00Z,7,6,2020,2,0,Slovakia,SK,SVK,5450421,Europe,28,1528,50
2020-06-08T00:00:00Z,8,6,2020,0,0,Slovakia,SK,SVK,5450421,Europe,28,1528,51
2020-06-09T00:00:00Z,9,6,2020,2,0,Slovakia,SK,SVK,5450421,Europe,28,1530,52
2020-06-10T00:00:00Z,10,6,2020,1,0,Slovakia,SK,SVK,5450421,Europe,28,1531,53
2020-06-11T00:00:00Z,11,6,2020,2,0,Slovakia,SK,SVK,5450421,Europe,28,1533,54
2020-06-12T00:00:00Z,12,6,2020,8,0,Slovakia,SK,SVK,5450421,Europe,28,1541,55
2020-06-13T00:00:00Z,13,6,2020,1,0,Slovakia,SK,SVK,5450421,Europe,28,1542,56
2020-06-14T00:00:00Z,14,6,2020,3,0,Slovakia,SK,SVK,5450421,Europe,28,1545,57
2020-06-15T00:00:00Z,15,6,2020,3,0,Slovakia,SK,SVK,5450421,Europe,28,1548,58
2020-06-16T00:00:00Z,16,6,2020,4,0,Slovakia,SK,SVK,5450421,Europe,28,1552,59
2020-06-17T00:00:00Z,17,6,2020,0,0,Slovakia,SK,SVK,5450421,Europe,28,1552,60
2020-06-18T00:00:00Z,18,6,2020,9,0,Slovakia,SK,SVK,5450421,Europe,28,1561,61
2020-06-19T00:00:00Z,19,6,2020,1,0,Slovakia,SK,SVK,5450421,Europe,28,1562,62
2020-06-20T00:00:00Z,20,6,2020,14,0,Slovakia,SK,SVK,5450421,Europe,28,1576,63
2020-06-21T00:00:00Z,21,6,2020,10,0,Slovakia,SK,SVK,5450421,Europe,28,1586,64
2020-06-22T00:00:00Z,22,6,2020,1,0,Slovakia,SK,SVK,5450421,Europe,28,1587,65
2020-06-23T00:00:00Z,23,6,2020,1,0,Slovakia,SK,SVK,5450421,Europe,28,1588,66
2020-06-24T00:00:00Z,24,6,2020,1,0,Slovakia,SK,SVK,5450421,Europe,28,1589,67
2020-06-25T00:00:00Z,25,6,2020,18,0,Slovakia,SK,SVK,5450421,Europe,28,1607,68
2020-03-30T00:00:00Z,30,3,2020,39,2,Slovenia,SI,SVN,2080908,Europe,11,730,1
2020-03-31T00:00:00Z,31,3,2020,33,0,Slovenia,SI,SVN,2080908,Europe,11,763,2
2020-04-01T00:00:00Z,1,4,2020,51,2,Slovenia,SI,SVN,2080908,Europe,13,814,3
2020-04-02T00:00:00Z,2,4,2020,27,2,Slovenia,SI,SVN,2080908,Europe,15,841,4
2020-04-03T00:00:00Z,3,4,2020,56,1,Slovenia,SI,SVN,2080908,Europe,16,897,5
2020-04-04T00:00:00Z,4,4,2020,37,4,Slovenia,SI,SVN,2080908,Europe,20,934,6
2020-04-05T00:00:00Z,5,4,2020,43,2,Slovenia,SI,SVN,2080908,Europe,22,977,7
2020-04-06T00:00:00Z,6,4,2020,20,6,Slovenia,SI,SVN,2080908,Europe,28,997,8
2020-04-07T00:00:00Z,7,4,2020,24,2,Slovenia,SI,SVN,2080908,Europe,30,1021,9
2020-04-08T00:00:00Z,8,4,2020,34,6,Slovenia,SI,SVN,2080908,Europe,36,1055,10
2020-04-09T00:00:00Z,9,4,2020,36,4,Slovenia,SI,SVN,2080908,Europe,40,1091,11
2020-04-10T00:00:00Z,10,4,2020,33,3,Slovenia,SI,SVN,2080908,Europe,43,1124,12
2020-04-11T00:00:00Z,11,4,2020,36,2,Slovenia,SI,SVN,2080908,Europe,45,1160,13
2020-04-12T00:00:00Z,12,4,2020,28,5,Slovenia,SI,SVN,2080908,Europe,50,1188,14
2020-04-13T00:00:00Z,13,4,2020,17,3,Slovenia,SI,SVN,2080908,Europe,53,1205,15
2020-04-14T00:00:00Z,14,4,2020,7,2,Slovenia,SI,SVN,2080908,Europe,55,1212,16
2020-04-15T00:00:00Z,15,4,2020,8,1,Slovenia,SI,SVN,2080908,Europe,56,1220,17
2020-04-16T00:00:00Z,16,4,2020,28,5,Slovenia,SI,SVN,2080908,Europe,61,1248,18
2020-04-17T00:00:00Z,17,4,2020,20,0,Slovenia,SI,SVN,2080908,Europe,61,1268,19
2020-04-18T00:00:00Z,18,4,2020,36,5,Slovenia,SI,SVN,2080908,Europe,66,1304,20
2020-04-19T00:00:00Z,19,4,2020,13,4,Slovenia,SI,SVN,2080908,Europe,70,1317,21
2020-04-20T00:00:00Z,20,4,2020,13,4,Slovenia,SI,SVN,2080908,Europe,74,1330,22
2020-04-21T00:00:00Z,21,4,2020,5,0,Slovenia,SI,SVN,2080908,Europe,74,1335,23
2020-04-22T00:00:00Z,22,4,2020,5,3,Slovenia,SI,SVN,2080908,Europe,77,1340,24
2020-04-23T00:00:00Z,23,4,2020,13,2,Slovenia,SI,SVN,2080908,Europe,79,1353,25
2020-04-24T00:00:00Z,24,4,2020,13,0,Slovenia,SI,SVN,2080908,Europe,79,1366,26
2020-04-25T00:00:00Z,25,4,2020,7,1,Slovenia,SI,SVN,2080908,Europe,80,1373,27
2020-04-26T00:00:00Z,26,4,2020,15,1,Slovenia,SI,SVN,2080908,Europe,81,1388,28
2020-04-27T00:00:00Z,27,4,2020,19,1,Slovenia,SI,SVN,2080908,Europe,82,1407,29
2020-04-28T00:00:00Z,28,4,2020,0,1,Slovenia,SI,SVN,2080908,Europe,83,1407,30
2020-04-29T00:00:00Z,29,4,2020,1,3,Slovenia,SI,SVN,2080908,Europe,86,1408,31
2020-04-30T00:00:00Z,30,4,2020,10,3,Slovenia,SI,SVN,2080908,Europe,89,1418,32
2020-05-01T00:00:00Z,1,5,2020,11,2,Slovenia,SI,SVN,2080908,Europe,91,1429,33
2020-05-02T00:00:00Z,2,5,2020,5,2,Slovenia,SI,SVN,2080908,Europe,93,1434,34
2020-05-03T00:00:00Z,3,5,2020,5,1,Slovenia,SI,SVN,2080908,Europe,94,1439,35
2020-05-04T00:00:00Z,4,5,2020,0,2,Slovenia,SI,SVN,2080908,Europe,96,1439,36
2020-05-05T00:00:00Z,5,5,2020,6,1,Slovenia,SI,SVN,2080908,Europe,97,1445,37
2020-05-06T00:00:00Z,6,5,2020,3,1,Slovenia,SI,SVN,2080908,Europe,98,1448,38
2020-05-07T00:00:00Z,7,5,2020,1,1,Slovenia,SI,SVN,2080908,Europe,99,1449,39
2020-05-08T00:00:00Z,8,5,2020,1,0,Slovenia,SI,SVN,2080908,Europe,99,1450,40
2020-05-09T00:00:00Z,9,5,2020,4,1,Slovenia,SI,SVN,2080908,Europe,100,1454,41
2020-05-10T00:00:00Z,10,5,2020,3,1,Slovenia,SI,SVN,2080908,Europe,101,1457,42
2020-05-11T00:00:00Z,11,5,2020,3,1,Slovenia,SI,SVN,2080908,Europe,102,1460,43
2020-05-12T00:00:00Z,12,5,2020,1,0,Slovenia,SI,SVN,2080908,Europe,102,1461,44
2020-05-13T00:00:00Z,13,5,2020,2,0,Slovenia,SI,SVN,2080908,Europe,102,1463,45
2020-05-14T00:00:00Z,14,5,2020,1,1,Slovenia,SI,SVN,2080908,Europe,103,1464,46
2020-05-15T00:00:00Z,15,5,2020,1,0,Slovenia,SI,SVN,2080908,Europe,103,1465,47
2020-05-16T00:00:00Z,16,5,2020,0,0,Slovenia,SI,SVN,2080908,Europe,103,1465,48
2020-05-17T00:00:00Z,17,5,2020,1,0,Slovenia,SI,SVN,2080908,Europe,103,1466,49
2020-05-18T00:00:00Z,18,5,2020,0,1,Slovenia,SI,SVN,2080908,Europe,104,1466,50
2020-05-19T00:00:00Z,19,5,2020,1,0,Slovenia,SI,SVN,2080908,Europe,104,1467,51
2020-05-20T00:00:00Z,20,5,2020,1,0,Slovenia,SI,SVN,2080908,Europe,104,1468,52
2020-05-21T00:00:00Z,21,5,2020,0,2,Slovenia,SI,SVN,2080908,Europe,106,1468,53
2020-05-22T00:00:00Z,22,5,2020,0,0,Slovenia,SI,SVN,2080908,Europe,106,1468,54
2020-05-23T00:00:00Z,23,5,2020,0,0,Slovenia,SI,SVN,2080908,Europe,106,1468,55
2020-05-24T00:00:00Z,24,5,2020,0,0,Slovenia,SI,SVN,2080908,Europe,106,1468,56
2020-05-25T00:00:00Z,25,5,2020,1,0,Slovenia,SI,SVN,2080908,Europe,106,1469,57
2020-05-26T00:00:00Z,26,5,2020,0,0,Slovenia,SI,SVN,2080908,Europe,106,1469,58
2020-05-27T00:00:00Z,27,5,2020,0,0,Slovenia,SI,SVN,2080908,Europe,106,1469,59
2020-05-28T00:00:00Z,28,5,2020,2,1,Slovenia,SI,SVN,2080908,Europe,107,1471,60
2020-05-29T00:00:00Z,29,5,2020,2,1,Slovenia,SI,SVN,2080908,Europe,108,1473,61
2020-05-30T00:00:00Z,30,5,2020,0,0,Slovenia,SI,SVN,2080908,Europe,108,1473,62
2020-05-31T00:00:00Z,31,5,2020,0,0,Slovenia,SI,SVN,2080908,Europe,108,1473,63
2020-06-01T00:00:00Z,1,6,2020,0,0,Slovenia,SI,SVN,2080908,Europe,108,1473,64
2020-06-02T00:00:00Z,2,6,2020,2,0,Slovenia,SI,SVN,2080908,Europe,108,1475,65
2020-06-03T00:00:00Z,3,6,2020,0,0,Slovenia,SI,SVN,2080908,Europe,108,1475,66
2020-06-04T00:00:00Z,4,6,2020,2,0,Slovenia,SI,SVN,2080908,Europe,108,1477,67
2020-06-05T00:00:00Z,5,6,2020,2,0,Slovenia,SI,SVN,2080908,Europe,108,1479,68
2020-06-06T00:00:00Z,6,6,2020,5,0,Slovenia,SI,SVN,2080908,Europe,108,1484,69
2020-06-07T00:00:00Z,7,6,2020,1,0,Slovenia,SI,SVN,2080908,Europe,108,1485,70
2020-06-08T00:00:00Z,8,6,2020,0,0,Slovenia,SI,SVN,2080908,Europe,108,1485,71
2020-06-09T00:00:00Z,9,6,2020,0,0,Slovenia,SI,SVN,2080908,Europe,108,1485,72
2020-06-10T00:00:00Z,10,6,2020,1,0,Slovenia,SI,SVN,2080908,Europe,108,1486,73
2020-06-11T00:00:00Z,11,6,2020,2,1,Slovenia,SI,SVN,2080908,Europe,109,1488,74
2020-06-12T00:00:00Z,12,6,2020,0,0,Slovenia,SI,SVN,2080908,Europe,109,1488,75
2020-06-13T00:00:00Z,13,6,2020,2,0,Slovenia,SI,SVN,2080908,Europe,109,1490,76
2020-06-14T00:00:00Z,14,6,2020,2,0,Slovenia,SI,SVN,2080908,Europe,109,1492,77
2020-06-15T00:00:00Z,15,6,2020,3,0,Slovenia,SI,SVN,2080908,Europe,109,1495,78
2020-06-16T00:00:00Z,16,6,2020,1,0,Slovenia,SI,SVN,2080908,Europe,109,1496,79
2020-06-17T00:00:00Z,17,6,2020,3,0,Slovenia,SI,SVN,2080908,Europe,109,1499,80
2020-06-18T00:00:00Z,18,6,2020,4,0,Slovenia,SI,SVN,2080908,Europe,109,1503,81
2020-06-19T00:00:00Z,19,6,2020,8,0,Slovenia,SI,SVN,2080908,Europe,109,1511,82
2020-06-20T00:00:00Z,20,6,2020,2,0,Slovenia,SI,SVN,2080908,Europe,109,1513,83
2020-06-21T00:00:00Z,21,6,2020,6,0,Slovenia,SI,SVN,2080908,Europe,109,1519,84
2020-06-22T00:00:00Z,22,6,2020,1,0,Slovenia,SI,SVN,2080908,Europe,109,1520,85
2020-06-23T00:00:00Z,23,6,2020,1,0,Slovenia,SI,SVN,2080908,Europe,109,1521,86
2020-06-24T00:00:00Z,24,6,2020,13,2,Slovenia,SI,SVN,2080908,Europe,111,1534,87
2020-06-25T00:00:00Z,25,6,2020,7,0,Slovenia,SI,SVN,2080908,Europe,111,1541,88
2020-04-23T00:00:00Z,23,4,2020,0,6,Somalia,SO,SOM,15442906,Africa,14,286,1
2020-04-24T00:00:00Z,24,4,2020,42,0,Somalia,SO,SOM,15442906,Africa,14,328,2
2020-04-25T00:00:00Z,25,4,2020,0,2,Somalia,SO,SOM,15442906,Africa,16,328,3
2020-04-26T00:00:00Z,26,4,2020,62,2,Somalia,SO,SOM,15442906,Africa,18,390,4
2020-04-27T00:00:00Z,27,4,2020,46,5,Somalia,SO,SOM,15442906,Africa,23,436,5
2020-04-28T00:00:00Z,28,4,2020,44,3,Somalia,SO,SOM,15442906,Africa,26,480,6
2020-04-29T00:00:00Z,29,4,2020,48,2,Somalia,SO,SOM,15442906,Africa,28,528,7
2020-04-30T00:00:00Z,30,4,2020,54,0,Somalia,SO,SOM,15442906,Africa,28,582,8
2020-05-01T00:00:00Z,1,5,2020,19,0,Somalia,SO,SOM,15442906,Africa,28,601,9
2020-05-02T00:00:00Z,2,5,2020,0,0,Somalia,SO,SOM,15442906,Africa,28,601,10
2020-05-03T00:00:00Z,3,5,2020,70,3,Somalia,SO,SOM,15442906,Africa,31,671,11
2020-05-04T00:00:00Z,4,5,2020,51,1,Somalia,SO,SOM,15442906,Africa,32,722,12
2020-05-05T00:00:00Z,5,5,2020,34,3,Somalia,SO,SOM,15442906,Africa,35,756,13
2020-05-06T00:00:00Z,6,5,2020,79,3,Somalia,SO,SOM,15442906,Africa,38,835,14
2020-05-07T00:00:00Z,7,5,2020,38,1,Somalia,SO,SOM,15442906,Africa,39,873,15
2020-05-08T00:00:00Z,8,5,2020,55,5,Somalia,SO,SOM,15442906,Africa,44,928,16
2020-05-09T00:00:00Z,9,5,2020,0,0,Somalia,SO,SOM,15442906,Africa,44,928,17
2020-05-10T00:00:00Z,10,5,2020,69,4,Somalia,SO,SOM,15442906,Africa,48,997,18
2020-05-11T00:00:00Z,11,5,2020,57,3,Somalia,SO,SOM,15442906,Africa,51,1054,19
2020-05-12T00:00:00Z,12,5,2020,35,1,Somalia,SO,SOM,15442906,Africa,52,1089,20
2020-05-13T00:00:00Z,13,5,2020,81,0,Somalia,SO,SOM,15442906,Africa,52,1170,21
2020-05-14T00:00:00Z,14,5,2020,49,0,Somalia,SO,SOM,15442906,Africa,52,1219,22
2020-05-15T00:00:00Z,15,5,2020,65,1,Somalia,SO,SOM,15442906,Africa,53,1284,23
2020-05-16T00:00:00Z,16,5,2020,0,0,Somalia,SO,SOM,15442906,Africa,53,1284,24
2020-05-17T00:00:00Z,17,5,2020,73,2,Somalia,SO,SOM,15442906,Africa,55,1357,25
2020-05-18T00:00:00Z,18,5,2020,64,1,Somalia,SO,SOM,15442906,Africa,56,1421,26
2020-05-19T00:00:00Z,19,5,2020,34,1,Somalia,SO,SOM,15442906,Africa,57,1455,27
2020-05-20T00:00:00Z,20,5,2020,47,2,Somalia,SO,SOM,15442906,Africa,59,1502,28
2020-05-21T00:00:00Z,21,5,2020,71,2,Somalia,SO,SOM,15442906,Africa,61,1573,29
2020-05-22T00:00:00Z,22,5,2020,21,0,Somalia,SO,SOM,15442906,Africa,61,1594,30
2020-05-23T00:00:00Z,23,5,2020,0,0,Somalia,SO,SOM,15442906,Africa,61,1594,31
2020-05-24T00:00:00Z,24,5,2020,0,0,Somalia,SO,SOM,15442906,Africa,61,1594,32
2020-05-25T00:00:00Z,25,5,2020,0,0,Somalia,SO,SOM,15442906,Africa,61,1594,33
2020-05-26T00:00:00Z,26,5,2020,95,5,Somalia,SO,SOM,15442906,Africa,66,1689,34
2020-05-27T00:00:00Z,27,5,2020,22,1,Somalia,SO,SOM,15442906,Africa,67,1711,35
2020-05-28T00:00:00Z,28,5,2020,20,0,Somalia,SO,SOM,15442906,Africa,67,1731,36
2020-05-29T00:00:00Z,29,5,2020,97,5,Somalia,SO,SOM,15442906,Africa,72,1828,37
2020-05-30T00:00:00Z,30,5,2020,0,0,Somalia,SO,SOM,15442906,Africa,72,1828,38
2020-05-31T00:00:00Z,31,5,2020,88,1,Somalia,SO,SOM,15442906,Africa,73,1916,39
2020-06-01T00:00:00Z,1,6,2020,60,5,Somalia,SO,SOM,15442906,Africa,78,1976,40
2020-06-02T00:00:00Z,2,6,2020,47,1,Somalia,SO,SOM,15442906,Africa,79,2023,41
2020-06-03T00:00:00Z,3,6,2020,66,0,Somalia,SO,SOM,15442906,Africa,79,2089,42
2020-06-04T00:00:00Z,4,6,2020,57,0,Somalia,SO,SOM,15442906,Africa,79,2146,43
2020-06-05T00:00:00Z,5,6,2020,58,0,Somalia,SO,SOM,15442906,Africa,79,2204,44
2020-06-06T00:00:00Z,6,6,2020,0,0,Somalia,SO,SOM,15442906,Africa,79,2204,45
2020-06-07T00:00:00Z,7,6,2020,85,3,Somalia,SO,SOM,15442906,Africa,82,2289,46
2020-06-08T00:00:00Z,8,6,2020,45,1,Somalia,SO,SOM,15442906,Africa,83,2334,47
2020-06-09T00:00:00Z,9,6,2020,34,1,Somalia,SO,SOM,15442906,Africa,84,2368,48
2020-06-10T00:00:00Z,10,6,2020,48,1,Somalia,SO,SOM,15442906,Africa,85,2416,49
2020-06-11T00:00:00Z,11,6,2020,36,0,Somalia,SO,SOM,15442906,Africa,85,2452,50
2020-06-12T00:00:00Z,12,6,2020,61,0,Somalia,SO,SOM,15442906,Africa,85,2513,51
2020-06-13T00:00:00Z,13,6,2020,0,0,Somalia,SO,SOM,15442906,Africa,85,2513,52
2020-06-14T00:00:00Z,14,6,2020,66,2,Somalia,SO,SOM,15442906,Africa,87,2579,53
2020-06-15T00:00:00Z,15,6,2020,24,1,Somalia,SO,SOM,15442906,Africa,88,2603,54
2020-06-16T00:00:00Z,16,6,2020,39,0,Somalia,SO,SOM,15442906,Africa,88,2642,55
2020-06-17T00:00:00Z,17,6,2020,16,0,Somalia,SO,SOM,15442906,Africa,88,2658,56
2020-06-18T00:00:00Z,18,6,2020,38,0,Somalia,SO,SOM,15442906,Africa,88,2696,57
2020-06-19T00:00:00Z,19,6,2020,23,0,Somalia,SO,SOM,15442906,Africa,88,2719,58
2020-06-20T00:00:00Z,20,6,2020,0,0,Somalia,SO,SOM,15442906,Africa,88,2719,59
2020-06-21T00:00:00Z,21,6,2020,36,0,Somalia,SO,SOM,15442906,Africa,88,2755,60
2020-06-22T00:00:00Z,22,6,2020,24,2,Somalia,SO,SOM,15442906,Africa,90,2779,61
2020-06-23T00:00:00Z,23,6,2020,33,0,Somalia,SO,SOM,15442906,Africa,90,2812,62
2020-06-24T00:00:00Z,24,6,2020,23,0,Somalia,SO,SOM,15442906,Africa,90,2835,63
2020-06-25T00:00:00Z,25,6,2020,25,0,Somalia,SO,SOM,15442906,Africa,90,2860,64
2020-04-06T00:00:00Z,6,4,2020,70,2,South_Africa,ZA,ZAF,58558267,Africa,11,1655,1
2020-04-07T00:00:00Z,7,4,2020,31,1,South_Africa,ZA,ZAF,58558267,Africa,12,1686,2
2020-04-08T00:00:00Z,8,4,2020,63,1,South_Africa,ZA,ZAF,58558267,Africa,13,1749,3
2020-04-09T00:00:00Z,9,4,2020,96,5,South_Africa,ZA,ZAF,58558267,Africa,18,1845,4
2020-04-10T00:00:00Z,10,4,2020,89,0,South_Africa,ZA,ZAF,58558267,Africa,18,1934,5
2020-04-11T00:00:00Z,11,4,2020,69,6,South_Africa,ZA,ZAF,58558267,Africa,24,2003,6
2020-04-12T00:00:00Z,12,4,2020,25,1,South_Africa,ZA,ZAF,58558267,Africa,25,2028,7
2020-04-13T00:00:00Z,13,4,2020,145,0,South_Africa,ZA,ZAF,58558267,Africa,25,2173,8
2020-04-14T00:00:00Z,14,4,2020,99,2,South_Africa,ZA,ZAF,58558267,Africa,27,2272,9
2020-04-15T00:00:00Z,15,4,2020,143,0,South_Africa,ZA,ZAF,58558267,Africa,27,2415,10
2020-04-16T00:00:00Z,16,4,2020,91,7,South_Africa,ZA,ZAF,58558267,Africa,34,2506,11
2020-04-17T00:00:00Z,17,4,2020,99,14,South_Africa,ZA,ZAF,58558267,Africa,48,2605,12
2020-04-18T00:00:00Z,18,4,2020,178,2,South_Africa,ZA,ZAF,58558267,Africa,50,2783,13
2020-04-19T00:00:00Z,19,4,2020,251,2,South_Africa,ZA,ZAF,58558267,Africa,52,3034,14
2020-04-20T00:00:00Z,20,4,2020,124,2,South_Africa,ZA,ZAF,58558267,Africa,54,3158,15
2020-04-21T00:00:00Z,21,4,2020,142,4,South_Africa,ZA,ZAF,58558267,Africa,58,3300,16
2020-04-22T00:00:00Z,22,4,2020,165,0,South_Africa,ZA,ZAF,58558267,Africa,58,3465,17
2020-04-23T00:00:00Z,23,4,2020,170,7,South_Africa,ZA,ZAF,58558267,Africa,65,3635,18
2020-04-24T00:00:00Z,24,4,2020,318,10,South_Africa,ZA,ZAF,58558267,Africa,75,3953,19
2020-04-25T00:00:00Z,25,4,2020,267,4,South_Africa,ZA,ZAF,58558267,Africa,79,4220,20
2020-04-26T00:00:00Z,26,4,2020,141,7,South_Africa,ZA,ZAF,58558267,Africa,86,4361,21
2020-04-27T00:00:00Z,27,4,2020,185,1,South_Africa,ZA,ZAF,58558267,Africa,87,4546,22
2020-04-28T00:00:00Z,28,4,2020,247,3,South_Africa,ZA,ZAF,58558267,Africa,90,4793,23
2020-04-29T00:00:00Z,29,4,2020,203,3,South_Africa,ZA,ZAF,58558267,Africa,93,4996,24
2020-04-30T00:00:00Z,30,4,2020,354,10,South_Africa,ZA,ZAF,58558267,Africa,103,5350,25
2020-05-01T00:00:00Z,1,5,2020,297,0,South_Africa,ZA,ZAF,58558267,Africa,103,5647,26
2020-05-02T00:00:00Z,2,5,2020,304,13,South_Africa,ZA,ZAF,58558267,Africa,116,5951,27
2020-05-03T00:00:00Z,3,5,2020,385,7,South_Africa,ZA,ZAF,58558267,Africa,123,6336,28
2020-05-04T00:00:00Z,4,5,2020,447,8,South_Africa,ZA,ZAF,58558267,Africa,131,6783,29
2020-05-05T00:00:00Z,5,5,2020,437,7,South_Africa,ZA,ZAF,58558267,Africa,138,7220,30
2020-05-06T00:00:00Z,6,5,2020,352,10,South_Africa,ZA,ZAF,58558267,Africa,148,7572,31
2020-05-07T00:00:00Z,7,5,2020,236,5,South_Africa,ZA,ZAF,58558267,Africa,153,7808,32
2020-05-08T00:00:00Z,8,5,2020,424,8,South_Africa,ZA,ZAF,58558267,Africa,161,8232,33
2020-05-09T00:00:00Z,9,5,2020,663,17,South_Africa,ZA,ZAF,58558267,Africa,178,8895,34
2020-05-10T00:00:00Z,10,5,2020,525,8,South_Africa,ZA,ZAF,58558267,Africa,186,9420,35
2020-05-11T00:00:00Z,11,5,2020,595,8,South_Africa,ZA,ZAF,58558267,Africa,194,10015,36
2020-05-12T00:00:00Z,12,5,2020,637,12,South_Africa,ZA,ZAF,58558267,Africa,206,10652,37
2020-05-13T00:00:00Z,13,5,2020,698,0,South_Africa,ZA,ZAF,58558267,Africa,206,11350,38
2020-05-14T00:00:00Z,14,5,2020,724,13,South_Africa,ZA,ZAF,58558267,Africa,219,12074,39
2020-05-15T00:00:00Z,15,5,2020,665,19,South_Africa,ZA,ZAF,58558267,Africa,238,12739,40
2020-05-16T00:00:00Z,16,5,2020,785,9,South_Africa,ZA,ZAF,58558267,Africa,247,13524,41
2020-05-17T00:00:00Z,17,5,2020,831,14,South_Africa,ZA,ZAF,58558267,Africa,261,14355,42
2020-05-18T00:00:00Z,18,5,2020,1160,3,South_Africa,ZA,ZAF,58558267,Africa,264,15515,43
2020-05-19T00:00:00Z,19,5,2020,918,22,South_Africa,ZA,ZAF,58558267,Africa,286,16433,44
2020-05-20T00:00:00Z,20,5,2020,767,26,South_Africa,ZA,ZAF,58558267,Africa,312,17200,45
2020-05-21T00:00:00Z,21,5,2020,803,27,South_Africa,ZA,ZAF,58558267,Africa,339,18003,46
2020-05-22T00:00:00Z,22,5,2020,1134,30,South_Africa,ZA,ZAF,58558267,Africa,369,19137,47
2020-05-23T00:00:00Z,23,5,2020,988,28,South_Africa,ZA,ZAF,58558267,Africa,397,20125,48
2020-05-24T00:00:00Z,24,5,2020,1218,10,South_Africa,ZA,ZAF,58558267,Africa,407,21343,49
2020-05-25T00:00:00Z,25,5,2020,1240,22,South_Africa,ZA,ZAF,58558267,Africa,429,22583,50
2020-05-26T00:00:00Z,26,5,2020,1032,52,South_Africa,ZA,ZAF,58558267,Africa,481,23615,51
2020-05-27T00:00:00Z,27,5,2020,649,43,South_Africa,ZA,ZAF,58558267,Africa,524,24264,52
2020-05-28T00:00:00Z,28,5,2020,1673,28,South_Africa,ZA,ZAF,58558267,Africa,552,25937,53
2020-05-29T00:00:00Z,29,5,2020,1466,25,South_Africa,ZA,ZAF,58558267,Africa,577,27403,54
2020-05-30T00:00:00Z,30,5,2020,1837,34,South_Africa,ZA,ZAF,58558267,Africa,611,29240,55
2020-05-31T00:00:00Z,31,5,2020,1727,32,South_Africa,ZA,ZAF,58558267,Africa,643,30967,56
2020-06-01T00:00:00Z,1,6,2020,1716,40,South_Africa,ZA,ZAF,58558267,Africa,683,32683,57
2020-06-02T00:00:00Z,2,6,2020,1674,22,South_Africa,ZA,ZAF,58558267,Africa,705,34357,58
2020-06-03T00:00:00Z,3,6,2020,1455,50,South_Africa,ZA,ZAF,58558267,Africa,755,35812,59
2020-06-04T00:00:00Z,4,6,2020,1713,37,South_Africa,ZA,ZAF,58558267,Africa,792,37525,60
2020-06-05T00:00:00Z,5,6,2020,3267,56,South_Africa,ZA,ZAF,58558267,Africa,848,40792,61
2020-06-06T00:00:00Z,6,6,2020,2642,60,South_Africa,ZA,ZAF,58558267,Africa,908,43434,62
2020-06-07T00:00:00Z,7,6,2020,2539,44,South_Africa,ZA,ZAF,58558267,Africa,952,45973,63
2020-06-08T00:00:00Z,8,6,2020,2312,46,South_Africa,ZA,ZAF,58558267,Africa,998,48285,64
2020-06-09T00:00:00Z,9,6,2020,2594,82,South_Africa,ZA,ZAF,58558267,Africa,1080,50879,65
2020-06-10T00:00:00Z,10,6,2020,2112,82,South_Africa,ZA,ZAF,58558267,Africa,1162,52991,66
2020-06-11T00:00:00Z,11,6,2020,2430,48,South_Africa,ZA,ZAF,58558267,Africa,1210,55421,67
2020-06-12T00:00:00Z,12,6,2020,3147,79,South_Africa,ZA,ZAF,58558267,Africa,1289,58568,68
2020-06-13T00:00:00Z,13,6,2020,3359,65,South_Africa,ZA,ZAF,58558267,Africa,1354,61927,69
2020-06-14T00:00:00Z,14,6,2020,3809,69,South_Africa,ZA,ZAF,58558267,Africa,1423,65736,70
2020-06-15T00:00:00Z,15,6,2020,4302,57,South_Africa,ZA,ZAF,58558267,Africa,1480,70038,71
2020-06-16T00:00:00Z,16,6,2020,3495,88,South_Africa,ZA,ZAF,58558267,Africa,1568,73533,72
2020-06-17T00:00:00Z,17,6,2020,2801,57,South_Africa,ZA,ZAF,58558267,Africa,1625,76334,73
2020-06-18T00:00:00Z,18,6,2020,4078,49,South_Africa,ZA,ZAF,58558267,Africa,1674,80412,74
2020-06-19T00:00:00Z,19,6,2020,3478,63,South_Africa,ZA,ZAF,58558267,Africa,1737,83890,75
2020-06-20T00:00:00Z,20,6,2020,3825,94,South_Africa,ZA,ZAF,58558267,Africa,1831,87715,76
2020-06-21T00:00:00Z,21,6,2020,4966,46,South_Africa,ZA,ZAF,58558267,Africa,1877,92681,77
2020-06-22T00:00:00Z,22,6,2020,4621,53,South_Africa,ZA,ZAF,58558267,Africa,1930,97302,78
2020-06-23T00:00:00Z,23,6,2020,4288,61,South_Africa,ZA,ZAF,58558267,Africa,1991,101590,79
2020-06-24T00:00:00Z,24,6,2020,4518,111,South_Africa,ZA,ZAF,58558267,Africa,2102,106108,80
2020-06-25T00:00:00Z,25,6,2020,5688,103,South_Africa,ZA,ZAF,58558267,Africa,2205,111796,81
2020-02-26T00:00:00Z,26,2,2020,254,3,South_Korea,KR,KOR,51225321,Asia,11,1146,1
2020-02-27T00:00:00Z,27,2,2020,449,1,South_Korea,KR,KOR,51225321,Asia,12,1595,2
2020-02-28T00:00:00Z,28,2,2020,427,1,South_Korea,KR,KOR,51225321,Asia,13,2022,3
2020-02-29T00:00:00Z,29,2,2020,909,3,South_Korea,KR,KOR,51225321,Asia,16,2931,4
2020-03-01T00:00:00Z,1,3,2020,595,1,South_Korea,KR,KOR,51225321,Asia,17,3526,5
2020-03-02T00:00:00Z,2,3,2020,686,5,South_Korea,KR,KOR,51225321,Asia,22,4212,6
2020-03-03T00:00:00Z,3,3,2020,600,6,South_Korea,KR,KOR,51225321,Asia,28,4812,7
2020-03-04T00:00:00Z,4,3,2020,516,4,South_Korea,KR,KOR,51225321,Asia,32,5328,8
2020-03-05T00:00:00Z,5,3,2020,438,3,South_Korea,KR,KOR,51225321,Asia,35,5766,9
2020-03-06T00:00:00Z,6,3,2020,518,7,South_Korea,KR,KOR,51225321,Asia,42,6284,10
2020-03-07T00:00:00Z,7,3,2020,483,2,South_Korea,KR,KOR,51225321,Asia,44,6767,11
2020-03-08T00:00:00Z,8,3,2020,367,6,South_Korea,KR,KOR,51225321,Asia,50,7134,12
2020-03-09T00:00:00Z,9,3,2020,248,1,South_Korea,KR,KOR,51225321,Asia,51,7382,13
2020-03-10T00:00:00Z,10,3,2020,131,3,South_Korea,KR,KOR,51225321,Asia,54,7513,14
2020-03-11T00:00:00Z,11,3,2020,242,6,South_Korea,KR,KOR,51225321,Asia,60,7755,15
2020-03-12T00:00:00Z,12,3,2020,114,6,South_Korea,KR,KOR,51225321,Asia,66,7869,16
2020-03-13T00:00:00Z,13,3,2020,110,1,South_Korea,KR,KOR,51225321,Asia,67,7979,17
2020-03-14T00:00:00Z,14,3,2020,107,5,South_Korea,KR,KOR,51225321,Asia,72,8086,18
2020-03-15T00:00:00Z,15,3,2020,76,3,South_Korea,KR,KOR,51225321,Asia,75,8162,19
2020-03-16T00:00:00Z,16,3,2020,74,0,South_Korea,KR,KOR,51225321,Asia,75,8236,20
2020-03-17T00:00:00Z,17,3,2020,84,6,South_Korea,KR,KOR,51225321,Asia,81,8320,21
2020-03-18T00:00:00Z,18,3,2020,93,5,South_Korea,KR,KOR,51225321,Asia,86,8413,22
2020-03-19T00:00:00Z,19,3,2020,152,5,South_Korea,KR,KOR,51225321,Asia,91,8565,23
2020-03-20T00:00:00Z,20,3,2020,87,9,South_Korea,KR,KOR,51225321,Asia,100,8652,24
2020-03-21T00:00:00Z,21,3,2020,147,3,South_Korea,KR,KOR,51225321,Asia,103,8799,25
2020-03-22T00:00:00Z,22,3,2020,98,1,South_Korea,KR,KOR,51225321,Asia,104,8897,26
2020-03-23T00:00:00Z,23,3,2020,64,9,South_Korea,KR,KOR,51225321,Asia,113,8961,27
2020-03-24T00:00:00Z,24,3,2020,76,7,South_Korea,KR,KOR,51225321,Asia,120,9037,28
2020-03-25T00:00:00Z,25,3,2020,100,6,South_Korea,KR,KOR,51225321,Asia,126,9137,29
2020-03-26T00:00:00Z,26,3,2020,104,5,South_Korea,KR,KOR,51225321,Asia,131,9241,30
2020-03-27T00:00:00Z,27,3,2020,91,8,South_Korea,KR,KOR,51225321,Asia,139,9332,31
2020-03-28T00:00:00Z,28,3,2020,146,5,South_Korea,KR,KOR,51225321,Asia,144,9478,32
2020-03-29T00:00:00Z,29,3,2020,105,8,South_Korea,KR,KOR,51225321,Asia,152,9583,33
2020-03-30T00:00:00Z,30,3,2020,78,6,South_Korea,KR,KOR,51225321,Asia,158,9661,34
2020-03-31T00:00:00Z,31,3,2020,125,5,South_Korea,KR,KOR,51225321,Asia,163,9786,35
2020-04-01T00:00:00Z,1,4,2020,0,0,South_Korea,KR,KOR,51225321,Asia,163,9786,36
2020-04-02T00:00:00Z,2,4,2020,190,6,South_Korea,KR,KOR,51225321,Asia,169,9976,37
2020-04-03T00:00:00Z,3,4,2020,86,5,South_Korea,KR,KOR,51225321,Asia,174,10062,38
2020-04-04T00:00:00Z,4,4,2020,94,3,South_Korea,KR,KOR,51225321,Asia,177,10156,39
2020-04-05T00:00:00Z,5,4,2020,81,6,South_Korea,KR,KOR,51225321,Asia,183,10237,40
2020-04-06T00:00:00Z,6,4,2020,47,3,South_Korea,KR,KOR,51225321,Asia,186,10284,41
2020-04-07T00:00:00Z,7,4,2020,47,6,South_Korea,KR,KOR,51225321,Asia,192,10331,42
2020-04-08T00:00:00Z,8,4,2020,53,8,South_Korea,KR,KOR,51225321,Asia,200,10384,43
2020-04-09T00:00:00Z,9,4,2020,39,4,South_Korea,KR,KOR,51225321,Asia,204,10423,44
2020-04-10T00:00:00Z,10,4,2020,27,4,South_Korea,KR,KOR,51225321,Asia,208,10450,45
2020-04-11T00:00:00Z,11,4,2020,0,0,South_Korea,KR,KOR,51225321,Asia,208,10450,46
2020-04-12T00:00:00Z,12,4,2020,62,6,South_Korea,KR,KOR,51225321,Asia,214,10512,47
2020-04-13T00:00:00Z,13,4,2020,25,3,South_Korea,KR,KOR,51225321,Asia,217,10537,48
2020-04-14T00:00:00Z,14,4,2020,27,5,South_Korea,KR,KOR,51225321,Asia,222,10564,49
2020-04-15T00:00:00Z,15,4,2020,27,3,South_Korea,KR,KOR,51225321,Asia,225,10591,50
2020-04-16T00:00:00Z,16,4,2020,22,4,South_Korea,KR,KOR,51225321,Asia,229,10613,51
2020-04-17T00:00:00Z,17,4,2020,22,1,South_Korea,KR,KOR,51225321,Asia,230,10635,52
2020-04-18T00:00:00Z,18,4,2020,18,2,South_Korea,KR,KOR,51225321,Asia,232,10653,53
2020-04-19T00:00:00Z,19,4,2020,8,2,South_Korea,KR,KOR,51225321,Asia,234,10661,54
2020-04-20T00:00:00Z,20,4,2020,13,2,South_Korea,KR,KOR,51225321,Asia,236,10674,55
2020-04-21T00:00:00Z,21,4,2020,9,1,South_Korea,KR,KOR,51225321,Asia,237,10683,56
2020-04-22T00:00:00Z,22,4,2020,11,1,South_Korea,KR,KOR,51225321,Asia,238,10694,57
2020-04-23T00:00:00Z,23,4,2020,8,2,South_Korea,KR,KOR,51225321,Asia,240,10702,58
2020-04-24T00:00:00Z,24,4,2020,6,0,South_Korea,KR,KOR,51225321,Asia,240,10708,59
2020-04-25T00:00:00Z,25,4,2020,10,0,South_Korea,KR,KOR,51225321,Asia,240,10718,60
2020-04-26T00:00:00Z,26,4,2020,10,2,South_Korea,KR,KOR,51225321,Asia,242,10728,61
2020-04-27T00:00:00Z,27,4,2020,10,1,South_Korea,KR,KOR,51225321,Asia,243,10738,62
2020-04-28T00:00:00Z,28,4,2020,14,1,South_Korea,KR,KOR,51225321,Asia,244,10752,63
2020-04-29T00:00:00Z,29,4,2020,9,2,South_Korea,KR,KOR,51225321,Asia,246,10761,64
2020-04-30T00:00:00Z,30,4,2020,4,1,South_Korea,KR,KOR,51225321,Asia,247,10765,65
2020-05-01T00:00:00Z,1,5,2020,9,1,South_Korea,KR,KOR,51225321,Asia,248,10774,66
2020-05-02T00:00:00Z,2,5,2020,6,2,South_Korea,KR,KOR,51225321,Asia,250,10780,67
2020-05-03T00:00:00Z,3,5,2020,13,0,South_Korea,KR,KOR,51225321,Asia,250,10793,68
2020-05-04T00:00:00Z,4,5,2020,8,2,South_Korea,KR,KOR,51225321,Asia,252,10801,69
2020-05-05T00:00:00Z,5,5,2020,3,2,South_Korea,KR,KOR,51225321,Asia,254,10804,70
2020-05-06T00:00:00Z,6,5,2020,2,1,South_Korea,KR,KOR,51225321,Asia,255,10806,71
2020-05-07T00:00:00Z,7,5,2020,4,1,South_Korea,KR,KOR,51225321,Asia,256,10810,72
2020-05-08T00:00:00Z,8,5,2020,12,0,South_Korea,KR,KOR,51225321,Asia,256,10822,73
2020-05-09T00:00:00Z,9,5,2020,18,0,South_Korea,KR,KOR,51225321,Asia,256,10840,74
2020-05-10T00:00:00Z,10,5,2020,34,0,South_Korea,KR,KOR,51225321,Asia,256,10874,75
2020-05-11T00:00:00Z,11,5,2020,35,0,South_Korea,KR,KOR,51225321,Asia,256,10909,76
2020-05-12T00:00:00Z,12,5,2020,27,2,South_Korea,KR,KOR,51225321,Asia,258,10936,77
2020-05-13T00:00:00Z,13,5,2020,26,1,South_Korea,KR,KOR,51225321,Asia,259,10962,78
2020-05-14T00:00:00Z,14,5,2020,29,1,South_Korea,KR,KOR,51225321,Asia,260,10991,79
2020-05-15T00:00:00Z,15,5,2020,27,0,South_Korea,KR,KOR,51225321,Asia,260,11018,80
2020-05-16T00:00:00Z,16,5,2020,19,2,South_Korea,KR,KOR,51225321,Asia,262,11037,81
2020-05-17T00:00:00Z,17,5,2020,13,0,South_Korea,KR,KOR,51225321,Asia,262,11050,82
2020-05-18T00:00:00Z,18,5,2020,15,1,South_Korea,KR,KOR,51225321,Asia,263,11065,83
2020-05-19T00:00:00Z,19,5,2020,13,0,South_Korea,KR,KOR,51225321,Asia,263,11078,84
2020-05-20T00:00:00Z,20,5,2020,32,0,South_Korea,KR,KOR,51225321,Asia,263,11110,85
2020-05-21T00:00:00Z,21,5,2020,12,1,South_Korea,KR,KOR,51225321,Asia,264,11122,86
2020-05-22T00:00:00Z,22,5,2020,20,0,South_Korea,KR,KOR,51225321,Asia,264,11142,87
2020-05-23T00:00:00Z,23,5,2020,23,2,South_Korea,KR,KOR,51225321,Asia,266,11165,88
2020-05-24T00:00:00Z,24,5,2020,25,0,South_Korea,KR,KOR,51225321,Asia,266,11190,89
2020-05-25T00:00:00Z,25,5,2020,16,1,South_Korea,KR,KOR,51225321,Asia,267,11206,90
2020-05-26T00:00:00Z,26,5,2020,19,2,South_Korea,KR,KOR,51225321,Asia,269,11225,91
2020-05-27T00:00:00Z,27,5,2020,40,0,South_Korea,KR,KOR,51225321,Asia,269,11265,92
2020-05-28T00:00:00Z,28,5,2020,79,0,South_Korea,KR,KOR,51225321,Asia,269,11344,93
2020-05-29T00:00:00Z,29,5,2020,58,0,South_Korea,KR,KOR,51225321,Asia,269,11402,94
2020-05-30T00:00:00Z,30,5,2020,39,0,South_Korea,KR,KOR,51225321,Asia,269,11441,95
2020-05-31T00:00:00Z,31,5,2020,27,1,South_Korea,KR,KOR,51225321,Asia,270,11468,96
2020-06-01T00:00:00Z,1,6,2020,35,1,South_Korea,KR,KOR,51225321,Asia,271,11503,97
2020-06-02T00:00:00Z,2,6,2020,38,1,South_Korea,KR,KOR,51225321,Asia,272,11541,98
2020-06-03T00:00:00Z,3,6,2020,49,1,South_Korea,KR,KOR,51225321,Asia,273,11590,99
2020-06-04T00:00:00Z,4,6,2020,39,0,South_Korea,KR,KOR,51225321,Asia,273,11629,100
2020-06-05T00:00:00Z,5,6,2020,39,0,South_Korea,KR,KOR,51225321,Asia,273,11668,101
2020-06-06T00:00:00Z,6,6,2020,51,0,South_Korea,KR,KOR,51225321,Asia,273,11719,102
2020-06-07T00:00:00Z,7,6,2020,57,0,South_Korea,KR,KOR,51225321,Asia,273,11776,103
2020-06-08T00:00:00Z,8,6,2020,38,0,South_Korea,KR,KOR,51225321,Asia,273,11814,104
2020-06-09T00:00:00Z,9,6,2020,38,1,South_Korea,KR,KOR,51225321,Asia,274,11852,105
2020-06-10T00:00:00Z,10,6,2020,50,2,South_Korea,KR,KOR,51225321,Asia,276,11902,106
2020-06-11T00:00:00Z,11,6,2020,45,0,South_Korea,KR,KOR,51225321,Asia,276,11947,107
2020-06-12T00:00:00Z,12,6,2020,56,1,South_Korea,KR,KOR,51225321,Asia,277,12003,108
2020-06-13T00:00:00Z,13,6,2020,48,0,South_Korea,KR,KOR,51225321,Asia,277,12051,109
2020-06-14T00:00:00Z,14,6,2020,33,0,South_Korea,KR,KOR,51225321,Asia,277,12084,110
2020-06-15T00:00:00Z,15,6,2020,37,0,South_Korea,KR,KOR,51225321,Asia,277,12121,111
2020-06-16T00:00:00Z,16,6,2020,34,1,South_Korea,KR,KOR,51225321,Asia,278,12155,112
2020-06-17T00:00:00Z,17,6,2020,43,1,South_Korea,KR,KOR,51225321,Asia,279,12198,113
2020-06-18T00:00:00Z,18,6,2020,59,1,South_Korea,KR,KOR,51225321,Asia,280,12257,114
2020-06-19T00:00:00Z,19,6,2020,49,0,South_Korea,KR,KOR,51225321,Asia,280,12306,115
2020-06-20T00:00:00Z,20,6,2020,67,0,South_Korea,KR,KOR,51225321,Asia,280,12373,116
2020-06-21T00:00:00Z,21,6,2020,48,0,South_Korea,KR,KOR,51225321,Asia,280,12421,117
2020-06-22T00:00:00Z,22,6,2020,17,0,South_Korea,KR,KOR,51225321,Asia,280,12438,118
2020-06-23T00:00:00Z,23,6,2020,46,1,South_Korea,KR,KOR,51225321,Asia,281,12484,119
2020-06-24T00:00:00Z,24,6,2020,51,0,South_Korea,KR,KOR,51225321,Asia,281,12535,120
2020-06-25T00:00:00Z,25,6,2020,28,1,South_Korea,KR,KOR,51225321,Asia,282,12563,121
2020-05-30T00:00:00Z,30,5,2020,188,2,South_Sudan,SS,SSD,11062114,Africa,10,994,1
2020-05-31T00:00:00Z,31,5,2020,0,0,South_Sudan,SS,SSD,11062114,Africa,10,994,2
2020-06-01T00:00:00Z,1,6,2020,0,0,South_Sudan,SS,SSD,11062114,Africa,10,994,3
2020-06-02T00:00:00Z,2,6,2020,0,0,South_Sudan,SS,SSD,11062114,Africa,10,994,4
2020-06-03T00:00:00Z,3,6,2020,0,0,South_Sudan,SS,SSD,11062114,Africa,10,994,5
2020-06-04T00:00:00Z,4,6,2020,0,0,South_Sudan,SS,SSD,11062114,Africa,10,994,6
2020-06-05T00:00:00Z,5,6,2020,323,4,South_Sudan,SS,SSD,11062114,Africa,14,1317,7
2020-06-06T00:00:00Z,6,6,2020,0,0,South_Sudan,SS,SSD,11062114,Africa,14,1317,8
2020-06-07T00:00:00Z,7,6,2020,0,0,South_Sudan,SS,SSD,11062114,Africa,14,1317,9
2020-06-08T00:00:00Z,8,6,2020,0,0,South_Sudan,SS,SSD,11062114,Africa,14,1317,10
2020-06-09T00:00:00Z,9,6,2020,287,5,South_Sudan,SS,SSD,11062114,Africa,19,1604,11
2020-06-10T00:00:00Z,10,6,2020,0,0,South_Sudan,SS,SSD,11062114,Africa,19,1604,12
2020-06-11T00:00:00Z,11,6,2020,0,0,South_Sudan,SS,SSD,11062114,Africa,19,1604,13
2020-06-12T00:00:00Z,12,6,2020,0,0,South_Sudan,SS,SSD,11062114,Africa,19,1604,14
2020-06-13T00:00:00Z,13,6,2020,66,3,South_Sudan,SS,SSD,11062114,Africa,22,1670,15
2020-06-14T00:00:00Z,14,6,2020,23,5,South_Sudan,SS,SSD,11062114,Africa,27,1693,16
2020-06-15T00:00:00Z,15,6,2020,0,0,South_Sudan,SS,SSD,11062114,Africa,27,1693,17
2020-06-16T00:00:00Z,16,6,2020,62,3,South_Sudan,SS,SSD,11062114,Africa,30,1755,18
2020-06-17T00:00:00Z,17,6,2020,21,0,South_Sudan,SS,SSD,11062114,Africa,30,1776,19
2020-06-18T00:00:00Z,18,6,2020,31,1,South_Sudan,SS,SSD,11062114,Africa,31,1807,20
2020-06-19T00:00:00Z,19,6,2020,6,0,South_Sudan,SS,SSD,11062114,Africa,31,1813,21
2020-06-20T00:00:00Z,20,6,2020,0,0,South_Sudan,SS,SSD,11062114,Africa,31,1813,22
2020-06-21T00:00:00Z,21,6,2020,51,3,South_Sudan,SS,SSD,11062114,Africa,34,1864,23
2020-06-22T00:00:00Z,22,6,2020,18,0,South_Sudan,SS,SSD,11062114,Africa,34,1882,24
2020-06-23T00:00:00Z,23,6,2020,10,0,South_Sudan,SS,SSD,11062114,Africa,34,1892,25
2020-06-24T00:00:00Z,24,6,2020,24,1,South_Sudan,SS,SSD,11062114,Africa,35,1916,26
2020-06-25T00:00:00Z,25,6,2020,14,1,South_Sudan,SS,SSD,11062114,Africa,36,1930,27
2020-03-10T00:00:00Z,10,3,2020,772,23,Spain,ES,ESP,46937060,Europe,28,2299,1
2020-03-11T00:00:00Z,11,3,2020,975,7,Spain,ES,ESP,46937060,Europe,35,3274,2
2020-03-12T00:00:00Z,12,3,2020,1153,12,Spain,ES,ESP,46937060,Europe,47,4427,3
2020-03-13T00:00:00Z,13,3,2020,1531,37,Spain,ES,ESP,46937060,Europe,84,5958,4
2020-03-14T00:00:00Z,14,3,2020,1683,37,Spain,ES,ESP,46937060,Europe,121,7641,5
2020-03-15T00:00:00Z,15,3,2020,2144,15,Spain,ES,ESP,46937060,Europe,136,9785,6
2020-03-16T00:00:00Z,16,3,2020,1706,152,Spain,ES,ESP,46937060,Europe,288,11491,7
2020-03-17T00:00:00Z,17,3,2020,2503,21,Spain,ES,ESP,46937060,Europe,309,13994,8
2020-03-18T00:00:00Z,18,3,2020,3694,182,Spain,ES,ESP,46937060,Europe,491,17688,9
2020-03-19T00:00:00Z,19,3,2020,4047,107,Spain,ES,ESP,46937060,Europe,598,21735,10
2020-03-20T00:00:00Z,20,3,2020,4569,169,Spain,ES,ESP,46937060,Europe,767,26304,11
2020-03-21T00:00:00Z,21,3,2020,5446,235,Spain,ES,ESP,46937060,Europe,1002,31750,12
2020-03-22T00:00:00Z,22,3,2020,4866,324,Spain,ES,ESP,46937060,Europe,1326,36616,13
2020-03-23T00:00:00Z,23,3,2020,4646,394,Spain,ES,ESP,46937060,Europe,1720,41262,14
2020-03-24T00:00:00Z,24,3,2020,7691,462,Spain,ES,ESP,46937060,Europe,2182,48953,15
2020-03-25T00:00:00Z,25,3,2020,8553,514,Spain,ES,ESP,46937060,Europe,2696,57506,16
2020-03-26T00:00:00Z,26,3,2020,8954,738,Spain,ES,ESP,46937060,Europe,3434,66460,17
2020-03-27T00:00:00Z,27,3,2020,9181,655,Spain,ES,ESP,46937060,Europe,4089,75641,18
2020-03-28T00:00:00Z,28,3,2020,8244,769,Spain,ES,ESP,46937060,Europe,4858,83885,19
2020-03-29T00:00:00Z,29,3,2020,6424,832,Spain,ES,ESP,46937060,Europe,5690,90309,20
2020-03-30T00:00:00Z,30,3,2020,5813,838,Spain,ES,ESP,46937060,Europe,6528,96122,21
2020-03-31T00:00:00Z,31,3,2020,8145,812,Spain,ES,ESP,46937060,Europe,7340,104267,22
2020-04-01T00:00:00Z,1,4,2020,7413,849,Spain,ES,ESP,46937060,Europe,8189,111680,23
2020-04-02T00:00:00Z,2,4,2020,7583,864,Spain,ES,ESP,46937060,Europe,9053,119263,24
2020-04-03T00:00:00Z,3,4,2020,7272,950,Spain,ES,ESP,46937060,Europe,10003,126535,25
2020-04-04T00:00:00Z,4,4,2020,6663,932,Spain,ES,ESP,46937060,Europe,10935,133198,26
2020-04-05T00:00:00Z,5,4,2020,5533,809,Spain,ES,ESP,46937060,Europe,11744,138731,27
2020-04-06T00:00:00Z,6,4,2020,3667,674,Spain,ES,ESP,46937060,Europe,12418,142398,28
2020-04-07T00:00:00Z,7,4,2020,5209,637,Spain,ES,ESP,46937060,Europe,13055,147607,29
2020-04-08T00:00:00Z,8,4,2020,5583,743,Spain,ES,ESP,46937060,Europe,13798,153190,30
2020-04-09T00:00:00Z,9,4,2020,5745,757,Spain,ES,ESP,46937060,Europe,14555,158935,31
2020-04-10T00:00:00Z,10,4,2020,4537,683,Spain,ES,ESP,46937060,Europe,15238,163472,32
2020-04-11T00:00:00Z,11,4,2020,4550,605,Spain,ES,ESP,46937060,Europe,15843,168022,33
2020-04-12T00:00:00Z,12,4,2020,3899,510,Spain,ES,ESP,46937060,Europe,16353,171921,34
2020-04-13T00:00:00Z,13,4,2020,3030,619,Spain,ES,ESP,46937060,Europe,16972,174951,35
2020-04-14T00:00:00Z,14,4,2020,3116,517,Spain,ES,ESP,46937060,Europe,17489,178067,36
2020-04-15T00:00:00Z,15,4,2020,4424,787,Spain,ES,ESP,46937060,Europe,18276,182491,37
2020-04-16T00:00:00Z,16,4,2020,3820,617,Spain,ES,ESP,46937060,Europe,18893,186311,38
2020-04-17T00:00:00Z,17,4,2020,3818,585,Spain,ES,ESP,46937060,Europe,19478,190129,39
2020-04-18T00:00:00Z,18,4,2020,3836,565,Spain,ES,ESP,46937060,Europe,20043,193965,40
2020-04-19T00:00:00Z,19,4,2020,-713,410,Spain,ES,ESP,46937060,Europe,20453,193252,41
2020-04-20T00:00:00Z,20,4,2020,2218,399,Spain,ES,ESP,46937060,Europe,20852,195470,42
2020-04-21T00:00:00Z,21,4,2020,2951,430,Spain,ES,ESP,46937060,Europe,21282,198421,43
2020-04-22T00:00:00Z,22,4,2020,2312,435,Spain,ES,ESP,46937060,Europe,21717,200733,44
2020-04-23T00:00:00Z,23,4,2020,2916,440,Spain,ES,ESP,46937060,Europe,22157,203649,45
2020-04-24T00:00:00Z,24,4,2020,2114,367,Spain,ES,ESP,46937060,Europe,22524,205763,46
2020-04-25T00:00:00Z,25,4,2020,2506,378,Spain,ES,ESP,46937060,Europe,22902,208269,47
2020-04-26T00:00:00Z,26,4,2020,1641,288,Spain,ES,ESP,46937060,Europe,23190,209910,48
2020-04-27T00:00:00Z,27,4,2020,1660,0,Spain,ES,ESP,46937060,Europe,23190,211570,49
2020-04-28T00:00:00Z,28,4,2020,1525,632,Spain,ES,ESP,46937060,Europe,23822,213095,50
2020-04-29T00:00:00Z,29,4,2020,847,453,Spain,ES,ESP,46937060,Europe,24275,213942,51
2020-04-30T00:00:00Z,30,4,2020,1241,268,Spain,ES,ESP,46937060,Europe,24543,215183,52
2020-05-01T00:00:00Z,1,5,2020,1387,281,Spain,ES,ESP,46937060,Europe,24824,216570,53
2020-05-02T00:00:00Z,2,5,2020,1234,276,Spain,ES,ESP,46937060,Europe,25100,217804,54
2020-05-03T00:00:00Z,3,5,2020,935,164,Spain,ES,ESP,46937060,Europe,25264,218739,55
2020-05-04T00:00:00Z,4,5,2020,466,164,Spain,ES,ESP,46937060,Europe,25428,219205,56
2020-05-05T00:00:00Z,5,5,2020,1039,185,Spain,ES,ESP,46937060,Europe,25613,220244,57
2020-05-06T00:00:00Z,6,5,2020,880,244,Spain,ES,ESP,46937060,Europe,25857,221124,58
2020-05-07T00:00:00Z,7,5,2020,921,213,Spain,ES,ESP,46937060,Europe,26070,222045,59
2020-05-08T00:00:00Z,8,5,2020,1173,181,Spain,ES,ESP,46937060,Europe,26251,223218,60
2020-05-09T00:00:00Z,9,5,2020,743,227,Spain,ES,ESP,46937060,Europe,26478,223961,61
2020-05-10T00:00:00Z,10,5,2020,3416,143,Spain,ES,ESP,46937060,Europe,26621,227377,62
2020-05-11T00:00:00Z,11,5,2020,393,123,Spain,ES,ESP,46937060,Europe,26744,227770,63
2020-05-12T00:00:00Z,12,5,2020,482,176,Spain,ES,ESP,46937060,Europe,26920,228252,64
2020-05-13T00:00:00Z,13,5,2020,439,184,Spain,ES,ESP,46937060,Europe,27104,228691,65
2020-05-14T00:00:00Z,14,5,2020,849,217,Spain,ES,ESP,46937060,Europe,27321,229540,66
2020-05-15T00:00:00Z,15,5,2020,643,138,Spain,ES,ESP,46937060,Europe,27459,230183,67
2020-05-16T00:00:00Z,16,5,2020,515,104,Spain,ES,ESP,46937060,Europe,27563,230698,68
2020-05-17T00:00:00Z,17,5,2020,652,87,Spain,ES,ESP,46937060,Europe,27650,231350,69
2020-05-18T00:00:00Z,18,5,2020,256,59,Spain,ES,ESP,46937060,Europe,27709,231606,70
2020-05-19T00:00:00Z,19,5,2020,431,69,Spain,ES,ESP,46937060,Europe,27778,232037,71
2020-05-20T00:00:00Z,20,5,2020,518,110,Spain,ES,ESP,46937060,Europe,27888,232555,72
2020-05-21T00:00:00Z,21,5,2020,482,52,Spain,ES,ESP,46937060,Europe,27940,233037,73
2020-05-22T00:00:00Z,22,5,2020,1787,688,Spain,ES,ESP,46937060,Europe,28628,234824,74
2020-05-23T00:00:00Z,23,5,2020,466,50,Spain,ES,ESP,46937060,Europe,28678,235290,75
2020-05-24T00:00:00Z,24,5,2020,482,74,Spain,ES,ESP,46937060,Europe,28752,235772,76
2020-05-25T00:00:00Z,25,5,2020,-372,-1918,Spain,ES,ESP,46937060,Europe,26834,235400,77
2020-05-26T00:00:00Z,26,5,2020,859,283,Spain,ES,ESP,46937060,Europe,27117,236259,78
2020-05-27T00:00:00Z,27,5,2020,510,1,Spain,ES,ESP,46937060,Europe,27118,236769,79
2020-05-28T00:00:00Z,28,5,2020,1137,1,Spain,ES,ESP,46937060,Europe,27119,237906,80
2020-05-29T00:00:00Z,29,5,2020,658,2,Spain,ES,ESP,46937060,Europe,27121,238564,81
2020-05-30T00:00:00Z,30,5,2020,664,4,Spain,ES,ESP,46937060,Europe,27125,239228,82
2020-05-31T00:00:00Z,31,5,2020,201,2,Spain,ES,ESP,46937060,Europe,27127,239429,83
2020-06-01T00:00:00Z,1,6,2020,209,0,Spain,ES,ESP,46937060,Europe,27127,239638,84
2020-06-02T00:00:00Z,2,6,2020,294,0,Spain,ES,ESP,46937060,Europe,27127,239932,85
2020-06-03T00:00:00Z,3,6,2020,394,1,Spain,ES,ESP,46937060,Europe,27128,240326,86
2020-06-04T00:00:00Z,4,6,2020,334,5,Spain,ES,ESP,46937060,Europe,27133,240660,87
2020-06-05T00:00:00Z,5,6,2020,318,1,Spain,ES,ESP,46937060,Europe,27134,240978,88
2020-06-06T00:00:00Z,6,6,2020,332,1,Spain,ES,ESP,46937060,Europe,27135,241310,89
2020-06-07T00:00:00Z,7,6,2020,240,1,Spain,ES,ESP,46937060,Europe,27136,241550,90
2020-06-08T00:00:00Z,8,6,2020,167,0,Spain,ES,ESP,46937060,Europe,27136,241717,91
2020-06-09T00:00:00Z,9,6,2020,249,0,Spain,ES,ESP,46937060,Europe,27136,241966,92
2020-06-10T00:00:00Z,10,6,2020,314,0,Spain,ES,ESP,46937060,Europe,27136,242280,93
2020-06-11T00:00:00Z,11,6,2020,427,0,Spain,ES,ESP,46937060,Europe,27136,242707,94
2020-06-12T00:00:00Z,12,6,2020,502,0,Spain,ES,ESP,46937060,Europe,27136,243209,95
2020-06-13T00:00:00Z,13,6,2020,396,0,Spain,ES,ESP,46937060,Europe,27136,243605,96
2020-06-14T00:00:00Z,14,6,2020,323,0,Spain,ES,ESP,46937060,Europe,27136,243928,97
2020-06-15T00:00:00Z,15,6,2020,181,0,Spain,ES,ESP,46937060,Europe,27136,244109,98
2020-06-16T00:00:00Z,16,6,2020,219,0,Spain,ES,ESP,46937060,Europe,27136,244328,99
2020-06-17T00:00:00Z,17,6,2020,355,0,Spain,ES,ESP,46937060,Europe,27136,244683,100
2020-06-18T00:00:00Z,18,6,2020,585,0,Spain,ES,ESP,46937060,Europe,27136,245268,101
2020-06-19T00:00:00Z,19,6,2020,307,1179,Spain,ES,ESP,46937060,Europe,28315,245575,102
2020-06-20T00:00:00Z,20,6,2020,363,7,Spain,ES,ESP,46937060,Europe,28322,245938,103
2020-06-21T00:00:00Z,21,6,2020,334,1,Spain,ES,ESP,46937060,Europe,28323,246272,104
2020-06-22T00:00:00Z,22,6,2020,232,1,Spain,ES,ESP,46937060,Europe,28324,246504,105
2020-06-23T00:00:00Z,23,6,2020,248,1,Spain,ES,ESP,46937060,Europe,28325,246752,106
2020-06-24T00:00:00Z,24,6,2020,334,2,Spain,ES,ESP,46937060,Europe,28327,247086,107
2020-05-26T00:00:00Z,26,5,2020,41,1,Sri_Lanka,LK,LKA,21323734,Asia,10,1182,1
2020-05-27T00:00:00Z,27,5,2020,137,0,Sri_Lanka,LK,LKA,21323734,Asia,10,1319,2
2020-05-28T00:00:00Z,28,5,2020,150,0,Sri_Lanka,LK,LKA,21323734,Asia,10,1469,3
2020-05-29T00:00:00Z,29,5,2020,61,0,Sri_Lanka,LK,LKA,21323734,Asia,10,1530,4
2020-05-30T00:00:00Z,30,5,2020,28,0,Sri_Lanka,LK,LKA,21323734,Asia,10,1558,5
2020-05-31T00:00:00Z,31,5,2020,62,0,Sri_Lanka,LK,LKA,21323734,Asia,10,1620,6
2020-06-01T00:00:00Z,1,6,2020,13,0,Sri_Lanka,LK,LKA,21323734,Asia,10,1633,7
2020-06-02T00:00:00Z,2,6,2020,10,1,Sri_Lanka,LK,LKA,21323734,Asia,11,1643,8
2020-06-03T00:00:00Z,3,6,2020,40,0,Sri_Lanka,LK,LKA,21323734,Asia,11,1683,9
2020-06-04T00:00:00Z,4,6,2020,66,0,Sri_Lanka,LK,LKA,21323734,Asia,11,1749,10
2020-06-05T00:00:00Z,5,6,2020,48,0,Sri_Lanka,LK,LKA,21323734,Asia,11,1797,11
2020-06-06T00:00:00Z,6,6,2020,4,0,Sri_Lanka,LK,LKA,21323734,Asia,11,1801,12
2020-06-07T00:00:00Z,7,6,2020,13,0,Sri_Lanka,LK,LKA,21323734,Asia,11,1814,13
2020-06-08T00:00:00Z,8,6,2020,21,0,Sri_Lanka,LK,LKA,21323734,Asia,11,1835,14
2020-06-09T00:00:00Z,9,6,2020,22,0,Sri_Lanka,LK,LKA,21323734,Asia,11,1857,15
2020-06-10T00:00:00Z,10,6,2020,2,0,Sri_Lanka,LK,LKA,21323734,Asia,11,1859,16
2020-06-11T00:00:00Z,11,6,2020,10,0,Sri_Lanka,LK,LKA,21323734,Asia,11,1869,17
2020-06-12T00:00:00Z,12,6,2020,8,0,Sri_Lanka,LK,LKA,21323734,Asia,11,1877,18
2020-06-13T00:00:00Z,13,6,2020,3,0,Sri_Lanka,LK,LKA,21323734,Asia,11,1880,19
2020-06-14T00:00:00Z,14,6,2020,4,0,Sri_Lanka,LK,LKA,21323734,Asia,11,1884,20
2020-06-15T00:00:00Z,15,6,2020,5,0,Sri_Lanka,LK,LKA,21323734,Asia,11,1889,21
2020-06-16T00:00:00Z,16,6,2020,16,0,Sri_Lanka,LK,LKA,21323734,Asia,11,1905,22
2020-06-17T00:00:00Z,17,6,2020,10,0,Sri_Lanka,LK,LKA,21323734,Asia,11,1915,23
2020-06-18T00:00:00Z,18,6,2020,9,0,Sri_Lanka,LK,LKA,21323734,Asia,11,1924,24
2020-06-19T00:00:00Z,19,6,2020,23,0,Sri_Lanka,LK,LKA,21323734,Asia,11,1947,25
2020-06-20T00:00:00Z,20,6,2020,3,0,Sri_Lanka,LK,LKA,21323734,Asia,11,1950,26
2020-06-21T00:00:00Z,21,6,2020,0,0,Sri_Lanka,LK,LKA,21323734,Asia,11,1950,27
2020-06-22T00:00:00Z,22,6,2020,0,0,Sri_Lanka,LK,LKA,21323734,Asia,11,1950,28
2020-06-23T00:00:00Z,23,6,2020,1,0,Sri_Lanka,LK,LKA,21323734,Asia,11,1951,29
2020-06-24T00:00:00Z,24,6,2020,40,0,Sri_Lanka,LK,LKA,21323734,Asia,11,1991,30
2020-06-25T00:00:00Z,25,6,2020,10,0,Sri_Lanka,LK,LKA,21323734,Asia,11,2001,31
2020-04-19T00:00:00Z,19,4,2020,34,5,Sudan,SD,SDN,42813237,Africa,10,66,1
2020-04-20T00:00:00Z,20,4,2020,0,0,Sudan,SD,SDN,42813237,Africa,10,66,2
2020-04-21T00:00:00Z,21,4,2020,26,2,Sudan,SD,SDN,42813237,Africa,12,92,3
2020-04-22T00:00:00Z,22,4,2020,15,0,Sudan,SD,SDN,42813237,Africa,12,107,4
2020-04-23T00:00:00Z,23,4,2020,33,1,Sudan,SD,SDN,42813237,Africa,13,140,5
2020-04-24T00:00:00Z,24,4,2020,22,0,Sudan,SD,SDN,42813237,Africa,13,162,6
2020-04-25T00:00:00Z,25,4,2020,12,3,Sudan,SD,SDN,42813237,Africa,16,174,7
2020-04-26T00:00:00Z,26,4,2020,39,1,Sudan,SD,SDN,42813237,Africa,17,213,8
2020-04-27T00:00:00Z,27,4,2020,24,4,Sudan,SD,SDN,42813237,Africa,21,237,9
2020-04-28T00:00:00Z,28,4,2020,38,1,Sudan,SD,SDN,42813237,Africa,22,275,10
2020-04-29T00:00:00Z,29,4,2020,43,3,Sudan,SD,SDN,42813237,Africa,25,318,11
2020-04-30T00:00:00Z,30,4,2020,57,3,Sudan,SD,SDN,42813237,Africa,28,375,12
2020-05-01T00:00:00Z,1,5,2020,67,3,Sudan,SD,SDN,42813237,Africa,31,442,13
2020-05-02T00:00:00Z,2,5,2020,0,0,Sudan,SD,SDN,42813237,Africa,31,442,14
2020-05-03T00:00:00Z,3,5,2020,150,10,Sudan,SD,SDN,42813237,Africa,41,592,15
2020-05-04T00:00:00Z,4,5,2020,86,0,Sudan,SD,SDN,42813237,Africa,41,678,16
2020-05-05T00:00:00Z,5,5,2020,0,0,Sudan,SD,SDN,42813237,Africa,41,678,17
2020-05-06T00:00:00Z,6,5,2020,100,4,Sudan,SD,SDN,42813237,Africa,45,778,18
2020-05-07T00:00:00Z,7,5,2020,74,4,Sudan,SD,SDN,42813237,Africa,49,852,19
2020-05-08T00:00:00Z,8,5,2020,78,3,Sudan,SD,SDN,42813237,Africa,52,930,20
2020-05-09T00:00:00Z,9,5,2020,181,7,Sudan,SD,SDN,42813237,Africa,59,1111,21
2020-05-10T00:00:00Z,10,5,2020,53,5,Sudan,SD,SDN,42813237,Africa,64,1164,22
2020-05-11T00:00:00Z,11,5,2020,199,6,Sudan,SD,SDN,42813237,Africa,70,1363,23
2020-05-12T00:00:00Z,12,5,2020,163,4,Sudan,SD,SDN,42813237,Africa,74,1526,24
2020-05-13T00:00:00Z,13,5,2020,135,6,Sudan,SD,SDN,42813237,Africa,80,1661,25
2020-05-14T00:00:00Z,14,5,2020,157,10,Sudan,SD,SDN,42813237,Africa,90,1818,26
2020-05-15T00:00:00Z,15,5,2020,146,1,Sudan,SD,SDN,42813237,Africa,91,1964,27
2020-05-16T00:00:00Z,16,5,2020,0,0,Sudan,SD,SDN,42813237,Africa,91,1964,28
2020-05-17T00:00:00Z,17,5,2020,0,0,Sudan,SD,SDN,42813237,Africa,91,1964,29
2020-05-18T00:00:00Z,18,5,2020,325,6,Sudan,SD,SDN,42813237,Africa,97,2289,30
2020-05-19T00:00:00Z,19,5,2020,302,8,Sudan,SD,SDN,42813237,Africa,105,2591,31
2020-05-20T00:00:00Z,20,5,2020,0,0,Sudan,SD,SDN,42813237,Africa,105,2591,32
2020-05-21T00:00:00Z,21,5,2020,137,6,Sudan,SD,SDN,42813237,Africa,111,2728,33
2020-05-22T00:00:00Z,22,5,2020,410,10,Sudan,SD,SDN,42813237,Africa,121,3138,34
2020-05-23T00:00:00Z,23,5,2020,240,16,Sudan,SD,SDN,42813237,Africa,137,3378,35
2020-05-24T00:00:00Z,24,5,2020,250,9,Sudan,SD,SDN,42813237,Africa,146,3628,36
2020-05-25T00:00:00Z,25,5,2020,6,0,Sudan,SD,SDN,42813237,Africa,146,3634,37
2020-05-26T00:00:00Z,26,5,2020,192,19,Sudan,SD,SDN,42813237,Africa,165,3826,38
2020-05-27T00:00:00Z,27,5,2020,150,5,Sudan,SD,SDN,42813237,Africa,170,3976,39
2020-05-28T00:00:00Z,28,5,2020,170,14,Sudan,SD,SDN,42813237,Africa,184,4146,40
2020-05-29T00:00:00Z,29,5,2020,200,11,Sudan,SD,SDN,42813237,Africa,195,4346,41
2020-05-30T00:00:00Z,30,5,2020,175,38,Sudan,SD,SDN,42813237,Africa,233,4521,42
2020-05-31T00:00:00Z,31,5,2020,279,29,Sudan,SD,SDN,42813237,Africa,262,4800,43
2020-06-01T00:00:00Z,1,6,2020,226,24,Sudan,SD,SDN,42813237,Africa,286,5026,44
2020-06-02T00:00:00Z,2,6,2020,147,12,Sudan,SD,SDN,42813237,Africa,298,5173,45
2020-06-03T00:00:00Z,3,6,2020,137,9,Sudan,SD,SDN,42813237,Africa,307,5310,46
2020-06-04T00:00:00Z,4,6,2020,0,0,Sudan,SD,SDN,42813237,Africa,307,5310,47
2020-06-05T00:00:00Z,5,6,2020,189,7,Sudan,SD,SDN,42813237,Africa,314,5499,48
2020-06-06T00:00:00Z,6,6,2020,215,19,Sudan,SD,SDN,42813237,Africa,333,5714,49
2020-06-07T00:00:00Z,7,6,2020,151,14,Sudan,SD,SDN,42813237,Africa,347,5865,50
2020-06-08T00:00:00Z,8,6,2020,218,12,Sudan,SD,SDN,42813237,Africa,359,6083,51
2020-06-09T00:00:00Z,9,6,2020,159,13,Sudan,SD,SDN,42813237,Africa,372,6242,52
2020-06-10T00:00:00Z,10,6,2020,0,0,Sudan,SD,SDN,42813237,Africa,372,6242,53
2020-06-11T00:00:00Z,11,6,2020,185,17,Sudan,SD,SDN,42813237,Africa,389,6427,54
2020-06-12T00:00:00Z,12,6,2020,303,24,Sudan,SD,SDN,42813237,Africa,413,6730,55
2020-06-13T00:00:00Z,13,6,2020,149,20,Sudan,SD,SDN,42813237,Africa,433,6879,56
2020-06-14T00:00:00Z,14,6,2020,0,0,Sudan,SD,SDN,42813237,Africa,433,6879,57
2020-06-15T00:00:00Z,15,6,2020,341,26,Sudan,SD,SDN,42813237,Africa,459,7220,58
2020-06-16T00:00:00Z,16,6,2020,0,0,Sudan,SD,SDN,42813237,Africa,459,7220,59
2020-06-17T00:00:00Z,17,6,2020,520,18,Sudan,SD,SDN,42813237,Africa,477,7740,60
2020-06-18T00:00:00Z,18,6,2020,280,10,Sudan,SD,SDN,42813237,Africa,487,8020,61
2020-06-19T00:00:00Z,19,6,2020,0,0,Sudan,SD,SDN,42813237,Africa,487,8020,62
2020-06-20T00:00:00Z,20,6,2020,296,19,Sudan,SD,SDN,42813237,Africa,506,8316,63
2020-06-21T00:00:00Z,21,6,2020,264,15,Sudan,SD,SDN,42813237,Africa,521,8580,64
2020-06-22T00:00:00Z,22,6,2020,0,0,Sudan,SD,SDN,42813237,Africa,521,8580,65
2020-06-23T00:00:00Z,23,6,2020,118,12,Sudan,SD,SDN,42813237,Africa,533,8698,66
2020-06-24T00:00:00Z,24,6,2020,191,15,Sudan,SD,SDN,42813237,Africa,548,8889,67
2020-06-25T00:00:00Z,25,6,2020,0,0,Sudan,SD,SDN,42813237,Africa,548,8889,68
2020-06-25T00:00:00Z,25,6,2020,38,1,Suriname,SR,SUR,581363,America,10,357,1
2020-03-19T00:00:00Z,19,3,2020,134,2,Sweden,SE,SWE,10230185,Europe,10,1301,1
2020-03-20T00:00:00Z,20,3,2020,122,0,Sweden,SE,SWE,10230185,Europe,10,1423,2
2020-03-21T00:00:00Z,21,3,2020,200,6,Sweden,SE,SWE,10230185,Europe,16,1623,3
2020-03-22T00:00:00Z,22,3,2020,123,4,Sweden,SE,SWE,10230185,Europe,20,1746,4
2020-03-23T00:00:00Z,23,3,2020,160,1,Sweden,SE,SWE,10230185,Europe,21,1906,5
2020-03-24T00:00:00Z,24,3,2020,110,4,Sweden,SE,SWE,10230185,Europe,25,2016,6
2020-03-25T00:00:00Z,25,3,2020,256,11,Sweden,SE,SWE,10230185,Europe,36,2272,7
2020-03-26T00:00:00Z,26,3,2020,238,6,Sweden,SE,SWE,10230185,Europe,42,2510,8
2020-03-27T00:00:00Z,27,3,2020,296,24,Sweden,SE,SWE,10230185,Europe,66,2806,9
2020-03-28T00:00:00Z,28,3,2020,240,26,Sweden,SE,SWE,10230185,Europe,92,3046,10
2020-03-29T00:00:00Z,29,3,2020,401,10,Sweden,SE,SWE,10230185,Europe,102,3447,11
2020-03-30T00:00:00Z,30,3,2020,253,8,Sweden,SE,SWE,10230185,Europe,110,3700,12
2020-03-31T00:00:00Z,31,3,2020,328,36,Sweden,SE,SWE,10230185,Europe,146,4028,13
2020-04-01T00:00:00Z,1,4,2020,407,34,Sweden,SE,SWE,10230185,Europe,180,4435,14
2020-04-02T00:00:00Z,2,4,2020,512,59,Sweden,SE,SWE,10230185,Europe,239,4947,15
2020-04-03T00:00:00Z,3,4,2020,519,43,Sweden,SE,SWE,10230185,Europe,282,5466,16
2020-04-04T00:00:00Z,4,4,2020,612,51,Sweden,SE,SWE,10230185,Europe,333,6078,17
2020-04-05T00:00:00Z,5,4,2020,365,40,Sweden,SE,SWE,10230185,Europe,373,6443,18
2020-04-06T00:00:00Z,6,4,2020,387,28,Sweden,SE,SWE,10230185,Europe,401,6830,19
2020-04-07T00:00:00Z,7,4,2020,376,76,Sweden,SE,SWE,10230185,Europe,477,7206,20
2020-04-08T00:00:00Z,8,4,2020,487,114,Sweden,SE,SWE,10230185,Europe,591,7693,21
2020-04-09T00:00:00Z,9,4,2020,726,96,Sweden,SE,SWE,10230185,Europe,687,8419,22
2020-04-10T00:00:00Z,10,4,2020,722,106,Sweden,SE,SWE,10230185,Europe,793,9141,23
2020-04-11T00:00:00Z,11,4,2020,544,77,Sweden,SE,SWE,10230185,Europe,870,9685,24
2020-04-12T00:00:00Z,12,4,2020,466,17,Sweden,SE,SWE,10230185,Europe,887,10151,25
2020-04-13T00:00:00Z,13,4,2020,332,12,Sweden,SE,SWE,10230185,Europe,899,10483,26
2020-04-14T00:00:00Z,14,4,2020,465,20,Sweden,SE,SWE,10230185,Europe,919,10948,27
2020-04-15T00:00:00Z,15,4,2020,497,114,Sweden,SE,SWE,10230185,Europe,1033,11445,28
2020-04-16T00:00:00Z,16,4,2020,482,170,Sweden,SE,SWE,10230185,Europe,1203,11927,29
2020-04-17T00:00:00Z,17,4,2020,613,130,Sweden,SE,SWE,10230185,Europe,1333,12540,30
2020-04-18T00:00:00Z,18,4,2020,676,67,Sweden,SE,SWE,10230185,Europe,1400,13216,31
2020-04-19T00:00:00Z,19,4,2020,606,111,Sweden,SE,SWE,10230185,Europe,1511,13822,32
2020-04-20T00:00:00Z,20,4,2020,563,29,Sweden,SE,SWE,10230185,Europe,1540,14385,33
2020-04-21T00:00:00Z,21,4,2020,392,40,Sweden,SE,SWE,10230185,Europe,1580,14777,34
2020-04-22T00:00:00Z,22,4,2020,545,185,Sweden,SE,SWE,10230185,Europe,1765,15322,35
2020-04-23T00:00:00Z,23,4,2020,682,172,Sweden,SE,SWE,10230185,Europe,1937,16004,36
2020-04-24T00:00:00Z,24,4,2020,751,84,Sweden,SE,SWE,10230185,Europe,2021,16755,37
2020-04-25T00:00:00Z,25,4,2020,812,131,Sweden,SE,SWE,10230185,Europe,2152,17567,38
2020-04-26T00:00:00Z,26,4,2020,610,40,Sweden,SE,SWE,10230185,Europe,2192,18177,39
2020-04-27T00:00:00Z,27,4,2020,463,2,Sweden,SE,SWE,10230185,Europe,2194,18640,40
2020-04-28T00:00:00Z,28,4,2020,286,80,Sweden,SE,SWE,10230185,Europe,2274,18926,41
2020-04-29T00:00:00Z,29,4,2020,695,81,Sweden,SE,SWE,10230185,Europe,2355,19621,42
2020-04-30T00:00:00Z,30,4,2020,681,107,Sweden,SE,SWE,10230185,Europe,2462,20302,43
2020-05-01T00:00:00Z,1,5,2020,790,124,Sweden,SE,SWE,10230185,Europe,2586,21092,44
2020-05-02T00:00:00Z,2,5,2020,428,67,Sweden,SE,SWE,10230185,Europe,2653,21520,45
2020-05-03T00:00:00Z,3,5,2020,562,16,Sweden,SE,SWE,10230185,Europe,2669,22082,46
2020-05-04T00:00:00Z,4,5,2020,235,10,Sweden,SE,SWE,10230185,Europe,2679,22317,47
2020-05-05T00:00:00Z,5,5,2020,404,90,Sweden,SE,SWE,10230185,Europe,2769,22721,48
2020-05-06T00:00:00Z,6,5,2020,495,85,Sweden,SE,SWE,10230185,Europe,2854,23216,49
2020-05-07T00:00:00Z,7,5,2020,702,87,Sweden,SE,SWE,10230185,Europe,2941,23918,50
2020-05-08T00:00:00Z,8,5,2020,705,99,Sweden,SE,SWE,10230185,Europe,3040,24623,51
2020-05-09T00:00:00Z,9,5,2020,642,135,Sweden,SE,SWE,10230185,Europe,3175,25265,52
2020-05-10T00:00:00Z,10,5,2020,656,45,Sweden,SE,SWE,10230185,Europe,3220,25921,53
2020-05-11T00:00:00Z,11,5,2020,401,5,Sweden,SE,SWE,10230185,Europe,3225,26322,54
2020-05-12T00:00:00Z,12,5,2020,348,31,Sweden,SE,SWE,10230185,Europe,3256,26670,55
2020-05-13T00:00:00Z,13,5,2020,602,57,Sweden,SE,SWE,10230185,Europe,3313,27272,56
2020-05-14T00:00:00Z,14,5,2020,637,147,Sweden,SE,SWE,10230185,Europe,3460,27909,57
2020-05-15T00:00:00Z,15,5,2020,673,69,Sweden,SE,SWE,10230185,Europe,3529,28582,58
2020-05-16T00:00:00Z,16,5,2020,625,117,Sweden,SE,SWE,10230185,Europe,3646,29207,59
2020-05-17T00:00:00Z,17,5,2020,470,28,Sweden,SE,SWE,10230185,Europe,3674,29677,60
2020-05-18T00:00:00Z,18,5,2020,466,5,Sweden,SE,SWE,10230185,Europe,3679,30143,61
2020-05-19T00:00:00Z,19,5,2020,234,19,Sweden,SE,SWE,10230185,Europe,3698,30377,62
2020-05-20T00:00:00Z,20,5,2020,422,45,Sweden,SE,SWE,10230185,Europe,3743,30799,63
2020-05-21T00:00:00Z,21,5,2020,724,88,Sweden,SE,SWE,10230185,Europe,3831,31523,64
2020-05-22T00:00:00Z,22,5,2020,649,40,Sweden,SE,SWE,10230185,Europe,3871,32172,65
2020-05-23T00:00:00Z,23,5,2020,637,54,Sweden,SE,SWE,10230185,Europe,3925,32809,66
2020-05-24T00:00:00Z,24,5,2020,379,67,Sweden,SE,SWE,10230185,Europe,3992,33188,67
2020-05-25T00:00:00Z,25,5,2020,271,6,Sweden,SE,SWE,10230185,Europe,3998,33459,68
2020-05-26T00:00:00Z,26,5,2020,384,31,Sweden,SE,SWE,10230185,Europe,4029,33843,69
2020-05-27T00:00:00Z,27,5,2020,597,96,Sweden,SE,SWE,10230185,Europe,4125,34440,70
2020-05-28T00:00:00Z,28,5,2020,648,95,Sweden,SE,SWE,10230185,Europe,4220,35088,71
2020-05-29T00:00:00Z,29,5,2020,639,46,Sweden,SE,SWE,10230185,Europe,4266,35727,72
2020-05-30T00:00:00Z,30,5,2020,749,84,Sweden,SE,SWE,10230185,Europe,4350,36476,73
2020-05-31T00:00:00Z,31,5,2020,637,45,Sweden,SE,SWE,10230185,Europe,4395,37113,74
2020-06-01T00:00:00Z,1,6,2020,429,0,Sweden,SE,SWE,10230185,Europe,4395,37542,75
2020-06-02T00:00:00Z,2,6,2020,272,8,Sweden,SE,SWE,10230185,Europe,4403,37814,76
2020-06-03T00:00:00Z,3,6,2020,775,65,Sweden,SE,SWE,10230185,Europe,4468,38589,77
2020-06-04T00:00:00Z,4,6,2020,2214,74,Sweden,SE,SWE,10230185,Europe,4542,40803,78
2020-06-05T00:00:00Z,5,6,2020,1080,20,Sweden,SE,SWE,10230185,Europe,4562,41883,79
2020-06-06T00:00:00Z,6,6,2020,1056,77,Sweden,SE,SWE,10230185,Europe,4639,42939,80
2020-06-07T00:00:00Z,7,6,2020,948,17,Sweden,SE,SWE,10230185,Europe,4656,43887,81
2020-06-08T00:00:00Z,8,6,2020,843,3,Sweden,SE,SWE,10230185,Europe,4659,44730,82
2020-06-09T00:00:00Z,9,6,2020,403,35,Sweden,SE,SWE,10230185,Europe,4694,45133,83
2020-06-10T00:00:00Z,10,6,2020,791,23,Sweden,SE,SWE,10230185,Europe,4717,45924,84
2020-06-11T00:00:00Z,11,6,2020,890,78,Sweden,SE,SWE,10230185,Europe,4795,46814,85
2020-06-12T00:00:00Z,12,6,2020,1474,19,Sweden,SE,SWE,10230185,Europe,4814,48288,86
2020-06-13T00:00:00Z,13,6,2020,1396,40,Sweden,SE,SWE,10230185,Europe,4854,49684,87
2020-06-14T00:00:00Z,14,6,2020,1247,20,Sweden,SE,SWE,10230185,Europe,4874,50931,88
2020-06-15T00:00:00Z,15,6,2020,683,0,Sweden,SE,SWE,10230185,Europe,4874,51614,89
2020-06-16T00:00:00Z,16,6,2020,769,17,Sweden,SE,SWE,10230185,Europe,4891,52383,90
2020-06-17T00:00:00Z,17,6,2020,940,48,Sweden,SE,SWE,10230185,Europe,4939,53323,91
2020-06-18T00:00:00Z,18,6,2020,1239,102,Sweden,SE,SWE,10230185,Europe,5041,54562,92
2020-06-19T00:00:00Z,19,6,2020,1481,12,Sweden,SE,SWE,10230185,Europe,5053,56043,93
2020-06-20T00:00:00Z,20,6,2020,0,0,Sweden,SE,SWE,10230185,Europe,5053,56043,94
2020-06-21T00:00:00Z,21,6,2020,0,0,Sweden,SE,SWE,10230185,Europe,5053,56043,95
2020-06-22T00:00:00Z,22,6,2020,0,0,Sweden,SE,SWE,10230185,Europe,5053,56043,96
2020-06-23T00:00:00Z,23,6,2020,2889,69,Sweden,SE,SWE,10230185,Europe,5122,58932,97
2020-06-24T00:00:00Z,24,6,2020,1905,39,Sweden,SE,SWE,10230185,Europe,5161,60837,98
2020-06-25T00:00:00Z,25,6,2020,1487,48,Sweden,SE,SWE,10230185,Europe,5209,62324,99
2020-03-15T00:00:00Z,15,3,2020,238,4,Switzerland,CH,CHE,8544527,Europe,11,1359,1
2020-03-16T00:00:00Z,16,3,2020,841,2,Switzerland,CH,CHE,8544527,Europe,13,2200,2
2020-03-17T00:00:00Z,17,3,2020,0,1,Switzerland,CH,CHE,8544527,Europe,14,2200,3
2020-03-18T00:00:00Z,18,3,2020,450,5,Switzerland,CH,CHE,8544527,Europe,19,2650,4
2020-03-19T00:00:00Z,19,3,2020,360,2,Switzerland,CH,CHE,8544527,Europe,21,3010,5
2020-03-20T00:00:00Z,20,3,2020,878,12,Switzerland,CH,CHE,8544527,Europe,33,3888,6
2020-03-21T00:00:00Z,21,3,2020,952,10,Switzerland,CH,CHE,8544527,Europe,43,4840,7
2020-03-22T00:00:00Z,22,3,2020,1237,13,Switzerland,CH,CHE,8544527,Europe,56,6077,8
2020-03-23T00:00:00Z,23,3,2020,894,4,Switzerland,CH,CHE,8544527,Europe,60,6971,9
2020-03-24T00:00:00Z,24,3,2020,1044,6,Switzerland,CH,CHE,8544527,Europe,66,8015,10
2020-03-25T00:00:00Z,25,3,2020,774,20,Switzerland,CH,CHE,8544527,Europe,86,8789,11
2020-03-26T00:00:00Z,26,3,2020,925,17,Switzerland,CH,CHE,8544527,Europe,103,9714,12
2020-03-27T00:00:00Z,27,3,2020,1000,58,Switzerland,CH,CHE,8544527,Europe,161,10714,13
2020-03-28T00:00:00Z,28,3,2020,1390,36,Switzerland,CH,CHE,8544527,Europe,197,12104,14
2020-03-29T00:00:00Z,29,3,2020,1048,38,Switzerland,CH,CHE,8544527,Europe,235,13152,15
2020-03-30T00:00:00Z,30,3,2020,1122,22,Switzerland,CH,CHE,8544527,Europe,257,14274,16
2020-03-31T00:00:00Z,31,3,2020,1138,38,Switzerland,CH,CHE,8544527,Europe,295,15412,17
2020-04-01T00:00:00Z,1,4,2020,696,78,Switzerland,CH,CHE,8544527,Europe,373,16108,18
2020-04-02T00:00:00Z,2,4,2020,962,5,Switzerland,CH,CHE,8544527,Europe,378,17070,19
2020-04-03T00:00:00Z,3,4,2020,1124,54,Switzerland,CH,CHE,8544527,Europe,432,18194,20
2020-04-04T00:00:00Z,4,4,2020,1033,52,Switzerland,CH,CHE,8544527,Europe,484,19227,21
2020-04-05T00:00:00Z,5,4,2020,974,56,Switzerland,CH,CHE,8544527,Europe,540,20201,22
2020-04-06T00:00:00Z,6,4,2020,821,19,Switzerland,CH,CHE,8544527,Europe,559,21022,23
2020-04-07T00:00:00Z,7,4,2020,552,25,Switzerland,CH,CHE,8544527,Europe,584,21574,24
2020-04-08T00:00:00Z,8,4,2020,590,57,Switzerland,CH,CHE,8544527,Europe,641,22164,25
2020-04-09T00:00:00Z,9,4,2020,546,64,Switzerland,CH,CHE,8544527,Europe,705,22710,26
2020-04-10T00:00:00Z,10,4,2020,785,51,Switzerland,CH,CHE,8544527,Europe,756,23495,27
2020-04-11T00:00:00Z,11,4,2020,733,49,Switzerland,CH,CHE,8544527,Europe,805,24228,28
2020-04-12T00:00:00Z,12,4,2020,592,26,Switzerland,CH,CHE,8544527,Europe,831,24820,29
2020-04-13T00:00:00Z,13,4,2020,400,27,Switzerland,CH,CHE,8544527,Europe,858,25220,30
2020-04-14T00:00:00Z,14,4,2020,279,0,Switzerland,CH,CHE,8544527,Europe,858,25499,31
2020-04-15T00:00:00Z,15,4,2020,254,42,Switzerland,CH,CHE,8544527,Europe,900,25753,32
2020-04-16T00:00:00Z,16,4,2020,583,73,Switzerland,CH,CHE,8544527,Europe,973,26336,33
2020-04-17T00:00:00Z,17,4,2020,315,43,Switzerland,CH,CHE,8544527,Europe,1016,26651,34
2020-04-18T00:00:00Z,18,4,2020,346,42,Switzerland,CH,CHE,8544527,Europe,1058,26997,35
2020-04-19T00:00:00Z,19,4,2020,325,52,Switzerland,CH,CHE,8544527,Europe,1110,27322,36
2020-04-20T00:00:00Z,20,4,2020,336,24,Switzerland,CH,CHE,8544527,Europe,1134,27658,37
2020-04-21T00:00:00Z,21,4,2020,168,7,Switzerland,CH,CHE,8544527,Europe,1141,27826,38
2020-04-22T00:00:00Z,22,4,2020,155,45,Switzerland,CH,CHE,8544527,Europe,1186,27981,39
2020-04-23T00:00:00Z,23,4,2020,205,30,Switzerland,CH,CHE,8544527,Europe,1216,28186,40
2020-04-24T00:00:00Z,24,4,2020,228,51,Switzerland,CH,CHE,8544527,Europe,1267,28414,41
2020-04-25T00:00:00Z,25,4,2020,181,41,Switzerland,CH,CHE,8544527,Europe,1308,28595,42
2020-04-26T00:00:00Z,26,4,2020,216,20,Switzerland,CH,CHE,8544527,Europe,1328,28811,43
2020-04-27T00:00:00Z,27,4,2020,167,8,Switzerland,CH,CHE,8544527,Europe,1336,28978,44
2020-04-28T00:00:00Z,28,4,2020,103,16,Switzerland,CH,CHE,8544527,Europe,1352,29081,45
2020-04-29T00:00:00Z,29,4,2020,100,27,Switzerland,CH,CHE,8544527,Europe,1379,29181,46
2020-04-30T00:00:00Z,30,4,2020,143,28,Switzerland,CH,CHE,8544527,Europe,1407,29324,47
2020-05-01T00:00:00Z,1,5,2020,179,15,Switzerland,CH,CHE,8544527,Europe,1422,29503,48
2020-05-02T00:00:00Z,2,5,2020,119,12,Switzerland,CH,CHE,8544527,Europe,1434,29622,49
2020-05-03T00:00:00Z,3,5,2020,112,32,Switzerland,CH,CHE,8544527,Europe,1466,29734,50
2020-05-04T00:00:00Z,4,5,2020,88,6,Switzerland,CH,CHE,8544527,Europe,1472,29822,51
2020-05-05T00:00:00Z,5,5,2020,76,4,Switzerland,CH,CHE,8544527,Europe,1476,29898,52
2020-05-06T00:00:00Z,6,5,2020,28,6,Switzerland,CH,CHE,8544527,Europe,1482,29926,53
2020-05-07T00:00:00Z,7,5,2020,51,22,Switzerland,CH,CHE,8544527,Europe,1504,29977,54
2020-05-08T00:00:00Z,8,5,2020,66,13,Switzerland,CH,CHE,8544527,Europe,1517,30043,55
2020-05-09T00:00:00Z,9,5,2020,81,8,Switzerland,CH,CHE,8544527,Europe,1525,30124,56
2020-05-10T00:00:00Z,10,5,2020,44,6,Switzerland,CH,CHE,8544527,Europe,1531,30168,57
2020-05-11T00:00:00Z,11,5,2020,54,6,Switzerland,CH,CHE,8544527,Europe,1537,30222,58
2020-05-12T00:00:00Z,12,5,2020,39,5,Switzerland,CH,CHE,8544527,Europe,1542,30261,59
2020-05-13T00:00:00Z,13,5,2020,36,18,Switzerland,CH,CHE,8544527,Europe,1560,30297,60
2020-05-14T00:00:00Z,14,5,2020,33,3,Switzerland,CH,CHE,8544527,Europe,1563,30330,61
2020-05-15T00:00:00Z,15,5,2020,50,25,Switzerland,CH,CHE,8544527,Europe,1588,30380,62
2020-05-16T00:00:00Z,16,5,2020,51,6,Switzerland,CH,CHE,8544527,Europe,1594,30431,63
2020-05-17T00:00:00Z,17,5,2020,58,7,Switzerland,CH,CHE,8544527,Europe,1601,30489,64
2020-05-18T00:00:00Z,18,5,2020,15,1,Switzerland,CH,CHE,8544527,Europe,1602,30504,65
2020-05-19T00:00:00Z,19,5,2020,10,0,Switzerland,CH,CHE,8544527,Europe,1602,30514,66
2020-05-20T00:00:00Z,20,5,2020,21,11,Switzerland,CH,CHE,8544527,Europe,1613,30535,67
2020-05-21T00:00:00Z,21,5,2020,40,16,Switzerland,CH,CHE,8544527,Europe,1629,30575,68
2020-05-22T00:00:00Z,22,5,2020,36,8,Switzerland,CH,CHE,8544527,Europe,1637,30611,69
2020-05-23T00:00:00Z,23,5,2020,13,0,Switzerland,CH,CHE,8544527,Europe,1637,30624,70
2020-05-24T00:00:00Z,24,5,2020,18,4,Switzerland,CH,CHE,8544527,Europe,1641,30642,71
2020-05-25T00:00:00Z,25,5,2020,11,0,Switzerland,CH,CHE,8544527,Europe,1641,30653,72
2020-05-26T00:00:00Z,26,5,2020,10,0,Switzerland,CH,CHE,8544527,Europe,1641,30663,73
2020-05-27T00:00:00Z,27,5,2020,15,6,Switzerland,CH,CHE,8544527,Europe,1647,30678,74
2020-05-28T00:00:00Z,28,5,2020,0,0,Switzerland,CH,CHE,8544527,Europe,1647,30678,75
2020-05-29T00:00:00Z,29,5,2020,35,7,Switzerland,CH,CHE,8544527,Europe,1654,30713,76
2020-05-30T00:00:00Z,30,5,2020,32,2,Switzerland,CH,CHE,8544527,Europe,1656,30745,77
2020-05-31T00:00:00Z,31,5,2020,17,0,Switzerland,CH,CHE,8544527,Europe,1656,30762,78
2020-06-01T00:00:00Z,1,6,2020,17,0,Switzerland,CH,CHE,8544527,Europe,1656,30779,79
2020-06-02T00:00:00Z,2,6,2020,9,0,Switzerland,CH,CHE,8544527,Europe,1656,30788,80
2020-06-03T00:00:00Z,3,6,2020,3,0,Switzerland,CH,CHE,8544527,Europe,1656,30791,81
2020-06-04T00:00:00Z,4,6,2020,19,3,Switzerland,CH,CHE,8544527,Europe,1659,30810,82
2020-06-05T00:00:00Z,5,6,2020,20,0,Switzerland,CH,CHE,8544527,Europe,1659,30830,83
2020-06-06T00:00:00Z,6,6,2020,23,0,Switzerland,CH,CHE,8544527,Europe,1659,30853,84
2020-06-07T00:00:00Z,7,6,2020,20,1,Switzerland,CH,CHE,8544527,Europe,1660,30873,85
2020-06-08T00:00:00Z,8,6,2020,9,0,Switzerland,CH,CHE,8544527,Europe,1660,30882,86
2020-06-09T00:00:00Z,9,6,2020,7,0,Switzerland,CH,CHE,8544527,Europe,1660,30889,87
2020-06-10T00:00:00Z,10,6,2020,16,2,Switzerland,CH,CHE,8544527,Europe,1662,30905,88
2020-06-11T00:00:00Z,11,6,2020,23,12,Switzerland,CH,CHE,8544527,Europe,1674,30928,89
2020-06-12T00:00:00Z,12,6,2020,33,0,Switzerland,CH,CHE,8544527,Europe,1674,30961,90
2020-06-13T00:00:00Z,13,6,2020,19,2,Switzerland,CH,CHE,8544527,Europe,1676,30980,91
2020-06-14T00:00:00Z,14,6,2020,31,0,Switzerland,CH,CHE,8544527,Europe,1676,31011,92
2020-06-15T00:00:00Z,15,6,2020,23,0,Switzerland,CH,CHE,8544527,Europe,1676,31034,93
2020-06-16T00:00:00Z,16,6,2020,14,0,Switzerland,CH,CHE,8544527,Europe,1676,31048,94
2020-06-17T00:00:00Z,17,6,2020,15,1,Switzerland,CH,CHE,8544527,Europe,1677,31063,95
2020-06-18T00:00:00Z,18,6,2020,37,0,Switzerland,CH,CHE,8544527,Europe,1677,31100,96
2020-06-19T00:00:00Z,19,6,2020,17,0,Switzerland,CH,CHE,8544527,Europe,1677,31117,97
2020-06-20T00:00:00Z,20,6,2020,92,0,Switzerland,CH,CHE,8544527,Europe,1677,31209,98
2020-06-21T00:00:00Z,21,6,2020,0,0,Switzerland,CH,CHE,8544527,Europe,1677,31209,99
2020-06-22T00:00:00Z,22,6,2020,0,2,Switzerland,CH,CHE,8544527,Europe,1679,31209,100
2020-06-23T00:00:00Z,23,6,2020,18,0,Switzerland,CH,CHE,8544527,Europe,1679,31227,101
2020-06-24T00:00:00Z,24,6,2020,22,0,Switzerland,CH,CHE,8544527,Europe,1679,31249,102
2020-06-25T00:00:00Z,25,6,2020,44,2,Switzerland,CH,CHE,8544527,Europe,1681,31293,103
2020-05-08T00:00:00Z,8,5,2020,82,4,Tajikistan,TJ,TJK,9321023,Asia,12,461,1
2020-05-09T00:00:00Z,9,5,2020,61,0,Tajikistan,TJ,TJK,9321023,Asia,12,522,2
2020-05-10T00:00:00Z,10,5,2020,90,8,Tajikistan,TJ,TJK,9321023,Asia,20,612,3
2020-05-11T00:00:00Z,11,5,2020,0,0,Tajikistan,TJ,TJK,9321023,Asia,20,612,4
2020-05-12T00:00:00Z,12,5,2020,49,1,Tajikistan,TJ,TJK,9321023,Asia,21,661,5
2020-05-13T00:00:00Z,13,5,2020,68,2,Tajikistan,TJ,TJK,9321023,Asia,23,729,6
2020-05-14T00:00:00Z,14,5,2020,72,0,Tajikistan,TJ,TJK,9321023,Asia,23,801,7
2020-05-15T00:00:00Z,15,5,2020,106,6,Tajikistan,TJ,TJK,9321023,Asia,29,907,8
2020-05-16T00:00:00Z,16,5,2020,211,4,Tajikistan,TJ,TJK,9321023,Asia,33,1118,9
2020-05-17T00:00:00Z,17,5,2020,204,3,Tajikistan,TJ,TJK,9321023,Asia,36,1322,10
2020-05-18T00:00:00Z,18,5,2020,202,3,Tajikistan,TJ,TJK,9321023,Asia,39,1524,11
2020-05-19T00:00:00Z,19,5,2020,205,2,Tajikistan,TJ,TJK,9321023,Asia,41,1729,12
2020-05-20T00:00:00Z,20,5,2020,0,0,Tajikistan,TJ,TJK,9321023,Asia,41,1729,13
2020-05-21T00:00:00Z,21,5,2020,207,3,Tajikistan,TJ,TJK,9321023,Asia,44,1936,14
2020-05-22T00:00:00Z,22,5,2020,204,0,Tajikistan,TJ,TJK,9321023,Asia,44,2140,15
2020-05-23T00:00:00Z,23,5,2020,210,0,Tajikistan,TJ,TJK,9321023,Asia,44,2350,16
2020-05-24T00:00:00Z,24,5,2020,201,0,Tajikistan,TJ,TJK,9321023,Asia,44,2551,17
2020-05-25T00:00:00Z,25,5,2020,187,0,Tajikistan,TJ,TJK,9321023,Asia,44,2738,18
2020-05-26T00:00:00Z,26,5,2020,362,2,Tajikistan,TJ,TJK,9321023,Asia,46,3100,19
2020-05-27T00:00:00Z,27,5,2020,0,0,Tajikistan,TJ,TJK,9321023,Asia,46,3100,20
2020-05-28T00:00:00Z,28,5,2020,0,0,Tajikistan,TJ,TJK,9321023,Asia,46,3100,21
2020-05-29T00:00:00Z,29,5,2020,463,1,Tajikistan,TJ,TJK,9321023,Asia,47,3563,22
2020-05-30T00:00:00Z,30,5,2020,0,0,Tajikistan,TJ,TJK,9321023,Asia,47,3563,23
2020-05-31T00:00:00Z,31,5,2020,244,0,Tajikistan,TJ,TJK,9321023,Asia,47,3807,24
2020-06-01T00:00:00Z,1,6,2020,0,0,Tajikistan,TJ,TJK,9321023,Asia,47,3807,25
2020-06-02T00:00:00Z,2,6,2020,123,0,Tajikistan,TJ,TJK,9321023,Asia,47,3930,26
2020-06-03T00:00:00Z,3,6,2020,83,0,Tajikistan,TJ,TJK,9321023,Asia,47,4013,27
2020-06-04T00:00:00Z,4,6,2020,87,0,Tajikistan,TJ,TJK,9321023,Asia,47,4100,28
2020-06-05T00:00:00Z,5,6,2020,189,1,Tajikistan,TJ,TJK,9321023,Asia,48,4289,29
2020-06-06T00:00:00Z,6,6,2020,81,0,Tajikistan,TJ,TJK,9321023,Asia,48,4370,30
2020-06-07T00:00:00Z,7,6,2020,83,0,Tajikistan,TJ,TJK,9321023,Asia,48,4453,31
2020-06-08T00:00:00Z,8,6,2020,76,0,Tajikistan,TJ,TJK,9321023,Asia,48,4529,32
2020-06-09T00:00:00Z,9,6,2020,80,0,Tajikistan,TJ,TJK,9321023,Asia,48,4609,33
2020-06-10T00:00:00Z,10,6,2020,81,0,Tajikistan,TJ,TJK,9321023,Asia,48,4690,34
2020-06-11T00:00:00Z,11,6,2020,73,0,Tajikistan,TJ,TJK,9321023,Asia,48,4763,35
2020-06-12T00:00:00Z,12,6,2020,71,1,Tajikistan,TJ,TJK,9321023,Asia,49,4834,36
2020-06-13T00:00:00Z,13,6,2020,68,0,Tajikistan,TJ,TJK,9321023,Asia,49,4902,37
2020-06-14T00:00:00Z,14,6,2020,69,1,Tajikistan,TJ,TJK,9321023,Asia,50,4971,38
2020-06-15T00:00:00Z,15,6,2020,64,0,Tajikistan,TJ,TJK,9321023,Asia,50,5035,39
2020-06-16T00:00:00Z,16,6,2020,62,0,Tajikistan,TJ,TJK,9321023,Asia,50,5097,40
2020-06-17T00:00:00Z,17,6,2020,63,0,Tajikistan,TJ,TJK,9321023,Asia,50,5160,41
2020-06-18T00:00:00Z,18,6,2020,61,1,Tajikistan,TJ,TJK,9321023,Asia,51,5221,42
2020-06-19T00:00:00Z,19,6,2020,58,0,Tajikistan,TJ,TJK,9321023,Asia,51,5279,43
2020-06-20T00:00:00Z,20,6,2020,59,0,Tajikistan,TJ,TJK,9321023,Asia,51,5338,44
2020-06-21T00:00:00Z,21,6,2020,61,1,Tajikistan,TJ,TJK,9321023,Asia,52,5399,45
2020-06-22T00:00:00Z,22,6,2020,58,0,Tajikistan,TJ,TJK,9321023,Asia,52,5457,46
2020-06-23T00:00:00Z,23,6,2020,56,0,Tajikistan,TJ,TJK,9321023,Asia,52,5513,47
2020-06-24T00:00:00Z,24,6,2020,54,0,Tajikistan,TJ,TJK,9321023,Asia,52,5567,48
2020-06-25T00:00:00Z,25,6,2020,63,0,Tajikistan,TJ,TJK,9321023,Asia,52,5630,49
2020-03-31T00:00:00Z,31,3,2020,263,3,Thailand,TH,THA,69625581,Asia,10,1651,1
2020-04-01T00:00:00Z,1,4,2020,0,0,Thailand,TH,THA,69625581,Asia,10,1651,2
2020-04-02T00:00:00Z,2,4,2020,120,2,Thailand,TH,THA,69625581,Asia,12,1771,3
2020-04-03T00:00:00Z,3,4,2020,104,3,Thailand,TH,THA,69625581,Asia,15,1875,4
2020-04-04T00:00:00Z,4,4,2020,103,4,Thailand,TH,THA,69625581,Asia,19,1978,5
2020-04-05T00:00:00Z,5,4,2020,191,4,Thailand,TH,THA,69625581,Asia,23,2169,6
2020-04-06T00:00:00Z,6,4,2020,51,3,Thailand,TH,THA,69625581,Asia,26,2220,7
2020-04-07T00:00:00Z,7,4,2020,38,0,Thailand,TH,THA,69625581,Asia,26,2258,8
2020-04-08T00:00:00Z,8,4,2020,111,4,Thailand,TH,THA,69625581,Asia,30,2369,9
2020-04-09T00:00:00Z,9,4,2020,54,2,Thailand,TH,THA,69625581,Asia,32,2423,10
2020-04-10T00:00:00Z,10,4,2020,50,1,Thailand,TH,THA,69625581,Asia,33,2473,11
2020-04-11T00:00:00Z,11,4,2020,45,2,Thailand,TH,THA,69625581,Asia,35,2518,12
2020-04-12T00:00:00Z,12,4,2020,33,3,Thailand,TH,THA,69625581,Asia,38,2551,13
2020-04-13T00:00:00Z,13,4,2020,28,2,Thailand,TH,THA,69625581,Asia,40,2579,14
2020-04-14T00:00:00Z,14,4,2020,34,1,Thailand,TH,THA,69625581,Asia,41,2613,15
2020-04-15T00:00:00Z,15,4,2020,30,2,Thailand,TH,THA,69625581,Asia,43,2643,16
2020-04-16T00:00:00Z,16,4,2020,29,3,Thailand,TH,THA,69625581,Asia,46,2672,17
2020-04-17T00:00:00Z,17,4,2020,28,1,Thailand,TH,THA,69625581,Asia,47,2700,18
2020-04-18T00:00:00Z,18,4,2020,0,0,Thailand,TH,THA,69625581,Asia,47,2700,19
2020-04-19T00:00:00Z,19,4,2020,33,0,Thailand,TH,THA,69625581,Asia,47,2733,20
2020-04-20T00:00:00Z,20,4,2020,32,0,Thailand,TH,THA,69625581,Asia,47,2765,21
2020-04-21T00:00:00Z,21,4,2020,27,0,Thailand,TH,THA,69625581,Asia,47,2792,22
2020-04-22T00:00:00Z,22,4,2020,19,1,Thailand,TH,THA,69625581,Asia,48,2811,23
2020-04-23T00:00:00Z,23,4,2020,28,2,Thailand,TH,THA,69625581,Asia,50,2839,24
2020-04-24T00:00:00Z,24,4,2020,0,0,Thailand,TH,THA,69625581,Asia,50,2839,25
2020-04-25T00:00:00Z,25,4,2020,15,0,Thailand,TH,THA,69625581,Asia,50,2854,26
2020-04-26T00:00:00Z,26,4,2020,68,1,Thailand,TH,THA,69625581,Asia,51,2922,27
2020-04-27T00:00:00Z,27,4,2020,0,0,Thailand,TH,THA,69625581,Asia,51,2922,28
2020-04-28T00:00:00Z,28,4,2020,16,3,Thailand,TH,THA,69625581,Asia,54,2938,29
2020-04-29T00:00:00Z,29,4,2020,0,0,Thailand,TH,THA,69625581,Asia,54,2938,30
2020-04-30T00:00:00Z,30,4,2020,16,0,Thailand,TH,THA,69625581,Asia,54,2954,31
2020-05-01T00:00:00Z,1,5,2020,6,0,Thailand,TH,THA,69625581,Asia,54,2960,32
2020-05-02T00:00:00Z,2,5,2020,0,0,Thailand,TH,THA,69625581,Asia,54,2960,33
2020-05-03T00:00:00Z,3,5,2020,6,0,Thailand,TH,THA,69625581,Asia,54,2966,34
2020-05-04T00:00:00Z,4,5,2020,3,0,Thailand,TH,THA,69625581,Asia,54,2969,35
2020-05-05T00:00:00Z,5,5,2020,18,0,Thailand,TH,THA,69625581,Asia,54,2987,36
2020-05-06T00:00:00Z,6,5,2020,1,0,Thailand,TH,THA,69625581,Asia,54,2988,37
2020-05-07T00:00:00Z,7,5,2020,1,1,Thailand,TH,THA,69625581,Asia,55,2989,38
2020-05-08T00:00:00Z,8,5,2020,3,0,Thailand,TH,THA,69625581,Asia,55,2992,39
2020-05-09T00:00:00Z,9,5,2020,8,0,Thailand,TH,THA,69625581,Asia,55,3000,40
2020-05-10T00:00:00Z,10,5,2020,4,1,Thailand,TH,THA,69625581,Asia,56,3004,41
2020-05-11T00:00:00Z,11,5,2020,11,0,Thailand,TH,THA,69625581,Asia,56,3015,42
2020-05-12T00:00:00Z,12,5,2020,0,0,Thailand,TH,THA,69625581,Asia,56,3015,43
2020-05-13T00:00:00Z,13,5,2020,2,0,Thailand,TH,THA,69625581,Asia,56,3017,44
2020-05-14T00:00:00Z,14,5,2020,0,0,Thailand,TH,THA,69625581,Asia,56,3017,45
2020-05-15T00:00:00Z,15,5,2020,1,0,Thailand,TH,THA,69625581,Asia,56,3018,46
2020-05-16T00:00:00Z,16,5,2020,7,0,Thailand,TH,THA,69625581,Asia,56,3025,47
2020-05-17T00:00:00Z,17,5,2020,3,0,Thailand,TH,THA,69625581,Asia,56,3028,48
2020-05-18T00:00:00Z,18,5,2020,0,0,Thailand,TH,THA,69625581,Asia,56,3028,49
2020-05-19T00:00:00Z,19,5,2020,3,0,Thailand,TH,THA,69625581,Asia,56,3031,50
2020-05-20T00:00:00Z,20,5,2020,3,0,Thailand,TH,THA,69625581,Asia,56,3034,51
2020-05-21T00:00:00Z,21,5,2020,0,0,Thailand,TH,THA,69625581,Asia,56,3034,52
2020-05-22T00:00:00Z,22,5,2020,3,0,Thailand,TH,THA,69625581,Asia,56,3037,53
2020-05-23T00:00:00Z,23,5,2020,3,0,Thailand,TH,THA,69625581,Asia,56,3040,54
2020-05-24T00:00:00Z,24,5,2020,0,0,Thailand,TH,THA,69625581,Asia,56,3040,55
2020-05-25T00:00:00Z,25,5,2020,2,1,Thailand,TH,THA,69625581,Asia,57,3042,56
2020-05-26T00:00:00Z,26,5,2020,0,0,Thailand,TH,THA,69625581,Asia,57,3042,57
2020-05-27T00:00:00Z,27,5,2020,3,0,Thailand,TH,THA,69625581,Asia,57,3045,58
2020-05-28T00:00:00Z,28,5,2020,9,0,Thailand,TH,THA,69625581,Asia,57,3054,59
2020-05-29T00:00:00Z,29,5,2020,11,0,Thailand,TH,THA,69625581,Asia,57,3065,60
2020-05-30T00:00:00Z,30,5,2020,11,0,Thailand,TH,THA,69625581,Asia,57,3076,61
2020-05-31T00:00:00Z,31,5,2020,5,0,Thailand,TH,THA,69625581,Asia,57,3081,62
2020-06-01T00:00:00Z,1,6,2020,0,0,Thailand,TH,THA,69625581,Asia,57,3081,63
2020-06-02T00:00:00Z,2,6,2020,1,0,Thailand,TH,THA,69625581,Asia,57,3082,64
2020-06-03T00:00:00Z,3,6,2020,1,1,Thailand,TH,THA,69625581,Asia,58,3083,65
2020-06-04T00:00:00Z,4,6,2020,18,0,Thailand,TH,THA,69625581,Asia,58,3101,66
2020-06-05T00:00:00Z,5,6,2020,1,0,Thailand,TH,THA,69625581,Asia,58,3102,67
2020-06-06T00:00:00Z,6,6,2020,2,0,Thailand,TH,THA,69625581,Asia,58,3104,68
2020-06-07T00:00:00Z,7,6,2020,8,0,Thailand,TH,THA,69625581,Asia,58,3112,69
2020-06-08T00:00:00Z,8,6,2020,7,0,Thailand,TH,THA,69625581,Asia,58,3119,70
2020-06-09T00:00:00Z,9,6,2020,0,0,Thailand,TH,THA,69625581,Asia,58,3119,71
2020-06-10T00:00:00Z,10,6,2020,6,0,Thailand,TH,THA,69625581,Asia,58,3125,72
2020-06-11T00:00:00Z,11,6,2020,0,0,Thailand,TH,THA,69625581,Asia,58,3125,73
2020-06-12T00:00:00Z,12,6,2020,0,0,Thailand,TH,THA,69625581,Asia,58,3125,74
2020-06-13T00:00:00Z,13,6,2020,4,0,Thailand,TH,THA,69625581,Asia,58,3129,75
2020-06-14T00:00:00Z,14,6,2020,5,0,Thailand,TH,THA,69625581,Asia,58,3134,76
2020-06-15T00:00:00Z,15,6,2020,1,0,Thailand,TH,THA,69625581,Asia,58,3135,77
2020-06-16T00:00:00Z,16,6,2020,0,0,Thailand,TH,THA,69625581,Asia,58,3135,78
2020-06-17T00:00:00Z,17,6,2020,0,0,Thailand,TH,THA,69625581,Asia,58,3135,79
2020-06-18T00:00:00Z,18,6,2020,6,0,Thailand,TH,THA,69625581,Asia,58,3141,80
2020-06-19T00:00:00Z,19,6,2020,0,0,Thailand,TH,THA,69625581,Asia,58,3141,81
2020-06-20T00:00:00Z,20,6,2020,5,0,Thailand,TH,THA,69625581,Asia,58,3146,82
2020-06-21T00:00:00Z,21,6,2020,1,0,Thailand,TH,THA,69625581,Asia,58,3147,83
2020-06-22T00:00:00Z,22,6,2020,1,0,Thailand,TH,THA,69625581,Asia,58,3148,84
2020-06-23T00:00:00Z,23,6,2020,3,0,Thailand,TH,THA,69625581,Asia,58,3151,85
2020-06-24T00:00:00Z,24,6,2020,5,0,Thailand,TH,THA,69625581,Asia,58,3156,86
2020-06-25T00:00:00Z,25,6,2020,2,0,Thailand,TH,THA,69625581,Asia,58,3158,87
2020-05-09T00:00:00Z,9,5,2020,10,1,Togo,TG,TGO,8082359,Africa,10,145,1
2020-05-10T00:00:00Z,10,5,2020,8,0,Togo,TG,TGO,8082359,Africa,10,153,2
2020-05-11T00:00:00Z,11,5,2020,21,1,Togo,TG,TGO,8082359,Africa,11,174,3
2020-05-12T00:00:00Z,12,5,2020,7,0,Togo,TG,TGO,8082359,Africa,11,181,4
2020-05-13T00:00:00Z,13,5,2020,18,0,Togo,TG,TGO,8082359,Africa,11,199,5
2020-05-14T00:00:00Z,14,5,2020,20,0,Togo,TG,TGO,8082359,Africa,11,219,6
2020-05-15T00:00:00Z,15,5,2020,19,0,Togo,TG,TGO,8082359,Africa,11,238,7
2020-05-16T00:00:00Z,16,5,2020,25,0,Togo,TG,TGO,8082359,Africa,11,263,8
2020-05-17T00:00:00Z,17,5,2020,35,0,Togo,TG,TGO,8082359,Africa,11,298,9
2020-05-18T00:00:00Z,18,5,2020,3,0,Togo,TG,TGO,8082359,Africa,11,301,10
2020-05-19T00:00:00Z,19,5,2020,29,1,Togo,TG,TGO,8082359,Africa,12,330,11
2020-05-20T00:00:00Z,20,5,2020,8,0,Togo,TG,TGO,8082359,Africa,12,338,12
2020-05-21T00:00:00Z,21,5,2020,2,0,Togo,TG,TGO,8082359,Africa,12,340,13
2020-05-22T00:00:00Z,22,5,2020,14,0,Togo,TG,TGO,8082359,Africa,12,354,14
2020-05-23T00:00:00Z,23,5,2020,9,0,Togo,TG,TGO,8082359,Africa,12,363,15
2020-05-24T00:00:00Z,24,5,2020,10,0,Togo,TG,TGO,8082359,Africa,12,373,16
2020-05-25T00:00:00Z,25,5,2020,8,0,Togo,TG,TGO,8082359,Africa,12,381,17
2020-05-26T00:00:00Z,26,5,2020,5,1,Togo,TG,TGO,8082359,Africa,13,386,18
2020-05-27T00:00:00Z,27,5,2020,5,0,Togo,TG,TGO,8082359,Africa,13,391,19
2020-05-28T00:00:00Z,28,5,2020,4,0,Togo,TG,TGO,8082359,Africa,13,395,20
2020-05-29T00:00:00Z,29,5,2020,27,0,Togo,TG,TGO,8082359,Africa,13,422,21
2020-05-30T00:00:00Z,30,5,2020,6,0,Togo,TG,TGO,8082359,Africa,13,428,22
2020-05-31T00:00:00Z,31,5,2020,5,0,Togo,TG,TGO,8082359,Africa,13,433,23
2020-06-01T00:00:00Z,1,6,2020,9,0,Togo,TG,TGO,8082359,Africa,13,442,24
2020-06-02T00:00:00Z,2,6,2020,1,0,Togo,TG,TGO,8082359,Africa,13,443,25
2020-06-03T00:00:00Z,3,6,2020,2,0,Togo,TG,TGO,8082359,Africa,13,445,26
2020-06-04T00:00:00Z,4,6,2020,7,0,Togo,TG,TGO,8082359,Africa,13,452,27
2020-06-05T00:00:00Z,5,6,2020,13,0,Togo,TG,TGO,8082359,Africa,13,465,28
2020-06-06T00:00:00Z,6,6,2020,20,0,Togo,TG,TGO,8082359,Africa,13,485,29
2020-06-07T00:00:00Z,7,6,2020,2,0,Togo,TG,TGO,8082359,Africa,13,487,30
2020-06-08T00:00:00Z,8,6,2020,8,0,Togo,TG,TGO,8082359,Africa,13,495,31
2020-06-09T00:00:00Z,9,6,2020,2,0,Togo,TG,TGO,8082359,Africa,13,497,32
2020-06-10T00:00:00Z,10,6,2020,4,0,Togo,TG,TGO,8082359,Africa,13,501,33
2020-06-11T00:00:00Z,11,6,2020,21,0,Togo,TG,TGO,8082359,Africa,13,522,34
2020-06-12T00:00:00Z,12,6,2020,2,0,Togo,TG,TGO,8082359,Africa,13,524,35
2020-06-13T00:00:00Z,13,6,2020,1,0,Togo,TG,TGO,8082359,Africa,13,525,36
2020-06-14T00:00:00Z,14,6,2020,5,0,Togo,TG,TGO,8082359,Africa,13,530,37
2020-06-15T00:00:00Z,15,6,2020,1,0,Togo,TG,TGO,8082359,Africa,13,531,38
2020-06-16T00:00:00Z,16,6,2020,1,0,Togo,TG,TGO,8082359,Africa,13,532,39
2020-06-17T00:00:00Z,17,6,2020,5,0,Togo,TG,TGO,8082359,Africa,13,537,40
2020-06-18T00:00:00Z,18,6,2020,7,0,Togo,TG,TGO,8082359,Africa,13,544,41
2020-06-19T00:00:00Z,19,6,2020,3,0,Togo,TG,TGO,8082359,Africa,13,547,42
2020-06-20T00:00:00Z,20,6,2020,8,0,Togo,TG,TGO,8082359,Africa,13,555,43
2020-06-21T00:00:00Z,21,6,2020,6,0,Togo,TG,TGO,8082359,Africa,13,561,44
2020-06-22T00:00:00Z,22,6,2020,8,0,Togo,TG,TGO,8082359,Africa,13,569,45
2020-06-23T00:00:00Z,23,6,2020,0,0,Togo,TG,TGO,8082359,Africa,13,569,46
2020-06-24T00:00:00Z,24,6,2020,7,0,Togo,TG,TGO,8082359,Africa,13,576,47
2020-06-25T00:00:00Z,25,6,2020,7,1,Togo,TG,TGO,8082359,Africa,14,583,48
2020-04-02T00:00:00Z,2,4,2020,32,1,Tunisia,TN,TUN,11694721,Africa,10,394,1
2020-04-03T00:00:00Z,3,4,2020,61,3,Tunisia,TN,TUN,11694721,Africa,13,455,2
2020-04-04T00:00:00Z,4,4,2020,0,0,Tunisia,TN,TUN,11694721,Africa,13,455,3
2020-04-05T00:00:00Z,5,4,2020,40,5,Tunisia,TN,TUN,11694721,Africa,18,495,4
2020-04-06T00:00:00Z,6,4,2020,58,1,Tunisia,TN,TUN,11694721,Africa,19,553,5
2020-04-07T00:00:00Z,7,4,2020,21,3,Tunisia,TN,TUN,11694721,Africa,22,574,6
2020-04-08T00:00:00Z,8,4,2020,22,0,Tunisia,TN,TUN,11694721,Africa,22,596,7
2020-04-09T00:00:00Z,9,4,2020,27,1,Tunisia,TN,TUN,11694721,Africa,23,623,8
2020-04-10T00:00:00Z,10,4,2020,20,2,Tunisia,TN,TUN,11694721,Africa,25,643,9
2020-04-11T00:00:00Z,11,4,2020,28,0,Tunisia,TN,TUN,11694721,Africa,25,671,10
2020-04-12T00:00:00Z,12,4,2020,14,3,Tunisia,TN,TUN,11694721,Africa,28,685,11
2020-04-13T00:00:00Z,13,4,2020,22,3,Tunisia,TN,TUN,11694721,Africa,31,707,12
2020-04-14T00:00:00Z,14,4,2020,19,3,Tunisia,TN,TUN,11694721,Africa,34,726,13
2020-04-15T00:00:00Z,15,4,2020,21,0,Tunisia,TN,TUN,11694721,Africa,34,747,14
2020-04-16T00:00:00Z,16,4,2020,33,1,Tunisia,TN,TUN,11694721,Africa,35,780,15
2020-04-17T00:00:00Z,17,4,2020,42,2,Tunisia,TN,TUN,11694721,Africa,37,822,16
2020-04-18T00:00:00Z,18,4,2020,42,0,Tunisia,TN,TUN,11694721,Africa,37,864,17
2020-04-19T00:00:00Z,19,4,2020,2,0,Tunisia,TN,TUN,11694721,Africa,37,866,18
2020-04-20T00:00:00Z,20,4,2020,13,1,Tunisia,TN,TUN,11694721,Africa,38,879,19
2020-04-21T00:00:00Z,21,4,2020,5,0,Tunisia,TN,TUN,11694721,Africa,38,884,20
2020-04-22T00:00:00Z,22,4,2020,17,0,Tunisia,TN,TUN,11694721,Africa,38,901,21
2020-04-23T00:00:00Z,23,4,2020,0,0,Tunisia,TN,TUN,11694721,Africa,38,901,22
2020-04-24T00:00:00Z,24,4,2020,17,0,Tunisia,TN,TUN,11694721,Africa,38,918,23
2020-04-25T00:00:00Z,25,4,2020,4,0,Tunisia,TN,TUN,11694721,Africa,38,922,24
2020-04-26T00:00:00Z,26,4,2020,17,0,Tunisia,TN,TUN,11694721,Africa,38,939,25
2020-04-27T00:00:00Z,27,4,2020,10,0,Tunisia,TN,TUN,11694721,Africa,38,949,26
2020-04-28T00:00:00Z,28,4,2020,18,1,Tunisia,TN,TUN,11694721,Africa,39,967,27
2020-04-29T00:00:00Z,29,4,2020,8,1,Tunisia,TN,TUN,11694721,Africa,40,975,28
2020-04-30T00:00:00Z,30,4,2020,5,0,Tunisia,TN,TUN,11694721,Africa,40,980,29
2020-05-01T00:00:00Z,1,5,2020,14,0,Tunisia,TN,TUN,11694721,Africa,40,994,30
2020-05-02T00:00:00Z,2,5,2020,4,1,Tunisia,TN,TUN,11694721,Africa,41,998,31
2020-05-03T00:00:00Z,3,5,2020,11,1,Tunisia,TN,TUN,11694721,Africa,42,1009,32
2020-05-04T00:00:00Z,4,5,2020,4,0,Tunisia,TN,TUN,11694721,Africa,42,1013,33
2020-05-05T00:00:00Z,5,5,2020,5,1,Tunisia,TN,TUN,11694721,Africa,43,1018,34
2020-05-06T00:00:00Z,6,5,2020,4,0,Tunisia,TN,TUN,11694721,Africa,43,1022,35
2020-05-07T00:00:00Z,7,5,2020,3,0,Tunisia,TN,TUN,11694721,Africa,43,1025,36
2020-05-08T00:00:00Z,8,5,2020,1,1,Tunisia,TN,TUN,11694721,Africa,44,1026,37
2020-05-09T00:00:00Z,9,5,2020,4,1,Tunisia,TN,TUN,11694721,Africa,45,1030,38
2020-05-10T00:00:00Z,10,5,2020,2,0,Tunisia,TN,TUN,11694721,Africa,45,1032,39
2020-05-11T00:00:00Z,11,5,2020,0,0,Tunisia,TN,TUN,11694721,Africa,45,1032,40
2020-05-12T00:00:00Z,12,5,2020,0,0,Tunisia,TN,TUN,11694721,Africa,45,1032,41
2020-05-13T00:00:00Z,13,5,2020,0,0,Tunisia,TN,TUN,11694721,Africa,45,1032,42
2020-05-14T00:00:00Z,14,5,2020,0,0,Tunisia,TN,TUN,11694721,Africa,45,1032,43
2020-05-15T00:00:00Z,15,5,2020,0,0,Tunisia,TN,TUN,11694721,Africa,45,1032,44
2020-05-16T00:00:00Z,16,5,2020,3,0,Tunisia,TN,TUN,11694721,Africa,45,1035,45
2020-05-17T00:00:00Z,17,5,2020,0,0,Tunisia,TN,TUN,11694721,Africa,45,1035,46
2020-05-18T00:00:00Z,18,5,2020,2,0,Tunisia,TN,TUN,11694721,Africa,45,1037,47
2020-05-19T00:00:00Z,19,5,2020,6,1,Tunisia,TN,TUN,11694721,Africa,46,1043,48
2020-05-20T00:00:00Z,20,5,2020,1,1,Tunisia,TN,TUN,11694721,Africa,47,1044,49
2020-05-21T00:00:00Z,21,5,2020,1,0,Tunisia,TN,TUN,11694721,Africa,47,1045,50
2020-05-22T00:00:00Z,22,5,2020,1,0,Tunisia,TN,TUN,11694721,Africa,47,1046,51
2020-05-23T00:00:00Z,23,5,2020,2,0,Tunisia,TN,TUN,11694721,Africa,47,1048,52
2020-05-24T00:00:00Z,24,5,2020,0,1,Tunisia,TN,TUN,11694721,Africa,48,1048,53
2020-05-25T00:00:00Z,25,5,2020,3,0,Tunisia,TN,TUN,11694721,Africa,48,1051,54
2020-05-26T00:00:00Z,26,5,2020,0,0,Tunisia,TN,TUN,11694721,Africa,48,1051,55
2020-05-27T00:00:00Z,27,5,2020,0,0,Tunisia,TN,TUN,11694721,Africa,48,1051,56
2020-05-28T00:00:00Z,28,5,2020,0,0,Tunisia,TN,TUN,11694721,Africa,48,1051,57
2020-05-29T00:00:00Z,29,5,2020,17,0,Tunisia,TN,TUN,11694721,Africa,48,1068,58
2020-05-30T00:00:00Z,30,5,2020,3,0,Tunisia,TN,TUN,11694721,Africa,48,1071,59
2020-05-31T00:00:00Z,31,5,2020,5,0,Tunisia,TN,TUN,11694721,Africa,48,1076,60
2020-06-01T00:00:00Z,1,6,2020,1,0,Tunisia,TN,TUN,11694721,Africa,48,1077,61
2020-06-02T00:00:00Z,2,6,2020,7,0,Tunisia,TN,TUN,11694721,Africa,48,1084,62
2020-06-03T00:00:00Z,3,6,2020,2,0,Tunisia,TN,TUN,11694721,Africa,48,1086,63
2020-06-04T00:00:00Z,4,6,2020,1,1,Tunisia,TN,TUN,11694721,Africa,49,1087,64
2020-06-05T00:00:00Z,5,6,2020,0,0,Tunisia,TN,TUN,11694721,Africa,49,1087,65
2020-06-06T00:00:00Z,6,6,2020,0,0,Tunisia,TN,TUN,11694721,Africa,49,1087,66
2020-06-07T00:00:00Z,7,6,2020,0,0,Tunisia,TN,TUN,11694721,Africa,49,1087,67
2020-06-08T00:00:00Z,8,6,2020,0,0,Tunisia,TN,TUN,11694721,Africa,49,1087,68
2020-06-09T00:00:00Z,9,6,2020,0,0,Tunisia,TN,TUN,11694721,Africa,49,1087,69
2020-06-10T00:00:00Z,10,6,2020,0,0,Tunisia,TN,TUN,11694721,Africa,49,1087,70
2020-06-11T00:00:00Z,11,6,2020,0,0,Tunisia,TN,TUN,11694721,Africa,49,1087,71
2020-06-12T00:00:00Z,12,6,2020,0,0,Tunisia,TN,TUN,11694721,Africa,49,1087,72
2020-06-13T00:00:00Z,13,6,2020,6,0,Tunisia,TN,TUN,11694721,Africa,49,1093,73
2020-06-14T00:00:00Z,14,6,2020,1,0,Tunisia,TN,TUN,11694721,Africa,49,1094,74
2020-06-15T00:00:00Z,15,6,2020,2,0,Tunisia,TN,TUN,11694721,Africa,49,1096,75
2020-06-16T00:00:00Z,16,6,2020,14,0,Tunisia,TN,TUN,11694721,Africa,49,1110,76
2020-06-17T00:00:00Z,17,6,2020,15,0,Tunisia,TN,TUN,11694721,Africa,49,1125,77
2020-06-18T00:00:00Z,18,6,2020,3,1,Tunisia,TN,TUN,11694721,Africa,50,1128,78
2020-06-19T00:00:00Z,19,6,2020,4,0,Tunisia,TN,TUN,11694721,Africa,50,1132,79
2020-06-20T00:00:00Z,20,6,2020,14,0,Tunisia,TN,TUN,11694721,Africa,50,1146,80
2020-06-21T00:00:00Z,21,6,2020,10,0,Tunisia,TN,TUN,11694721,Africa,50,1156,81
2020-06-22T00:00:00Z,22,6,2020,1,0,Tunisia,TN,TUN,11694721,Africa,50,1157,82
2020-06-23T00:00:00Z,23,6,2020,2,0,Tunisia,TN,TUN,11694721,Africa,50,1159,83
2020-06-24T00:00:00Z,24,6,2020,0,0,Tunisia,TN,TUN,11694721,Africa,50,1159,84
2020-06-25T00:00:00Z,25,6,2020,1,0,Tunisia,TN,TUN,11694721,Africa,50,1160,85
2020-03-22T00:00:00Z,22,3,2020,277,12,Turkey,TR,TUR,82003882,Asia,21,947,1
2020-03-23T00:00:00Z,23,3,2020,289,9,Turkey,TR,TUR,82003882,Asia,30,1236,2
2020-03-24T00:00:00Z,24,3,2020,293,7,Turkey,TR,TUR,82003882,Asia,37,1529,3
2020-03-25T00:00:00Z,25,3,2020,343,7,Turkey,TR,TUR,82003882,Asia,44,1872,4
2020-03-26T00:00:00Z,26,3,2020,561,15,Turkey,TR,TUR,82003882,Asia,59,2433,5
2020-03-27T00:00:00Z,27,3,2020,1196,16,Turkey,TR,TUR,82003882,Asia,75,3629,6
2020-03-28T00:00:00Z,28,3,2020,2069,17,Turkey,TR,TUR,82003882,Asia,92,5698,7
2020-03-29T00:00:00Z,29,3,2020,1704,16,Turkey,TR,TUR,82003882,Asia,108,7402,8
2020-03-30T00:00:00Z,30,3,2020,1815,23,Turkey,TR,TUR,82003882,Asia,131,9217,9
2020-03-31T00:00:00Z,31,3,2020,1610,37,Turkey,TR,TUR,82003882,Asia,168,10827,10
2020-04-01T00:00:00Z,1,4,2020,2704,46,Turkey,TR,TUR,82003882,Asia,214,13531,11
2020-04-02T00:00:00Z,2,4,2020,2148,63,Turkey,TR,TUR,82003882,Asia,277,15679,12
2020-04-03T00:00:00Z,3,4,2020,2456,79,Turkey,TR,TUR,82003882,Asia,356,18135,13
2020-04-04T00:00:00Z,4,4,2020,2786,69,Turkey,TR,TUR,82003882,Asia,425,20921,14
2020-04-05T00:00:00Z,5,4,2020,3013,76,Turkey,TR,TUR,82003882,Asia,501,23934,15
2020-04-06T00:00:00Z,6,4,2020,3135,73,Turkey,TR,TUR,82003882,Asia,574,27069,16
2020-04-07T00:00:00Z,7,4,2020,3148,75,Turkey,TR,TUR,82003882,Asia,649,30217,17
2020-04-08T00:00:00Z,8,4,2020,3892,76,Turkey,TR,TUR,82003882,Asia,725,34109,18
2020-04-09T00:00:00Z,9,4,2020,4117,87,Turkey,TR,TUR,82003882,Asia,812,38226,19
2020-04-10T00:00:00Z,10,4,2020,4056,96,Turkey,TR,TUR,82003882,Asia,908,42282,20
2020-04-11T00:00:00Z,11,4,2020,4747,98,Turkey,TR,TUR,82003882,Asia,1006,47029,21
2020-04-12T00:00:00Z,12,4,2020,5138,95,Turkey,TR,TUR,82003882,Asia,1101,52167,22
2020-04-13T00:00:00Z,13,4,2020,4789,97,Turkey,TR,TUR,82003882,Asia,1198,56956,23
2020-04-14T00:00:00Z,14,4,2020,4093,98,Turkey,TR,TUR,82003882,Asia,1296,61049,24
2020-04-15T00:00:00Z,15,4,2020,4062,107,Turkey,TR,TUR,82003882,Asia,1403,65111,25
2020-04-16T00:00:00Z,16,4,2020,4281,115,Turkey,TR,TUR,82003882,Asia,1518,69392,26
2020-04-17T00:00:00Z,17,4,2020,4801,125,Turkey,TR,TUR,82003882,Asia,1643,74193,27
2020-04-18T00:00:00Z,18,4,2020,4353,126,Turkey,TR,TUR,82003882,Asia,1769,78546,28
2020-04-19T00:00:00Z,19,4,2020,3783,121,Turkey,TR,TUR,82003882,Asia,1890,82329,29
2020-04-20T00:00:00Z,20,4,2020,3977,127,Turkey,TR,TUR,82003882,Asia,2017,86306,30
2020-04-21T00:00:00Z,21,4,2020,4674,123,Turkey,TR,TUR,82003882,Asia,2140,90980,31
2020-04-22T00:00:00Z,22,4,2020,4611,119,Turkey,TR,TUR,82003882,Asia,2259,95591,32
2020-04-23T00:00:00Z,23,4,2020,3083,117,Turkey,TR,TUR,82003882,Asia,2376,98674,33
2020-04-24T00:00:00Z,24,4,2020,3116,115,Turkey,TR,TUR,82003882,Asia,2491,101790,34
2020-04-25T00:00:00Z,25,4,2020,3122,109,Turkey,TR,TUR,82003882,Asia,2600,104912,35
2020-04-26T00:00:00Z,26,4,2020,2861,106,Turkey,TR,TUR,82003882,Asia,2706,107773,36
2020-04-27T00:00:00Z,27,4,2020,2357,99,Turkey,TR,TUR,82003882,Asia,2805,110130,37
2020-04-28T00:00:00Z,28,4,2020,2131,95,Turkey,TR,TUR,82003882,Asia,2900,112261,38
2020-04-29T00:00:00Z,29,4,2020,2392,92,Turkey,TR,TUR,82003882,Asia,2992,114653,39
2020-04-30T00:00:00Z,30,4,2020,2936,89,Turkey,TR,TUR,82003882,Asia,3081,117589,40
2020-05-01T00:00:00Z,1,5,2020,2615,93,Turkey,TR,TUR,82003882,Asia,3174,120204,41
2020-05-02T00:00:00Z,2,5,2020,2188,84,Turkey,TR,TUR,82003882,Asia,3258,122392,42
2020-05-03T00:00:00Z,3,5,2020,1983,78,Turkey,TR,TUR,82003882,Asia,3336,124375,43
2020-05-04T00:00:00Z,4,5,2020,1670,61,Turkey,TR,TUR,82003882,Asia,3397,126045,44
2020-05-05T00:00:00Z,5,5,2020,1614,64,Turkey,TR,TUR,82003882,Asia,3461,127659,45
2020-05-06T00:00:00Z,6,5,2020,1832,59,Turkey,TR,TUR,82003882,Asia,3520,129491,46
2020-05-07T00:00:00Z,7,5,2020,2253,64,Turkey,TR,TUR,82003882,Asia,3584,131744,47
2020-05-08T00:00:00Z,8,5,2020,1977,57,Turkey,TR,TUR,82003882,Asia,3641,133721,48
2020-05-09T00:00:00Z,9,5,2020,1848,48,Turkey,TR,TUR,82003882,Asia,3689,135569,49
2020-05-10T00:00:00Z,10,5,2020,1546,50,Turkey,TR,TUR,82003882,Asia,3739,137115,50
2020-05-11T00:00:00Z,11,5,2020,1542,47,Turkey,TR,TUR,82003882,Asia,3786,138657,51
2020-05-12T00:00:00Z,12,5,2020,1114,55,Turkey,TR,TUR,82003882,Asia,3841,139771,52
2020-05-13T00:00:00Z,13,5,2020,1704,53,Turkey,TR,TUR,82003882,Asia,3894,141475,53
2020-05-14T00:00:00Z,14,5,2020,1639,58,Turkey,TR,TUR,82003882,Asia,3952,143114,54
2020-05-15T00:00:00Z,15,5,2020,1635,55,Turkey,TR,TUR,82003882,Asia,4007,144749,55
2020-05-16T00:00:00Z,16,5,2020,1708,48,Turkey,TR,TUR,82003882,Asia,4055,146457,56
2020-05-17T00:00:00Z,17,5,2020,1610,41,Turkey,TR,TUR,82003882,Asia,4096,148067,57
2020-05-18T00:00:00Z,18,5,2020,1368,44,Turkey,TR,TUR,82003882,Asia,4140,149435,58
2020-05-19T00:00:00Z,19,5,2020,1158,31,Turkey,TR,TUR,82003882,Asia,4171,150593,59
2020-05-20T00:00:00Z,20,5,2020,1022,28,Turkey,TR,TUR,82003882,Asia,4199,151615,60
2020-05-21T00:00:00Z,21,5,2020,972,23,Turkey,TR,TUR,82003882,Asia,4222,152587,61
2020-05-22T00:00:00Z,22,5,2020,961,27,Turkey,TR,TUR,82003882,Asia,4249,153548,62
2020-05-23T00:00:00Z,23,5,2020,952,27,Turkey,TR,TUR,82003882,Asia,4276,154500,63
2020-05-24T00:00:00Z,24,5,2020,1186,32,Turkey,TR,TUR,82003882,Asia,4308,155686,64
2020-05-25T00:00:00Z,25,5,2020,1141,32,Turkey,TR,TUR,82003882,Asia,4340,156827,65
2020-05-26T00:00:00Z,26,5,2020,987,29,Turkey,TR,TUR,82003882,Asia,4369,157814,66
2020-05-27T00:00:00Z,27,5,2020,948,28,Turkey,TR,TUR,82003882,Asia,4397,158762,67
2020-05-28T00:00:00Z,28,5,2020,1035,34,Turkey,TR,TUR,82003882,Asia,4431,159797,68
2020-05-29T00:00:00Z,29,5,2020,1182,30,Turkey,TR,TUR,82003882,Asia,4461,160979,69
2020-05-30T00:00:00Z,30,5,2020,1141,28,Turkey,TR,TUR,82003882,Asia,4489,162120,70
2020-05-31T00:00:00Z,31,5,2020,983,26,Turkey,TR,TUR,82003882,Asia,4515,163103,71
2020-06-01T00:00:00Z,1,6,2020,839,25,Turkey,TR,TUR,82003882,Asia,4540,163942,72
2020-06-02T00:00:00Z,2,6,2020,827,23,Turkey,TR,TUR,82003882,Asia,4563,164769,73
2020-06-03T00:00:00Z,3,6,2020,786,22,Turkey,TR,TUR,82003882,Asia,4585,165555,74
2020-06-04T00:00:00Z,4,6,2020,867,24,Turkey,TR,TUR,82003882,Asia,4609,166422,75
2020-06-05T00:00:00Z,5,6,2020,988,21,Turkey,TR,TUR,82003882,Asia,4630,167410,76
2020-06-06T00:00:00Z,6,6,2020,930,18,Turkey,TR,TUR,82003882,Asia,4648,168340,77
2020-06-07T00:00:00Z,7,6,2020,878,21,Turkey,TR,TUR,82003882,Asia,4669,169218,78
2020-06-08T00:00:00Z,8,6,2020,914,23,Turkey,TR,TUR,82003882,Asia,4692,170132,79
2020-06-09T00:00:00Z,9,6,2020,989,19,Turkey,TR,TUR,82003882,Asia,4711,171121,80
2020-06-10T00:00:00Z,10,6,2020,993,18,Turkey,TR,TUR,82003882,Asia,4729,172114,81
2020-06-11T00:00:00Z,11,6,2020,922,17,Turkey,TR,TUR,82003882,Asia,4746,173036,82
2020-06-12T00:00:00Z,12,6,2020,987,17,Turkey,TR,TUR,82003882,Asia,4763,174023,83
2020-06-13T00:00:00Z,13,6,2020,1195,15,Turkey,TR,TUR,82003882,Asia,4778,175218,84
2020-06-14T00:00:00Z,14,6,2020,1459,14,Turkey,TR,TUR,82003882,Asia,4792,176677,85
2020-06-15T00:00:00Z,15,6,2020,1562,15,Turkey,TR,TUR,82003882,Asia,4807,178239,86
2020-06-16T00:00:00Z,16,6,2020,1592,18,Turkey,TR,TUR,82003882,Asia,4825,179831,87
2020-06-17T00:00:00Z,17,6,2020,1467,17,Turkey,TR,TUR,82003882,Asia,4842,181298,88
2020-06-18T00:00:00Z,18,6,2020,1429,19,Turkey,TR,TUR,82003882,Asia,4861,182727,89
2020-06-19T00:00:00Z,19,6,2020,1304,21,Turkey,TR,TUR,82003882,Asia,4882,184031,90
2020-06-20T00:00:00Z,20,6,2020,1214,23,Turkey,TR,TUR,82003882,Asia,4905,185245,91
2020-06-21T00:00:00Z,21,6,2020,1248,22,Turkey,TR,TUR,82003882,Asia,4927,186493,92
2020-06-22T00:00:00Z,22,6,2020,1192,23,Turkey,TR,TUR,82003882,Asia,4950,187685,93
2020-06-23T00:00:00Z,23,6,2020,1212,24,Turkey,TR,TUR,82003882,Asia,4974,188897,94
2020-06-24T00:00:00Z,24,6,2020,1268,27,Turkey,TR,TUR,82003882,Asia,5001,190165,95
2020-06-25T00:00:00Z,25,6,2020,1492,24,Turkey,TR,TUR,82003882,Asia,5025,191657,96
2020-03-31T00:00:00Z,31,3,2020,62,2,Ukraine,UA,UKR,43993643,Europe,11,480,1
2020-04-01T00:00:00Z,1,4,2020,69,2,Ukraine,UA,UKR,43993643,Europe,13,549,2
2020-04-02T00:00:00Z,2,4,2020,245,7,Ukraine,UA,UKR,43993643,Europe,20,794,3
2020-04-03T00:00:00Z,3,4,2020,10,0,Ukraine,UA,UKR,43993643,Europe,20,804,4
2020-04-04T00:00:00Z,4,4,2020,183,3,Ukraine,UA,UKR,43993643,Europe,23,987,5
2020-04-05T00:00:00Z,5,4,2020,109,5,Ukraine,UA,UKR,43993643,Europe,28,1096,6
2020-04-06T00:00:00Z,6,4,2020,155,4,Ukraine,UA,UKR,43993643,Europe,32,1251,7
2020-04-07T00:00:00Z,7,4,2020,68,6,Ukraine,UA,UKR,43993643,Europe,38,1319,8
2020-04-08T00:00:00Z,8,4,2020,143,7,Ukraine,UA,UKR,43993643,Europe,45,1462,9
2020-04-09T00:00:00Z,9,4,2020,206,7,Ukraine,UA,UKR,43993643,Europe,52,1668,10
2020-04-10T00:00:00Z,10,4,2020,224,5,Ukraine,UA,UKR,43993643,Europe,57,1892,11
2020-04-11T00:00:00Z,11,4,2020,311,12,Ukraine,UA,UKR,43993643,Europe,69,2203,12
2020-04-12T00:00:00Z,12,4,2020,308,4,Ukraine,UA,UKR,43993643,Europe,73,2511,13
2020-04-13T00:00:00Z,13,4,2020,266,10,Ukraine,UA,UKR,43993643,Europe,83,2777,14
2020-04-14T00:00:00Z,14,4,2020,325,10,Ukraine,UA,UKR,43993643,Europe,93,3102,15
2020-04-15T00:00:00Z,15,4,2020,270,5,Ukraine,UA,UKR,43993643,Europe,98,3372,16
2020-04-16T00:00:00Z,16,4,2020,789,18,Ukraine,UA,UKR,43993643,Europe,116,4161,17
2020-04-17T00:00:00Z,17,4,2020,301,9,Ukraine,UA,UKR,43993643,Europe,125,4462,18
2020-04-18T00:00:00Z,18,4,2020,644,8,Ukraine,UA,UKR,43993643,Europe,133,5106,19
2020-04-19T00:00:00Z,19,4,2020,343,8,Ukraine,UA,UKR,43993643,Europe,141,5449,20
2020-04-20T00:00:00Z,20,4,2020,261,10,Ukraine,UA,UKR,43993643,Europe,151,5710,21
2020-04-21T00:00:00Z,21,4,2020,415,10,Ukraine,UA,UKR,43993643,Europe,161,6125,22
2020-04-22T00:00:00Z,22,4,2020,467,13,Ukraine,UA,UKR,43993643,Europe,174,6592,23
2020-04-23T00:00:00Z,23,4,2020,578,13,Ukraine,UA,UKR,43993643,Europe,187,7170,24
2020-04-24T00:00:00Z,24,4,2020,477,6,Ukraine,UA,UKR,43993643,Europe,193,7647,25
2020-04-25T00:00:00Z,25,4,2020,478,8,Ukraine,UA,UKR,43993643,Europe,201,8125,26
2020-04-26T00:00:00Z,26,4,2020,492,8,Ukraine,UA,UKR,43993643,Europe,209,8617,27
2020-04-27T00:00:00Z,27,4,2020,392,11,Ukraine,UA,UKR,43993643,Europe,220,9009,28
2020-04-28T00:00:00Z,28,4,2020,0,0,Ukraine,UA,UKR,43993643,Europe,220,9009,29
2020-04-29T00:00:00Z,29,4,2020,401,19,Ukraine,UA,UKR,43993643,Europe,239,9410,30
2020-04-30T00:00:00Z,30,4,2020,456,11,Ukraine,UA,UKR,43993643,Europe,250,9866,31
2020-05-01T00:00:00Z,1,5,2020,540,0,Ukraine,UA,UKR,43993643,Europe,250,10406,32
2020-05-02T00:00:00Z,2,5,2020,455,29,Ukraine,UA,UKR,43993643,Europe,279,10861,33
2020-05-03T00:00:00Z,3,5,2020,550,0,Ukraine,UA,UKR,43993643,Europe,279,11411,34
2020-05-04T00:00:00Z,4,5,2020,502,9,Ukraine,UA,UKR,43993643,Europe,288,11913,35
2020-05-05T00:00:00Z,5,5,2020,418,15,Ukraine,UA,UKR,43993643,Europe,303,12331,36
2020-05-06T00:00:00Z,6,5,2020,366,13,Ukraine,UA,UKR,43993643,Europe,316,12697,37
2020-05-07T00:00:00Z,7,5,2020,487,11,Ukraine,UA,UKR,43993643,Europe,327,13184,38
2020-05-08T00:00:00Z,8,5,2020,507,13,Ukraine,UA,UKR,43993643,Europe,340,13691,39
2020-05-09T00:00:00Z,9,5,2020,504,21,Ukraine,UA,UKR,43993643,Europe,361,14195,40
2020-05-10T00:00:00Z,10,5,2020,515,15,Ukraine,UA,UKR,43993643,Europe,376,14710,41
2020-05-11T00:00:00Z,11,5,2020,522,15,Ukraine,UA,UKR,43993643,Europe,391,15232,42
2020-05-12T00:00:00Z,12,5,2020,416,17,Ukraine,UA,UKR,43993643,Europe,408,15648,43
2020-05-13T00:00:00Z,13,5,2020,375,17,Ukraine,UA,UKR,43993643,Europe,425,16023,44
2020-05-14T00:00:00Z,14,5,2020,402,14,Ukraine,UA,UKR,43993643,Europe,439,16425,45
2020-05-15T00:00:00Z,15,5,2020,422,17,Ukraine,UA,UKR,43993643,Europe,456,16847,46
2020-05-16T00:00:00Z,16,5,2020,483,27,Ukraine,UA,UKR,43993643,Europe,483,17330,47
2020-05-17T00:00:00Z,17,5,2020,528,14,Ukraine,UA,UKR,43993643,Europe,497,17858,48
2020-05-18T00:00:00Z,18,5,2020,433,17,Ukraine,UA,UKR,43993643,Europe,514,18291,49
2020-05-19T00:00:00Z,19,5,2020,325,21,Ukraine,UA,UKR,43993643,Europe,535,18616,50
2020-05-20T00:00:00Z,20,5,2020,260,13,Ukraine,UA,UKR,43993643,Europe,548,18876,51
2020-05-21T00:00:00Z,21,5,2020,354,16,Ukraine,UA,UKR,43993643,Europe,564,19230,52
2020-05-22T00:00:00Z,22,5,2020,476,15,Ukraine,UA,UKR,43993643,Europe,579,19706,53
2020-05-23T00:00:00Z,23,5,2020,442,9,Ukraine,UA,UKR,43993643,Europe,588,20148,54
2020-05-24T00:00:00Z,24,5,2020,432,17,Ukraine,UA,UKR,43993643,Europe,605,20580,55
2020-05-25T00:00:00Z,25,5,2020,406,12,Ukraine,UA,UKR,43993643,Europe,617,20986,56
2020-05-26T00:00:00Z,26,5,2020,259,6,Ukraine,UA,UKR,43993643,Europe,623,21245,57
2020-05-27T00:00:00Z,27,5,2020,339,21,Ukraine,UA,UKR,43993643,Europe,644,21584,58
2020-05-28T00:00:00Z,28,5,2020,0,0,Ukraine,UA,UKR,43993643,Europe,644,21584,59
2020-05-29T00:00:00Z,29,5,2020,798,25,Ukraine,UA,UKR,43993643,Europe,669,22382,60
2020-05-30T00:00:00Z,30,5,2020,822,27,Ukraine,UA,UKR,43993643,Europe,696,23204,61
2020-05-31T00:00:00Z,31,5,2020,0,0,Ukraine,UA,UKR,43993643,Europe,696,23204,62
2020-06-01T00:00:00Z,1,6,2020,468,12,Ukraine,UA,UKR,43993643,Europe,708,23672,63
2020-06-02T00:00:00Z,2,6,2020,668,19,Ukraine,UA,UKR,43993643,Europe,727,24340,64
2020-06-03T00:00:00Z,3,6,2020,483,8,Ukraine,UA,UKR,43993643,Europe,735,24823,65
2020-06-04T00:00:00Z,4,6,2020,588,12,Ukraine,UA,UKR,43993643,Europe,747,25411,66
2020-06-05T00:00:00Z,5,6,2020,553,15,Ukraine,UA,UKR,43993643,Europe,762,25964,67
2020-06-06T00:00:00Z,6,6,2020,550,15,Ukraine,UA,UKR,43993643,Europe,777,26514,68
2020-06-07T00:00:00Z,7,6,2020,0,0,Ukraine,UA,UKR,43993643,Europe,777,26514,69
2020-06-08T00:00:00Z,8,6,2020,485,11,Ukraine,UA,UKR,43993643,Europe,788,26999,70
2020-06-09T00:00:00Z,9,6,2020,463,9,Ukraine,UA,UKR,43993643,Europe,797,27462,71
2020-06-10T00:00:00Z,10,6,2020,394,13,Ukraine,UA,UKR,43993643,Europe,810,27856,72
2020-06-11T00:00:00Z,11,6,2020,525,23,Ukraine,UA,UKR,43993643,Europe,833,28381,73
2020-06-12T00:00:00Z,12,6,2020,689,21,Ukraine,UA,UKR,43993643,Europe,854,29070,74
2020-06-13T00:00:00Z,13,6,2020,683,16,Ukraine,UA,UKR,43993643,Europe,870,29753,75
2020-06-14T00:00:00Z,14,6,2020,753,10,Ukraine,UA,UKR,43993643,Europe,880,30506,76
2020-06-15T00:00:00Z,15,6,2020,648,9,Ukraine,UA,UKR,43993643,Europe,889,31154,77
2020-06-16T00:00:00Z,16,6,2020,656,12,Ukraine,UA,UKR,43993643,Europe,901,31810,78
2020-06-17T00:00:00Z,17,6,2020,666,11,Ukraine,UA,UKR,43993643,Europe,912,32476,79
2020-06-18T00:00:00Z,18,6,2020,758,31,Ukraine,UA,UKR,43993643,Europe,943,33234,80
2020-06-19T00:00:00Z,19,6,2020,829,23,Ukraine,UA,UKR,43993643,Europe,966,34063,81
2020-06-20T00:00:00Z,20,6,2020,921,19,Ukraine,UA,UKR,43993643,Europe,985,34984,82
2020-06-21T00:00:00Z,21,6,2020,841,9,Ukraine,UA,UKR,43993643,Europe,994,35825,83
2020-06-22T00:00:00Z,22,6,2020,735,8,Ukraine,UA,UKR,43993643,Europe,1002,36560,84
2020-06-23T00:00:00Z,23,6,2020,681,10,Ukraine,UA,UKR,43993643,Europe,1012,37241,85
2020-06-24T00:00:00Z,24,6,2020,1773,39,Ukraine,UA,UKR,43993643,Europe,1051,39014,86
2020-06-25T00:00:00Z,25,6,2020,0,0,Ukraine,UA,UKR,43993643,Europe,1051,39014,87
2020-04-05T00:00:00Z,5,4,2020,481,2,United_Arab_Emirates,AE,ARE,9770526,Asia,10,1505,1
2020-04-06T00:00:00Z,6,4,2020,294,0,United_Arab_Emirates,AE,ARE,9770526,Asia,10,1799,2
2020-04-07T00:00:00Z,7,4,2020,277,1,United_Arab_Emirates,AE,ARE,9770526,Asia,11,2076,3
2020-04-08T00:00:00Z,8,4,2020,283,1,United_Arab_Emirates,AE,ARE,9770526,Asia,12,2359,4
2020-04-09T00:00:00Z,9,4,2020,300,0,United_Arab_Emirates,AE,ARE,9770526,Asia,12,2659,5
2020-04-10T00:00:00Z,10,4,2020,331,2,United_Arab_Emirates,AE,ARE,9770526,Asia,14,2990,6
2020-04-11T00:00:00Z,11,4,2020,370,2,United_Arab_Emirates,AE,ARE,9770526,Asia,16,3360,7
2020-04-12T00:00:00Z,12,4,2020,376,4,United_Arab_Emirates,AE,ARE,9770526,Asia,20,3736,8
2020-04-13T00:00:00Z,13,4,2020,387,2,United_Arab_Emirates,AE,ARE,9770526,Asia,22,4123,9
2020-04-14T00:00:00Z,14,4,2020,398,3,United_Arab_Emirates,AE,ARE,9770526,Asia,25,4521,10
2020-04-15T00:00:00Z,15,4,2020,412,3,United_Arab_Emirates,AE,ARE,9770526,Asia,28,4933,11
2020-04-16T00:00:00Z,16,4,2020,432,5,United_Arab_Emirates,AE,ARE,9770526,Asia,33,5365,12
2020-04-17T00:00:00Z,17,4,2020,460,0,United_Arab_Emirates,AE,ARE,9770526,Asia,33,5825,13
2020-04-18T00:00:00Z,18,4,2020,0,2,United_Arab_Emirates,AE,ARE,9770526,Asia,35,5825,14
2020-04-19T00:00:00Z,19,4,2020,477,2,United_Arab_Emirates,AE,ARE,9770526,Asia,37,6302,15
2020-04-20T00:00:00Z,20,4,2020,479,4,United_Arab_Emirates,AE,ARE,9770526,Asia,41,6781,16
2020-04-21T00:00:00Z,21,4,2020,484,2,United_Arab_Emirates,AE,ARE,9770526,Asia,43,7265,17
2020-04-22T00:00:00Z,22,4,2020,490,3,United_Arab_Emirates,AE,ARE,9770526,Asia,46,7755,18
2020-04-23T00:00:00Z,23,4,2020,483,6,United_Arab_Emirates,AE,ARE,9770526,Asia,52,8238,19
2020-04-24T00:00:00Z,24,4,2020,518,4,United_Arab_Emirates,AE,ARE,9770526,Asia,56,8756,20
2020-04-25T00:00:00Z,25,4,2020,525,8,United_Arab_Emirates,AE,ARE,9770526,Asia,64,9281,21
2020-04-26T00:00:00Z,26,4,2020,532,0,United_Arab_Emirates,AE,ARE,9770526,Asia,64,9813,22
2020-04-27T00:00:00Z,27,4,2020,536,12,United_Arab_Emirates,AE,ARE,9770526,Asia,76,10349,23
2020-04-28T00:00:00Z,28,4,2020,490,6,United_Arab_Emirates,AE,ARE,9770526,Asia,82,10839,24
2020-04-29T00:00:00Z,29,4,2020,541,7,United_Arab_Emirates,AE,ARE,9770526,Asia,89,11380,25
2020-04-30T00:00:00Z,30,4,2020,549,9,United_Arab_Emirates,AE,ARE,9770526,Asia,98,11929,26
2020-05-01T00:00:00Z,1,5,2020,552,7,United_Arab_Emirates,AE,ARE,9770526,Asia,105,12481,27
2020-05-02T00:00:00Z,2,5,2020,557,6,United_Arab_Emirates,AE,ARE,9770526,Asia,111,13038,28
2020-05-03T00:00:00Z,3,5,2020,561,8,United_Arab_Emirates,AE,ARE,9770526,Asia,119,13599,29
2020-05-04T00:00:00Z,4,5,2020,564,7,United_Arab_Emirates,AE,ARE,9770526,Asia,126,14163,30
2020-05-05T00:00:00Z,5,5,2020,567,11,United_Arab_Emirates,AE,ARE,9770526,Asia,137,14730,31
2020-05-06T00:00:00Z,6,5,2020,462,9,United_Arab_Emirates,AE,ARE,9770526,Asia,146,15192,32
2020-05-07T00:00:00Z,7,5,2020,546,11,United_Arab_Emirates,AE,ARE,9770526,Asia,157,15738,33
2020-05-08T00:00:00Z,8,5,2020,502,8,United_Arab_Emirates,AE,ARE,9770526,Asia,165,16240,34
2020-05-09T00:00:00Z,9,5,2020,553,9,United_Arab_Emirates,AE,ARE,9770526,Asia,174,16793,35
2020-05-10T00:00:00Z,10,5,2020,624,11,United_Arab_Emirates,AE,ARE,9770526,Asia,185,17417,36
2020-05-11T00:00:00Z,11,5,2020,781,13,United_Arab_Emirates,AE,ARE,9770526,Asia,198,18198,37
2020-05-12T00:00:00Z,12,5,2020,680,3,United_Arab_Emirates,AE,ARE,9770526,Asia,201,18878,38
2020-05-13T00:00:00Z,13,5,2020,783,2,United_Arab_Emirates,AE,ARE,9770526,Asia,203,19661,39
2020-05-14T00:00:00Z,14,5,2020,725,3,United_Arab_Emirates,AE,ARE,9770526,Asia,206,20386,40
2020-05-15T00:00:00Z,15,5,2020,698,2,United_Arab_Emirates,AE,ARE,9770526,Asia,208,21084,41
2020-05-16T00:00:00Z,16,5,2020,747,2,United_Arab_Emirates,AE,ARE,9770526,Asia,210,21831,42
2020-05-17T00:00:00Z,17,5,2020,796,4,United_Arab_Emirates,AE,ARE,9770526,Asia,214,22627,43
2020-05-18T00:00:00Z,18,5,2020,731,6,United_Arab_Emirates,AE,ARE,9770526,Asia,220,23358,44
2020-05-19T00:00:00Z,19,5,2020,832,4,United_Arab_Emirates,AE,ARE,9770526,Asia,224,24190,45
2020-05-20T00:00:00Z,20,5,2020,873,3,United_Arab_Emirates,AE,ARE,9770526,Asia,227,25063,46
2020-05-21T00:00:00Z,21,5,2020,941,6,United_Arab_Emirates,AE,ARE,9770526,Asia,233,26004,47
2020-05-22T00:00:00Z,22,5,2020,894,4,United_Arab_Emirates,AE,ARE,9770526,Asia,237,26898,48
2020-05-23T00:00:00Z,23,5,2020,994,4,United_Arab_Emirates,AE,ARE,9770526,Asia,241,27892,49
2020-05-24T00:00:00Z,24,5,2020,812,3,United_Arab_Emirates,AE,ARE,9770526,Asia,244,28704,50
2020-05-25T00:00:00Z,25,5,2020,781,1,United_Arab_Emirates,AE,ARE,9770526,Asia,245,29485,51
2020-05-26T00:00:00Z,26,5,2020,822,3,United_Arab_Emirates,AE,ARE,9770526,Asia,248,30307,52
2020-05-27T00:00:00Z,27,5,2020,779,5,United_Arab_Emirates,AE,ARE,9770526,Asia,253,31086,53
2020-05-28T00:00:00Z,28,5,2020,883,2,United_Arab_Emirates,AE,ARE,9770526,Asia,255,31969,54
2020-05-29T00:00:00Z,29,5,2020,563,3,United_Arab_Emirates,AE,ARE,9770526,Asia,258,32532,55
2020-05-30T00:00:00Z,30,5,2020,638,2,United_Arab_Emirates,AE,ARE,9770526,Asia,260,33170,56
2020-05-31T00:00:00Z,31,5,2020,726,2,United_Arab_Emirates,AE,ARE,9770526,Asia,262,33896,57
2020-06-01T00:00:00Z,1,6,2020,661,2,United_Arab_Emirates,AE,ARE,9770526,Asia,264,34557,58
2020-06-02T00:00:00Z,2,6,2020,635,2,United_Arab_Emirates,AE,ARE,9770526,Asia,266,35192,59
2020-06-03T00:00:00Z,3,6,2020,596,3,United_Arab_Emirates,AE,ARE,9770526,Asia,269,35788,60
2020-06-04T00:00:00Z,4,6,2020,571,1,United_Arab_Emirates,AE,ARE,9770526,Asia,270,36359,61
2020-06-05T00:00:00Z,5,6,2020,659,3,United_Arab_Emirates,AE,ARE,9770526,Asia,273,37018,62
2020-06-06T00:00:00Z,6,6,2020,624,1,United_Arab_Emirates,AE,ARE,9770526,Asia,274,37642,63
2020-06-07T00:00:00Z,7,6,2020,626,1,United_Arab_Emirates,AE,ARE,9770526,Asia,275,38268,64
2020-06-08T00:00:00Z,8,6,2020,540,1,United_Arab_Emirates,AE,ARE,9770526,Asia,276,38808,65
2020-06-09T00:00:00Z,9,6,2020,568,5,United_Arab_Emirates,AE,ARE,9770526,Asia,281,39376,66
2020-06-10T00:00:00Z,10,6,2020,528,2,United_Arab_Emirates,AE,ARE,9770526,Asia,283,39904,67
2020-06-11T00:00:00Z,11,6,2020,603,1,United_Arab_Emirates,AE,ARE,9770526,Asia,284,40507,68
2020-06-12T00:00:00Z,12,6,2020,479,2,United_Arab_Emirates,AE,ARE,9770526,Asia,286,40986,69
2020-06-13T00:00:00Z,13,6,2020,513,1,United_Arab_Emirates,AE,ARE,9770526,Asia,287,41499,70
2020-06-14T00:00:00Z,14,6,2020,401,1,United_Arab_Emirates,AE,ARE,9770526,Asia,288,41900,71
2020-06-15T00:00:00Z,15,6,2020,394,1,United_Arab_Emirates,AE,ARE,9770526,Asia,289,42294,72
2020-06-16T00:00:00Z,16,6,2020,342,2,United_Arab_Emirates,AE,ARE,9770526,Asia,291,42636,73
2020-06-17T00:00:00Z,17,6,2020,346,2,United_Arab_Emirates,AE,ARE,9770526,Asia,293,42982,74
2020-06-18T00:00:00Z,18,6,2020,382,2,United_Arab_Emirates,AE,ARE,9770526,Asia,295,43364,75
2020-06-19T00:00:00Z,19,6,2020,388,3,United_Arab_Emirates,AE,ARE,9770526,Asia,298,43752,76
2020-06-20T00:00:00Z,20,6,2020,393,2,United_Arab_Emirates,AE,ARE,9770526,Asia,300,44145,77
2020-06-21T00:00:00Z,21,6,2020,388,1,United_Arab_Emirates,AE,ARE,9770526,Asia,301,44533,78
2020-06-22T00:00:00Z,22,6,2020,392,1,United_Arab_Emirates,AE,ARE,9770526,Asia,302,44925,79
2020-06-23T00:00:00Z,23,6,2020,378,1,United_Arab_Emirates,AE,ARE,9770526,Asia,303,45303,80
2020-06-24T00:00:00Z,24,6,2020,380,2,United_Arab_Emirates,AE,ARE,9770526,Asia,305,45683,81
2020-06-25T00:00:00Z,25,6,2020,450,2,United_Arab_Emirates,AE,ARE,9770526,Asia,307,46133,82
2020-03-14T00:00:00Z,14,3,2020,117,1,United_Kingdom,UK,GBR,66647112,Europe,10,707,1
2020-03-15T00:00:00Z,15,3,2020,433,18,United_Kingdom,UK,GBR,66647112,Europe,28,1140,2
2020-03-16T00:00:00Z,16,3,2020,251,15,United_Kingdom,UK,GBR,66647112,Europe,43,1391,3
2020-03-17T00:00:00Z,17,3,2020,152,22,United_Kingdom,UK,GBR,66647112,Europe,65,1543,4
2020-03-18T00:00:00Z,18,3,2020,407,16,United_Kingdom,UK,GBR,66647112,Europe,81,1950,5
2020-03-19T00:00:00Z,19,3,2020,680,34,United_Kingdom,UK,GBR,66647112,Europe,115,2630,6
2020-03-20T00:00:00Z,20,3,2020,647,43,United_Kingdom,UK,GBR,66647112,Europe,158,3277,7
2020-03-21T00:00:00Z,21,3,2020,706,36,United_Kingdom,UK,GBR,66647112,Europe,194,3983,8
2020-03-22T00:00:00Z,22,3,2020,1035,56,United_Kingdom,UK,GBR,66647112,Europe,250,5018,9
2020-03-23T00:00:00Z,23,3,2020,665,35,United_Kingdom,UK,GBR,66647112,Europe,285,5683,10
2020-03-24T00:00:00Z,24,3,2020,967,74,United_Kingdom,UK,GBR,66647112,Europe,359,6650,11
2020-03-25T00:00:00Z,25,3,2020,1427,149,United_Kingdom,UK,GBR,66647112,Europe,508,8077,12
2020-03-26T00:00:00Z,26,3,2020,1452,186,United_Kingdom,UK,GBR,66647112,Europe,694,9529,13
2020-03-27T00:00:00Z,27,3,2020,2129,183,United_Kingdom,UK,GBR,66647112,Europe,877,11658,14
2020-03-28T00:00:00Z,28,3,2020,2885,284,United_Kingdom,UK,GBR,66647112,Europe,1161,14543,15
2020-03-29T00:00:00Z,29,3,2020,2546,294,United_Kingdom,UK,GBR,66647112,Europe,1455,17089,16
2020-03-30T00:00:00Z,30,3,2020,2433,214,United_Kingdom,UK,GBR,66647112,Europe,1669,19522,17
2020-03-31T00:00:00Z,31,3,2020,2619,374,United_Kingdom,UK,GBR,66647112,Europe,2043,22141,18
2020-04-01T00:00:00Z,1,4,2020,3009,382,United_Kingdom,UK,GBR,66647112,Europe,2425,25150,19
2020-04-02T00:00:00Z,2,4,2020,4324,670,United_Kingdom,UK,GBR,66647112,Europe,3095,29474,20
2020-04-03T00:00:00Z,3,4,2020,4244,652,United_Kingdom,UK,GBR,66647112,Europe,3747,33718,21
2020-04-04T00:00:00Z,4,4,2020,4450,714,United_Kingdom,UK,GBR,66647112,Europe,4461,38168,22
2020-04-05T00:00:00Z,5,4,2020,3735,760,United_Kingdom,UK,GBR,66647112,Europe,5221,41903,23
2020-04-06T00:00:00Z,6,4,2020,5903,644,United_Kingdom,UK,GBR,66647112,Europe,5865,47806,24
2020-04-07T00:00:00Z,7,4,2020,3802,568,United_Kingdom,UK,GBR,66647112,Europe,6433,51608,25
2020-04-08T00:00:00Z,8,4,2020,3634,1038,United_Kingdom,UK,GBR,66647112,Europe,7471,55242,26
2020-04-09T00:00:00Z,9,4,2020,5491,1034,United_Kingdom,UK,GBR,66647112,Europe,8505,60733,27
2020-04-10T00:00:00Z,10,4,2020,4344,1103,United_Kingdom,UK,GBR,66647112,Europe,9608,65077,28
2020-04-11T00:00:00Z,11,4,2020,5195,1152,United_Kingdom,UK,GBR,66647112,Europe,10760,70272,29
2020-04-12T00:00:00Z,12,4,2020,8719,839,United_Kingdom,UK,GBR,66647112,Europe,11599,78991,30
2020-04-13T00:00:00Z,13,4,2020,5288,686,United_Kingdom,UK,GBR,66647112,Europe,12285,84279,31
2020-04-14T00:00:00Z,14,4,2020,4342,744,United_Kingdom,UK,GBR,66647112,Europe,13029,88621,32
2020-04-15T00:00:00Z,15,4,2020,5252,1044,United_Kingdom,UK,GBR,66647112,Europe,14073,93873,33
2020-04-16T00:00:00Z,16,4,2020,4603,842,United_Kingdom,UK,GBR,66647112,Europe,14915,98476,34
2020-04-17T00:00:00Z,17,4,2020,4617,1029,United_Kingdom,UK,GBR,66647112,Europe,15944,103093,35
2020-04-18T00:00:00Z,18,4,2020,5599,935,United_Kingdom,UK,GBR,66647112,Europe,16879,108692,36
2020-04-19T00:00:00Z,19,4,2020,5525,1115,United_Kingdom,UK,GBR,66647112,Europe,17994,114217,37
2020-04-20T00:00:00Z,20,4,2020,5850,498,United_Kingdom,UK,GBR,66647112,Europe,18492,120067,38
2020-04-21T00:00:00Z,21,4,2020,4676,559,United_Kingdom,UK,GBR,66647112,Europe,19051,124743,39
2020-04-22T00:00:00Z,22,4,2020,4301,1172,United_Kingdom,UK,GBR,66647112,Europe,20223,129044,40
2020-04-23T00:00:00Z,23,4,2020,4451,837,United_Kingdom,UK,GBR,66647112,Europe,21060,133495,41
2020-04-24T00:00:00Z,24,4,2020,4583,727,United_Kingdom,UK,GBR,66647112,Europe,21787,138078,42
2020-04-25T00:00:00Z,25,4,2020,5386,1005,United_Kingdom,UK,GBR,66647112,Europe,22792,143464,43
2020-04-26T00:00:00Z,26,4,2020,4913,843,United_Kingdom,UK,GBR,66647112,Europe,23635,148377,44
2020-04-27T00:00:00Z,27,4,2020,4463,420,United_Kingdom,UK,GBR,66647112,Europe,24055,152840,45
2020-04-28T00:00:00Z,28,4,2020,4309,338,United_Kingdom,UK,GBR,66647112,Europe,24393,157149,46
2020-04-29T00:00:00Z,29,4,2020,3996,909,United_Kingdom,UK,GBR,66647112,Europe,25302,161145,47
2020-04-30T00:00:00Z,30,4,2020,4076,795,United_Kingdom,UK,GBR,66647112,Europe,26097,165221,48
2020-05-01T00:00:00Z,1,5,2020,6032,674,United_Kingdom,UK,GBR,66647112,Europe,26771,171253,49
2020-05-02T00:00:00Z,2,5,2020,6201,739,United_Kingdom,UK,GBR,66647112,Europe,27510,177454,50
2020-05-03T00:00:00Z,3,5,2020,4806,621,United_Kingdom,UK,GBR,66647112,Europe,28131,182260,51
2020-05-04T00:00:00Z,4,5,2020,4339,315,United_Kingdom,UK,GBR,66647112,Europe,28446,186599,52
2020-05-05T00:00:00Z,5,5,2020,3985,288,United_Kingdom,UK,GBR,66647112,Europe,28734,190584,53
2020-05-06T00:00:00Z,6,5,2020,4406,693,United_Kingdom,UK,GBR,66647112,Europe,29427,194990,54
2020-05-07T00:00:00Z,7,5,2020,6211,649,United_Kingdom,UK,GBR,66647112,Europe,30076,201201,55
2020-05-08T00:00:00Z,8,5,2020,5514,539,United_Kingdom,UK,GBR,66647112,Europe,30615,206715,56
2020-05-09T00:00:00Z,9,5,2020,4649,626,United_Kingdom,UK,GBR,66647112,Europe,31241,211364,57
2020-05-10T00:00:00Z,10,5,2020,3896,346,United_Kingdom,UK,GBR,66647112,Europe,31587,215260,58
2020-05-11T00:00:00Z,11,5,2020,3923,268,United_Kingdom,UK,GBR,66647112,Europe,31855,219183,59
2020-05-12T00:00:00Z,12,5,2020,3877,210,United_Kingdom,UK,GBR,66647112,Europe,32065,223060,60
2020-05-13T00:00:00Z,13,5,2020,3403,627,United_Kingdom,UK,GBR,66647112,Europe,32692,226463,61
2020-05-14T00:00:00Z,14,5,2020,3242,494,United_Kingdom,UK,GBR,66647112,Europe,33186,229705,62
2020-05-15T00:00:00Z,15,5,2020,3446,428,United_Kingdom,UK,GBR,66647112,Europe,33614,233151,63
2020-05-16T00:00:00Z,16,5,2020,3560,384,United_Kingdom,UK,GBR,66647112,Europe,33998,236711,64
2020-05-17T00:00:00Z,17,5,2020,3450,468,United_Kingdom,UK,GBR,66647112,Europe,34466,240161,65
2020-05-18T00:00:00Z,18,5,2020,3534,170,United_Kingdom,UK,GBR,66647112,Europe,34636,243695,66
2020-05-19T00:00:00Z,19,5,2020,2711,160,United_Kingdom,UK,GBR,66647112,Europe,34796,246406,67
2020-05-20T00:00:00Z,20,5,2020,2412,545,United_Kingdom,UK,GBR,66647112,Europe,35341,248818,68
2020-05-21T00:00:00Z,21,5,2020,-525,363,United_Kingdom,UK,GBR,66647112,Europe,35704,248293,69
2020-05-22T00:00:00Z,22,5,2020,2615,338,United_Kingdom,UK,GBR,66647112,Europe,36042,250908,70
2020-05-23T00:00:00Z,23,5,2020,3287,351,United_Kingdom,UK,GBR,66647112,Europe,36393,254195,71
2020-05-24T00:00:00Z,24,5,2020,2959,282,United_Kingdom,UK,GBR,66647112,Europe,36675,257154,72
2020-05-25T00:00:00Z,25,5,2020,2405,118,United_Kingdom,UK,GBR,66647112,Europe,36793,259559,73
2020-05-26T00:00:00Z,26,5,2020,1625,121,United_Kingdom,UK,GBR,66647112,Europe,36914,261184,74
2020-05-27T00:00:00Z,27,5,2020,4043,134,United_Kingdom,UK,GBR,66647112,Europe,37048,265227,75
2020-05-28T00:00:00Z,28,5,2020,2013,412,United_Kingdom,UK,GBR,66647112,Europe,37460,267240,76
2020-05-29T00:00:00Z,29,5,2020,1887,377,United_Kingdom,UK,GBR,66647112,Europe,37837,269127,77
2020-05-30T00:00:00Z,30,5,2020,2095,324,United_Kingdom,UK,GBR,66647112,Europe,38161,271222,78
2020-05-31T00:00:00Z,31,5,2020,1604,215,United_Kingdom,UK,GBR,66647112,Europe,38376,272826,79
2020-06-01T00:00:00Z,1,6,2020,1936,113,United_Kingdom,UK,GBR,66647112,Europe,38489,274762,80
2020-06-02T00:00:00Z,2,6,2020,1570,556,United_Kingdom,UK,GBR,66647112,Europe,39045,276332,81
2020-06-03T00:00:00Z,3,6,2020,1653,324,United_Kingdom,UK,GBR,66647112,Europe,39369,277985,82
2020-06-04T00:00:00Z,4,6,2020,1871,359,United_Kingdom,UK,GBR,66647112,Europe,39728,279856,83
2020-06-05T00:00:00Z,5,6,2020,1805,176,United_Kingdom,UK,GBR,66647112,Europe,39904,281661,84
2020-06-06T00:00:00Z,6,6,2020,1650,357,United_Kingdom,UK,GBR,66647112,Europe,40261,283311,85
2020-06-07T00:00:00Z,7,6,2020,1557,204,United_Kingdom,UK,GBR,66647112,Europe,40465,284868,86
2020-06-08T00:00:00Z,8,6,2020,1326,77,United_Kingdom,UK,GBR,66647112,Europe,40542,286194,87
2020-06-09T00:00:00Z,9,6,2020,1205,55,United_Kingdom,UK,GBR,66647112,Europe,40597,287399,88
2020-06-10T00:00:00Z,10,6,2020,1741,286,United_Kingdom,UK,GBR,66647112,Europe,40883,289140,89
2020-06-11T00:00:00Z,11,6,2020,1003,245,United_Kingdom,UK,GBR,66647112,Europe,41128,290143,90
2020-06-12T00:00:00Z,12,6,2020,1266,151,United_Kingdom,UK,GBR,66647112,Europe,41279,291409,91
2020-06-13T00:00:00Z,13,6,2020,1541,202,United_Kingdom,UK,GBR,66647112,Europe,41481,292950,92
2020-06-14T00:00:00Z,14,6,2020,1425,181,United_Kingdom,UK,GBR,66647112,Europe,41662,294375,93
2020-06-15T00:00:00Z,15,6,2020,1514,36,United_Kingdom,UK,GBR,66647112,Europe,41698,295889,94
2020-06-16T00:00:00Z,16,6,2020,968,38,United_Kingdom,UK,GBR,66647112,Europe,41736,296857,95
2020-06-17T00:00:00Z,17,6,2020,1279,233,United_Kingdom,UK,GBR,66647112,Europe,41969,298136,96
2020-06-18T00:00:00Z,18,6,2020,1115,184,United_Kingdom,UK,GBR,66647112,Europe,42153,299251,97
2020-06-19T00:00:00Z,19,6,2020,1218,135,United_Kingdom,UK,GBR,66647112,Europe,42288,300469,98
2020-06-20T00:00:00Z,20,6,2020,1346,173,United_Kingdom,UK,GBR,66647112,Europe,42461,301815,99
2020-06-21T00:00:00Z,21,6,2020,1295,128,United_Kingdom,UK,GBR,66647112,Europe,42589,303110,100
2020-06-22T00:00:00Z,22,6,2020,1221,43,United_Kingdom,UK,GBR,66647112,Europe,42632,304331,101
2020-06-23T00:00:00Z,23,6,2020,958,15,United_Kingdom,UK,GBR,66647112,Europe,42647,305289,102
2020-06-24T00:00:00Z,24,6,2020,921,280,United_Kingdom,UK,GBR,66647112,Europe,42927,306210,103
2020-06-25T00:00:00Z,25,6,2020,652,154,United_Kingdom,UK,GBR,66647112,Europe,43081,306862,104
2020-04-23T00:00:00Z,23,4,2020,31,2,United_Republic_of_Tanzania,TZ,TZA,58005461,Africa,10,285,1
2020-04-24T00:00:00Z,24,4,2020,0,0,United_Republic_of_Tanzania,TZ,TZA,58005461,Africa,10,285,2
2020-04-25T00:00:00Z,25,4,2020,15,0,United_Republic_of_Tanzania,TZ,TZA,58005461,Africa,10,300,3
2020-04-26T00:00:00Z,26,4,2020,0,0,United_Republic_of_Tanzania,TZ,TZA,58005461,Africa,10,300,4
2020-04-27T00:00:00Z,27,4,2020,0,0,United_Republic_of_Tanzania,TZ,TZA,58005461,Africa,10,300,5
2020-04-28T00:00:00Z,28,4,2020,0,0,United_Republic_of_Tanzania,TZ,TZA,58005461,Africa,10,300,6
2020-04-29T00:00:00Z,29,4,2020,6,0,United_Republic_of_Tanzania,TZ,TZA,58005461,Africa,10,306,7
2020-04-30T00:00:00Z,30,4,2020,174,6,United_Republic_of_Tanzania,TZ,TZA,58005461,Africa,16,480,8
2020-05-01T00:00:00Z,1,5,2020,0,0,United_Republic_of_Tanzania,TZ,TZA,58005461,Africa,16,480,9
2020-05-02T00:00:00Z,2,5,2020,0,0,United_Republic_of_Tanzania,TZ,TZA,58005461,Africa,16,480,10
2020-05-03T00:00:00Z,3,5,2020,0,0,United_Republic_of_Tanzania,TZ,TZA,58005461,Africa,16,480,11
2020-05-04T00:00:00Z,4,5,2020,0,0,United_Republic_of_Tanzania,TZ,TZA,58005461,Africa,16,480,12
2020-05-05T00:00:00Z,5,5,2020,0,2,United_Republic_of_Tanzania,TZ,TZA,58005461,Africa,18,480,13
2020-05-06T00:00:00Z,6,5,2020,0,0,United_Republic_of_Tanzania,TZ,TZA,58005461,Africa,18,480,14
2020-05-07T00:00:00Z,7,5,2020,0,0,United_Republic_of_Tanzania,TZ,TZA,58005461,Africa,18,480,15
2020-05-08T00:00:00Z,8,5,2020,29,3,United_Republic_of_Tanzania,TZ,TZA,58005461,Africa,21,509,16
2020-05-09T00:00:00Z,9,5,2020,0,0,United_Republic_of_Tanzania,TZ,TZA,58005461,Africa,21,509,17
2020-05-10T00:00:00Z,10,5,2020,0,0,United_Republic_of_Tanzania,TZ,TZA,58005461,Africa,21,509,18
2020-05-11T00:00:00Z,11,5,2020,0,0,United_Republic_of_Tanzania,TZ,TZA,58005461,Africa,21,509,19
2020-05-12T00:00:00Z,12,5,2020,0,0,United_Republic_of_Tanzania,TZ,TZA,58005461,Africa,21,509,20
2020-05-13T00:00:00Z,13,5,2020,0,0,United_Republic_of_Tanzania,TZ,TZA,58005461,Africa,21,509,21
2020-05-14T00:00:00Z,14,5,2020,0,0,United_Republic_of_Tanzania,TZ,TZA,58005461,Africa,21,509,22
2020-05-15T00:00:00Z,15,5,2020,0,0,United_Republic_of_Tanzania,TZ,TZA,58005461,Africa,21,509,23
2020-05-16T00:00:00Z,16,5,2020,0,0,United_Republic_of_Tanzania,TZ,TZA,58005461,Africa,21,509,24
2020-05-17T00:00:00Z,17,5,2020,0,0,United_Republic_of_Tanzania,TZ,TZA,58005461,Africa,21,509,25
2020-05-18T00:00:00Z,18,5,2020,0,0,United_Republic_of_Tanzania,TZ,TZA,58005461,Africa,21,509,26
2020-05-19T00:00:00Z,19,5,2020,0,0,United_Republic_of_Tanzania,TZ,TZA,58005461,Africa,21,509,27
2020-05-20T00:00:00Z,20,5,2020,0,0,United_Republic_of_Tanzania,TZ,TZA,58005461,Africa,21,509,28
2020-05-21T00:00:00Z,21,5,2020,0,0,United_Republic_of_Tanzania,TZ,TZA,58005461,Africa,21,509,29
2020-05-22T00:00:00Z,22,5,2020,0,0,United_Republic_of_Tanzania,TZ,TZA,58005461,Africa,21,509,30
2020-05-23T00:00:00Z,23,5,2020,0,0,United_Republic_of_Tanzania,TZ,TZA,58005461,Africa,21,509,31
2020-05-24T00:00:00Z,24,5,2020,0,0,United_Republic_of_Tanzania,TZ,TZA,58005461,Africa,21,509,32
2020-05-25T00:00:00Z,25,5,2020,0,0,United_Republic_of_Tanzania,TZ,TZA,58005461,Africa,21,509,33
2020-05-26T00:00:00Z,26,5,2020,0,0,United_Republic_of_Tanzania,TZ,TZA,58005461,Africa,21,509,34
2020-05-27T00:00:00Z,27,5,2020,0,0,United_Republic_of_Tanzania,TZ,TZA,58005461,Africa,21,509,35
2020-05-28T00:00:00Z,28,5,2020,0,0,United_Republic_of_Tanzania,TZ,TZA,58005461,Africa,21,509,36
2020-05-29T00:00:00Z,29,5,2020,0,0,United_Republic_of_Tanzania,TZ,TZA,58005461,Africa,21,509,37
2020-05-30T00:00:00Z,30,5,2020,0,0,United_Republic_of_Tanzania,TZ,TZA,58005461,Africa,21,509,38
2020-05-31T00:00:00Z,31,5,2020,0,0,United_Republic_of_Tanzania,TZ,TZA,58005461,Africa,21,509,39
2020-06-01T00:00:00Z,1,6,2020,0,0,United_Republic_of_Tanzania,TZ,TZA,58005461,Africa,21,509,40
2020-06-02T00:00:00Z,2,6,2020,0,0,United_Republic_of_Tanzania,TZ,TZA,58005461,Africa,21,509,41
2020-06-03T00:00:00Z,3,6,2020,0,0,United_Republic_of_Tanzania,TZ,TZA,58005461,Africa,21,509,42
2020-06-04T00:00:00Z,4,6,2020,0,0,United_Republic_of_Tanzania,TZ,TZA,58005461,Africa,21,509,43
2020-06-05T00:00:00Z,5,6,2020,0,0,United_Republic_of_Tanzania,TZ,TZA,58005461,Africa,21,509,44
2020-06-06T00:00:00Z,6,6,2020,0,0,United_Republic_of_Tanzania,TZ,TZA,58005461,Africa,21,509,45
2020-06-07T00:00:00Z,7,6,2020,0,0,United_Republic_of_Tanzania,TZ,TZA,58005461,Africa,21,509,46
2020-06-08T00:00:00Z,8,6,2020,0,0,United_Republic_of_Tanzania,TZ,TZA,58005461,Africa,21,509,47
2020-06-09T00:00:00Z,9,6,2020,0,0,United_Republic_of_Tanzania,TZ,TZA,58005461,Africa,21,509,48
2020-06-10T00:00:00Z,10,6,2020,0,0,United_Republic_of_Tanzania,TZ,TZA,58005461,Africa,21,509,49
2020-06-11T00:00:00Z,11,6,2020,0,0,United_Republic_of_Tanzania,TZ,TZA,58005461,Africa,21,509,50
2020-06-12T00:00:00Z,12,6,2020,0,0,United_Republic_of_Tanzania,TZ,TZA,58005461,Africa,21,509,51
2020-06-13T00:00:00Z,13,6,2020,0,0,United_Republic_of_Tanzania,TZ,TZA,58005461,Africa,21,509,52
2020-06-14T00:00:00Z,14,6,2020,0,0,United_Republic_of_Tanzania,TZ,TZA,58005461,Africa,21,509,53
2020-06-15T00:00:00Z,15,6,2020,0,0,United_Republic_of_Tanzania,TZ,TZA,58005461,Africa,21,509,54
2020-06-16T00:00:00Z,16,6,2020,0,0,United_Republic_of_Tanzania,TZ,TZA,58005461,Africa,21,509,55
2020-06-17T00:00:00Z,17,6,2020,0,0,United_Republic_of_Tanzania,TZ,TZA,58005461,Africa,21,509,56
2020-06-18T00:00:00Z,18,6,2020,0,0,United_Republic_of_Tanzania,TZ,TZA,58005461,Africa,21,509,57
2020-06-19T00:00:00Z,19,6,2020,0,0,United_Republic_of_Tanzania,TZ,TZA,58005461,Africa,21,509,58
2020-06-20T00:00:00Z,20,6,2020,0,0,United_Republic_of_Tanzania,TZ,TZA,58005461,Africa,21,509,59
2020-06-21T00:00:00Z,21,6,2020,0,0,United_Republic_of_Tanzania,TZ,TZA,58005461,Africa,21,509,60
2020-06-22T00:00:00Z,22,6,2020,0,0,United_Republic_of_Tanzania,TZ,TZA,58005461,Africa,21,509,61
2020-06-23T00:00:00Z,23,6,2020,0,0,United_Republic_of_Tanzania,TZ,TZA,58005461,Africa,21,509,62
2020-06-24T00:00:00Z,24,6,2020,0,0,United_Republic_of_Tanzania,TZ,TZA,58005461,Africa,21,509,63
2020-06-25T00:00:00Z,25,6,2020,0,0,United_Republic_of_Tanzania,TZ,TZA,58005461,Africa,21,509,64
2020-03-05T00:00:00Z,5,3,2020,34,2,United_States_of_America,US,USA,329064917,America,11,159,1
2020-03-06T00:00:00Z,6,3,2020,74,1,United_States_of_America,US,USA,329064917,America,12,233,2
2020-03-07T00:00:00Z,7,3,2020,105,2,United_States_of_America,US,USA,329064917,America,14,338,3
2020-03-08T00:00:00Z,8,3,2020,95,3,United_States_of_America,US,USA,329064917,America,17,433,4
2020-03-09T00:00:00Z,9,3,2020,121,4,United_States_of_America,US,USA,329064917,America,21,554,5
2020-03-10T00:00:00Z,10,3,2020,200,5,United_States_of_America,US,USA,329064917,America,26,754,6
2020-03-11T00:00:00Z,11,3,2020,271,2,United_States_of_America,US,USA,329064917,America,28,1025,7
2020-03-12T00:00:00Z,12,3,2020,287,2,United_States_of_America,US,USA,329064917,America,30,1312,8
2020-03-13T00:00:00Z,13,3,2020,351,10,United_States_of_America,US,USA,329064917,America,40,1663,9
2020-03-14T00:00:00Z,14,3,2020,511,7,United_States_of_America,US,USA,329064917,America,47,2174,10
2020-03-15T00:00:00Z,15,3,2020,777,10,United_States_of_America,US,USA,329064917,America,57,2951,11
2020-03-16T00:00:00Z,16,3,2020,823,12,United_States_of_America,US,USA,329064917,America,69,3774,12
2020-03-17T00:00:00Z,17,3,2020,887,16,United_States_of_America,US,USA,329064917,America,85,4661,13
2020-03-18T00:00:00Z,18,3,2020,1766,23,United_States_of_America,US,USA,329064917,America,108,6427,14
2020-03-19T00:00:00Z,19,3,2020,2988,42,United_States_of_America,US,USA,329064917,America,150,9415,15
2020-03-20T00:00:00Z,20,3,2020,4835,0,United_States_of_America,US,USA,329064917,America,150,14250,16
2020-03-21T00:00:00Z,21,3,2020,5374,110,United_States_of_America,US,USA,329064917,America,260,19624,17
2020-03-22T00:00:00Z,22,3,2020,7123,80,United_States_of_America,US,USA,329064917,America,340,26747,18
2020-03-23T00:00:00Z,23,3,2020,8459,131,United_States_of_America,US,USA,329064917,America,471,35206,19
2020-03-24T00:00:00Z,24,3,2020,11236,119,United_States_of_America,US,USA,329064917,America,590,46442,20
2020-03-25T00:00:00Z,25,3,2020,8789,211,United_States_of_America,US,USA,329064917,America,801,55231,21
2020-03-26T00:00:00Z,26,3,2020,13963,249,United_States_of_America,US,USA,329064917,America,1050,69194,22
2020-03-27T00:00:00Z,27,3,2020,16797,246,United_States_of_America,US,USA,329064917,America,1296,85991,23
2020-03-28T00:00:00Z,28,3,2020,18695,411,United_States_of_America,US,USA,329064917,America,1707,104686,24
2020-03-29T00:00:00Z,29,3,2020,19979,484,United_States_of_America,US,USA,329064917,America,2191,124665,25
2020-03-30T00:00:00Z,30,3,2020,18360,318,United_States_of_America,US,USA,329064917,America,2509,143025,26
2020-03-31T00:00:00Z,31,3,2020,21595,661,United_States_of_America,US,USA,329064917,America,3170,164620,27
2020-04-01T00:00:00Z,1,4,2020,24998,909,United_States_of_America,US,USA,329064917,America,4079,189618,28
2020-04-02T00:00:00Z,2,4,2020,27103,1059,United_States_of_America,US,USA,329064917,America,5138,216721,29
2020-04-03T00:00:00Z,3,4,2020,28819,915,United_States_of_America,US,USA,329064917,America,6053,245540,30
2020-04-04T00:00:00Z,4,4,2020,32425,1104,United_States_of_America,US,USA,329064917,America,7157,277965,31
2020-04-05T00:00:00Z,5,4,2020,34272,1344,United_States_of_America,US,USA,329064917,America,8501,312237,32
2020-04-06T00:00:00Z,6,4,2020,25398,1146,United_States_of_America,US,USA,329064917,America,9647,337635,33
2020-04-07T00:00:00Z,7,4,2020,30561,1342,United_States_of_America,US,USA,329064917,America,10989,368196,34
2020-04-08T00:00:00Z,8,4,2020,30613,1906,United_States_of_America,US,USA,329064917,America,12895,398809,35
2020-04-09T00:00:00Z,9,4,2020,33323,1922,United_States_of_America,US,USA,329064917,America,14817,432132,36
2020-04-10T00:00:00Z,10,4,2020,33901,1873,United_States_of_America,US,USA,329064917,America,16690,466033,37
2020-04-11T00:00:00Z,11,4,2020,35527,2087,United_States_of_America,US,USA,329064917,America,18777,501560,38
2020-04-12T00:00:00Z,12,4,2020,28391,1831,United_States_of_America,US,USA,329064917,America,20608,529951,39
2020-04-13T00:00:00Z,13,4,2020,27620,1500,United_States_of_America,US,USA,329064917,America,22108,557571,40
2020-04-14T00:00:00Z,14,4,2020,25023,1541,United_States_of_America,US,USA,329064917,America,23649,582594,41
2020-04-15T00:00:00Z,15,4,2020,26922,2408,United_States_of_America,US,USA,329064917,America,26057,609516,42
2020-04-16T00:00:00Z,16,4,2020,30148,4928,United_States_of_America,US,USA,329064917,America,30985,639664,43
2020-04-17T00:00:00Z,17,4,2020,31667,2299,United_States_of_America,US,USA,329064917,America,33284,671331,44
2020-04-18T00:00:00Z,18,4,2020,30833,3770,United_States_of_America,US,USA,329064917,America,37054,702164,45
2020-04-19T00:00:00Z,19,4,2020,32922,1856,United_States_of_America,US,USA,329064917,America,38910,735086,46
2020-04-20T00:00:00Z,20,4,2020,24601,1772,United_States_of_America,US,USA,329064917,America,40682,759687,47
2020-04-21T00:00:00Z,21,4,2020,28065,1857,United_States_of_America,US,USA,329064917,America,42539,787752,48
2020-04-22T00:00:00Z,22,4,2020,37289,2524,United_States_of_America,US,USA,329064917,America,45063,825041,49
2020-04-23T00:00:00Z,23,4,2020,17588,1721,United_States_of_America,US,USA,329064917,America,46784,842629,50
2020-04-24T00:00:00Z,24,4,2020,26543,3179,United_States_of_America,US,USA,329064917,America,49963,869172,51
2020-04-25T00:00:00Z,25,4,2020,21352,1054,United_States_of_America,US,USA,329064917,America,51017,890524,52
2020-04-26T00:00:00Z,26,4,2020,48529,2172,United_States_of_America,US,USA,329064917,America,53189,939053,53
2020-04-27T00:00:00Z,27,4,2020,26857,1687,United_States_of_America,US,USA,329064917,America,54876,965910,54
2020-04-28T00:00:00Z,28,4,2020,22541,1369,United_States_of_America,US,USA,329064917,America,56245,988451,55
2020-04-29T00:00:00Z,29,4,2020,24132,2110,United_States_of_America,US,USA,329064917,America,58355,1012583,56
2020-04-30T00:00:00Z,30,4,2020,27326,2611,United_States_of_America,US,USA,329064917,America,60966,1039909,57
2020-05-01T00:00:00Z,1,5,2020,29917,2040,United_States_of_America,US,USA,329064917,America,63006,1069826,58
2020-05-02T00:00:00Z,2,5,2020,33955,2062,United_States_of_America,US,USA,329064917,America,65068,1103781,59
2020-05-03T00:00:00Z,3,5,2020,29288,1317,United_States_of_America,US,USA,329064917,America,66385,1133069,60
2020-05-04T00:00:00Z,4,5,2020,24972,1297,United_States_of_America,US,USA,329064917,America,67682,1158041,61
2020-05-05T00:00:00Z,5,5,2020,22593,1252,United_States_of_America,US,USA,329064917,America,68934,1180634,62
2020-05-06T00:00:00Z,6,5,2020,23841,2144,United_States_of_America,US,USA,329064917,America,71078,1204475,63
2020-05-07T00:00:00Z,7,5,2020,24128,2353,United_States_of_America,US,USA,329064917,America,73431,1228603,64
2020-05-08T00:00:00Z,8,5,2020,28369,2239,United_States_of_America,US,USA,329064917,America,75670,1256972,65
2020-05-09T00:00:00Z,9,5,2020,26957,1510,United_States_of_America,US,USA,329064917,America,77180,1283929,66
2020-05-10T00:00:00Z,10,5,2020,25612,1614,United_States_of_America,US,USA,329064917,America,78794,1309541,67
2020-05-11T00:00:00Z,11,5,2020,20258,734,United_States_of_America,US,USA,329064917,America,79528,1329799,68
2020-05-12T00:00:00Z,12,5,2020,18117,1156,United_States_of_America,US,USA,329064917,America,80684,1347916,69
2020-05-13T00:00:00Z,13,5,2020,22048,1703,United_States_of_America,US,USA,329064917,America,82387,1369964,70
2020-05-14T00:00:00Z,14,5,2020,20782,1746,United_States_of_America,US,USA,329064917,America,84133,1390746,71
2020-05-15T00:00:00Z,15,5,2020,27143,1773,United_States_of_America,US,USA,329064917,America,85906,1417889,72
2020-05-16T00:00:00Z,16,5,2020,25508,1662,United_States_of_America,US,USA,329064917,America,87568,1443397,73
2020-05-17T00:00:00Z,17,5,2020,24487,1186,United_States_of_America,US,USA,329064917,America,88754,1467884,74
2020-05-18T00:00:00Z,18,5,2020,18873,808,United_States_of_America,US,USA,329064917,America,89562,1486757,75
2020-05-19T00:00:00Z,19,5,2020,21841,791,United_States_of_America,US,USA,329064917,America,90353,1508598,76
2020-05-20T00:00:00Z,20,5,2020,19970,1568,United_States_of_America,US,USA,329064917,America,91921,1528568,77
2020-05-21T00:00:00Z,21,5,2020,23285,1518,United_States_of_America,US,USA,329064917,America,93439,1551853,78
2020-05-22T00:00:00Z,22,5,2020,25434,1263,United_States_of_America,US,USA,329064917,America,94702,1577287,79
2020-05-23T00:00:00Z,23,5,2020,24147,1305,United_States_of_America,US,USA,329064917,America,96007,1601434,80
2020-05-24T00:00:00Z,24,5,2020,21236,1080,United_States_of_America,US,USA,329064917,America,97087,1622670,81
2020-05-25T00:00:00Z,25,5,2020,20568,633,United_States_of_America,US,USA,329064917,America,97720,1643238,82
2020-05-26T00:00:00Z,26,5,2020,19064,500,United_States_of_America,US,USA,329064917,America,98220,1662302,83
2020-05-27T00:00:00Z,27,5,2020,18910,696,United_States_of_America,US,USA,329064917,America,98916,1681212,84
2020-05-28T00:00:00Z,28,5,2020,18721,1526,United_States_of_America,US,USA,329064917,America,100442,1699933,85
2020-05-29T00:00:00Z,29,5,2020,21817,1175,United_States_of_America,US,USA,329064917,America,101617,1721750,86
2020-05-30T00:00:00Z,30,5,2020,25337,1219,United_States_of_America,US,USA,329064917,America,102836,1747087,87
2020-05-31T00:00:00Z,31,5,2020,23297,945,United_States_of_America,US,USA,329064917,America,103781,1770384,88
2020-06-01T00:00:00Z,1,6,2020,19807,602,United_States_of_America,US,USA,329064917,America,104383,1790191,89
2020-06-02T00:00:00Z,2,6,2020,21086,764,United_States_of_America,US,USA,329064917,America,105147,1811277,90
2020-06-03T00:00:00Z,3,6,2020,20544,1034,United_States_of_America,US,USA,329064917,America,106181,1831821,91
2020-06-04T00:00:00Z,4,6,2020,19699,994,United_States_of_America,US,USA,329064917,America,107175,1851520,92
2020-06-05T00:00:00Z,5,6,2020,21140,1036,United_States_of_America,US,USA,329064917,America,108211,1872660,93
2020-06-06T00:00:00Z,6,6,2020,25178,932,United_States_of_America,US,USA,329064917,America,109143,1897838,94
2020-06-07T00:00:00Z,7,6,2020,22223,659,United_States_of_America,US,USA,329064917,America,109802,1920061,95
2020-06-08T00:00:00Z,8,6,2020,22302,712,United_States_of_America,US,USA,329064917,America,110514,1942363,96
2020-06-09T00:00:00Z,9,6,2020,18822,493,United_States_of_America,US,USA,329064917,America,111007,1961185,97
2020-06-10T00:00:00Z,10,6,2020,18665,999,United_States_of_America,US,USA,329064917,America,112006,1979850,98
2020-06-11T00:00:00Z,11,6,2020,20614,918,United_States_of_America,US,USA,329064917,America,112924,2000464,99
2020-06-12T00:00:00Z,12,6,2020,22883,896,United_States_of_America,US,USA,329064917,America,113820,2023347,100
2020-06-13T00:00:00Z,13,6,2020,25639,849,United_States_of_America,US,USA,329064917,America,114669,2048986,101
2020-06-14T00:00:00Z,14,6,2020,25540,767,United_States_of_America,US,USA,329064917,America,115436,2074526,102
2020-06-15T00:00:00Z,15,6,2020,19543,296,United_States_of_America,US,USA,329064917,America,115732,2094069,103
2020-06-16T00:00:00Z,16,6,2020,19957,395,United_States_of_America,US,USA,329064917,America,116127,2114026,104
2020-06-17T00:00:00Z,17,6,2020,23705,836,United_States_of_America,US,USA,329064917,America,116963,2137731,105
2020-06-18T00:00:00Z,18,6,2020,25559,754,United_States_of_America,US,USA,329064917,America,117717,2163290,106
2020-06-19T00:00:00Z,19,6,2020,27762,717,United_States_of_America,US,USA,329064917,America,118434,2191052,107
2020-06-20T00:00:00Z,20,6,2020,29909,678,United_States_of_America,US,USA,329064917,America,119112,2220961,108
2020-06-21T00:00:00Z,21,6,2020,34158,607,United_States_of_America,US,USA,329064917,America,119719,2255119,109
2020-06-22T00:00:00Z,22,6,2020,25793,256,United_States_of_America,US,USA,329064917,America,119975,2280912,110
2020-06-23T00:00:00Z,23,6,2020,31390,427,United_States_of_America,US,USA,329064917,America,120402,2312302,111
2020-06-24T00:00:00Z,24,6,2020,34720,826,United_States_of_America,US,USA,329064917,America,121228,2347022,112
2020-06-25T00:00:00Z,25,6,2020,34339,751,United_States_of_America,US,USA,329064917,America,121979,2381361,113
2020-04-20T00:00:00Z,20,4,2020,11,1,Uruguay,UY,URY,3461731,America,10,528,1
2020-04-21T00:00:00Z,21,4,2020,7,0,Uruguay,UY,URY,3461731,America,10,535,2
2020-04-22T00:00:00Z,22,4,2020,8,2,Uruguay,UY,URY,3461731,America,12,543,3
2020-04-23T00:00:00Z,23,4,2020,6,0,Uruguay,UY,URY,3461731,America,12,549,4
2020-04-24T00:00:00Z,24,4,2020,8,0,Uruguay,UY,URY,3461731,America,12,557,5
2020-04-25T00:00:00Z,25,4,2020,6,0,Uruguay,UY,URY,3461731,America,12,563,6
2020-04-26T00:00:00Z,26,4,2020,33,2,Uruguay,UY,URY,3461731,America,14,596,7
2020-04-27T00:00:00Z,27,4,2020,10,1,Uruguay,UY,URY,3461731,America,15,606,8
2020-04-28T00:00:00Z,28,4,2020,14,0,Uruguay,UY,URY,3461731,America,15,620,9
2020-04-29T00:00:00Z,29,4,2020,5,0,Uruguay,UY,URY,3461731,America,15,625,10
2020-04-30T00:00:00Z,30,4,2020,5,0,Uruguay,UY,URY,3461731,America,15,630,11
2020-05-01T00:00:00Z,1,5,2020,13,2,Uruguay,UY,URY,3461731,America,17,643,12
2020-05-02T00:00:00Z,2,5,2020,5,0,Uruguay,UY,URY,3461731,America,17,648,13
2020-05-03T00:00:00Z,3,5,2020,4,0,Uruguay,UY,URY,3461731,America,17,652,14
2020-05-04T00:00:00Z,4,5,2020,3,0,Uruguay,UY,URY,3461731,America,17,655,15
2020-05-05T00:00:00Z,5,5,2020,2,0,Uruguay,UY,URY,3461731,America,17,657,16
2020-05-06T00:00:00Z,6,5,2020,13,0,Uruguay,UY,URY,3461731,America,17,670,17
2020-05-07T00:00:00Z,7,5,2020,3,0,Uruguay,UY,URY,3461731,America,17,673,18
2020-05-08T00:00:00Z,8,5,2020,11,0,Uruguay,UY,URY,3461731,America,17,684,19
2020-05-09T00:00:00Z,9,5,2020,10,1,Uruguay,UY,URY,3461731,America,18,694,20
2020-05-10T00:00:00Z,10,5,2020,8,0,Uruguay,UY,URY,3461731,America,18,702,21
2020-05-11T00:00:00Z,11,5,2020,5,1,Uruguay,UY,URY,3461731,America,19,707,22
2020-05-12T00:00:00Z,12,5,2020,4,0,Uruguay,UY,URY,3461731,America,19,711,23
2020-05-13T00:00:00Z,13,5,2020,6,0,Uruguay,UY,URY,3461731,America,19,717,24
2020-05-14T00:00:00Z,14,5,2020,2,0,Uruguay,UY,URY,3461731,America,19,719,25
2020-05-15T00:00:00Z,15,5,2020,5,0,Uruguay,UY,URY,3461731,America,19,724,26
2020-05-16T00:00:00Z,16,5,2020,8,0,Uruguay,UY,URY,3461731,America,19,732,27
2020-05-17T00:00:00Z,17,5,2020,1,0,Uruguay,UY,URY,3461731,America,19,733,28
2020-05-18T00:00:00Z,18,5,2020,1,1,Uruguay,UY,URY,3461731,America,20,734,29
2020-05-19T00:00:00Z,19,5,2020,3,0,Uruguay,UY,URY,3461731,America,20,737,30
2020-05-20T00:00:00Z,20,5,2020,1,0,Uruguay,UY,URY,3461731,America,20,738,31
2020-05-21T00:00:00Z,21,5,2020,8,0,Uruguay,UY,URY,3461731,America,20,746,32
2020-05-22T00:00:00Z,22,5,2020,3,0,Uruguay,UY,URY,3461731,America,20,749,33
2020-05-23T00:00:00Z,23,5,2020,4,0,Uruguay,UY,URY,3461731,America,20,753,34
2020-05-24T00:00:00Z,24,5,2020,11,2,Uruguay,UY,URY,3461731,America,22,764,35
2020-05-25T00:00:00Z,25,5,2020,5,0,Uruguay,UY,URY,3461731,America,22,769,36
2020-05-26T00:00:00Z,26,5,2020,18,0,Uruguay,UY,URY,3461731,America,22,787,37
2020-05-27T00:00:00Z,27,5,2020,2,0,Uruguay,UY,URY,3461731,America,22,789,38
2020-05-28T00:00:00Z,28,5,2020,14,0,Uruguay,UY,URY,3461731,America,22,803,39
2020-05-29T00:00:00Z,29,5,2020,8,0,Uruguay,UY,URY,3461731,America,22,811,40
2020-05-30T00:00:00Z,30,5,2020,5,0,Uruguay,UY,URY,3461731,America,22,816,41
2020-05-31T00:00:00Z,31,5,2020,5,0,Uruguay,UY,URY,3461731,America,22,821,42
2020-06-01T00:00:00Z,1,6,2020,2,0,Uruguay,UY,URY,3461731,America,22,823,43
2020-06-02T00:00:00Z,2,6,2020,2,1,Uruguay,UY,URY,3461731,America,23,825,44
2020-06-03T00:00:00Z,3,6,2020,1,0,Uruguay,UY,URY,3461731,America,23,826,45
2020-06-04T00:00:00Z,4,6,2020,2,0,Uruguay,UY,URY,3461731,America,23,828,46
2020-06-05T00:00:00Z,5,6,2020,4,0,Uruguay,UY,URY,3461731,America,23,832,47
2020-06-06T00:00:00Z,6,6,2020,2,0,Uruguay,UY,URY,3461731,America,23,834,48
2020-06-07T00:00:00Z,7,6,2020,11,0,Uruguay,UY,URY,3461731,America,23,845,49
2020-06-08T00:00:00Z,8,6,2020,0,0,Uruguay,UY,URY,3461731,America,23,845,50
2020-06-09T00:00:00Z,9,6,2020,0,0,Uruguay,UY,URY,3461731,America,23,845,51
2020-06-10T00:00:00Z,10,6,2020,1,0,Uruguay,UY,URY,3461731,America,23,846,52
2020-06-11T00:00:00Z,11,6,2020,1,0,Uruguay,UY,URY,3461731,America,23,847,53
2020-06-12T00:00:00Z,12,6,2020,0,0,Uruguay,UY,URY,3461731,America,23,847,54
2020-06-13T00:00:00Z,13,6,2020,0,0,Uruguay,UY,URY,3461731,America,23,847,55
2020-06-14T00:00:00Z,14,6,2020,0,0,Uruguay,UY,URY,3461731,America,23,847,56
2020-06-15T00:00:00Z,15,6,2020,1,0,Uruguay,UY,URY,3461731,America,23,848,57
2020-06-16T00:00:00Z,16,6,2020,0,0,Uruguay,UY,URY,3461731,America,23,848,58
2020-06-17T00:00:00Z,17,6,2020,1,1,Uruguay,UY,URY,3461731,America,24,849,59
2020-06-18T00:00:00Z,18,6,2020,0,0,Uruguay,UY,URY,3461731,America,24,849,60
2020-06-19T00:00:00Z,19,6,2020,1,0,Uruguay,UY,URY,3461731,America,24,850,61
2020-06-20T00:00:00Z,20,6,2020,3,0,Uruguay,UY,URY,3461731,America,24,853,62
2020-06-21T00:00:00Z,21,6,2020,6,1,Uruguay,UY,URY,3461731,America,25,859,63
2020-06-22T00:00:00Z,22,6,2020,17,0,Uruguay,UY,URY,3461731,America,25,876,64
2020-06-23T00:00:00Z,23,6,2020,6,0,Uruguay,UY,URY,3461731,America,25,882,65
2020-06-24T00:00:00Z,24,6,2020,3,0,Uruguay,UY,URY,3461731,America,25,885,66
2020-06-25T00:00:00Z,25,6,2020,17,1,Uruguay,UY,URY,3461731,America,26,902,67
2020-05-04T00:00:00Z,4,5,2020,22,1,Uzbekistan,UZ,UZB,32981715,Asia,10,2149,1
2020-05-05T00:00:00Z,5,5,2020,40,0,Uzbekistan,UZ,UZB,32981715,Asia,10,2189,2
2020-05-06T00:00:00Z,6,5,2020,18,0,Uzbekistan,UZ,UZB,32981715,Asia,10,2207,3
2020-05-07T00:00:00Z,7,5,2020,26,0,Uzbekistan,UZ,UZB,32981715,Asia,10,2233,4
2020-05-08T00:00:00Z,8,5,2020,65,0,Uzbekistan,UZ,UZB,32981715,Asia,10,2298,5
2020-05-09T00:00:00Z,9,5,2020,38,0,Uzbekistan,UZ,UZB,32981715,Asia,10,2336,6
2020-05-10T00:00:00Z,10,5,2020,51,0,Uzbekistan,UZ,UZB,32981715,Asia,10,2387,7
2020-05-11T00:00:00Z,11,5,2020,31,0,Uzbekistan,UZ,UZB,32981715,Asia,10,2418,8
2020-05-12T00:00:00Z,12,5,2020,91,0,Uzbekistan,UZ,UZB,32981715,Asia,10,2509,9
2020-05-13T00:00:00Z,13,5,2020,38,0,Uzbekistan,UZ,UZB,32981715,Asia,10,2547,10
2020-05-14T00:00:00Z,14,5,2020,65,1,Uzbekistan,UZ,UZB,32981715,Asia,11,2612,11
2020-05-15T00:00:00Z,15,5,2020,33,0,Uzbekistan,UZ,UZB,32981715,Asia,11,2645,12
2020-05-16T00:00:00Z,16,5,2020,46,0,Uzbekistan,UZ,UZB,32981715,Asia,11,2691,13
2020-05-17T00:00:00Z,17,5,2020,50,0,Uzbekistan,UZ,UZB,32981715,Asia,11,2741,14
2020-05-18T00:00:00Z,18,5,2020,12,1,Uzbekistan,UZ,UZB,32981715,Asia,12,2753,15
2020-05-19T00:00:00Z,19,5,2020,49,1,Uzbekistan,UZ,UZB,32981715,Asia,13,2802,16
2020-05-20T00:00:00Z,20,5,2020,78,0,Uzbekistan,UZ,UZB,32981715,Asia,13,2880,17
2020-05-21T00:00:00Z,21,5,2020,70,0,Uzbekistan,UZ,UZB,32981715,Asia,13,2950,18
2020-05-22T00:00:00Z,22,5,2020,56,0,Uzbekistan,UZ,UZB,32981715,Asia,13,3006,19
2020-05-23T00:00:00Z,23,5,2020,72,0,Uzbekistan,UZ,UZB,32981715,Asia,13,3078,20
2020-05-24T00:00:00Z,24,5,2020,54,0,Uzbekistan,UZ,UZB,32981715,Asia,13,3132,21
2020-05-25T00:00:00Z,25,5,2020,32,0,Uzbekistan,UZ,UZB,32981715,Asia,13,3164,22
2020-05-26T00:00:00Z,26,5,2020,97,0,Uzbekistan,UZ,UZB,32981715,Asia,13,3261,23
2020-05-27T00:00:00Z,27,5,2020,72,1,Uzbekistan,UZ,UZB,32981715,Asia,14,3333,24
2020-05-28T00:00:00Z,28,5,2020,0,0,Uzbekistan,UZ,UZB,32981715,Asia,14,3333,25
2020-05-29T00:00:00Z,29,5,2020,111,0,Uzbekistan,UZ,UZB,32981715,Asia,14,3444,26
2020-05-30T00:00:00Z,30,5,2020,69,0,Uzbekistan,UZ,UZB,32981715,Asia,14,3513,27
2020-05-31T00:00:00Z,31,5,2020,41,0,Uzbekistan,UZ,UZB,32981715,Asia,14,3554,28
2020-06-01T00:00:00Z,1,6,2020,108,1,Uzbekistan,UZ,UZB,32981715,Asia,15,3662,29
2020-06-02T00:00:00Z,2,6,2020,56,0,Uzbekistan,UZ,UZB,32981715,Asia,15,3718,30
2020-06-03T00:00:00Z,3,6,2020,51,0,Uzbekistan,UZ,UZB,32981715,Asia,15,3769,31
2020-06-04T00:00:00Z,4,6,2020,105,1,Uzbekistan,UZ,UZB,32981715,Asia,16,3874,32
2020-06-05T00:00:00Z,5,6,2020,91,0,Uzbekistan,UZ,UZB,32981715,Asia,16,3965,33
2020-06-06T00:00:00Z,6,6,2020,57,0,Uzbekistan,UZ,UZB,32981715,Asia,16,4022,34
2020-06-07T00:00:00Z,7,6,2020,159,1,Uzbekistan,UZ,UZB,32981715,Asia,17,4181,35
2020-06-08T00:00:00Z,8,6,2020,171,0,Uzbekistan,UZ,UZB,32981715,Asia,17,4352,36
2020-06-09T00:00:00Z,9,6,2020,96,1,Uzbekistan,UZ,UZB,32981715,Asia,18,4448,37
2020-06-10T00:00:00Z,10,6,2020,99,0,Uzbekistan,UZ,UZB,32981715,Asia,18,4547,38
2020-06-11T00:00:00Z,11,6,2020,148,1,Uzbekistan,UZ,UZB,32981715,Asia,19,4695,39
2020-06-12T00:00:00Z,12,6,2020,124,0,Uzbekistan,UZ,UZB,32981715,Asia,19,4819,40
2020-06-13T00:00:00Z,13,6,2020,82,0,Uzbekistan,UZ,UZB,32981715,Asia,19,4901,41
2020-06-14T00:00:00Z,14,6,2020,93,0,Uzbekistan,UZ,UZB,32981715,Asia,19,4994,42
2020-06-15T00:00:00Z,15,6,2020,109,0,Uzbekistan,UZ,UZB,32981715,Asia,19,5103,43
2020-06-16T00:00:00Z,16,6,2020,190,0,Uzbekistan,UZ,UZB,32981715,Asia,19,5293,44
2020-06-17T00:00:00Z,17,6,2020,268,0,Uzbekistan,UZ,UZB,32981715,Asia,19,5561,45
2020-06-18T00:00:00Z,18,6,2020,136,0,Uzbekistan,UZ,UZB,32981715,Asia,19,5697,46
2020-06-19T00:00:00Z,19,6,2020,158,0,Uzbekistan,UZ,UZB,32981715,Asia,19,5855,47
2020-06-20T00:00:00Z,20,6,2020,170,0,Uzbekistan,UZ,UZB,32981715,Asia,19,6025,48
2020-06-21T00:00:00Z,21,6,2020,191,0,Uzbekistan,UZ,UZB,32981715,Asia,19,6216,49
2020-06-22T00:00:00Z,22,6,2020,142,0,Uzbekistan,UZ,UZB,32981715,Asia,19,6358,50
2020-06-23T00:00:00Z,23,6,2020,142,0,Uzbekistan,UZ,UZB,32981715,Asia,19,6500,51
2020-06-24T00:00:00Z,24,6,2020,255,0,Uzbekistan,UZ,UZB,32981715,Asia,19,6755,52
2020-06-25T00:00:00Z,25,6,2020,235,0,Uzbekistan,UZ,UZB,32981715,Asia,19,6990,53
2020-04-22T00:00:00Z,22,4,2020,29,1,Venezuela,VE,VEN,28515829,America,10,285,1
2020-04-23T00:00:00Z,23,4,2020,3,0,Venezuela,VE,VEN,28515829,America,10,288,2
2020-04-24T00:00:00Z,24,4,2020,10,0,Venezuela,VE,VEN,28515829,America,10,298,3
2020-04-25T00:00:00Z,25,4,2020,20,0,Venezuela,VE,VEN,28515829,America,10,318,4
2020-04-26T00:00:00Z,26,4,2020,5,0,Venezuela,VE,VEN,28515829,America,10,323,5
2020-04-27T00:00:00Z,27,4,2020,2,0,Venezuela,VE,VEN,28515829,America,10,325,6
2020-04-28T00:00:00Z,28,4,2020,4,0,Venezuela,VE,VEN,28515829,America,10,329,7
2020-04-29T00:00:00Z,29,4,2020,0,0,Venezuela,VE,VEN,28515829,America,10,329,8
2020-04-30T00:00:00Z,30,4,2020,2,0,Venezuela,VE,VEN,28515829,America,10,331,9
2020-05-01T00:00:00Z,1,5,2020,2,0,Venezuela,VE,VEN,28515829,America,10,333,10
2020-05-02T00:00:00Z,2,5,2020,2,0,Venezuela,VE,VEN,28515829,America,10,335,11
2020-05-03T00:00:00Z,3,5,2020,10,0,Venezuela,VE,VEN,28515829,America,10,345,12
2020-05-04T00:00:00Z,4,5,2020,12,0,Venezuela,VE,VEN,28515829,America,10,357,13
2020-05-05T00:00:00Z,5,5,2020,4,0,Venezuela,VE,VEN,28515829,America,10,361,14
2020-05-06T00:00:00Z,6,5,2020,6,0,Venezuela,VE,VEN,28515829,America,10,367,15
2020-05-07T00:00:00Z,7,5,2020,12,0,Venezuela,VE,VEN,28515829,America,10,379,16
2020-05-08T00:00:00Z,8,5,2020,2,0,Venezuela,VE,VEN,28515829,America,10,381,17
2020-05-09T00:00:00Z,9,5,2020,7,0,Venezuela,VE,VEN,28515829,America,10,388,18
2020-05-10T00:00:00Z,10,5,2020,14,0,Venezuela,VE,VEN,28515829,America,10,402,19
2020-05-11T00:00:00Z,11,5,2020,12,0,Venezuela,VE,VEN,28515829,America,10,414,20
2020-05-12T00:00:00Z,12,5,2020,8,0,Venezuela,VE,VEN,28515829,America,10,422,21
2020-05-13T00:00:00Z,13,5,2020,1,0,Venezuela,VE,VEN,28515829,America,10,423,22
2020-05-14T00:00:00Z,14,5,2020,17,0,Venezuela,VE,VEN,28515829,America,10,440,23
2020-05-15T00:00:00Z,15,5,2020,15,0,Venezuela,VE,VEN,28515829,America,10,455,24
2020-05-16T00:00:00Z,16,5,2020,4,0,Venezuela,VE,VEN,28515829,America,10,459,25
2020-05-17T00:00:00Z,17,5,2020,45,0,Venezuela,VE,VEN,28515829,America,10,504,26
2020-05-18T00:00:00Z,18,5,2020,37,0,Venezuela,VE,VEN,28515829,America,10,541,27
2020-05-19T00:00:00Z,19,5,2020,77,0,Venezuela,VE,VEN,28515829,America,10,618,28
2020-05-20T00:00:00Z,20,5,2020,131,0,Venezuela,VE,VEN,28515829,America,10,749,29
2020-05-21T00:00:00Z,21,5,2020,75,0,Venezuela,VE,VEN,28515829,America,10,824,30
2020-05-22T00:00:00Z,22,5,2020,58,0,Venezuela,VE,VEN,28515829,America,10,882,31
2020-05-23T00:00:00Z,23,5,2020,62,0,Venezuela,VE,VEN,28515829,America,10,944,32
2020-05-24T00:00:00Z,24,5,2020,0,0,Venezuela,VE,VEN,28515829,America,10,944,33
2020-05-25T00:00:00Z,25,5,2020,177,0,Venezuela,VE,VEN,28515829,America,10,1121,34
2020-05-26T00:00:00Z,26,5,2020,56,0,Venezuela,VE,VEN,28515829,America,10,1177,35
2020-05-27T00:00:00Z,27,5,2020,34,1,Venezuela,VE,VEN,28515829,America,11,1211,36
2020-05-28T00:00:00Z,28,5,2020,34,0,Venezuela,VE,VEN,28515829,America,11,1245,37
2020-05-29T00:00:00Z,29,5,2020,82,0,Venezuela,VE,VEN,28515829,America,11,1327,38
2020-05-30T00:00:00Z,30,5,2020,42,3,Venezuela,VE,VEN,28515829,America,14,1369,39
2020-05-31T00:00:00Z,31,5,2020,90,0,Venezuela,VE,VEN,28515829,America,14,1459,40
2020-06-01T00:00:00Z,1,6,2020,51,0,Venezuela,VE,VEN,28515829,America,14,1510,41
2020-06-02T00:00:00Z,2,6,2020,152,3,Venezuela,VE,VEN,28515829,America,17,1662,42
2020-06-03T00:00:00Z,3,6,2020,157,1,Venezuela,VE,VEN,28515829,America,18,1819,43
2020-06-04T00:00:00Z,4,6,2020,133,2,Venezuela,VE,VEN,28515829,America,20,1952,44
2020-06-05T00:00:00Z,5,6,2020,135,0,Venezuela,VE,VEN,28515829,America,20,2087,45
2020-06-06T00:00:00Z,6,6,2020,58,0,Venezuela,VE,VEN,28515829,America,20,2145,46
2020-06-07T00:00:00Z,7,6,2020,171,2,Venezuela,VE,VEN,28515829,America,22,2316,47
2020-06-08T00:00:00Z,8,6,2020,61,0,Venezuela,VE,VEN,28515829,America,22,2377,48
2020-06-09T00:00:00Z,9,6,2020,96,0,Venezuela,VE,VEN,28515829,America,22,2473,49
2020-06-10T00:00:00Z,10,6,2020,159,1,Venezuela,VE,VEN,28515829,America,23,2632,50
2020-06-11T00:00:00Z,11,6,2020,106,0,Venezuela,VE,VEN,28515829,America,23,2738,51
2020-06-12T00:00:00Z,12,6,2020,76,0,Venezuela,VE,VEN,28515829,America,23,2814,52
2020-06-13T00:00:00Z,13,6,2020,65,0,Venezuela,VE,VEN,28515829,America,23,2879,53
2020-06-14T00:00:00Z,14,6,2020,25,1,Venezuela,VE,VEN,28515829,America,24,2904,54
2020-06-15T00:00:00Z,15,6,2020,74,1,Venezuela,VE,VEN,28515829,America,25,2978,55
2020-06-16T00:00:00Z,16,6,2020,84,1,Venezuela,VE,VEN,28515829,America,26,3062,56
2020-06-17T00:00:00Z,17,6,2020,88,1,Venezuela,VE,VEN,28515829,America,27,3150,57
2020-06-19T00:00:00Z,19,6,2020,334,1,Venezuela,VE,VEN,28515829,America,28,3484,58
2020-06-20T00:00:00Z,20,6,2020,107,2,Venezuela,VE,VEN,28515829,America,30,3591,59
2020-06-21T00:00:00Z,21,6,2020,199,3,Venezuela,VE,VEN,28515829,America,33,3790,60
2020-06-22T00:00:00Z,22,6,2020,128,0,Venezuela,VE,VEN,28515829,America,33,3918,61
2020-06-23T00:00:00Z,23,6,2020,130,2,Venezuela,VE,VEN,28515829,America,35,4048,62
2020-06-24T00:00:00Z,24,6,2020,138,0,Venezuela,VE,VEN,28515829,America,35,4186,63
2020-06-25T00:00:00Z,25,6,2020,179,3,Venezuela,VE,VEN,28515829,America,38,4365,64
2020-05-13T00:00:00Z,13,5,2020,11,2,Yemen,YE,YEM,29161922,Asia,11,67,1
2020-05-14T00:00:00Z,14,5,2020,3,1,Yemen,YE,YEM,29161922,Asia,12,70,2
2020-05-15T00:00:00Z,15,5,2020,17,1,Yemen,YE,YEM,29161922,Asia,13,87,3
2020-05-16T00:00:00Z,16,5,2020,19,2,Yemen,YE,YEM,29161922,Asia,15,106,4
2020-05-17T00:00:00Z,17,5,2020,18,4,Yemen,YE,YEM,29161922,Asia,19,124,5
2020-05-18T00:00:00Z,18,5,2020,4,1,Yemen,YE,YEM,29161922,Asia,20,128,6
2020-05-19T00:00:00Z,19,5,2020,2,0,Yemen,YE,YEM,29161922,Asia,20,130,7
2020-05-20T00:00:00Z,20,5,2020,37,8,Yemen,YE,YEM,29161922,Asia,28,167,8
2020-05-21T00:00:00Z,21,5,2020,13,1,Yemen,YE,YEM,29161922,Asia,29,180,9
2020-05-22T00:00:00Z,22,5,2020,13,4,Yemen,YE,YEM,29161922,Asia,33,193,10
2020-05-23T00:00:00Z,23,5,2020,12,0,Yemen,YE,YEM,29161922,Asia,33,205,11
2020-05-24T00:00:00Z,24,5,2020,7,6,Yemen,YE,YEM,29161922,Asia,39,212,12
2020-05-25T00:00:00Z,25,5,2020,10,3,Yemen,YE,YEM,29161922,Asia,42,222,13
2020-05-26T00:00:00Z,26,5,2020,15,3,Yemen,YE,YEM,29161922,Asia,45,237,14
2020-05-27T00:00:00Z,27,5,2020,12,4,Yemen,YE,YEM,29161922,Asia,49,249,15
2020-05-28T00:00:00Z,28,5,2020,6,4,Yemen,YE,YEM,29161922,Asia,53,255,16
2020-05-29T00:00:00Z,29,5,2020,23,4,Yemen,YE,YEM,29161922,Asia,57,278,17
2020-05-30T00:00:00Z,30,5,2020,9,9,Yemen,YE,YEM,29161922,Asia,66,287,18
2020-05-31T00:00:00Z,31,5,2020,23,11,Yemen,YE,YEM,29161922,Asia,77,310,19
2020-06-01T00:00:00Z,1,6,2020,13,3,Yemen,YE,YEM,29161922,Asia,80,323,20
2020-06-02T00:00:00Z,2,6,2020,31,4,Yemen,YE,YEM,29161922,Asia,84,354,21
2020-06-03T00:00:00Z,3,6,2020,45,3,Yemen,YE,YEM,29161922,Asia,87,399,22
2020-06-04T00:00:00Z,4,6,2020,4,1,Yemen,YE,YEM,29161922,Asia,88,403,23
2020-06-05T00:00:00Z,5,6,2020,50,15,Yemen,YE,YEM,29161922,Asia,103,453,24
2020-06-06T00:00:00Z,6,6,2020,16,8,Yemen,YE,YEM,29161922,Asia,111,469,25
2020-06-07T00:00:00Z,7,6,2020,4,1,Yemen,YE,YEM,29161922,Asia,112,473,26
2020-06-08T00:00:00Z,8,6,2020,13,0,Yemen,YE,YEM,29161922,Asia,112,486,27
2020-06-09T00:00:00Z,9,6,2020,10,0,Yemen,YE,YEM,29161922,Asia,112,496,28
2020-06-10T00:00:00Z,10,6,2020,28,15,Yemen,YE,YEM,29161922,Asia,127,524,29
2020-06-11T00:00:00Z,11,6,2020,36,2,Yemen,YE,YEM,29161922,Asia,129,560,30
2020-06-12T00:00:00Z,12,6,2020,31,7,Yemen,YE,YEM,29161922,Asia,136,591,31
2020-06-13T00:00:00Z,13,6,2020,41,3,Yemen,YE,YEM,29161922,Asia,139,632,32
2020-06-14T00:00:00Z,14,6,2020,73,21,Yemen,YE,YEM,29161922,Asia,160,705,33
2020-06-15T00:00:00Z,15,6,2020,23,4,Yemen,YE,YEM,29161922,Asia,164,728,34
2020-06-16T00:00:00Z,16,6,2020,116,44,Yemen,YE,YEM,29161922,Asia,208,844,35
2020-06-17T00:00:00Z,17,6,2020,45,7,Yemen,YE,YEM,29161922,Asia,215,889,36
2020-06-18T00:00:00Z,18,6,2020,13,29,Yemen,YE,YEM,29161922,Asia,244,902,37
2020-06-19T00:00:00Z,19,6,2020,4,4,Yemen,YE,YEM,29161922,Asia,248,906,38
2020-06-20T00:00:00Z,20,6,2020,13,3,Yemen,YE,YEM,29161922,Asia,251,919,39
2020-06-21T00:00:00Z,21,6,2020,4,3,Yemen,YE,YEM,29161922,Asia,254,923,40
2020-06-22T00:00:00Z,22,6,2020,18,2,Yemen,YE,YEM,29161922,Asia,256,941,41
2020-06-23T00:00:00Z,23,6,2020,26,1,Yemen,YE,YEM,29161922,Asia,257,967,42
2020-06-24T00:00:00Z,24,6,2020,25,4,Yemen,YE,YEM,29161922,Asia,261,992,43
2020-06-25T00:00:00Z,25,6,2020,23,13,Yemen,YE,YEM,29161922,Asia,274,1015,44
2020-06-09T00:00:00Z,9,6,2020,46,3,Zambia,ZM,ZMB,17861034,Africa,10,1200,1
2020-06-10T00:00:00Z,10,6,2020,0,0,Zambia,ZM,ZMB,17861034,Africa,10,1200,2
2020-06-11T00:00:00Z,11,6,2020,52,0,Zambia,ZM,ZMB,17861034,Africa,10,1252,3
2020-06-12T00:00:00Z,12,6,2020,0,0,Zambia,ZM,ZMB,17861034,Africa,10,1252,4
2020-06-13T00:00:00Z,13,6,2020,69,0,Zambia,ZM,ZMB,17861034,Africa,10,1321,5
2020-06-14T00:00:00Z,14,6,2020,36,0,Zambia,ZM,ZMB,17861034,Africa,10,1357,6
2020-06-15T00:00:00Z,15,6,2020,1,1,Zambia,ZM,ZMB,17861034,Africa,11,1358,7
2020-06-16T00:00:00Z,16,6,2020,24,0,Zambia,ZM,ZMB,17861034,Africa,11,1382,8
2020-06-17T00:00:00Z,17,6,2020,23,0,Zambia,ZM,ZMB,17861034,Africa,11,1405,9
2020-06-18T00:00:00Z,18,6,2020,7,0,Zambia,ZM,ZMB,17861034,Africa,11,1412,10
2020-06-19T00:00:00Z,19,6,2020,4,0,Zambia,ZM,ZMB,17861034,Africa,11,1416,11
2020-06-20T00:00:00Z,20,6,2020,14,0,Zambia,ZM,ZMB,17861034,Africa,11,1430,12
2020-06-21T00:00:00Z,21,6,2020,0,0,Zambia,ZM,ZMB,17861034,Africa,11,1430,13
2020-06-22T00:00:00Z,22,6,2020,0,0,Zambia,ZM,ZMB,17861034,Africa,11,1430,14
2020-06-23T00:00:00Z,23,6,2020,0,0,Zambia,ZM,ZMB,17861034,Africa,11,1430,15
2020-06-24T00:00:00Z,24,6,2020,47,7,Zambia,ZM,ZMB,17861034,Africa,18,1477,16
2020-06-25T00:00:00Z,25,6,2020,12,0,Zambia,ZM,ZMB,17861034,Africa,18,1489,17
