DateRep,day,month,year,Cases,Deaths,Country,geoId,countryterritoryCode,popData2018,continentExp,Total Deaths,Total Cases,Days since tenth death
2020-04-08T00:00:00Z,8,4,2020,30,4,Afghanistan,AF,AFG,37172386,Asia,11,367,1
2020-04-09T00:00:00Z,9,4,2020,56,3,Afghanistan,AF,AFG,37172386,Asia,14,423,2
2020-04-10T00:00:00Z,10,4,2020,61,1,Afghanistan,AF,AFG,37172386,Asia,15,484,3
2020-04-11T00:00:00Z,11,4,2020,37,0,Afghanistan,AF,AFG,37172386,Asia,15,521,4
2020-04-12T00:00:00Z,12,4,2020,34,3,Afghanistan,AF,AFG,37172386,Asia,18,555,5
2020-04-13T00:00:00Z,13,4,2020,52,0,Afghanistan,AF,AFG,37172386,Asia,18,607,6
2020-04-14T00:00:00Z,14,4,2020,58,3,Afghanistan,AF,AFG,37172386,Asia,21,665,7
2020-04-15T00:00:00Z,15,4,2020,49,2,Afghanistan,AF,AFG,37172386,Asia,23,714,8
2020-04-16T00:00:00Z,16,4,2020,70,2,Afghanistan,AF,AFG,37172386,Asia,25,784,9
2020-04-17T00:00:00Z,17,4,2020,10,4,Afghanistan,AF,AFG,37172386,Asia,29,794,10
2020-04-18T00:00:00Z,18,4,2020,51,1,Afghanistan,AF,AFG,37172386,Asia,30,845,11
2020-04-19T00:00:00Z,19,4,2020,63,0,Afghanistan,AF,AFG,37172386,Asia,30,908,12
2020-04-20T00:00:00Z,20,4,2020,88,3,Afghanistan,AF,AFG,37172386,Asia,33,996,13
2020-04-21T00:00:00Z,21,4,2020,35,2,Afghanistan,AF,AFG,37172386,Asia,35,1031,14
2020-04-22T00:00:00Z,22,4,2020,61,1,Afghanistan,AF,AFG,37172386,Asia,36,1092,15
2020-04-23T00:00:00Z,23,4,2020,84,4,Afghanistan,AF,AFG,37172386,Asia,40,1176,16
2020-04-24T00:00:00Z,24,4,2020,105,2,Afghanistan,AF,AFG,37172386,Asia,42,1281,17
2020-04-25T00:00:00Z,25,4,2020,70,1,Afghanistan,AF,AFG,37172386,Asia,43,1351,18
2020-04-26T00:00:00Z,26,4,2020,112,4,Afghanistan,AF,AFG,37172386,Asia,47,1463,19
2020-04-27T00:00:00Z,27,4,2020,68,10,Afghanistan,AF,AFG,37172386,Asia,57,1531,20
2020-04-28T00:00:00Z,28,4,2020,172,0,Afghanistan,AF,AFG,37172386,Asia,57,1703,21
2020-04-29T00:00:00Z,29,4,2020,124,3,Afghanistan,AF,AFG,37172386,Asia,60,1827,22
2020-04-30T00:00:00Z,30,4,2020,122,0,Afghanistan,AF,AFG,37172386,Asia,60,1949,23
2020-05-01T00:00:00Z,1,5,2020,222,4,Afghanistan,AF,AFG,37172386,Asia,64,2171,24
2020-05-02T00:00:00Z,2,5,2020,164,4,Afghanistan,AF,AFG,37172386,Asia,68,2335,25
2020-05-03T00:00:00Z,3,5,2020,134,4,Afghanistan,AF,AFG,37172386,Asia,72,2469,26
2020-05-04T00:00:00Z,4,5,2020,235,13,Afghanistan,AF,AFG,37172386,Asia,85,2704,27
2020-05-05T00:00:00Z,5,5,2020,190,5,Afghanistan,AF,AFG,37172386,Asia,90,2894,28
2020-05-06T00:00:00Z,6,5,2020,330,5,Afghanistan,AF,AFG,37172386,Asia,95,3224,29
2020-05-07T00:00:00Z,7,5,2020,168,9,Afghanistan,AF,AFG,37172386,Asia,104,3392,30
2020-05-08T00:00:00Z,8,5,2020,171,2,Afghanistan,AF,AFG,37172386,Asia,106,3563,31
2020-05-09T00:00:00Z,9,5,2020,215,3,Afghanistan,AF,AFG,37172386,Asia,109,3778,32
2020-05-10T00:00:00Z,10,5,2020,255,6,Afghanistan,AF,AFG,37172386,Asia,115,4033,33
2020-05-11T00:00:00Z,11,5,2020,369,5,Afghanistan,AF,AFG,37172386,Asia,120,4402,34
2020-05-12T00:00:00Z,12,5,2020,285,2,Afghanistan,AF,AFG,37172386,Asia,122,4687,35
2020-05-13T00:00:00Z,13,5,2020,280,5,Afghanistan,AF,AFG,37172386,Asia,127,4967,36
2020-05-14T00:00:00Z,14,5,2020,259,3,Afghanistan,AF,AFG,37172386,Asia,130,5226,37
2020-05-15T00:00:00Z,15,5,2020,113,6,Afghanistan,AF,AFG,37172386,Asia,136,5339,38
2020-05-16T00:00:00Z,16,5,2020,1063,32,Afghanistan,AF,AFG,37172386,Asia,168,6402,39
2020-05-17T00:00:00Z,17,5,2020,0,0,Afghanistan,AF,AFG,37172386,Asia,168,6402,40
2020-05-18T00:00:00Z,18,5,2020,262,1,Afghanistan,AF,AFG,37172386,Asia,169,6664,41
2020-05-19T00:00:00Z,19,5,2020,408,4,Afghanistan,AF,AFG,37172386,Asia,173,7072,42
2020-05-20T00:00:00Z,20,5,2020,581,5,Afghanistan,AF,AFG,37172386,Asia,178,7653,43
2020-05-21T00:00:00Z,21,5,2020,492,9,Afghanistan,AF,AFG,37172386,Asia,187,8145,44
2020-05-22T00:00:00Z,22,5,2020,531,6,Afghanistan,AF,AFG,37172386,Asia,193,8676,45
2020-05-23T00:00:00Z,23,5,2020,540,12,Afghanistan,AF,AFG,37172386,Asia,205,9216,46
2020-05-24T00:00:00Z,24,5,2020,782,11,Afghanistan,AF,AFG,37172386,Asia,216,9998,47
2020-05-25T00:00:00Z,25,5,2020,584,2,Afghanistan,AF,AFG,37172386,Asia,218,10582,48
2020-05-26T00:00:00Z,26,5,2020,591,1,Afghanistan,AF,AFG,37172386,Asia,219,11173,49
2020-05-27T00:00:00Z,27,5,2020,658,1,Afghanistan,AF,AFG,37172386,Asia,220,11831,50
2020-03-29T00:00:00Z,29,3,2020,11,1,Albania,AL,ALB,2866376,Europe,10,197,1
2020-03-30T00:00:00Z,30,3,2020,15,0,Albania,AL,ALB,2866376,Europe,10,212,2
2020-03-31T00:00:00Z,31,3,2020,11,2,Albania,AL,ALB,2866376,Europe,12,223,3
2020-04-01T00:00:00Z,1,4,2020,20,3,Albania,AL,ALB,2866376,Europe,15,243,4
2020-04-02T00:00:00Z,2,4,2020,16,0,Albania,AL,ALB,2866376,Europe,15,259,5
2020-04-03T00:00:00Z,3,4,2020,18,1,Albania,AL,ALB,2866376,Europe,16,277,6
2020-04-04T00:00:00Z,4,4,2020,27,1,Albania,AL,ALB,2866376,Europe,17,304,7
2020-04-05T00:00:00Z,5,4,2020,29,2,Albania,AL,ALB,2866376,Europe,19,333,8
2020-04-06T00:00:00Z,6,4,2020,28,2,Albania,AL,ALB,2866376,Europe,21,361,9
2020-04-07T00:00:00Z,7,4,2020,16,1,Albania,AL,ALB,2866376,Europe,22,377,10
2020-04-08T00:00:00Z,8,4,2020,6,0,Albania,AL,ALB,2866376,Europe,22,383,11
2020-04-09T00:00:00Z,9,4,2020,17,0,Albania,AL,ALB,2866376,Europe,22,400,12
2020-04-10T00:00:00Z,10,4,2020,9,1,Albania,AL,ALB,2866376,Europe,23,409,13
2020-04-11T00:00:00Z,11,4,2020,7,0,Albania,AL,ALB,2866376,Europe,23,416,14
2020-04-12T00:00:00Z,12,4,2020,17,0,Albania,AL,ALB,2866376,Europe,23,433,15
2020-04-13T00:00:00Z,13,4,2020,13,0,Albania,AL,ALB,2866376,Europe,23,446,16
2020-04-14T00:00:00Z,14,4,2020,21,0,Albania,AL,ALB,2866376,Europe,23,467,17
2020-04-15T00:00:00Z,15,4,2020,8,1,Albania,AL,ALB,2866376,Europe,24,475,18
2020-04-16T00:00:00Z,16,4,2020,19,1,Albania,AL,ALB,2866376,Europe,25,494,19
2020-04-17T00:00:00Z,17,4,2020,24,1,Albania,AL,ALB,2866376,Europe,26,518,20
2020-04-18T00:00:00Z,18,4,2020,21,0,Albania,AL,ALB,2866376,Europe,26,539,21
2020-04-19T00:00:00Z,19,4,2020,9,0,Albania,AL,ALB,2866376,Europe,26,548,22
2020-04-20T00:00:00Z,20,4,2020,14,0,Albania,AL,ALB,2866376,Europe,26,562,23
2020-04-21T00:00:00Z,21,4,2020,22,0,Albania,AL,ALB,2866376,Europe,26,584,24
2020-04-22T00:00:00Z,22,4,2020,25,0,Albania,AL,ALB,2866376,Europe,26,609,25
2020-04-23T00:00:00Z,23,4,2020,25,1,Albania,AL,ALB,2866376,Europe,27,634,26
2020-04-24T00:00:00Z,24,4,2020,29,0,Albania,AL,ALB,2866376,Europe,27,663,27
2020-04-25T00:00:00Z,25,4,2020,15,0,Albania,AL,ALB,2866376,Europe,27,678,28
2020-04-26T00:00:00Z,26,4,2020,34,0,Albania,AL,ALB,2866376,Europe,27,712,29
2020-04-27T00:00:00Z,27,4,2020,14,1,Albania,AL,ALB,2866376,Europe,28,726,30
2020-04-28T00:00:00Z,28,4,2020,10,0,Albania,AL,ALB,2866376,Europe,28,736,31
2020-04-29T00:00:00Z,29,4,2020,14,2,Albania,AL,ALB,2866376,Europe,30,750,32
2020-04-30T00:00:00Z,30,4,2020,16,1,Albania,AL,ALB,2866376,Europe,31,766,33
2020-05-01T00:00:00Z,1,5,2020,7,0,Albania,AL,ALB,2866376,Europe,31,773,34
2020-05-02T00:00:00Z,2,5,2020,9,0,Albania,AL,ALB,2866376,Europe,31,782,35
2020-05-03T00:00:00Z,3,5,2020,7,0,Albania,AL,ALB,2866376,Europe,31,789,36
2020-05-04T00:00:00Z,4,5,2020,6,0,Albania,AL,ALB,2866376,Europe,31,795,37
2020-05-05T00:00:00Z,5,5,2020,8,0,Albania,AL,ALB,2866376,Europe,31,803,38
2020-05-06T00:00:00Z,6,5,2020,17,0,Albania,AL,ALB,2866376,Europe,31,820,39
2020-05-07T00:00:00Z,7,5,2020,12,0,Albania,AL,ALB,2866376,Europe,31,832,40
2020-05-08T00:00:00Z,8,5,2020,10,0,Albania,AL,ALB,2866376,Europe,31,842,41
2020-05-09T00:00:00Z,9,5,2020,8,0,Albania,AL,ALB,2866376,Europe,31,850,42
2020-05-10T00:00:00Z,10,5,2020,6,0,Albania,AL,ALB,2866376,Europe,31,856,43
2020-05-11T00:00:00Z,11,5,2020,12,0,Albania,AL,ALB,2866376,Europe,31,868,44
2020-05-12T00:00:00Z,12,5,2020,4,0,Albania,AL,ALB,2866376,Europe,31,872,45
2020-05-13T00:00:00Z,13,5,2020,4,0,Albania,AL,ALB,2866376,Europe,31,876,46
2020-05-14T00:00:00Z,14,5,2020,4,0,Albania,AL,ALB,2866376,Europe,31,880,47
2020-05-15T00:00:00Z,15,5,2020,18,0,Albania,AL,ALB,2866376,Europe,31,898,48
2020-05-16T00:00:00Z,16,5,2020,18,0,Albania,AL,ALB,2866376,Europe,31,916,49
2020-05-17T00:00:00Z,17,5,2020,17,0,Albania,AL,ALB,2866376,Europe,31,933,50
2020-05-18T00:00:00Z,18,5,2020,13,0,Albania,AL,ALB,2866376,Europe,31,946,51
2020-05-19T00:00:00Z,19,5,2020,2,0,Albania,AL,ALB,2866376,Europe,31,948,52
2020-05-20T00:00:00Z,20,5,2020,1,0,Albania,AL,ALB,2866376,Europe,31,949,53
2020-05-21T00:00:00Z,21,5,2020,15,0,Albania,AL,ALB,2866376,Europe,31,964,54
2020-05-22T00:00:00Z,22,5,2020,5,0,Albania,AL,ALB,2866376,Europe,31,969,55
2020-05-23T00:00:00Z,23,5,2020,12,0,Albania,AL,ALB,2866376,Europe,31,981,56
2020-05-24T00:00:00Z,24,5,2020,8,0,Albania,AL,ALB,2866376,Europe,31,989,57
2020-05-25T00:00:00Z,25,5,2020,9,1,Albania,AL,ALB,2866376,Europe,32,998,58
2020-05-26T00:00:00Z,26,5,2020,6,0,Albania,AL,ALB,2866376,Europe,32,1004,59
2020-05-27T00:00:00Z,27,5,2020,25,1,Albania,AL,ALB,2866376,Europe,33,1029,60
2020-03-21T00:00:00Z,21,3,2020,12,3,Algeria,DZ,DZA,42228429,Africa,10,102,1
2020-03-22T00:00:00Z,22,3,2020,37,5,Algeria,DZ,DZA,42228429,Africa,15,139,2
2020-03-23T00:00:00Z,23,3,2020,62,2,Algeria,DZ,DZA,42228429,Africa,17,201,3
2020-03-24T00:00:00Z,24,3,2020,29,0,Algeria,DZ,DZA,42228429,Africa,17,230,4
2020-03-25T00:00:00Z,25,3,2020,34,2,Algeria,DZ,DZA,42228429,Africa,19,264,5
2020-03-26T00:00:00Z,26,3,2020,38,2,Algeria,DZ,DZA,42228429,Africa,21,302,6
2020-03-27T00:00:00Z,27,3,2020,65,4,Algeria,DZ,DZA,42228429,Africa,25,367,7
2020-03-28T00:00:00Z,28,3,2020,42,1,Algeria,DZ,DZA,42228429,Africa,26,409,8
2020-03-29T00:00:00Z,29,3,2020,45,3,Algeria,DZ,DZA,42228429,Africa,29,454,9
2020-03-30T00:00:00Z,30,3,2020,57,2,Algeria,DZ,DZA,42228429,Africa,31,511,10
2020-03-31T00:00:00Z,31,3,2020,73,4,Algeria,DZ,DZA,42228429,Africa,35,584,11
2020-04-01T00:00:00Z,1,4,2020,132,9,Algeria,DZ,DZA,42228429,Africa,44,716,12
2020-04-02T00:00:00Z,2,4,2020,131,14,Algeria,DZ,DZA,42228429,Africa,58,847,13
2020-04-03T00:00:00Z,3,4,2020,139,5,Algeria,DZ,DZA,42228429,Africa,63,986,14
2020-04-04T00:00:00Z,4,4,2020,185,42,Algeria,DZ,DZA,42228429,Africa,105,1171,15
2020-04-05T00:00:00Z,5,4,2020,80,25,Algeria,DZ,DZA,42228429,Africa,130,1251,16
2020-04-06T00:00:00Z,6,4,2020,69,22,Algeria,DZ,DZA,42228429,Africa,152,1320,17
2020-04-07T00:00:00Z,7,4,2020,103,21,Algeria,DZ,DZA,42228429,Africa,173,1423,18
2020-04-08T00:00:00Z,8,4,2020,45,20,Algeria,DZ,DZA,42228429,Africa,193,1468,19
2020-04-09T00:00:00Z,9,4,2020,104,12,Algeria,DZ,DZA,42228429,Africa,205,1572,20
2020-04-10T00:00:00Z,10,4,2020,94,30,Algeria,DZ,DZA,42228429,Africa,235,1666,21
2020-04-11T00:00:00Z,11,4,2020,95,21,Algeria,DZ,DZA,42228429,Africa,256,1761,22
2020-04-12T00:00:00Z,12,4,2020,64,19,Algeria,DZ,DZA,42228429,Africa,275,1825,23
2020-04-13T00:00:00Z,13,4,2020,89,18,Algeria,DZ,DZA,42228429,Africa,293,1914,24
2020-04-14T00:00:00Z,14,4,2020,69,20,Algeria,DZ,DZA,42228429,Africa,313,1983,25
2020-04-15T00:00:00Z,15,4,2020,87,12,Algeria,DZ,DZA,42228429,Africa,325,2070,26
2020-04-16T00:00:00Z,16,4,2020,90,11,Algeria,DZ,DZA,42228429,Africa,336,2160,27
2020-04-17T00:00:00Z,17,4,2020,108,12,Algeria,DZ,DZA,42228429,Africa,348,2268,28
2020-04-18T00:00:00Z,18,4,2020,150,16,Algeria,DZ,DZA,42228429,Africa,364,2418,29
2020-04-19T00:00:00Z,19,4,2020,117,3,Algeria,DZ,DZA,42228429,Africa,367,2535,30
2020-04-20T00:00:00Z,20,4,2020,94,8,Algeria,DZ,DZA,42228429,Africa,375,2629,31
2020-04-21T00:00:00Z,21,4,2020,89,9,Algeria,DZ,DZA,42228429,Africa,384,2718,32
2020-04-22T00:00:00Z,22,4,2020,93,8,Algeria,DZ,DZA,42228429,Africa,392,2811,33
2020-04-23T00:00:00Z,23,4,2020,99,10,Algeria,DZ,DZA,42228429,Africa,402,2910,34
2020-04-24T00:00:00Z,24,4,2020,97,5,Algeria,DZ,DZA,42228429,Africa,407,3007,35
2020-04-25T00:00:00Z,25,4,2020,120,8,Algeria,DZ,DZA,42228429,Africa,415,3127,36
2020-04-26T00:00:00Z,26,4,2020,129,4,Algeria,DZ,DZA,42228429,Africa,419,3256,37
2020-04-27T00:00:00Z,27,4,2020,126,6,Algeria,DZ,DZA,42228429,Africa,425,3382,38
2020-04-28T00:00:00Z,28,4,2020,135,7,Algeria,DZ,DZA,42228429,Africa,432,3517,39
2020-04-29T00:00:00Z,29,4,2020,132,5,Algeria,DZ,DZA,42228429,Africa,437,3649,40
2020-04-30T00:00:00Z,30,4,2020,199,7,Algeria,DZ,DZA,42228429,Africa,444,3848,41
2020-05-01T00:00:00Z,1,5,2020,158,6,Algeria,DZ,DZA,42228429,Africa,450,4006,42
2020-05-02T00:00:00Z,2,5,2020,148,3,Algeria,DZ,DZA,42228429,Africa,453,4154,43
2020-05-03T00:00:00Z,3,5,2020,141,6,Algeria,DZ,DZA,42228429,Africa,459,4295,44
2020-05-04T00:00:00Z,4,5,2020,179,4,Algeria,DZ,DZA,42228429,Africa,463,4474,45
2020-05-05T00:00:00Z,5,5,2020,174,2,Algeria,DZ,DZA,42228429,Africa,465,4648,46
2020-05-06T00:00:00Z,6,5,2020,190,5,Algeria,DZ,DZA,42228429,Africa,470,4838,47
2020-05-07T00:00:00Z,7,5,2020,159,6,Algeria,DZ,DZA,42228429,Africa,476,4997,48
2020-05-08T00:00:00Z,8,5,2020,185,7,Algeria,DZ,DZA,42228429,Africa,483,5182,49
2020-05-09T00:00:00Z,9,5,2020,187,5,Algeria,DZ,DZA,42228429,Africa,488,5369,50
2020-05-10T00:00:00Z,10,5,2020,189,6,Algeria,DZ,DZA,42228429,Africa,494,5558,51
2020-05-11T00:00:00Z,11,5,2020,165,8,Algeria,DZ,DZA,42228429,Africa,502,5723,52
2020-05-12T00:00:00Z,12,5,2020,168,5,Algeria,DZ,DZA,42228429,Africa,507,5891,53
2020-05-13T00:00:00Z,13,5,2020,176,8,Algeria,DZ,DZA,42228429,Africa,515,6067,54
2020-05-14T00:00:00Z,14,5,2020,186,7,Algeria,DZ,DZA,42228429,Africa,522,6253,55
2020-05-15T00:00:00Z,15,5,2020,189,7,Algeria,DZ,DZA,42228429,Africa,529,6442,56
2020-05-16T00:00:00Z,16,5,2020,187,7,Algeria,DZ,DZA,42228429,Africa,536,6629,57
2020-05-17T00:00:00Z,17,5,2020,192,6,Algeria,DZ,DZA,42228429,Africa,542,6821,58
2020-05-18T00:00:00Z,18,5,2020,198,6,Algeria,DZ,DZA,42228429,Africa,548,7019,59
2020-05-19T00:00:00Z,19,5,2020,182,7,Algeria,DZ,DZA,42228429,Africa,555,7201,60
2020-05-20T00:00:00Z,20,5,2020,176,6,Algeria,DZ,DZA,42228429,Africa,561,7377,61
2020-05-21T00:00:00Z,21,5,2020,165,7,Algeria,DZ,DZA,42228429,Africa,568,7542,62
2020-05-22T00:00:00Z,22,5,2020,186,7,Algeria,DZ,DZA,42228429,Africa,575,7728,63
2020-05-23T00:00:00Z,23,5,2020,190,7,Algeria,DZ,DZA,42228429,Africa,582,7918,64
2020-05-24T00:00:00Z,24,5,2020,195,10,Algeria,DZ,DZA,42228429,Africa,592,8113,65
2020-05-25T00:00:00Z,25,5,2020,193,8,Algeria,DZ,DZA,42228429,Africa,600,8306,66
2020-05-26T00:00:00Z,26,5,2020,197,9,Algeria,DZ,DZA,42228429,Africa,609,8503,67
2020-05-27T00:00:00Z,27,5,2020,194,8,Algeria,DZ,DZA,42228429,Africa,617,8697,68
2020-04-01T00:00:00Z,1,4,2020,6,4,Andorra,AD,AND,77006,Europe,12,376,1
2020-04-02T00:00:00Z,2,4,2020,14,2,Andorra,AD,AND,77006,Europe,14,390,2
2020-04-03T00:00:00Z,3,4,2020,38,1,Andorra,AD,AND,77006,Europe,15,428,3
2020-04-04T00:00:00Z,4,4,2020,11,1,Andorra,AD,AND,77006,Europe,16,439,4
2020-04-05T00:00:00Z,5,4,2020,27,1,Andorra,AD,AND,77006,Europe,17,466,5
2020-04-06T00:00:00Z,6,4,2020,35,1,Andorra,AD,AND,77006,Europe,18,501,6
2020-04-07T00:00:00Z,7,4,2020,25,3,Andorra,AD,AND,77006,Europe,21,526,7
2020-04-08T00:00:00Z,8,4,2020,19,1,Andorra,AD,AND,77006,Europe,22,545,8
2020-04-09T00:00:00Z,9,4,2020,19,1,Andorra,AD,AND,77006,Europe,23,564,9
2020-04-10T00:00:00Z,10,4,2020,19,2,Andorra,AD,AND,77006,Europe,25,583,10
2020-04-11T00:00:00Z,11,4,2020,18,1,Andorra,AD,AND,77006,Europe,26,601,11
2020-04-12T00:00:00Z,12,4,2020,21,2,Andorra,AD,AND,77006,Europe,28,622,12
2020-04-13T00:00:00Z,13,4,2020,16,1,Andorra,AD,AND,77006,Europe,29,638,13
2020-04-14T00:00:00Z,14,4,2020,8,0,Andorra,AD,AND,77006,Europe,29,646,14
2020-04-15T00:00:00Z,15,4,2020,13,2,Andorra,AD,AND,77006,Europe,31,659,15
2020-04-16T00:00:00Z,16,4,2020,14,2,Andorra,AD,AND,77006,Europe,33,673,16
2020-04-17T00:00:00Z,17,4,2020,9,0,Andorra,AD,AND,77006,Europe,33,682,17
2020-04-18T00:00:00Z,18,4,2020,14,2,Andorra,AD,AND,77006,Europe,35,696,18
2020-04-19T00:00:00Z,19,4,2020,8,0,Andorra,AD,AND,77006,Europe,35,704,19
2020-04-20T00:00:00Z,20,4,2020,9,1,Andorra,AD,AND,77006,Europe,36,713,20
2020-04-21T00:00:00Z,21,4,2020,4,0,Andorra,AD,AND,77006,Europe,36,717,21
2020-04-22T00:00:00Z,22,4,2020,0,1,Andorra,AD,AND,77006,Europe,37,717,22
2020-04-23T00:00:00Z,23,4,2020,6,0,Andorra,AD,AND,77006,Europe,37,723,23
2020-04-24T00:00:00Z,24,4,2020,1,0,Andorra,AD,AND,77006,Europe,37,724,24
2020-04-25T00:00:00Z,25,4,2020,7,3,Andorra,AD,AND,77006,Europe,40,731,25
2020-04-26T00:00:00Z,26,4,2020,2,0,Andorra,AD,AND,77006,Europe,40,733,26
2020-04-27T00:00:00Z,27,4,2020,7,0,Andorra,AD,AND,77006,Europe,40,740,27
2020-04-28T00:00:00Z,28,4,2020,3,0,Andorra,AD,AND,77006,Europe,40,743,28
2020-04-29T00:00:00Z,29,4,2020,0,1,Andorra,AD,AND,77006,Europe,41,743,29
2020-04-30T00:00:00Z,30,4,2020,0,1,Andorra,AD,AND,77006,Europe,42,743,30
2020-05-01T00:00:00Z,1,5,2020,2,0,Andorra,AD,AND,77006,Europe,42,745,31
2020-05-02T00:00:00Z,2,5,2020,1,1,Andorra,AD,AND,77006,Europe,43,746,32
2020-05-03T00:00:00Z,3,5,2020,1,1,Andorra,AD,AND,77006,Europe,44,747,33
2020-05-04T00:00:00Z,4,5,2020,1,1,Andorra,AD,AND,77006,Europe,45,748,34
2020-05-05T00:00:00Z,5,5,2020,2,0,Andorra,AD,AND,77006,Europe,45,750,35
2020-05-06T00:00:00Z,6,5,2020,1,1,Andorra,AD,AND,77006,Europe,46,751,36
2020-05-07T00:00:00Z,7,5,2020,0,0,Andorra,AD,AND,77006,Europe,46,751,37
2020-05-08T00:00:00Z,8,5,2020,1,1,Andorra,AD,AND,77006,Europe,47,752,38
2020-05-09T00:00:00Z,9,5,2020,0,0,Andorra,AD,AND,77006,Europe,47,752,39
2020-05-10T00:00:00Z,10,5,2020,2,1,Andorra,AD,AND,77006,Europe,48,754,40
2020-05-11T00:00:00Z,11,5,2020,1,0,Andorra,AD,AND,77006,Europe,48,755,41
2020-05-12T00:00:00Z,12,5,2020,1,0,Andorra,AD,AND,77006,Europe,48,756,42
2020-05-13T00:00:00Z,13,5,2020,2,0,Andorra,AD,AND,77006,Europe,48,758,43
2020-05-14T00:00:00Z,14,5,2020,2,1,Andorra,AD,AND,77006,Europe,49,760,44
2020-05-15T00:00:00Z,15,5,2020,1,0,Andorra,AD,AND,77006,Europe,49,761,45
2020-05-16T00:00:00Z,16,5,2020,0,0,Andorra,AD,AND,77006,Europe,49,761,46
2020-05-17T00:00:00Z,17,5,2020,0,2,Andorra,AD,AND,77006,Europe,51,761,47
2020-05-18T00:00:00Z,18,5,2020,0,0,Andorra,AD,AND,77006,Europe,51,761,48
2020-05-19T00:00:00Z,19,5,2020,0,0,Andorra,AD,AND,77006,Europe,51,761,49
2020-05-20T00:00:00Z,20,5,2020,0,0,Andorra,AD,AND,77006,Europe,51,761,50
2020-05-21T00:00:00Z,21,5,2020,1,0,Andorra,AD,AND,77006,Europe,51,762,51
2020-05-22T00:00:00Z,22,5,2020,0,0,Andorra,AD,AND,77006,Europe,51,762,52
2020-05-23T00:00:00Z,23,5,2020,0,0,Andorra,AD,AND,77006,Europe,51,762,53
2020-05-24T00:00:00Z,24,5,2020,0,0,Andorra,AD,AND,77006,Europe,51,762,54
2020-05-25T00:00:00Z,25,5,2020,1,0,Andorra,AD,AND,77006,Europe,51,763,55
2020-05-26T00:00:00Z,26,5,2020,0,0,Andorra,AD,AND,77006,Europe,51,763,56
2020-05-27T00:00:00Z,27,5,2020,0,0,Andorra,AD,AND,77006,Europe,51,763,57
2020-03-27T00:00:00Z,27,3,2020,87,4,Argentina,AR,ARG,44494502,America,12,589,1
2020-03-28T00:00:00Z,28,3,2020,101,5,Argentina,AR,ARG,44494502,America,17,690,2
2020-03-29T00:00:00Z,29,3,2020,55,2,Argentina,AR,ARG,44494502,America,19,745,3
2020-03-30T00:00:00Z,30,3,2020,75,1,Argentina,AR,ARG,44494502,America,20,820,4
2020-03-31T00:00:00Z,31,3,2020,146,4,Argentina,AR,ARG,44494502,America,24,966,5
2020-04-01T00:00:00Z,1,4,2020,0,0,Argentina,AR,ARG,44494502,America,24,966,6
2020-04-02T00:00:00Z,2,4,2020,167,7,Argentina,AR,ARG,44494502,America,31,1133,7
2020-04-03T00:00:00Z,3,4,2020,0,3,Argentina,AR,ARG,44494502,America,34,1133,8
2020-04-04T00:00:00Z,4,4,2020,132,3,Argentina,AR,ARG,44494502,America,37,1265,9
2020-04-05T00:00:00Z,5,4,2020,186,6,Argentina,AR,ARG,44494502,America,43,1451,10
2020-04-06T00:00:00Z,6,4,2020,103,3,Argentina,AR,ARG,44494502,America,46,1554,11
2020-04-07T00:00:00Z,7,4,2020,74,7,Argentina,AR,ARG,44494502,America,53,1628,12
2020-04-08T00:00:00Z,8,4,2020,87,7,Argentina,AR,ARG,44494502,America,60,1715,13
2020-04-09T00:00:00Z,9,4,2020,80,5,Argentina,AR,ARG,44494502,America,65,1795,14
2020-04-10T00:00:00Z,10,4,2020,99,14,Argentina,AR,ARG,44494502,America,79,1894,15
2020-04-11T00:00:00Z,11,4,2020,81,3,Argentina,AR,ARG,44494502,America,82,1975,16
2020-04-12T00:00:00Z,12,4,2020,162,7,Argentina,AR,ARG,44494502,America,89,2137,17
2020-04-13T00:00:00Z,13,4,2020,66,6,Argentina,AR,ARG,44494502,America,95,2203,18
2020-04-14T00:00:00Z,14,4,2020,69,3,Argentina,AR,ARG,44494502,America,98,2272,19
2020-04-15T00:00:00Z,15,4,2020,160,7,Argentina,AR,ARG,44494502,America,105,2432,20
2020-04-16T00:00:00Z,16,4,2020,0,4,Argentina,AR,ARG,44494502,America,109,2432,21
2020-04-17T00:00:00Z,17,4,2020,128,6,Argentina,AR,ARG,44494502,America,115,2560,22
2020-04-18T00:00:00Z,18,4,2020,98,7,Argentina,AR,ARG,44494502,America,122,2658,23
2020-04-19T00:00:00Z,19,4,2020,170,10,Argentina,AR,ARG,44494502,America,132,2828,24
2020-04-20T00:00:00Z,20,4,2020,102,2,Argentina,AR,ARG,44494502,America,134,2930,25
2020-04-21T00:00:00Z,21,4,2020,90,8,Argentina,AR,ARG,44494502,America,142,3020,26
2020-04-22T00:00:00Z,22,4,2020,112,9,Argentina,AR,ARG,44494502,America,151,3132,27
2020-04-23T00:00:00Z,23,4,2020,144,8,Argentina,AR,ARG,44494502,America,159,3276,28
2020-04-24T00:00:00Z,24,4,2020,147,6,Argentina,AR,ARG,44494502,America,165,3423,29
2020-04-25T00:00:00Z,25,4,2020,0,2,Argentina,AR,ARG,44494502,America,167,3423,30
2020-04-26T00:00:00Z,26,4,2020,344,18,Argentina,AR,ARG,44494502,America,185,3767,31
2020-04-27T00:00:00Z,27,4,2020,0,1,Argentina,AR,ARG,44494502,America,186,3767,32
2020-04-28T00:00:00Z,28,4,2020,223,11,Argentina,AR,ARG,44494502,America,197,3990,33
2020-04-29T00:00:00Z,29,4,2020,124,10,Argentina,AR,ARG,44494502,America,207,4114,34
2020-04-30T00:00:00Z,30,4,2020,158,7,Argentina,AR,ARG,44494502,America,214,4272,35
2020-05-01T00:00:00Z,1,5,2020,143,4,Argentina,AR,ARG,44494502,America,218,4415,36
2020-05-02T00:00:00Z,2,5,2020,104,7,Argentina,AR,ARG,44494502,America,225,4519,37
2020-05-03T00:00:00Z,3,5,2020,149,12,Argentina,AR,ARG,44494502,America,237,4668,38
2020-05-04T00:00:00Z,4,5,2020,102,9,Argentina,AR,ARG,44494502,America,246,4770,39
2020-05-05T00:00:00Z,5,5,2020,104,14,Argentina,AR,ARG,44494502,America,260,4874,40
2020-05-06T00:00:00Z,6,5,2020,133,4,Argentina,AR,ARG,44494502,America,264,5007,41
2020-05-07T00:00:00Z,7,5,2020,188,9,Argentina,AR,ARG,44494502,America,273,5195,42
2020-05-08T00:00:00Z,8,5,2020,163,9,Argentina,AR,ARG,44494502,America,282,5358,43
2020-05-09T00:00:00Z,9,5,2020,240,11,Argentina,AR,ARG,44494502,America,293,5598,44
2020-05-10T00:00:00Z,10,5,2020,165,7,Argentina,AR,ARG,44494502,America,300,5763,45
2020-05-11T00:00:00Z,11,5,2020,13,0,Argentina,AR,ARG,44494502,America,300,5776,46
2020-05-12T00:00:00Z,12,5,2020,245,5,Argentina,AR,ARG,44494502,America,305,6021,47
2020-05-13T00:00:00Z,13,5,2020,529,14,Argentina,AR,ARG,44494502,America,319,6550,48
2020-05-14T00:00:00Z,14,5,2020,316,10,Argentina,AR,ARG,44494502,America,329,6866,49
2020-05-15T00:00:00Z,15,5,2020,255,24,Argentina,AR,ARG,44494502,America,353,7121,50
2020-05-16T00:00:00Z,16,5,2020,345,3,Argentina,AR,ARG,44494502,America,356,7466,51
2020-05-17T00:00:00Z,17,5,2020,326,7,Argentina,AR,ARG,44494502,America,363,7792,52
2020-05-18T00:00:00Z,18,5,2020,0,3,Argentina,AR,ARG,44494502,America,366,7792,53
2020-05-19T00:00:00Z,19,5,2020,566,16,Argentina,AR,ARG,44494502,America,382,8358,54
2020-05-20T00:00:00Z,20,5,2020,438,11,Argentina,AR,ARG,44494502,America,393,8796,55
2020-05-21T00:00:00Z,21,5,2020,474,10,Argentina,AR,ARG,44494502,America,403,9270,56
2020-05-22T00:00:00Z,22,5,2020,648,13,Argentina,AR,ARG,44494502,America,416,9918,57
2020-05-23T00:00:00Z,23,5,2020,718,17,Argentina,AR,ARG,44494502,America,433,10636,58
2020-05-24T00:00:00Z,24,5,2020,704,12,Argentina,AR,ARG,44494502,America,445,11340,59
2020-05-25T00:00:00Z,25,5,2020,723,7,Argentina,AR,ARG,44494502,America,452,12063,60
2020-05-26T00:00:00Z,26,5,2020,552,15,Argentina,AR,ARG,44494502,America,467,12615,61
2020-05-27T00:00:00Z,27,5,2020,600,17,Argentina,AR,ARG,44494502,America,484,13215,62
2020-04-10T00:00:00Z,10,4,2020,40,1,Armenia,AM,ARM,2951776,Europe,10,921,1
2020-04-11T00:00:00Z,11,4,2020,16,1,Armenia,AM,ARM,2951776,Europe,11,937,2
2020-04-12T00:00:00Z,12,4,2020,30,2,Armenia,AM,ARM,2951776,Europe,13,967,3
2020-04-13T00:00:00Z,13,4,2020,46,0,Armenia,AM,ARM,2951776,Europe,13,1013,4
2020-04-14T00:00:00Z,14,4,2020,26,1,Armenia,AM,ARM,2951776,Europe,14,1039,5
2020-04-15T00:00:00Z,15,4,2020,72,3,Armenia,AM,ARM,2951776,Europe,17,1111,6
2020-04-16T00:00:00Z,16,4,2020,48,1,Armenia,AM,ARM,2951776,Europe,18,1159,7
2020-04-17T00:00:00Z,17,4,2020,42,1,Armenia,AM,ARM,2951776,Europe,19,1201,8
2020-04-18T00:00:00Z,18,4,2020,47,1,Armenia,AM,ARM,2951776,Europe,20,1248,9
2020-04-19T00:00:00Z,19,4,2020,43,0,Armenia,AM,ARM,2951776,Europe,20,1291,10
2020-04-20T00:00:00Z,20,4,2020,48,2,Armenia,AM,ARM,2951776,Europe,22,1339,11
2020-04-21T00:00:00Z,21,4,2020,62,2,Armenia,AM,ARM,2951776,Europe,24,1401,12
2020-04-22T00:00:00Z,22,4,2020,72,0,Armenia,AM,ARM,2951776,Europe,24,1473,13
2020-04-23T00:00:00Z,23,4,2020,50,0,Armenia,AM,ARM,2951776,Europe,24,1523,14
2020-04-24T00:00:00Z,24,4,2020,73,3,Armenia,AM,ARM,2951776,Europe,27,1596,15
2020-04-25T00:00:00Z,25,4,2020,81,1,Armenia,AM,ARM,2951776,Europe,28,1677,16
2020-04-26T00:00:00Z,26,4,2020,69,0,Armenia,AM,ARM,2951776,Europe,28,1746,17
2020-04-27T00:00:00Z,27,4,2020,62,1,Armenia,AM,ARM,2951776,Europe,29,1808,18
2020-04-28T00:00:00Z,28,4,2020,59,1,Armenia,AM,ARM,2951776,Europe,30,1867,19
2020-04-29T00:00:00Z,29,4,2020,65,0,Armenia,AM,ARM,2951776,Europe,30,1932,20
2020-04-30T00:00:00Z,30,4,2020,0,0,Armenia,AM,ARM,2951776,Europe,30,1932,21
2020-05-01T00:00:00Z,1,5,2020,134,2,Armenia,AM,ARM,2951776,Europe,32,2066,22
2020-05-02T00:00:00Z,2,5,2020,82,1,Armenia,AM,ARM,2951776,Europe,33,2148,23
2020-05-03T00:00:00Z,3,5,2020,125,0,Armenia,AM,ARM,2951776,Europe,33,2273,24
2020-05-04T00:00:00Z,4,5,2020,113,2,Armenia,AM,ARM,2951776,Europe,35,2386,25
2020-05-05T00:00:00Z,5,5,2020,121,4,Armenia,AM,ARM,2951776,Europe,39,2507,26
2020-05-06T00:00:00Z,6,5,2020,112,1,Armenia,AM,ARM,2951776,Europe,40,2619,27
2020-05-07T00:00:00Z,7,5,2020,163,0,Armenia,AM,ARM,2951776,Europe,40,2782,28
2020-05-08T00:00:00Z,8,5,2020,102,2,Armenia,AM,ARM,2951776,Europe,42,2884,29
2020-05-09T00:00:00Z,9,5,2020,145,1,Armenia,AM,ARM,2951776,Europe,43,3029,30
2020-05-10T00:00:00Z,10,5,2020,146,1,Armenia,AM,ARM,2951776,Europe,44,3175,31
2020-05-11T00:00:00Z,11,5,2020,138,1,Armenia,AM,ARM,2951776,Europe,45,3313,32
2020-05-12T00:00:00Z,12,5,2020,79,1,Armenia,AM,ARM,2951776,Europe,46,3392,33
2020-05-13T00:00:00Z,13,5,2020,146,1,Armenia,AM,ARM,2951776,Europe,47,3538,34
2020-05-14T00:00:00Z,14,5,2020,180,1,Armenia,AM,ARM,2951776,Europe,48,3718,35
2020-05-15T00:00:00Z,15,5,2020,142,1,Armenia,AM,ARM,2951776,Europe,49,3860,36
2020-05-16T00:00:00Z,16,5,2020,184,3,Armenia,AM,ARM,2951776,Europe,52,4044,37
2020-05-17T00:00:00Z,17,5,2020,239,3,Armenia,AM,ARM,2951776,Europe,55,4283,38
2020-05-18T00:00:00Z,18,5,2020,189,5,Armenia,AM,ARM,2951776,Europe,60,4472,39
2020-05-19T00:00:00Z,19,5,2020,351,1,Armenia,AM,ARM,2951776,Europe,61,4823,40
2020-05-20T00:00:00Z,20,5,2020,218,3,Armenia,AM,ARM,2951776,Europe,64,5041,41
2020-05-21T00:00:00Z,21,5,2020,230,3,Armenia,AM,ARM,2951776,Europe,67,5271,42
2020-05-22T00:00:00Z,22,5,2020,335,3,Armenia,AM,ARM,2951776,Europe,70,5606,43
2020-05-23T00:00:00Z,23,5,2020,322,4,Armenia,AM,ARM,2951776,Europe,74,5928,44
2020-05-24T00:00:00Z,24,5,2020,374,3,Armenia,AM,ARM,2951776,Europe,77,6302,45
2020-05-25T00:00:00Z,25,5,2020,359,4,Armenia,AM,ARM,2951776,Europe,81,6661,46
2020-05-26T00:00:00Z,26,5,2020,452,6,Armenia,AM,ARM,2951776,Europe,87,7113,47
2020-05-27T00:00:00Z,27,5,2020,289,4,Armenia,AM,ARM,2951776,Europe,91,7402,48
2020-03-26T00:00:00Z,26,3,2020,376,3,Australia,AU,AUS,24992369,Oceania,11,2799,1
2020-03-27T00:00:00Z,27,3,2020,367,2,Australia,AU,AUS,24992369,Oceania,13,3166,2
2020-03-28T00:00:00Z,28,3,2020,212,0,Australia,AU,AUS,24992369,Oceania,13,3378,3
2020-03-29T00:00:00Z,29,3,2020,431,1,Australia,AU,AUS,24992369,Oceania,14,3809,4
2020-03-30T00:00:00Z,30,3,2020,284,2,Australia,AU,AUS,24992369,Oceania,16,4093,5
2020-03-31T00:00:00Z,31,3,2020,464,3,Australia,AU,AUS,24992369,Oceania,19,4557,6
2020-04-01T00:00:00Z,1,4,2020,150,1,Australia,AU,AUS,24992369,Oceania,20,4707,7
2020-04-02T00:00:00Z,2,4,2020,269,1,Australia,AU,AUS,24992369,Oceania,21,4976,8
2020-04-03T00:00:00Z,3,4,2020,248,2,Australia,AU,AUS,24992369,Oceania,23,5224,9
2020-04-04T00:00:00Z,4,4,2020,324,7,Australia,AU,AUS,24992369,Oceania,30,5548,10
2020-04-05T00:00:00Z,5,4,2020,139,4,Australia,AU,AUS,24992369,Oceania,34,5687,11
2020-04-06T00:00:00Z,6,4,2020,57,2,Australia,AU,AUS,24992369,Oceania,36,5744,12
2020-04-07T00:00:00Z,7,4,2020,100,6,Australia,AU,AUS,24992369,Oceania,42,5844,13
2020-04-08T00:00:00Z,8,4,2020,112,3,Australia,AU,AUS,24992369,Oceania,45,5956,14
2020-04-09T00:00:00Z,9,4,2020,96,5,Australia,AU,AUS,24992369,Oceania,50,6052,15
2020-04-10T00:00:00Z,10,4,2020,100,2,Australia,AU,AUS,24992369,Oceania,52,6152,16
2020-04-11T00:00:00Z,11,4,2020,86,2,Australia,AU,AUS,24992369,Oceania,54,6238,17
2020-04-12T00:00:00Z,12,4,2020,51,3,Australia,AU,AUS,24992369,Oceania,57,6289,18
2020-04-13T00:00:00Z,13,4,2020,33,4,Australia,AU,AUS,24992369,Oceania,61,6322,19
2020-04-14T00:00:00Z,14,4,2020,44,0,Australia,AU,AUS,24992369,Oceania,61,6366,20
2020-04-15T00:00:00Z,15,4,2020,50,0,Australia,AU,AUS,24992369,Oceania,61,6416,21
2020-04-16T00:00:00Z,16,4,2020,42,2,Australia,AU,AUS,24992369,Oceania,63,6458,22
2020-04-17T00:00:00Z,17,4,2020,39,0,Australia,AU,AUS,24992369,Oceania,63,6497,23
2020-04-18T00:00:00Z,18,4,2020,36,4,Australia,AU,AUS,24992369,Oceania,67,6533,24
2020-04-19T00:00:00Z,19,4,2020,53,2,Australia,AU,AUS,24992369,Oceania,69,6586,25
2020-04-20T00:00:00Z,20,4,2020,26,1,Australia,AU,AUS,24992369,Oceania,70,6612,26
2020-04-21T00:00:00Z,21,4,2020,13,1,Australia,AU,AUS,24992369,Oceania,71,6625,27
2020-04-22T00:00:00Z,22,4,2020,22,3,Australia,AU,AUS,24992369,Oceania,74,6647,28
2020-04-23T00:00:00Z,23,4,2020,7,0,Australia,AU,AUS,24992369,Oceania,74,6654,29
2020-04-24T00:00:00Z,24,4,2020,13,1,Australia,AU,AUS,24992369,Oceania,75,6667,30
2020-04-25T00:00:00Z,25,4,2020,20,4,Australia,AU,AUS,24992369,Oceania,79,6687,31
2020-04-26T00:00:00Z,26,4,2020,16,2,Australia,AU,AUS,24992369,Oceania,81,6703,32
2020-04-27T00:00:00Z,27,4,2020,10,2,Australia,AU,AUS,24992369,Oceania,83,6713,33
2020-04-28T00:00:00Z,28,4,2020,12,1,Australia,AU,AUS,24992369,Oceania,84,6725,34
2020-04-29T00:00:00Z,29,4,2020,13,4,Australia,AU,AUS,24992369,Oceania,88,6738,35
2020-04-30T00:00:00Z,30,4,2020,8,2,Australia,AU,AUS,24992369,Oceania,90,6746,36
2020-05-01T00:00:00Z,1,5,2020,16,2,Australia,AU,AUS,24992369,Oceania,92,6762,37
2020-05-02T00:00:00Z,2,5,2020,5,1,Australia,AU,AUS,24992369,Oceania,93,6767,38
2020-05-03T00:00:00Z,3,5,2020,16,0,Australia,AU,AUS,24992369,Oceania,93,6783,39
2020-05-04T00:00:00Z,4,5,2020,18,2,Australia,AU,AUS,24992369,Oceania,95,6801,40
2020-05-05T00:00:00Z,5,5,2020,24,0,Australia,AU,AUS,24992369,Oceania,95,6825,41
2020-05-06T00:00:00Z,6,5,2020,24,1,Australia,AU,AUS,24992369,Oceania,96,6849,42
2020-05-07T00:00:00Z,7,5,2020,26,1,Australia,AU,AUS,24992369,Oceania,97,6875,43
2020-05-08T00:00:00Z,8,5,2020,21,0,Australia,AU,AUS,24992369,Oceania,97,6896,44
2020-05-09T00:00:00Z,9,5,2020,18,0,Australia,AU,AUS,24992369,Oceania,97,6914,45
2020-05-10T00:00:00Z,10,5,2020,15,0,Australia,AU,AUS,24992369,Oceania,97,6929,46
2020-05-11T00:00:00Z,11,5,2020,12,0,Australia,AU,AUS,24992369,Oceania,97,6941,47
2020-05-12T00:00:00Z,12,5,2020,7,0,Australia,AU,AUS,24992369,Oceania,97,6948,48
2020-05-13T00:00:00Z,13,5,2020,16,0,Australia,AU,AUS,24992369,Oceania,97,6964,49
2020-05-14T00:00:00Z,14,5,2020,11,1,Australia,AU,AUS,24992369,Oceania,98,6975,50
2020-05-15T00:00:00Z,15,5,2020,14,0,Australia,AU,AUS,24992369,Oceania,98,6989,51
2020-05-16T00:00:00Z,16,5,2020,30,0,Australia,AU,AUS,24992369,Oceania,98,7019,52
2020-05-17T00:00:00Z,17,5,2020,17,0,Australia,AU,AUS,24992369,Oceania,98,7036,53
2020-05-18T00:00:00Z,18,5,2020,9,0,Australia,AU,AUS,24992369,Oceania,98,7045,54
2020-05-19T00:00:00Z,19,5,2020,15,1,Australia,AU,AUS,24992369,Oceania,99,7060,55
2020-05-20T00:00:00Z,20,5,2020,8,0,Australia,AU,AUS,24992369,Oceania,99,7068,56
2020-05-21T00:00:00Z,21,5,2020,11,1,Australia,AU,AUS,24992369,Oceania,100,7079,57
2020-05-22T00:00:00Z,22,5,2020,2,0,Australia,AU,AUS,24992369,Oceania,100,7081,58
2020-05-23T00:00:00Z,23,5,2020,14,1,Australia,AU,AUS,24992369,Oceania,101,7095,59
2020-05-24T00:00:00Z,24,5,2020,11,1,Australia,AU,AUS,24992369,Oceania,102,7106,60
2020-05-25T00:00:00Z,25,5,2020,3,0,Australia,AU,AUS,24992369,Oceania,102,7109,61
2020-05-26T00:00:00Z,26,5,2020,9,0,Australia,AU,AUS,24992369,Oceania,102,7118,62
2020-05-27T00:00:00Z,27,5,2020,15,0,Australia,AU,AUS,24992369,Oceania,102,7133,63
2020-03-23T00:00:00Z,23,3,2020,607,8,Austria,AT,AUT,8847037,Europe,16,3631,1
2020-03-24T00:00:00Z,24,3,2020,855,9,Austria,AT,AUT,8847037,Europe,25,4486,2
2020-03-25T00:00:00Z,25,3,2020,796,5,Austria,AT,AUT,8847037,Europe,30,5282,3
2020-03-26T00:00:00Z,26,3,2020,606,4,Austria,AT,AUT,8847037,Europe,34,5888,4
2020-03-27T00:00:00Z,27,3,2020,1141,18,Austria,AT,AUT,8847037,Europe,52,7029,5
2020-03-28T00:00:00Z,28,3,2020,668,16,Austria,AT,AUT,8847037,Europe,68,7697,6
2020-03-29T00:00:00Z,29,3,2020,594,0,Austria,AT,AUT,8847037,Europe,68,8291,7
2020-03-30T00:00:00Z,30,3,2020,522,18,Austria,AT,AUT,8847037,Europe,86,8813,8
2020-03-31T00:00:00Z,31,3,2020,805,22,Austria,AT,AUT,8847037,Europe,108,9618,9
2020-04-01T00:00:00Z,1,4,2020,564,20,Austria,AT,AUT,8847037,Europe,128,10182,10
2020-04-02T00:00:00Z,2,4,2020,529,18,Austria,AT,AUT,8847037,Europe,146,10711,11
2020-04-03T00:00:00Z,3,4,2020,418,12,Austria,AT,AUT,8847037,Europe,158,11129,12
2020-04-04T00:00:00Z,4,4,2020,396,10,Austria,AT,AUT,8847037,Europe,168,11525,13
2020-04-05T00:00:00Z,5,4,2020,241,18,Austria,AT,AUT,8847037,Europe,186,11766,14
2020-04-06T00:00:00Z,6,4,2020,217,18,Austria,AT,AUT,8847037,Europe,204,11983,15
2020-04-07T00:00:00Z,7,4,2020,314,16,Austria,AT,AUT,8847037,Europe,220,12297,16
2020-04-08T00:00:00Z,8,4,2020,343,23,Austria,AT,AUT,8847037,Europe,243,12640,17
2020-04-09T00:00:00Z,9,4,2020,329,30,Austria,AT,AUT,8847037,Europe,273,12969,18
2020-04-10T00:00:00Z,10,4,2020,279,22,Austria,AT,AUT,8847037,Europe,295,13248,19
2020-04-11T00:00:00Z,11,4,2020,312,24,Austria,AT,AUT,8847037,Europe,319,13560,20
2020-04-12T00:00:00Z,12,4,2020,247,18,Austria,AT,AUT,8847037,Europe,337,13807,21
2020-04-13T00:00:00Z,13,4,2020,130,13,Austria,AT,AUT,8847037,Europe,350,13937,22
2020-04-14T00:00:00Z,14,4,2020,106,18,Austria,AT,AUT,8847037,Europe,368,14043,23
2020-04-15T00:00:00Z,15,4,2020,191,16,Austria,AT,AUT,8847037,Europe,384,14234,24
2020-04-16T00:00:00Z,16,4,2020,136,9,Austria,AT,AUT,8847037,Europe,393,14370,25
2020-04-17T00:00:00Z,17,4,2020,78,17,Austria,AT,AUT,8847037,Europe,410,14448,26
2020-04-18T00:00:00Z,18,4,2020,155,21,Austria,AT,AUT,8847037,Europe,431,14603,27
2020-04-19T00:00:00Z,19,4,2020,59,12,Austria,AT,AUT,8847037,Europe,443,14662,28
2020-04-20T00:00:00Z,20,4,2020,48,9,Austria,AT,AUT,8847037,Europe,452,14710,29
2020-04-21T00:00:00Z,21,4,2020,73,10,Austria,AT,AUT,8847037,Europe,462,14783,30
2020-04-22T00:00:00Z,22,4,2020,50,1,Austria,AT,AUT,8847037,Europe,463,14833,31
2020-04-23T00:00:00Z,23,4,2020,91,31,Austria,AT,AUT,8847037,Europe,494,14924,32
2020-04-24T00:00:00Z,24,4,2020,61,14,Austria,AT,AUT,8847037,Europe,508,14985,33
2020-04-25T00:00:00Z,25,4,2020,83,5,Austria,AT,AUT,8847037,Europe,513,15068,34
2020-04-26T00:00:00Z,26,4,2020,66,23,Austria,AT,AUT,8847037,Europe,536,15134,35
2020-04-27T00:00:00Z,27,4,2020,55,6,Austria,AT,AUT,8847037,Europe,542,15189,36
2020-04-28T00:00:00Z,28,4,2020,67,7,Austria,AT,AUT,8847037,Europe,549,15256,37
2020-04-29T00:00:00Z,29,4,2020,58,20,Austria,AT,AUT,8847037,Europe,569,15314,38
2020-04-30T00:00:00Z,30,4,2020,50,11,Austria,AT,AUT,8847037,Europe,580,15364,39
2020-05-01T00:00:00Z,1,5,2020,60,4,Austria,AT,AUT,8847037,Europe,584,15424,40
2020-05-02T00:00:00Z,2,5,2020,34,5,Austria,AT,AUT,8847037,Europe,589,15458,41
2020-05-03T00:00:00Z,3,5,2020,12,7,Austria,AT,AUT,8847037,Europe,596,15470,42
2020-05-04T00:00:00Z,4,5,2020,68,2,Austria,AT,AUT,8847037,Europe,598,15538,43
2020-05-05T00:00:00Z,5,5,2020,31,2,Austria,AT,AUT,8847037,Europe,600,15569,44
2020-05-06T00:00:00Z,6,5,2020,17,6,Austria,AT,AUT,8847037,Europe,606,15586,45
2020-05-07T00:00:00Z,7,5,2020,65,2,Austria,AT,AUT,8847037,Europe,608,15651,46
2020-05-08T00:00:00Z,8,5,2020,22,1,Austria,AT,AUT,8847037,Europe,609,15673,47
2020-05-09T00:00:00Z,9,5,2020,62,5,Austria,AT,AUT,8847037,Europe,614,15735,48
2020-05-10T00:00:00Z,10,5,2020,42,1,Austria,AT,AUT,8847037,Europe,615,15777,49
2020-05-11T00:00:00Z,11,5,2020,10,3,Austria,AT,AUT,8847037,Europe,618,15787,50
2020-05-12T00:00:00Z,12,5,2020,87,2,Austria,AT,AUT,8847037,Europe,620,15874,51
2020-05-13T00:00:00Z,13,5,2020,36,3,Austria,AT,AUT,8847037,Europe,623,15910,52
2020-05-14T00:00:00Z,14,5,2020,54,1,Austria,AT,AUT,8847037,Europe,624,15964,53
2020-05-15T00:00:00Z,15,5,2020,41,2,Austria,AT,AUT,8847037,Europe,626,16005,54
2020-05-16T00:00:00Z,16,5,2020,63,2,Austria,AT,AUT,8847037,Europe,628,16068,55
2020-05-17T00:00:00Z,17,5,2020,72,0,Austria,AT,AUT,8847037,Europe,628,16140,56
2020-05-18T00:00:00Z,18,5,2020,14,1,Austria,AT,AUT,8847037,Europe,629,16154,57
2020-05-19T00:00:00Z,19,5,2020,25,0,Austria,AT,AUT,8847037,Europe,629,16179,58
2020-05-20T00:00:00Z,20,5,2020,78,3,Austria,AT,AUT,8847037,Europe,632,16257,59
2020-05-21T00:00:00Z,21,5,2020,18,1,Austria,AT,AUT,8847037,Europe,633,16275,60
2020-05-22T00:00:00Z,22,5,2020,57,0,Austria,AT,AUT,8847037,Europe,633,16332,61
2020-05-23T00:00:00Z,23,5,2020,29,2,Austria,AT,AUT,8847037,Europe,635,16361,62
2020-05-24T00:00:00Z,24,5,2020,46,4,Austria,AT,AUT,8847037,Europe,639,16407,63
2020-05-25T00:00:00Z,25,5,2020,32,1,Austria,AT,AUT,8847037,Europe,640,16439,64
2020-05-26T00:00:00Z,26,5,2020,20,1,Austria,AT,AUT,8847037,Europe,641,16459,65
2020-05-27T00:00:00Z,27,5,2020,38,2,Austria,AT,AUT,8847037,Europe,643,16497,66
2020-04-11T00:00:00Z,11,4,2020,65,1,Azerbaijan,AZ,AZE,9942334,Europe,10,991,1
2020-04-12T00:00:00Z,12,4,2020,67,1,Azerbaijan,AZ,AZE,9942334,Europe,11,1058,2
2020-04-13T00:00:00Z,13,4,2020,40,0,Azerbaijan,AZ,AZE,9942334,Europe,11,1098,3
2020-04-14T00:00:00Z,14,4,2020,50,1,Azerbaijan,AZ,AZE,9942334,Europe,12,1148,4
2020-04-15T00:00:00Z,15,4,2020,49,1,Azerbaijan,AZ,AZE,9942334,Europe,13,1197,5
2020-04-16T00:00:00Z,16,4,2020,56,0,Azerbaijan,AZ,AZE,9942334,Europe,13,1253,6
2020-04-17T00:00:00Z,17,4,2020,30,2,Azerbaijan,AZ,AZE,9942334,Europe,15,1283,7
2020-04-18T00:00:00Z,18,4,2020,57,0,Azerbaijan,AZ,AZE,9942334,Europe,15,1340,8
2020-04-19T00:00:00Z,19,4,2020,33,3,Azerbaijan,AZ,AZE,9942334,Europe,18,1373,9
2020-04-20T00:00:00Z,20,4,2020,25,1,Azerbaijan,AZ,AZE,9942334,Europe,19,1398,10
2020-04-21T00:00:00Z,21,4,2020,38,0,Azerbaijan,AZ,AZE,9942334,Europe,19,1436,11
2020-04-22T00:00:00Z,22,4,2020,44,1,Azerbaijan,AZ,AZE,9942334,Europe,20,1480,12
2020-04-23T00:00:00Z,23,4,2020,38,0,Azerbaijan,AZ,AZE,9942334,Europe,20,1518,13
2020-04-24T00:00:00Z,24,4,2020,30,0,Azerbaijan,AZ,AZE,9942334,Europe,20,1548,14
2020-04-25T00:00:00Z,25,4,2020,44,1,Azerbaijan,AZ,AZE,9942334,Europe,21,1592,15
2020-04-26T00:00:00Z,26,4,2020,25,0,Azerbaijan,AZ,AZE,9942334,Europe,21,1617,16
2020-04-27T00:00:00Z,27,4,2020,28,0,Azerbaijan,AZ,AZE,9942334,Europe,21,1645,17
2020-04-28T00:00:00Z,28,4,2020,33,1,Azerbaijan,AZ,AZE,9942334,Europe,22,1678,18
2020-04-29T00:00:00Z,29,4,2020,39,0,Azerbaijan,AZ,AZE,9942334,Europe,22,1717,19
2020-04-30T00:00:00Z,30,4,2020,49,1,Azerbaijan,AZ,AZE,9942334,Europe,23,1766,20
2020-05-01T00:00:00Z,1,5,2020,38,1,Azerbaijan,AZ,AZE,9942334,Europe,24,1804,21
2020-05-02T00:00:00Z,2,5,2020,50,1,Azerbaijan,AZ,AZE,9942334,Europe,25,1854,22
2020-05-03T00:00:00Z,3,5,2020,40,0,Azerbaijan,AZ,AZE,9942334,Europe,25,1894,23
2020-05-04T00:00:00Z,4,5,2020,38,0,Azerbaijan,AZ,AZE,9942334,Europe,25,1932,24
2020-05-05T00:00:00Z,5,5,2020,52,1,Azerbaijan,AZ,AZE,9942334,Europe,26,1984,25
2020-05-06T00:00:00Z,6,5,2020,76,0,Azerbaijan,AZ,AZE,9942334,Europe,26,2060,26
2020-05-07T00:00:00Z,7,5,2020,67,2,Azerbaijan,AZ,AZE,9942334,Europe,28,2127,27
2020-05-08T00:00:00Z,8,5,2020,77,0,Azerbaijan,AZ,AZE,9942334,Europe,28,2204,28
2020-05-09T00:00:00Z,9,5,2020,75,0,Azerbaijan,AZ,AZE,9942334,Europe,28,2279,29
2020-05-10T00:00:00Z,10,5,2020,143,3,Azerbaijan,AZ,AZE,9942334,Europe,31,2422,30
2020-05-11T00:00:00Z,11,5,2020,97,1,Azerbaijan,AZ,AZE,9942334,Europe,32,2519,31
2020-05-12T00:00:00Z,12,5,2020,70,0,Azerbaijan,AZ,AZE,9942334,Europe,32,2589,32
2020-05-13T00:00:00Z,13,5,2020,104,1,Azerbaijan,AZ,AZE,9942334,Europe,33,2693,33
2020-05-14T00:00:00Z,14,5,2020,65,2,Azerbaijan,AZ,AZE,9942334,Europe,35,2758,34
2020-05-15T00:00:00Z,15,5,2020,121,0,Azerbaijan,AZ,AZE,9942334,Europe,35,2879,35
2020-05-16T00:00:00Z,16,5,2020,101,1,Azerbaijan,AZ,AZE,9942334,Europe,36,2980,36
2020-05-17T00:00:00Z,17,5,2020,158,0,Azerbaijan,AZ,AZE,9942334,Europe,36,3138,37
2020-05-18T00:00:00Z,18,5,2020,136,3,Azerbaijan,AZ,AZE,9942334,Europe,39,3274,38
2020-05-19T00:00:00Z,19,5,2020,13,1,Azerbaijan,AZ,AZE,9942334,Europe,40,3287,39
2020-05-20T00:00:00Z,20,5,2020,231,1,Azerbaijan,AZ,AZE,9942334,Europe,41,3518,40
2020-05-21T00:00:00Z,21,5,2020,113,2,Azerbaijan,AZ,AZE,9942334,Europe,43,3631,41
2020-05-22T00:00:00Z,22,5,2020,118,1,Azerbaijan,AZ,AZE,9942334,Europe,44,3749,42
2020-05-23T00:00:00Z,23,5,2020,106,2,Azerbaijan,AZ,AZE,9942334,Europe,46,3855,43
2020-05-24T00:00:00Z,24,5,2020,127,3,Azerbaijan,AZ,AZE,9942334,Europe,49,3982,44
2020-05-25T00:00:00Z,25,5,2020,140,0,Azerbaijan,AZ,AZE,9942334,Europe,49,4122,45
2020-05-26T00:00:00Z,26,5,2020,149,2,Azerbaijan,AZ,AZE,9942334,Europe,51,4271,46
2020-05-27T00:00:00Z,27,5,2020,132,1,Azerbaijan,AZ,AZE,9942334,Europe,52,4403,47
2020-04-24T00:00:00Z,24,4,2020,2,2,Bahamas,BS,BHS,385640,America,11,72,1
2020-04-25T00:00:00Z,25,4,2020,1,0,Bahamas,BS,BHS,385640,America,11,73,2
2020-04-26T00:00:00Z,26,4,2020,5,0,Bahamas,BS,BHS,385640,America,11,78,3
2020-04-27T00:00:00Z,27,4,2020,2,0,Bahamas,BS,BHS,385640,America,11,80,4
2020-04-28T00:00:00Z,28,4,2020,0,0,Bahamas,BS,BHS,385640,America,11,80,5
2020-04-29T00:00:00Z,29,4,2020,0,0,Bahamas,BS,BHS,385640,America,11,80,6
2020-04-30T00:00:00Z,30,4,2020,0,0,Bahamas,BS,BHS,385640,America,11,80,7
2020-05-01T00:00:00Z,1,5,2020,1,0,Bahamas,BS,BHS,385640,America,11,81,8
2020-05-02T00:00:00Z,2,5,2020,1,0,Bahamas,BS,BHS,385640,America,11,82,9
2020-05-03T00:00:00Z,3,5,2020,1,0,Bahamas,BS,BHS,385640,America,11,83,10
2020-05-04T00:00:00Z,4,5,2020,0,0,Bahamas,BS,BHS,385640,America,11,83,11
2020-05-05T00:00:00Z,5,5,2020,0,0,Bahamas,BS,BHS,385640,America,11,83,12
2020-05-06T00:00:00Z,6,5,2020,6,0,Bahamas,BS,BHS,385640,America,11,89,13
2020-05-07T00:00:00Z,7,5,2020,3,0,Bahamas,BS,BHS,385640,America,11,92,14
2020-05-08T00:00:00Z,8,5,2020,0,0,Bahamas,BS,BHS,385640,America,11,92,15
2020-05-09T00:00:00Z,9,5,2020,0,0,Bahamas,BS,BHS,385640,America,11,92,16
2020-05-10T00:00:00Z,10,5,2020,0,0,Bahamas,BS,BHS,385640,America,11,92,17
2020-05-11T00:00:00Z,11,5,2020,0,0,Bahamas,BS,BHS,385640,America,11,92,18
2020-05-12T00:00:00Z,12,5,2020,1,0,Bahamas,BS,BHS,385640,America,11,93,19
2020-05-13T00:00:00Z,13,5,2020,0,0,Bahamas,BS,BHS,385640,America,11,93,20
2020-05-14T00:00:00Z,14,5,2020,1,0,Bahamas,BS,BHS,385640,America,11,94,21
2020-05-15T00:00:00Z,15,5,2020,2,0,Bahamas,BS,BHS,385640,America,11,96,22
2020-05-16T00:00:00Z,16,5,2020,0,0,Bahamas,BS,BHS,385640,America,11,96,23
2020-05-17T00:00:00Z,17,5,2020,0,0,Bahamas,BS,BHS,385640,America,11,96,24
2020-05-18T00:00:00Z,18,5,2020,0,0,Bahamas,BS,BHS,385640,America,11,96,25
2020-05-19T00:00:00Z,19,5,2020,0,0,Bahamas,BS,BHS,385640,America,11,96,26
2020-05-20T00:00:00Z,20,5,2020,0,0,Bahamas,BS,BHS,385640,America,11,96,27
2020-05-21T00:00:00Z,21,5,2020,1,0,Bahamas,BS,BHS,385640,America,11,97,28
2020-05-22T00:00:00Z,22,5,2020,0,0,Bahamas,BS,BHS,385640,America,11,97,29
2020-05-23T00:00:00Z,23,5,2020,0,0,Bahamas,BS,BHS,385640,America,11,97,30
2020-05-24T00:00:00Z,24,5,2020,3,0,Bahamas,BS,BHS,385640,America,11,100,31
2020-05-25T00:00:00Z,25,5,2020,0,0,Bahamas,BS,BHS,385640,America,11,100,32
2020-05-26T00:00:00Z,26,5,2020,0,0,Bahamas,BS,BHS,385640,America,11,100,33
2020-05-27T00:00:00Z,27,5,2020,0,0,Bahamas,BS,BHS,385640,America,11,100,34
2020-05-14T00:00:00Z,14,5,2020,285,1,Bahrain,BH,BHR,1569439,Asia,10,5816,1
2020-05-15T00:00:00Z,15,5,2020,382,0,Bahrain,BH,BHR,1569439,Asia,10,6198,2
2020-05-16T00:00:00Z,16,5,2020,385,2,Bahrain,BH,BHR,1569439,Asia,12,6583,3
2020-05-17T00:00:00Z,17,5,2020,164,0,Bahrain,BH,BHR,1569439,Asia,12,6747,4
2020-05-18T00:00:00Z,18,5,2020,209,0,Bahrain,BH,BHR,1569439,Asia,12,6956,5
2020-05-19T00:00:00Z,19,5,2020,228,0,Bahrain,BH,BHR,1569439,Asia,12,7184,6
2020-05-20T00:00:00Z,20,5,2020,348,0,Bahrain,BH,BHR,1569439,Asia,12,7532,7
2020-05-21T00:00:00Z,21,5,2020,356,0,Bahrain,BH,BHR,1569439,Asia,12,7888,8
2020-05-22T00:00:00Z,22,5,2020,286,0,Bahrain,BH,BHR,1569439,Asia,12,8174,9
2020-05-23T00:00:00Z,23,5,2020,240,0,Bahrain,BH,BHR,1569439,Asia,12,8414,10
2020-05-24T00:00:00Z,24,5,2020,388,1,Bahrain,BH,BHR,1569439,Asia,13,8802,11
2020-05-25T00:00:00Z,25,5,2020,336,1,Bahrain,BH,BHR,1569439,Asia,14,9138,12
2020-05-26T00:00:00Z,26,5,2020,33,0,Bahrain,BH,BHR,1569439,Asia,14,9171,13
2020-05-27T00:00:00Z,27,5,2020,195,0,Bahrain,BH,BHR,1569439,Asia,14,9366,14
2020-04-07T00:00:00Z,7,4,2020,35,3,Bangladesh,BD,BGD,161356039,Asia,12,123,1
2020-04-08T00:00:00Z,8,4,2020,41,5,Bangladesh,BD,BGD,161356039,Asia,17,164,2
2020-04-09T00:00:00Z,9,4,2020,54,3,Bangladesh,BD,BGD,161356039,Asia,20,218,3
2020-04-10T00:00:00Z,10,4,2020,112,1,Bangladesh,BD,BGD,161356039,Asia,21,330,4
2020-04-11T00:00:00Z,11,4,2020,94,6,Bangladesh,BD,BGD,161356039,Asia,27,424,5
2020-04-12T00:00:00Z,12,4,2020,58,3,Bangladesh,BD,BGD,161356039,Asia,30,482,6
2020-04-13T00:00:00Z,13,4,2020,139,4,Bangladesh,BD,BGD,161356039,Asia,34,621,7
2020-04-14T00:00:00Z,14,4,2020,182,5,Bangladesh,BD,BGD,161356039,Asia,39,803,8
2020-04-15T00:00:00Z,15,4,2020,209,7,Bangladesh,BD,BGD,161356039,Asia,46,1012,9
2020-04-16T00:00:00Z,16,4,2020,219,4,Bangladesh,BD,BGD,161356039,Asia,50,1231,10
2020-04-17T00:00:00Z,17,4,2020,341,10,Bangladesh,BD,BGD,161356039,Asia,60,1572,11
2020-04-18T00:00:00Z,18,4,2020,266,15,Bangladesh,BD,BGD,161356039,Asia,75,1838,12
2020-04-19T00:00:00Z,19,4,2020,306,9,Bangladesh,BD,BGD,161356039,Asia,84,2144,13
2020-04-20T00:00:00Z,20,4,2020,312,7,Bangladesh,BD,BGD,161356039,Asia,91,2456,14
2020-04-21T00:00:00Z,21,4,2020,492,10,Bangladesh,BD,BGD,161356039,Asia,101,2948,15
2020-04-22T00:00:00Z,22,4,2020,434,9,Bangladesh,BD,BGD,161356039,Asia,110,3382,16
2020-04-23T00:00:00Z,23,4,2020,390,10,Bangladesh,BD,BGD,161356039,Asia,120,3772,17
2020-04-24T00:00:00Z,24,4,2020,414,7,Bangladesh,BD,BGD,161356039,Asia,127,4186,18
2020-04-25T00:00:00Z,25,4,2020,503,4,Bangladesh,BD,BGD,161356039,Asia,131,4689,19
2020-04-26T00:00:00Z,26,4,2020,309,9,Bangladesh,BD,BGD,161356039,Asia,140,4998,20
2020-04-27T00:00:00Z,27,4,2020,418,5,Bangladesh,BD,BGD,161356039,Asia,145,5416,21
2020-04-28T00:00:00Z,28,4,2020,497,7,Bangladesh,BD,BGD,161356039,Asia,152,5913,22
2020-04-29T00:00:00Z,29,4,2020,549,3,Bangladesh,BD,BGD,161356039,Asia,155,6462,23
2020-04-30T00:00:00Z,30,4,2020,641,8,Bangladesh,BD,BGD,161356039,Asia,163,7103,24
2020-05-01T00:00:00Z,1,5,2020,564,5,Bangladesh,BD,BGD,161356039,Asia,168,7667,25
2020-05-02T00:00:00Z,2,5,2020,571,2,Bangladesh,BD,BGD,161356039,Asia,170,8238,26
2020-05-03T00:00:00Z,3,5,2020,552,5,Bangladesh,BD,BGD,161356039,Asia,175,8790,27
2020-05-04T00:00:00Z,4,5,2020,665,2,Bangladesh,BD,BGD,161356039,Asia,177,9455,28
2020-05-05T00:00:00Z,5,5,2020,688,5,Bangladesh,BD,BGD,161356039,Asia,182,10143,29
2020-05-06T00:00:00Z,6,5,2020,786,1,Bangladesh,BD,BGD,161356039,Asia,183,10929,30
2020-05-07T00:00:00Z,7,5,2020,790,3,Bangladesh,BD,BGD,161356039,Asia,186,11719,31
2020-05-08T00:00:00Z,8,5,2020,706,13,Bangladesh,BD,BGD,161356039,Asia,199,12425,32
2020-05-09T00:00:00Z,9,5,2020,709,7,Bangladesh,BD,BGD,161356039,Asia,206,13134,33
2020-05-10T00:00:00Z,10,5,2020,636,8,Bangladesh,BD,BGD,161356039,Asia,214,13770,34
2020-05-11T00:00:00Z,11,5,2020,887,14,Bangladesh,BD,BGD,161356039,Asia,228,14657,35
2020-05-12T00:00:00Z,12,5,2020,1034,11,Bangladesh,BD,BGD,161356039,Asia,239,15691,36
2020-05-13T00:00:00Z,13,5,2020,969,11,Bangladesh,BD,BGD,161356039,Asia,250,16660,37
2020-05-14T00:00:00Z,14,5,2020,1162,19,Bangladesh,BD,BGD,161356039,Asia,269,17822,38
2020-05-15T00:00:00Z,15,5,2020,1041,14,Bangladesh,BD,BGD,161356039,Asia,283,18863,39
2020-05-16T00:00:00Z,16,5,2020,1202,15,Bangladesh,BD,BGD,161356039,Asia,298,20065,40
2020-05-17T00:00:00Z,17,5,2020,930,16,Bangladesh,BD,BGD,161356039,Asia,314,20995,41
2020-05-18T00:00:00Z,18,5,2020,1273,14,Bangladesh,BD,BGD,161356039,Asia,328,22268,42
2020-05-19T00:00:00Z,19,5,2020,1602,21,Bangladesh,BD,BGD,161356039,Asia,349,23870,43
2020-05-20T00:00:00Z,20,5,2020,1251,21,Bangladesh,BD,BGD,161356039,Asia,370,25121,44
2020-05-21T00:00:00Z,21,5,2020,1617,16,Bangladesh,BD,BGD,161356039,Asia,386,26738,45
2020-05-22T00:00:00Z,22,5,2020,1773,22,Bangladesh,BD,BGD,161356039,Asia,408,28511,46
2020-05-23T00:00:00Z,23,5,2020,1694,24,Bangladesh,BD,BGD,161356039,Asia,432,30205,47
2020-05-24T00:00:00Z,24,5,2020,1873,20,Bangladesh,BD,BGD,161356039,Asia,452,32078,48
2020-05-25T00:00:00Z,25,5,2020,1532,28,Bangladesh,BD,BGD,161356039,Asia,480,33610,49
2020-05-26T00:00:00Z,26,5,2020,1975,21,Bangladesh,BD,BGD,161356039,Asia,501,35585,50
2020-05-27T00:00:00Z,27,5,2020,1166,21,Bangladesh,BD,BGD,161356039,Asia,522,36751,51
2020-04-07T00:00:00Z,7,4,2020,136,5,Belarus,BY,BLR,9485386,Europe,13,700,1
2020-04-08T00:00:00Z,8,4,2020,161,0,Belarus,BY,BLR,9485386,Europe,13,861,2
2020-04-09T00:00:00Z,9,4,2020,205,0,Belarus,BY,BLR,9485386,Europe,13,1066,3
2020-04-10T00:00:00Z,10,4,2020,420,3,Belarus,BY,BLR,9485386,Europe,16,1486,4
2020-04-11T00:00:00Z,11,4,2020,495,3,Belarus,BY,BLR,9485386,Europe,19,1981,5
2020-04-12T00:00:00Z,12,4,2020,245,4,Belarus,BY,BLR,9485386,Europe,23,2226,6
2020-04-13T00:00:00Z,13,4,2020,352,3,Belarus,BY,BLR,9485386,Europe,26,2578,7
2020-04-14T00:00:00Z,14,4,2020,341,3,Belarus,BY,BLR,9485386,Europe,29,2919,8
2020-04-15T00:00:00Z,15,4,2020,362,4,Belarus,BY,BLR,9485386,Europe,33,3281,9
2020-04-16T00:00:00Z,16,4,2020,447,3,Belarus,BY,BLR,9485386,Europe,36,3728,10
2020-04-17T00:00:00Z,17,4,2020,476,4,Belarus,BY,BLR,9485386,Europe,40,4204,11
2020-04-18T00:00:00Z,18,4,2020,575,2,Belarus,BY,BLR,9485386,Europe,42,4779,12
2020-04-19T00:00:00Z,19,4,2020,0,3,Belarus,BY,BLR,9485386,Europe,45,4779,13
2020-04-20T00:00:00Z,20,4,2020,0,2,Belarus,BY,BLR,9485386,Europe,47,4779,14
2020-04-21T00:00:00Z,21,4,2020,1485,4,Belarus,BY,BLR,9485386,Europe,51,6264,15
2020-04-22T00:00:00Z,22,4,2020,459,4,Belarus,BY,BLR,9485386,Europe,55,6723,16
2020-04-23T00:00:00Z,23,4,2020,558,3,Belarus,BY,BLR,9485386,Europe,58,7281,17
2020-04-24T00:00:00Z,24,4,2020,741,2,Belarus,BY,BLR,9485386,Europe,60,8022,18
2020-04-25T00:00:00Z,25,4,2020,751,3,Belarus,BY,BLR,9485386,Europe,63,8773,19
2020-04-26T00:00:00Z,26,4,2020,817,4,Belarus,BY,BLR,9485386,Europe,67,9590,20
2020-04-27T00:00:00Z,27,4,2020,873,5,Belarus,BY,BLR,9485386,Europe,72,10463,21
2020-04-28T00:00:00Z,28,4,2020,826,3,Belarus,BY,BLR,9485386,Europe,75,11289,22
2020-04-29T00:00:00Z,29,4,2020,919,4,Belarus,BY,BLR,9485386,Europe,79,12208,23
2020-04-30T00:00:00Z,30,4,2020,973,5,Belarus,BY,BLR,9485386,Europe,84,13181,24
2020-05-01T00:00:00Z,1,5,2020,846,5,Belarus,BY,BLR,9485386,Europe,89,14027,25
2020-05-02T00:00:00Z,2,5,2020,890,4,Belarus,BY,BLR,9485386,Europe,93,14917,26
2020-05-03T00:00:00Z,3,5,2020,911,4,Belarus,BY,BLR,9485386,Europe,97,15828,27
2020-05-04T00:00:00Z,4,5,2020,877,2,Belarus,BY,BLR,9485386,Europe,99,16705,28
2020-05-05T00:00:00Z,5,5,2020,784,4,Belarus,BY,BLR,9485386,Europe,103,17489,29
2020-05-06T00:00:00Z,6,5,2020,861,4,Belarus,BY,BLR,9485386,Europe,107,18350,30
2020-05-07T00:00:00Z,7,5,2020,905,5,Belarus,BY,BLR,9485386,Europe,112,19255,31
2020-05-08T00:00:00Z,8,5,2020,913,4,Belarus,BY,BLR,9485386,Europe,116,20168,32
2020-05-09T00:00:00Z,9,5,2020,933,5,Belarus,BY,BLR,9485386,Europe,121,21101,33
2020-05-10T00:00:00Z,10,5,2020,951,5,Belarus,BY,BLR,9485386,Europe,126,22052,34
2020-05-11T00:00:00Z,11,5,2020,921,5,Belarus,BY,BLR,9485386,Europe,131,22973,35
2020-05-12T00:00:00Z,12,5,2020,933,4,Belarus,BY,BLR,9485386,Europe,135,23906,36
2020-05-13T00:00:00Z,13,5,2020,967,7,Belarus,BY,BLR,9485386,Europe,142,24873,37
2020-05-14T00:00:00Z,14,5,2020,952,4,Belarus,BY,BLR,9485386,Europe,146,25825,38
2020-05-15T00:00:00Z,15,5,2020,947,5,Belarus,BY,BLR,9485386,Europe,151,26772,39
2020-05-16T00:00:00Z,16,5,2020,958,5,Belarus,BY,BLR,9485386,Europe,156,27730,40
2020-05-17T00:00:00Z,17,5,2020,951,4,Belarus,BY,BLR,9485386,Europe,160,28681,41
2020-05-18T00:00:00Z,18,5,2020,969,5,Belarus,BY,BLR,9485386,Europe,165,29650,42
2020-05-19T00:00:00Z,19,5,2020,922,6,Belarus,BY,BLR,9485386,Europe,171,30572,43
2020-05-20T00:00:00Z,20,5,2020,936,4,Belarus,BY,BLR,9485386,Europe,175,31508,44
2020-05-21T00:00:00Z,21,5,2020,918,4,Belarus,BY,BLR,9485386,Europe,179,32426,45
2020-05-22T00:00:00Z,22,5,2020,945,6,Belarus,BY,BLR,9485386,Europe,185,33371,46
2020-05-23T00:00:00Z,23,5,2020,932,5,Belarus,BY,BLR,9485386,Europe,190,34303,47
2020-05-24T00:00:00Z,24,5,2020,941,4,Belarus,BY,BLR,9485386,Europe,194,35244,48
2020-05-25T00:00:00Z,25,5,2020,954,5,Belarus,BY,BLR,9485386,Europe,199,36198,49
2020-05-26T00:00:00Z,26,5,2020,946,5,Belarus,BY,BLR,9485386,Europe,204,37144,50
2020-05-27T00:00:00Z,27,5,2020,915,4,Belarus,BY,BLR,9485386,Europe,208,38059,51
2020-03-19T00:00:00Z,19,3,2020,243,9,Belgium,BE,BEL,11422068,Europe,14,1486,1
2020-03-20T00:00:00Z,20,3,2020,309,7,Belgium,BE,BEL,11422068,Europe,21,1795,2
2020-03-21T00:00:00Z,21,3,2020,462,16,Belgium,BE,BEL,11422068,Europe,37,2257,3
2020-03-22T00:00:00Z,22,3,2020,558,30,Belgium,BE,BEL,11422068,Europe,67,2815,4
2020-03-23T00:00:00Z,23,3,2020,586,8,Belgium,BE,BEL,11422068,Europe,75,3401,5
2020-03-24T00:00:00Z,24,3,2020,342,13,Belgium,BE,BEL,11422068,Europe,88,3743,6
2020-03-25T00:00:00Z,25,3,2020,526,34,Belgium,BE,BEL,11422068,Europe,122,4269,7
2020-03-26T00:00:00Z,26,3,2020,668,56,Belgium,BE,BEL,11422068,Europe,178,4937,8
2020-03-27T00:00:00Z,27,3,2020,1298,42,Belgium,BE,BEL,11422068,Europe,220,6235,9
2020-03-28T00:00:00Z,28,3,2020,1049,69,Belgium,BE,BEL,11422068,Europe,289,7284,10
2020-03-29T00:00:00Z,29,3,2020,1850,64,Belgium,BE,BEL,11422068,Europe,353,9134,11
2020-03-30T00:00:00Z,30,3,2020,1702,78,Belgium,BE,BEL,11422068,Europe,431,10836,12
2020-03-31T00:00:00Z,31,3,2020,1063,82,Belgium,BE,BEL,11422068,Europe,513,11899,13
2020-04-01T00:00:00Z,1,4,2020,876,192,Belgium,BE,BEL,11422068,Europe,705,12775,14
2020-04-02T00:00:00Z,2,4,2020,1189,123,Belgium,BE,BEL,11422068,Europe,828,13964,15
2020-04-03T00:00:00Z,3,4,2020,1384,183,Belgium,BE,BEL,11422068,Europe,1011,15348,16
2020-04-04T00:00:00Z,4,4,2020,1422,132,Belgium,BE,BEL,11422068,Europe,1143,16770,17
2020-04-05T00:00:00Z,5,4,2020,1661,140,Belgium,BE,BEL,11422068,Europe,1283,18431,18
2020-04-06T00:00:00Z,6,4,2020,1260,164,Belgium,BE,BEL,11422068,Europe,1447,19691,19
2020-04-07T00:00:00Z,7,4,2020,1123,185,Belgium,BE,BEL,11422068,Europe,1632,20814,20
2020-04-08T00:00:00Z,8,4,2020,1380,403,Belgium,BE,BEL,11422068,Europe,2035,22194,21
2020-04-09T00:00:00Z,9,4,2020,1209,205,Belgium,BE,BEL,11422068,Europe,2240,23403,22
2020-04-10T00:00:00Z,10,4,2020,1580,283,Belgium,BE,BEL,11422068,Europe,2523,24983,23
2020-04-11T00:00:00Z,11,4,2020,1684,496,Belgium,BE,BEL,11422068,Europe,3019,26667,24
2020-04-12T00:00:00Z,12,4,2020,1351,327,Belgium,BE,BEL,11422068,Europe,3346,28018,25
2020-04-13T00:00:00Z,13,4,2020,1629,254,Belgium,BE,BEL,11422068,Europe,3600,29647,26
2020-04-14T00:00:00Z,14,4,2020,942,303,Belgium,BE,BEL,11422068,Europe,3903,30589,27
2020-04-15T00:00:00Z,15,4,2020,530,254,Belgium,BE,BEL,11422068,Europe,4157,31119,28
2020-04-16T00:00:00Z,16,4,2020,2454,283,Belgium,BE,BEL,11422068,Europe,4440,33573,29
2020-04-17T00:00:00Z,17,4,2020,1236,417,Belgium,BE,BEL,11422068,Europe,4857,34809,30
2020-04-18T00:00:00Z,18,4,2020,1329,306,Belgium,BE,BEL,11422068,Europe,5163,36138,31
2020-04-19T00:00:00Z,19,4,2020,1045,290,Belgium,BE,BEL,11422068,Europe,5453,37183,32
2020-04-20T00:00:00Z,20,4,2020,1313,230,Belgium,BE,BEL,11422068,Europe,5683,38496,33
2020-04-21T00:00:00Z,21,4,2020,1487,145,Belgium,BE,BEL,11422068,Europe,5828,39983,34
2020-04-22T00:00:00Z,22,4,2020,973,170,Belgium,BE,BEL,11422068,Europe,5998,40956,35
2020-04-23T00:00:00Z,23,4,2020,933,264,Belgium,BE,BEL,11422068,Europe,6262,41889,36
2020-04-24T00:00:00Z,24,4,2020,908,228,Belgium,BE,BEL,11422068,Europe,6490,42797,37
2020-04-25T00:00:00Z,25,4,2020,1496,189,Belgium,BE,BEL,11422068,Europe,6679,44293,38
2020-04-26T00:00:00Z,26,4,2020,1032,238,Belgium,BE,BEL,11422068,Europe,6917,45325,39
2020-04-27T00:00:00Z,27,4,2020,809,177,Belgium,BE,BEL,11422068,Europe,7094,46134,40
2020-04-28T00:00:00Z,28,4,2020,553,113,Belgium,BE,BEL,11422068,Europe,7207,46687,41
2020-04-29T00:00:00Z,29,4,2020,647,124,Belgium,BE,BEL,11422068,Europe,7331,47334,42
2020-04-30T00:00:00Z,30,4,2020,525,170,Belgium,BE,BEL,11422068,Europe,7501,47859,43
2020-05-01T00:00:00Z,1,5,2020,660,93,Belgium,BE,BEL,11422068,Europe,7594,48519,44
2020-05-02T00:00:00Z,2,5,2020,513,109,Belgium,BE,BEL,11422068,Europe,7703,49032,45
2020-05-03T00:00:00Z,3,5,2020,485,62,Belgium,BE,BEL,11422068,Europe,7765,49517,46
2020-05-04T00:00:00Z,4,5,2020,389,79,Belgium,BE,BEL,11422068,Europe,7844,49906,47
2020-05-05T00:00:00Z,5,5,2020,361,80,Belgium,BE,BEL,11422068,Europe,7924,50267,48
2020-05-06T00:00:00Z,6,5,2020,242,92,Belgium,BE,BEL,11422068,Europe,8016,50509,49
2020-05-07T00:00:00Z,7,5,2020,272,323,Belgium,BE,BEL,11422068,Europe,8339,50781,50
2020-05-08T00:00:00Z,8,5,2020,639,76,Belgium,BE,BEL,11422068,Europe,8415,51420,51
2020-05-09T00:00:00Z,9,5,2020,591,106,Belgium,BE,BEL,11422068,Europe,8521,52011,52
2020-05-10T00:00:00Z,10,5,2020,585,60,Belgium,BE,BEL,11422068,Europe,8581,52596,53
2020-05-11T00:00:00Z,11,5,2020,485,75,Belgium,BE,BEL,11422068,Europe,8656,53081,54
2020-05-12T00:00:00Z,12,5,2020,368,51,Belgium,BE,BEL,11422068,Europe,8707,53449,55
2020-05-13T00:00:00Z,13,5,2020,330,54,Belgium,BE,BEL,11422068,Europe,8761,53779,56
2020-05-14T00:00:00Z,14,5,2020,202,82,Belgium,BE,BEL,11422068,Europe,8843,53981,57
2020-05-15T00:00:00Z,15,5,2020,307,60,Belgium,BE,BEL,11422068,Europe,8903,54288,58
2020-05-16T00:00:00Z,16,5,2020,356,56,Belgium,BE,BEL,11422068,Europe,8959,54644,59
2020-05-17T00:00:00Z,17,5,2020,345,46,Belgium,BE,BEL,11422068,Europe,9005,54989,60
2020-05-18T00:00:00Z,18,5,2020,291,47,Belgium,BE,BEL,11422068,Europe,9052,55280,61
2020-05-19T00:00:00Z,19,5,2020,279,28,Belgium,BE,BEL,11422068,Europe,9080,55559,62
2020-05-20T00:00:00Z,20,5,2020,232,28,Belgium,BE,BEL,11422068,Europe,9108,55791,63
2020-05-21T00:00:00Z,21,5,2020,192,42,Belgium,BE,BEL,11422068,Europe,9150,55983,64
2020-05-22T00:00:00Z,22,5,2020,252,36,Belgium,BE,BEL,11422068,Europe,9186,56235,65
2020-05-23T00:00:00Z,23,5,2020,276,26,Belgium,BE,BEL,11422068,Europe,9212,56511,66
2020-05-24T00:00:00Z,24,5,2020,299,25,Belgium,BE,BEL,11422068,Europe,9237,56810,67
2020-05-25T00:00:00Z,25,5,2020,282,43,Belgium,BE,BEL,11422068,Europe,9280,57092,68
2020-05-26T00:00:00Z,26,5,2020,250,32,Belgium,BE,BEL,11422068,Europe,9312,57342,69
2020-05-27T00:00:00Z,27,5,2020,113,22,Belgium,BE,BEL,11422068,Europe,9334,57455,70
2020-04-04T00:00:00Z,4,4,2020,7,1,Bolivia,BO,BOL,11353142,America,10,139,1
2020-04-05T00:00:00Z,5,4,2020,18,0,Bolivia,BO,BOL,11353142,America,10,157,2
2020-04-06T00:00:00Z,6,4,2020,26,1,Bolivia,BO,BOL,11353142,America,11,183,3
2020-04-07T00:00:00Z,7,4,2020,11,3,Bolivia,BO,BOL,11353142,America,14,194,4
2020-04-08T00:00:00Z,8,4,2020,16,1,Bolivia,BO,BOL,11353142,America,15,210,5
2020-04-09T00:00:00Z,9,4,2020,54,3,Bolivia,BO,BOL,11353142,America,18,264,6
2020-04-10T00:00:00Z,10,4,2020,4,1,Bolivia,BO,BOL,11353142,America,19,268,7
2020-04-11T00:00:00Z,11,4,2020,8,1,Bolivia,BO,BOL,11353142,America,20,276,8
2020-04-12T00:00:00Z,12,4,2020,24,4,Bolivia,BO,BOL,11353142,America,24,300,9
2020-04-13T00:00:00Z,13,4,2020,30,3,Bolivia,BO,BOL,11353142,America,27,330,10
2020-04-14T00:00:00Z,14,4,2020,24,1,Bolivia,BO,BOL,11353142,America,28,354,11
2020-04-15T00:00:00Z,15,4,2020,43,0,Bolivia,BO,BOL,11353142,America,28,397,12
2020-04-16T00:00:00Z,16,4,2020,44,1,Bolivia,BO,BOL,11353142,America,29,441,13
2020-04-17T00:00:00Z,17,4,2020,24,2,Bolivia,BO,BOL,11353142,America,31,465,14
2020-04-18T00:00:00Z,18,4,2020,28,0,Bolivia,BO,BOL,11353142,America,31,493,15
2020-04-19T00:00:00Z,19,4,2020,27,1,Bolivia,BO,BOL,11353142,America,32,520,16
2020-04-20T00:00:00Z,20,4,2020,44,1,Bolivia,BO,BOL,11353142,America,33,564,17
2020-04-21T00:00:00Z,21,4,2020,34,1,Bolivia,BO,BOL,11353142,America,34,598,18
2020-04-22T00:00:00Z,22,4,2020,11,3,Bolivia,BO,BOL,11353142,America,37,609,19
2020-04-23T00:00:00Z,23,4,2020,63,3,Bolivia,BO,BOL,11353142,America,40,672,20
2020-04-24T00:00:00Z,24,4,2020,31,3,Bolivia,BO,BOL,11353142,America,43,703,21
2020-04-25T00:00:00Z,25,4,2020,104,1,Bolivia,BO,BOL,11353142,America,44,807,22
2020-04-26T00:00:00Z,26,4,2020,59,2,Bolivia,BO,BOL,11353142,America,46,866,23
2020-04-27T00:00:00Z,27,4,2020,84,4,Bolivia,BO,BOL,11353142,America,50,950,24
2020-04-28T00:00:00Z,28,4,2020,64,3,Bolivia,BO,BOL,11353142,America,53,1014,25
2020-04-29T00:00:00Z,29,4,2020,39,2,Bolivia,BO,BOL,11353142,America,55,1053,26
2020-04-30T00:00:00Z,30,4,2020,57,4,Bolivia,BO,BOL,11353142,America,59,1110,27
2020-05-01T00:00:00Z,1,5,2020,57,3,Bolivia,BO,BOL,11353142,America,62,1167,28
2020-05-02T00:00:00Z,2,5,2020,62,4,Bolivia,BO,BOL,11353142,America,66,1229,29
2020-05-03T00:00:00Z,3,5,2020,241,5,Bolivia,BO,BOL,11353142,America,71,1470,30
2020-05-04T00:00:00Z,4,5,2020,124,5,Bolivia,BO,BOL,11353142,America,76,1594,31
2020-05-05T00:00:00Z,5,5,2020,87,6,Bolivia,BO,BOL,11353142,America,82,1681,32
2020-05-06T00:00:00Z,6,5,2020,121,4,Bolivia,BO,BOL,11353142,America,86,1802,33
2020-05-07T00:00:00Z,7,5,2020,84,5,Bolivia,BO,BOL,11353142,America,91,1886,34
2020-05-08T00:00:00Z,8,5,2020,195,11,Bolivia,BO,BOL,11353142,America,102,2081,35
2020-05-09T00:00:00Z,9,5,2020,185,4,Bolivia,BO,BOL,11353142,America,106,2266,36
2020-05-10T00:00:00Z,10,5,2020,171,8,Bolivia,BO,BOL,11353142,America,114,2437,37
2020-05-11T00:00:00Z,11,5,2020,119,4,Bolivia,BO,BOL,11353142,America,118,2556,38
2020-05-12T00:00:00Z,12,5,2020,275,4,Bolivia,BO,BOL,11353142,America,122,2831,39
2020-05-13T00:00:00Z,13,5,2020,133,6,Bolivia,BO,BOL,11353142,America,128,2964,40
2020-05-14T00:00:00Z,14,5,2020,184,14,Bolivia,BO,BOL,11353142,America,142,3148,41
2020-05-15T00:00:00Z,15,5,2020,224,10,Bolivia,BO,BOL,11353142,America,152,3372,42
2020-05-16T00:00:00Z,16,5,2020,205,12,Bolivia,BO,BOL,11353142,America,164,3577,43
2020-05-17T00:00:00Z,17,5,2020,249,1,Bolivia,BO,BOL,11353142,America,165,3826,44
2020-05-18T00:00:00Z,18,5,2020,262,4,Bolivia,BO,BOL,11353142,America,169,4088,45
2020-05-19T00:00:00Z,19,5,2020,175,5,Bolivia,BO,BOL,11353142,America,174,4263,46
2020-05-20T00:00:00Z,20,5,2020,218,15,Bolivia,BO,BOL,11353142,America,189,4481,47
2020-05-21T00:00:00Z,21,5,2020,438,10,Bolivia,BO,BOL,11353142,America,199,4919,48
2020-05-22T00:00:00Z,22,5,2020,268,16,Bolivia,BO,BOL,11353142,America,215,5187,49
2020-05-23T00:00:00Z,23,5,2020,392,15,Bolivia,BO,BOL,11353142,America,230,5579,50
2020-05-24T00:00:00Z,24,5,2020,336,10,Bolivia,BO,BOL,11353142,America,240,5915,51
2020-05-25T00:00:00Z,25,5,2020,348,10,Bolivia,BO,BOL,11353142,America,250,6263,52
2020-05-26T00:00:00Z,26,5,2020,397,11,Bolivia,BO,BOL,11353142,America,261,6660,53
2020-05-27T00:00:00Z,27,5,2020,476,13,Bolivia,BO,BOL,11353142,America,274,7136,54
2020-04-01T00:00:00Z,1,4,2020,60,4,Bosnia_and_Herzegovina,BA,BIH,3323929,Europe,12,413,1
2020-04-02T00:00:00Z,2,4,2020,51,1,Bosnia_and_Herzegovina,BA,BIH,3323929,Europe,13,464,2
2020-04-03T00:00:00Z,3,4,2020,68,4,Bosnia_and_Herzegovina,BA,BIH,3323929,Europe,17,532,3
2020-04-04T00:00:00Z,4,4,2020,54,1,Bosnia_and_Herzegovina,BA,BIH,3323929,Europe,18,586,4
2020-04-05T00:00:00Z,5,4,2020,46,3,Bosnia_and_Herzegovina,BA,BIH,3323929,Europe,21,632,5
2020-04-06T00:00:00Z,6,4,2020,31,3,Bosnia_and_Herzegovina,BA,BIH,3323929,Europe,24,663,6
2020-04-07T00:00:00Z,7,4,2020,32,4,Bosnia_and_Herzegovina,BA,BIH,3323929,Europe,28,695,7
2020-04-08T00:00:00Z,8,4,2020,86,4,Bosnia_and_Herzegovina,BA,BIH,3323929,Europe,32,781,8
2020-04-09T00:00:00Z,9,4,2020,35,3,Bosnia_and_Herzegovina,BA,BIH,3323929,Europe,35,816,9
2020-04-10T00:00:00Z,10,4,2020,59,1,Bosnia_and_Herzegovina,BA,BIH,3323929,Europe,36,875,10
2020-04-11T00:00:00Z,11,4,2020,26,1,Bosnia_and_Herzegovina,BA,BIH,3323929,Europe,37,901,11
2020-04-12T00:00:00Z,12,4,2020,47,0,Bosnia_and_Herzegovina,BA,BIH,3323929,Europe,37,948,12
2020-04-13T00:00:00Z,13,4,2020,59,1,Bosnia_and_Herzegovina,BA,BIH,3323929,Europe,38,1007,13
2020-04-14T00:00:00Z,14,4,2020,21,0,Bosnia_and_Herzegovina,BA,BIH,3323929,Europe,38,1028,14
2020-04-15T00:00:00Z,15,4,2020,45,1,Bosnia_and_Herzegovina,BA,BIH,3323929,Europe,39,1073,15
2020-04-16T00:00:00Z,16,4,2020,27,1,Bosnia_and_Herzegovina,BA,BIH,3323929,Europe,40,1100,16
2020-04-17T00:00:00Z,17,4,2020,52,1,Bosnia_and_Herzegovina,BA,BIH,3323929,Europe,41,1152,17
2020-04-18T00:00:00Z,18,4,2020,58,3,Bosnia_and_Herzegovina,BA,BIH,3323929,Europe,44,1210,18
2020-04-19T00:00:00Z,19,4,2020,44,1,Bosnia_and_Herzegovina,BA,BIH,3323929,Europe,45,1254,19
2020-04-20T00:00:00Z,20,4,2020,15,1,Bosnia_and_Herzegovina,BA,BIH,3323929,Europe,46,1269,20
2020-04-21T00:00:00Z,21,4,2020,31,2,Bosnia_and_Herzegovina,BA,BIH,3323929,Europe,48,1300,21
2020-04-22T00:00:00Z,22,4,2020,40,2,Bosnia_and_Herzegovina,BA,BIH,3323929,Europe,50,1340,22
2020-04-23T00:00:00Z,23,4,2020,27,2,Bosnia_and_Herzegovina,BA,BIH,3323929,Europe,52,1367,23
2020-04-24T00:00:00Z,24,4,2020,46,1,Bosnia_and_Herzegovina,BA,BIH,3323929,Europe,53,1413,24
2020-04-25T00:00:00Z,25,4,2020,7,1,Bosnia_and_Herzegovina,BA,BIH,3323929,Europe,54,1420,25
2020-04-26T00:00:00Z,26,4,2020,65,2,Bosnia_and_Herzegovina,BA,BIH,3323929,Europe,56,1485,26
2020-04-27T00:00:00Z,27,4,2020,31,2,Bosnia_and_Herzegovina,BA,BIH,3323929,Europe,58,1516,27
2020-04-28T00:00:00Z,28,4,2020,48,2,Bosnia_and_Herzegovina,BA,BIH,3323929,Europe,60,1564,28
2020-04-29T00:00:00Z,29,4,2020,24,2,Bosnia_and_Herzegovina,BA,BIH,3323929,Europe,62,1588,29
2020-04-30T00:00:00Z,30,4,2020,0,0,Bosnia_and_Herzegovina,BA,BIH,3323929,Europe,62,1588,30
2020-05-01T00:00:00Z,1,5,2020,101,2,Bosnia_and_Herzegovina,BA,BIH,3323929,Europe,64,1689,31
2020-05-02T00:00:00Z,2,5,2020,92,6,Bosnia_and_Herzegovina,BA,BIH,3323929,Europe,70,1781,32
2020-05-03T00:00:00Z,3,5,2020,58,2,Bosnia_and_Herzegovina,BA,BIH,3323929,Europe,72,1839,33
2020-05-04T00:00:00Z,4,5,2020,18,5,Bosnia_and_Herzegovina,BA,BIH,3323929,Europe,77,1857,34
2020-05-05T00:00:00Z,5,5,2020,69,1,Bosnia_and_Herzegovina,BA,BIH,3323929,Europe,78,1926,35
2020-05-06T00:00:00Z,6,5,2020,20,1,Bosnia_and_Herzegovina,BA,BIH,3323929,Europe,79,1946,36
2020-05-07T00:00:00Z,7,5,2020,41,7,Bosnia_and_Herzegovina,BA,BIH,3323929,Europe,86,1987,37
2020-05-08T00:00:00Z,8,5,2020,40,4,Bosnia_and_Herzegovina,BA,BIH,3323929,Europe,90,2027,38
2020-05-09T00:00:00Z,9,5,2020,43,8,Bosnia_and_Herzegovina,BA,BIH,3323929,Europe,98,2070,39
2020-05-10T00:00:00Z,10,5,2020,0,0,Bosnia_and_Herzegovina,BA,BIH,3323929,Europe,98,2070,40
2020-05-11T00:00:00Z,11,5,2020,20,4,Bosnia_and_Herzegovina,BA,BIH,3323929,Europe,102,2090,41
2020-05-12T00:00:00Z,12,5,2020,52,10,Bosnia_and_Herzegovina,BA,BIH,3323929,Europe,112,2142,42
2020-05-13T00:00:00Z,13,5,2020,16,5,Bosnia_and_Herzegovina,BA,BIH,3323929,Europe,117,2158,43
2020-05-14T00:00:00Z,14,5,2020,23,3,Bosnia_and_Herzegovina,BA,BIH,3323929,Europe,120,2181,44
2020-05-15T00:00:00Z,15,5,2020,35,3,Bosnia_and_Herzegovina,BA,BIH,3323929,Europe,123,2216,45
2020-05-16T00:00:00Z,16,5,2020,21,4,Bosnia_and_Herzegovina,BA,BIH,3323929,Europe,127,2237,46
2020-05-17T00:00:00Z,17,5,2020,30,2,Bosnia_and_Herzegovina,BA,BIH,3323929,Europe,129,2267,47
2020-05-18T00:00:00Z,18,5,2020,22,3,Bosnia_and_Herzegovina,BA,BIH,3323929,Europe,132,2289,48
2020-05-19T00:00:00Z,19,5,2020,14,0,Bosnia_and_Herzegovina,BA,BIH,3323929,Europe,132,2303,49
2020-05-20T00:00:00Z,20,5,2020,16,1,Bosnia_and_Herzegovina,BA,BIH,3323929,Europe,133,2319,50
2020-05-21T00:00:00Z,21,5,2020,15,2,Bosnia_and_Herzegovina,BA,BIH,3323929,Europe,135,2334,51
2020-05-22T00:00:00Z,22,5,2020,18,4,Bosnia_and_Herzegovina,BA,BIH,3323929,Europe,139,2352,52
2020-05-23T00:00:00Z,23,5,2020,20,2,Bosnia_and_Herzegovina,BA,BIH,3323929,Europe,141,2372,53
2020-05-24T00:00:00Z,24,5,2020,19,0,Bosnia_and_Herzegovina,BA,BIH,3323929,Europe,141,2391,54
2020-05-25T00:00:00Z,25,5,2020,10,3,Bosnia_and_Herzegovina,BA,BIH,3323929,Europe,144,2401,55
2020-05-26T00:00:00Z,26,5,2020,5,2,Bosnia_and_Herzegovina,BA,BIH,3323929,Europe,146,2406,56
2020-05-27T00:00:00Z,27,5,2020,10,3,Bosnia_and_Herzegovina,BA,BIH,3323929,Europe,149,2416,57
2020-03-21T00:00:00Z,21,3,2020,283,5,Brazil,BR,BRA,209469333,America,11,904,1
2020-03-22T00:00:00Z,22,3,2020,224,7,Brazil,BR,BRA,209469333,America,18,1128,2
2020-03-23T00:00:00Z,23,3,2020,418,7,Brazil,BR,BRA,209469333,America,25,1546,3
2020-03-24T00:00:00Z,24,3,2020,345,9,Brazil,BR,BRA,209469333,America,34,1891,4
2020-03-25T00:00:00Z,25,3,2020,310,12,Brazil,BR,BRA,209469333,America,46,2201,5
2020-03-26T00:00:00Z,26,3,2020,232,11,Brazil,BR,BRA,209469333,America,57,2433,6
2020-03-27T00:00:00Z,27,3,2020,482,20,Brazil,BR,BRA,209469333,America,77,2915,7
2020-03-28T00:00:00Z,28,3,2020,502,15,Brazil,BR,BRA,209469333,America,92,3417,8
2020-03-29T00:00:00Z,29,3,2020,487,22,Brazil,BR,BRA,209469333,America,114,3904,9
2020-03-30T00:00:00Z,30,3,2020,352,22,Brazil,BR,BRA,209469333,America,136,4256,10
2020-03-31T00:00:00Z,31,3,2020,323,23,Brazil,BR,BRA,209469333,America,159,4579,11
2020-04-01T00:00:00Z,1,4,2020,1138,42,Brazil,BR,BRA,209469333,America,201,5717,12
2020-04-02T00:00:00Z,2,4,2020,1119,40,Brazil,BR,BRA,209469333,America,241,6836,13
2020-04-03T00:00:00Z,3,4,2020,1074,58,Brazil,BR,BRA,209469333,America,299,7910,14
2020-04-04T00:00:00Z,4,4,2020,1146,60,Brazil,BR,BRA,209469333,America,359,9056,15
2020-04-05T00:00:00Z,5,4,2020,1222,73,Brazil,BR,BRA,209469333,America,432,10278,16
2020-04-06T00:00:00Z,6,4,2020,852,54,Brazil,BR,BRA,209469333,America,486,11130,17
2020-04-07T00:00:00Z,7,4,2020,926,67,Brazil,BR,BRA,209469333,America,553,12056,18
2020-04-08T00:00:00Z,8,4,2020,1661,114,Brazil,BR,BRA,209469333,America,667,13717,19
2020-04-09T00:00:00Z,9,4,2020,2210,133,Brazil,BR,BRA,209469333,America,800,15927,20
2020-04-10T00:00:00Z,10,4,2020,1930,141,Brazil,BR,BRA,209469333,America,941,17857,21
2020-04-11T00:00:00Z,11,4,2020,1781,115,Brazil,BR,BRA,209469333,America,1056,19638,22
2020-04-12T00:00:00Z,12,4,2020,1089,68,Brazil,BR,BRA,209469333,America,1124,20727,23
2020-04-13T00:00:00Z,13,4,2020,1442,99,Brazil,BR,BRA,209469333,America,1223,22169,24
2020-04-14T00:00:00Z,14,4,2020,1261,105,Brazil,BR,BRA,209469333,America,1328,23430,25
2020-04-15T00:00:00Z,15,4,2020,1832,204,Brazil,BR,BRA,209469333,America,1532,25262,26
2020-04-16T00:00:00Z,16,4,2020,3058,204,Brazil,BR,BRA,209469333,America,1736,28320,27
2020-04-17T00:00:00Z,17,4,2020,2105,188,Brazil,BR,BRA,209469333,America,1924,30425,28
2020-04-18T00:00:00Z,18,4,2020,3257,217,Brazil,BR,BRA,209469333,America,2141,33682,29
2020-04-19T00:00:00Z,19,4,2020,2917,206,Brazil,BR,BRA,209469333,America,2347,36599,30
2020-04-20T00:00:00Z,20,4,2020,2055,115,Brazil,BR,BRA,209469333,America,2462,38654,31
2020-04-21T00:00:00Z,21,4,2020,1927,113,Brazil,BR,BRA,209469333,America,2575,40581,32
2020-04-22T00:00:00Z,22,4,2020,2498,166,Brazil,BR,BRA,209469333,America,2741,43079,33
2020-04-23T00:00:00Z,23,4,2020,2678,165,Brazil,BR,BRA,209469333,America,2906,45757,34
2020-04-24T00:00:00Z,24,4,2020,3735,407,Brazil,BR,BRA,209469333,America,3313,49492,35
2020-04-25T00:00:00Z,25,4,2020,3503,357,Brazil,BR,BRA,209469333,America,3670,52995,36
2020-04-26T00:00:00Z,26,4,2020,5514,346,Brazil,BR,BRA,209469333,America,4016,58509,37
2020-04-27T00:00:00Z,27,4,2020,3379,189,Brazil,BR,BRA,209469333,America,4205,61888,38
2020-04-28T00:00:00Z,28,4,2020,4613,338,Brazil,BR,BRA,209469333,America,4543,66501,39
2020-04-29T00:00:00Z,29,4,2020,5385,474,Brazil,BR,BRA,209469333,America,5017,71886,40
2020-04-30T00:00:00Z,30,4,2020,6276,449,Brazil,BR,BRA,209469333,America,5466,78162,41
2020-05-01T00:00:00Z,1,5,2020,7218,435,Brazil,BR,BRA,209469333,America,5901,85380,42
2020-05-02T00:00:00Z,2,5,2020,6209,428,Brazil,BR,BRA,209469333,America,6329,91589,43
2020-05-03T00:00:00Z,3,5,2020,4970,421,Brazil,BR,BRA,209469333,America,6750,96559,44
2020-05-04T00:00:00Z,4,5,2020,4588,275,Brazil,BR,BRA,209469333,America,7025,101147,45
2020-05-05T00:00:00Z,5,5,2020,6633,296,Brazil,BR,BRA,209469333,America,7321,107780,46
2020-05-06T00:00:00Z,6,5,2020,6935,600,Brazil,BR,BRA,209469333,America,7921,114715,47
2020-05-07T00:00:00Z,7,5,2020,10503,615,Brazil,BR,BRA,209469333,America,8536,125218,48
2020-05-08T00:00:00Z,8,5,2020,9888,610,Brazil,BR,BRA,209469333,America,9146,135106,49
2020-05-09T00:00:00Z,9,5,2020,10222,751,Brazil,BR,BRA,209469333,America,9897,145328,50
2020-05-10T00:00:00Z,10,5,2020,10611,730,Brazil,BR,BRA,209469333,America,10627,155939,51
2020-05-11T00:00:00Z,11,5,2020,6760,496,Brazil,BR,BRA,209469333,America,11123,162699,52
2020-05-12T00:00:00Z,12,5,2020,5632,396,Brazil,BR,BRA,209469333,America,11519,168331,53
2020-05-13T00:00:00Z,13,5,2020,9258,881,Brazil,BR,BRA,209469333,America,12400,177589,54
2020-05-14T00:00:00Z,14,5,2020,11385,749,Brazil,BR,BRA,209469333,America,13149,188974,55
2020-05-15T00:00:00Z,15,5,2020,13944,844,Brazil,BR,BRA,209469333,America,13993,202918,56
2020-05-16T00:00:00Z,16,5,2020,15305,824,Brazil,BR,BRA,209469333,America,14817,218223,57
2020-05-17T00:00:00Z,17,5,2020,14919,816,Brazil,BR,BRA,209469333,America,15633,233142,58
2020-05-18T00:00:00Z,18,5,2020,7938,485,Brazil,BR,BRA,209469333,America,16118,241080,59
2020-05-19T00:00:00Z,19,5,2020,13140,674,Brazil,BR,BRA,209469333,America,16792,254220,60
2020-05-20T00:00:00Z,20,5,2020,17408,1179,Brazil,BR,BRA,209469333,America,17971,271628,61
2020-05-21T00:00:00Z,21,5,2020,19951,888,Brazil,BR,BRA,209469333,America,18859,291579,62
2020-05-22T00:00:00Z,22,5,2020,18508,1188,Brazil,BR,BRA,209469333,America,20047,310087,63
2020-05-23T00:00:00Z,23,5,2020,20803,1001,Brazil,BR,BRA,209469333,America,21048,330890,64
2020-05-24T00:00:00Z,24,5,2020,16508,965,Brazil,BR,BRA,209469333,America,22013,347398,65
2020-05-25T00:00:00Z,25,5,2020,15813,653,Brazil,BR,BRA,209469333,America,22666,363211,66
2020-05-26T00:00:00Z,26,5,2020,11687,807,Brazil,BR,BRA,209469333,America,23473,374898,67
2020-05-27T00:00:00Z,27,5,2020,16324,1039,Brazil,BR,BRA,209469333,America,24512,391222,68
2020-04-02T00:00:00Z,2,4,2020,23,2,Bulgaria,BG,BGR,7024216,Europe,10,422,1
2020-04-03T00:00:00Z,3,4,2020,35,0,Bulgaria,BG,BGR,7024216,Europe,10,457,2
2020-04-04T00:00:00Z,4,4,2020,28,4,Bulgaria,BG,BGR,7024216,Europe,14,485,3
2020-04-05T00:00:00Z,5,4,2020,18,3,Bulgaria,BG,BGR,7024216,Europe,17,503,4
2020-04-06T00:00:00Z,6,4,2020,28,3,Bulgaria,BG,BGR,7024216,Europe,20,531,5
2020-04-07T00:00:00Z,7,4,2020,18,2,Bulgaria,BG,BGR,7024216,Europe,22,549,6
2020-04-08T00:00:00Z,8,4,2020,28,1,Bulgaria,BG,BGR,7024216,Europe,23,577,7
2020-04-09T00:00:00Z,9,4,2020,16,1,Bulgaria,BG,BGR,7024216,Europe,24,593,8
2020-04-10T00:00:00Z,10,4,2020,31,0,Bulgaria,BG,BGR,7024216,Europe,24,624,9
2020-04-11T00:00:00Z,11,4,2020,11,1,Bulgaria,BG,BGR,7024216,Europe,25,635,10
2020-04-12T00:00:00Z,12,4,2020,26,3,Bulgaria,BG,BGR,7024216,Europe,28,661,11
2020-04-13T00:00:00Z,13,4,2020,14,1,Bulgaria,BG,BGR,7024216,Europe,29,675,12
2020-04-14T00:00:00Z,14,4,2020,10,3,Bulgaria,BG,BGR,7024216,Europe,32,685,13
2020-04-15T00:00:00Z,15,4,2020,28,3,Bulgaria,BG,BGR,7024216,Europe,35,713,14
2020-04-16T00:00:00Z,16,4,2020,34,1,Bulgaria,BG,BGR,7024216,Europe,36,747,15
2020-04-17T00:00:00Z,17,4,2020,53,2,Bulgaria,BG,BGR,7024216,Europe,38,800,16
2020-04-18T00:00:00Z,18,4,2020,46,3,Bulgaria,BG,BGR,7024216,Europe,41,846,17
2020-04-19T00:00:00Z,19,4,2020,32,0,Bulgaria,BG,BGR,7024216,Europe,41,878,18
2020-04-20T00:00:00Z,20,4,2020,37,2,Bulgaria,BG,BGR,7024216,Europe,43,915,19
2020-04-21T00:00:00Z,21,4,2020,14,0,Bulgaria,BG,BGR,7024216,Europe,43,929,20
2020-04-22T00:00:00Z,22,4,2020,46,2,Bulgaria,BG,BGR,7024216,Europe,45,975,21
2020-04-23T00:00:00Z,23,4,2020,49,4,Bulgaria,BG,BGR,7024216,Europe,49,1024,22
2020-04-24T00:00:00Z,24,4,2020,73,3,Bulgaria,BG,BGR,7024216,Europe,52,1097,23
2020-04-25T00:00:00Z,25,4,2020,91,2,Bulgaria,BG,BGR,7024216,Europe,54,1188,24
2020-04-26T00:00:00Z,26,4,2020,59,1,Bulgaria,BG,BGR,7024216,Europe,55,1247,25
2020-04-27T00:00:00Z,27,4,2020,53,1,Bulgaria,BG,BGR,7024216,Europe,56,1300,26
2020-04-28T00:00:00Z,28,4,2020,63,2,Bulgaria,BG,BGR,7024216,Europe,58,1363,27
2020-04-29T00:00:00Z,29,4,2020,36,0,Bulgaria,BG,BGR,7024216,Europe,58,1399,28
2020-04-30T00:00:00Z,30,4,2020,48,6,Bulgaria,BG,BGR,7024216,Europe,64,1447,29
2020-05-01T00:00:00Z,1,5,2020,59,2,Bulgaria,BG,BGR,7024216,Europe,66,1506,30
2020-05-02T00:00:00Z,2,5,2020,82,3,Bulgaria,BG,BGR,7024216,Europe,69,1588,31
2020-05-03T00:00:00Z,3,5,2020,6,3,Bulgaria,BG,BGR,7024216,Europe,72,1594,32
2020-05-04T00:00:00Z,4,5,2020,24,1,Bulgaria,BG,BGR,7024216,Europe,73,1618,33
2020-05-05T00:00:00Z,5,5,2020,34,5,Bulgaria,BG,BGR,7024216,Europe,78,1652,34
2020-05-06T00:00:00Z,6,5,2020,37,0,Bulgaria,BG,BGR,7024216,Europe,78,1689,35
2020-05-07T00:00:00Z,7,5,2020,89,6,Bulgaria,BG,BGR,7024216,Europe,84,1778,36
2020-05-08T00:00:00Z,8,5,2020,51,0,Bulgaria,BG,BGR,7024216,Europe,84,1829,37
2020-05-09T00:00:00Z,9,5,2020,82,4,Bulgaria,BG,BGR,7024216,Europe,88,1911,38
2020-05-10T00:00:00Z,10,5,2020,44,2,Bulgaria,BG,BGR,7024216,Europe,90,1955,39
2020-05-11T00:00:00Z,11,5,2020,10,1,Bulgaria,BG,BGR,7024216,Europe,91,1965,40
2020-05-12T00:00:00Z,12,5,2020,25,2,Bulgaria,BG,BGR,7024216,Europe,93,1990,41
2020-05-13T00:00:00Z,13,5,2020,33,2,Bulgaria,BG,BGR,7024216,Europe,95,2023,42
2020-05-14T00:00:00Z,14,5,2020,46,1,Bulgaria,BG,BGR,7024216,Europe,96,2069,43
2020-05-15T00:00:00Z,15,5,2020,31,3,Bulgaria,BG,BGR,7024216,Europe,99,2100,44
2020-05-16T00:00:00Z,16,5,2020,38,3,Bulgaria,BG,BGR,7024216,Europe,102,2138,45
2020-05-17T00:00:00Z,17,5,2020,73,6,Bulgaria,BG,BGR,7024216,Europe,108,2211,46
2020-05-18T00:00:00Z,18,5,2020,24,2,Bulgaria,BG,BGR,7024216,Europe,110,2235,47
2020-05-19T00:00:00Z,19,5,2020,24,2,Bulgaria,BG,BGR,7024216,Europe,112,2259,48
2020-05-20T00:00:00Z,20,5,2020,33,4,Bulgaria,BG,BGR,7024216,Europe,116,2292,49
2020-05-21T00:00:00Z,21,5,2020,39,4,Bulgaria,BG,BGR,7024216,Europe,120,2331,50
2020-05-22T00:00:00Z,22,5,2020,41,5,Bulgaria,BG,BGR,7024216,Europe,125,2372,51
2020-05-23T00:00:00Z,23,5,2020,36,1,Bulgaria,BG,BGR,7024216,Europe,126,2408,52
2020-05-24T00:00:00Z,24,5,2020,0,0,Bulgaria,BG,BGR,7024216,Europe,126,2408,53
2020-05-25T00:00:00Z,25,5,2020,25,4,Bulgaria,BG,BGR,7024216,Europe,130,2433,54
2020-05-26T00:00:00Z,26,5,2020,0,0,Bulgaria,BG,BGR,7024216,Europe,130,2433,55
2020-05-27T00:00:00Z,27,5,2020,27,3,Bulgaria,BG,BGR,7024216,Europe,133,2460,56
2020-03-31T00:00:00Z,31,3,2020,42,3,Burkina_Faso,BF,BFA,19751535,Africa,12,222,1
2020-04-01T00:00:00Z,1,4,2020,24,0,Burkina_Faso,BF,BFA,19751535,Africa,12,246,2
2020-04-02T00:00:00Z,2,4,2020,15,2,Burkina_Faso,BF,BFA,19751535,Africa,14,261,3
2020-04-03T00:00:00Z,3,4,2020,27,2,Burkina_Faso,BF,BFA,19751535,Africa,16,288,4
2020-04-04T00:00:00Z,4,4,2020,0,0,Burkina_Faso,BF,BFA,19751535,Africa,16,288,5
2020-04-05T00:00:00Z,5,4,2020,14,0,Burkina_Faso,BF,BFA,19751535,Africa,16,302,6
2020-04-06T00:00:00Z,6,4,2020,43,1,Burkina_Faso,BF,BFA,19751535,Africa,17,345,7
2020-04-07T00:00:00Z,7,4,2020,19,0,Burkina_Faso,BF,BFA,19751535,Africa,17,364,8
2020-04-08T00:00:00Z,8,4,2020,20,2,Burkina_Faso,BF,BFA,19751535,Africa,19,384,9
2020-04-09T00:00:00Z,9,4,2020,30,4,Burkina_Faso,BF,BFA,19751535,Africa,23,414,10
2020-04-10T00:00:00Z,10,4,2020,29,1,Burkina_Faso,BF,BFA,19751535,Africa,24,443,11
2020-04-11T00:00:00Z,11,4,2020,5,2,Burkina_Faso,BF,BFA,19751535,Africa,26,448,12
2020-04-12T00:00:00Z,12,4,2020,36,1,Burkina_Faso,BF,BFA,19751535,Africa,27,484,13
2020-04-13T00:00:00Z,13,4,2020,13,0,Burkina_Faso,BF,BFA,19751535,Africa,27,497,14
2020-04-14T00:00:00Z,14,4,2020,18,1,Burkina_Faso,BF,BFA,19751535,Africa,28,515,15
2020-04-15T00:00:00Z,15,4,2020,13,2,Burkina_Faso,BF,BFA,19751535,Africa,30,528,16
2020-04-16T00:00:00Z,16,4,2020,14,2,Burkina_Faso,BF,BFA,19751535,Africa,32,542,17
2020-04-17T00:00:00Z,17,4,2020,1,0,Burkina_Faso,BF,BFA,19751535,Africa,32,543,18
2020-04-18T00:00:00Z,18,4,2020,14,3,Burkina_Faso,BF,BFA,19751535,Africa,35,557,19
2020-04-19T00:00:00Z,19,4,2020,8,1,Burkina_Faso,BF,BFA,19751535,Africa,36,565,20
2020-04-20T00:00:00Z,20,4,2020,11,0,Burkina_Faso,BF,BFA,19751535,Africa,36,576,21
2020-04-21T00:00:00Z,21,4,2020,5,2,Burkina_Faso,BF,BFA,19751535,Africa,38,581,22
2020-04-22T00:00:00Z,22,4,2020,19,0,Burkina_Faso,BF,BFA,19751535,Africa,38,600,23
2020-04-23T00:00:00Z,23,4,2020,9,1,Burkina_Faso,BF,BFA,19751535,Africa,39,609,24
2020-04-24T00:00:00Z,24,4,2020,7,2,Burkina_Faso,BF,BFA,19751535,Africa,41,616,25
2020-04-25T00:00:00Z,25,4,2020,10,0,Burkina_Faso,BF,BFA,19751535,Africa,41,626,26
2020-04-26T00:00:00Z,26,4,2020,3,0,Burkina_Faso,BF,BFA,19751535,Africa,41,629,27
2020-04-27T00:00:00Z,27,4,2020,3,1,Burkina_Faso,BF,BFA,19751535,Africa,42,632,28
2020-04-28T00:00:00Z,28,4,2020,3,0,Burkina_Faso,BF,BFA,19751535,Africa,42,635,29
2020-04-29T00:00:00Z,29,4,2020,3,0,Burkina_Faso,BF,BFA,19751535,Africa,42,638,30
2020-04-30T00:00:00Z,30,4,2020,3,1,Burkina_Faso,BF,BFA,19751535,Africa,43,641,31
2020-05-01T00:00:00Z,1,5,2020,4,0,Burkina_Faso,BF,BFA,19751535,Africa,43,645,32
2020-05-02T00:00:00Z,2,5,2020,4,1,Burkina_Faso,BF,BFA,19751535,Africa,44,649,33
2020-05-03T00:00:00Z,3,5,2020,3,0,Burkina_Faso,BF,BFA,19751535,Africa,44,652,34
2020-05-04T00:00:00Z,4,5,2020,10,1,Burkina_Faso,BF,BFA,19751535,Africa,45,662,35
2020-05-05T00:00:00Z,5,5,2020,10,1,Burkina_Faso,BF,BFA,19751535,Africa,46,672,36
2020-05-06T00:00:00Z,6,5,2020,16,2,Burkina_Faso,BF,BFA,19751535,Africa,48,688,37
2020-05-07T00:00:00Z,7,5,2020,41,0,Burkina_Faso,BF,BFA,19751535,Africa,48,729,38
2020-05-08T00:00:00Z,8,5,2020,7,0,Burkina_Faso,BF,BFA,19751535,Africa,48,736,39
2020-05-09T00:00:00Z,9,5,2020,8,0,Burkina_Faso,BF,BFA,19751535,Africa,48,744,40
2020-05-10T00:00:00Z,10,5,2020,4,0,Burkina_Faso,BF,BFA,19751535,Africa,48,748,41
2020-05-11T00:00:00Z,11,5,2020,3,1,Burkina_Faso,BF,BFA,19751535,Africa,49,751,42
2020-05-12T00:00:00Z,12,5,2020,9,1,Burkina_Faso,BF,BFA,19751535,Africa,50,760,43
2020-05-13T00:00:00Z,13,5,2020,6,1,Burkina_Faso,BF,BFA,19751535,Africa,51,766,44
2020-05-14T00:00:00Z,14,5,2020,7,0,Burkina_Faso,BF,BFA,19751535,Africa,51,773,45
2020-05-15T00:00:00Z,15,5,2020,0,0,Burkina_Faso,BF,BFA,19751535,Africa,51,773,46
2020-05-16T00:00:00Z,16,5,2020,9,0,Burkina_Faso,BF,BFA,19751535,Africa,51,782,47
2020-05-17T00:00:00Z,17,5,2020,0,0,Burkina_Faso,BF,BFA,19751535,Africa,51,782,48
2020-05-18T00:00:00Z,18,5,2020,14,0,Burkina_Faso,BF,BFA,19751535,Africa,51,796,49
2020-05-19T00:00:00Z,19,5,2020,0,0,Burkina_Faso,BF,BFA,19751535,Africa,51,796,50
2020-05-20T00:00:00Z,20,5,2020,10,1,Burkina_Faso,BF,BFA,19751535,Africa,52,806,51
2020-05-21T00:00:00Z,21,5,2020,3,0,Burkina_Faso,BF,BFA,19751535,Africa,52,809,52
2020-05-22T00:00:00Z,22,5,2020,3,0,Burkina_Faso,BF,BFA,19751535,Africa,52,812,53
2020-05-23T00:00:00Z,23,5,2020,2,0,Burkina_Faso,BF,BFA,19751535,Africa,52,814,54
2020-05-24T00:00:00Z,24,5,2020,0,0,Burkina_Faso,BF,BFA,19751535,Africa,52,814,55
2020-05-25T00:00:00Z,25,5,2020,18,0,Burkina_Faso,BF,BFA,19751535,Africa,52,832,56
2020-05-26T00:00:00Z,26,5,2020,9,0,Burkina_Faso,BF,BFA,19751535,Africa,52,841,57
2020-05-27T00:00:00Z,27,5,2020,4,1,Burkina_Faso,BF,BFA,19751535,Africa,53,845,58
2020-04-09T00:00:00Z,9,4,2020,45,1,Cameroon,CM,CMR,25216237,Africa,10,730,1
2020-04-10T00:00:00Z,10,4,2020,0,0,Cameroon,CM,CMR,25216237,Africa,10,730,2
2020-04-11T00:00:00Z,11,4,2020,73,0,Cameroon,CM,CMR,25216237,Africa,10,803,3
2020-04-12T00:00:00Z,12,4,2020,17,1,Cameroon,CM,CMR,25216237,Africa,11,820,4
2020-04-13T00:00:00Z,13,4,2020,0,1,Cameroon,CM,CMR,25216237,Africa,12,820,5
2020-04-14T00:00:00Z,14,4,2020,0,0,Cameroon,CM,CMR,25216237,Africa,12,820,6
2020-04-15T00:00:00Z,15,4,2020,35,5,Cameroon,CM,CMR,25216237,Africa,17,855,7
2020-04-16T00:00:00Z,16,4,2020,0,0,Cameroon,CM,CMR,25216237,Africa,17,855,8
2020-04-17T00:00:00Z,17,4,2020,0,4,Cameroon,CM,CMR,25216237,Africa,21,855,9
2020-04-18T00:00:00Z,18,4,2020,161,0,Cameroon,CM,CMR,25216237,Africa,21,1016,10
2020-04-19T00:00:00Z,19,4,2020,0,0,Cameroon,CM,CMR,25216237,Africa,21,1016,11
2020-04-20T00:00:00Z,20,4,2020,0,21,Cameroon,CM,CMR,25216237,Africa,42,1016,12
2020-04-21T00:00:00Z,21,4,2020,1,0,Cameroon,CM,CMR,25216237,Africa,42,1017,13
2020-04-22T00:00:00Z,22,4,2020,146,0,Cameroon,CM,CMR,25216237,Africa,42,1163,14
2020-04-23T00:00:00Z,23,4,2020,0,1,Cameroon,CM,CMR,25216237,Africa,43,1163,15
2020-04-24T00:00:00Z,24,4,2020,238,6,Cameroon,CM,CMR,25216237,Africa,49,1401,16
2020-04-25T00:00:00Z,25,4,2020,2,0,Cameroon,CM,CMR,25216237,Africa,49,1403,17
2020-04-26T00:00:00Z,26,4,2020,115,4,Cameroon,CM,CMR,25216237,Africa,53,1518,18
2020-04-27T00:00:00Z,27,4,2020,103,3,Cameroon,CM,CMR,25216237,Africa,56,1621,19
2020-04-28T00:00:00Z,28,4,2020,0,2,Cameroon,CM,CMR,25216237,Africa,58,1621,20
2020-04-29T00:00:00Z,29,4,2020,185,1,Cameroon,CM,CMR,25216237,Africa,59,1806,21
2020-04-30T00:00:00Z,30,4,2020,26,2,Cameroon,CM,CMR,25216237,Africa,61,1832,22
2020-05-01T00:00:00Z,1,5,2020,0,0,Cameroon,CM,CMR,25216237,Africa,61,1832,23
2020-05-02T00:00:00Z,2,5,2020,237,0,Cameroon,CM,CMR,25216237,Africa,61,2069,24
2020-05-03T00:00:00Z,3,5,2020,8,3,Cameroon,CM,CMR,25216237,Africa,64,2077,25
2020-05-04T00:00:00Z,4,5,2020,0,0,Cameroon,CM,CMR,25216237,Africa,64,2077,26
2020-05-05T00:00:00Z,5,5,2020,27,0,Cameroon,CM,CMR,25216237,Africa,64,2104,27
2020-05-06T00:00:00Z,6,5,2020,0,0,Cameroon,CM,CMR,25216237,Africa,64,2104,28
2020-05-07T00:00:00Z,7,5,2020,161,44,Cameroon,CM,CMR,25216237,Africa,108,2265,29
2020-05-08T00:00:00Z,8,5,2020,0,0,Cameroon,CM,CMR,25216237,Africa,108,2265,30
2020-05-09T00:00:00Z,9,5,2020,0,0,Cameroon,CM,CMR,25216237,Africa,108,2265,31
2020-05-10T00:00:00Z,10,5,2020,9,0,Cameroon,CM,CMR,25216237,Africa,108,2274,32
2020-05-11T00:00:00Z,11,5,2020,305,6,Cameroon,CM,CMR,25216237,Africa,114,2579,33
2020-05-12T00:00:00Z,12,5,2020,110,11,Cameroon,CM,CMR,25216237,Africa,125,2689,34
2020-05-13T00:00:00Z,13,5,2020,0,0,Cameroon,CM,CMR,25216237,Africa,125,2689,35
2020-05-14T00:00:00Z,14,5,2020,111,11,Cameroon,CM,CMR,25216237,Africa,136,2800,36
2020-05-15T00:00:00Z,15,5,2020,154,3,Cameroon,CM,CMR,25216237,Africa,139,2954,37
2020-05-16T00:00:00Z,16,5,2020,151,1,Cameroon,CM,CMR,25216237,Africa,140,3105,38
2020-05-17T00:00:00Z,17,5,2020,187,0,Cameroon,CM,CMR,25216237,Africa,140,3292,39
2020-05-18T00:00:00Z,18,5,2020,0,0,Cameroon,CM,CMR,25216237,Africa,140,3292,40
2020-05-19T00:00:00Z,19,5,2020,0,0,Cameroon,CM,CMR,25216237,Africa,140,3292,41
2020-05-20T00:00:00Z,20,5,2020,237,0,Cameroon,CM,CMR,25216237,Africa,140,3529,42
2020-05-21T00:00:00Z,21,5,2020,204,6,Cameroon,CM,CMR,25216237,Africa,146,3733,43
2020-05-22T00:00:00Z,22,5,2020,555,10,Cameroon,CM,CMR,25216237,Africa,156,4288,44
2020-05-23T00:00:00Z,23,5,2020,112,3,Cameroon,CM,CMR,25216237,Africa,159,4400,45
2020-05-24T00:00:00Z,24,5,2020,197,0,Cameroon,CM,CMR,25216237,Africa,159,4597,46
2020-05-25T00:00:00Z,25,5,2020,293,6,Cameroon,CM,CMR,25216237,Africa,165,4890,47
2020-05-26T00:00:00Z,26,5,2020,154,6,Cameroon,CM,CMR,25216237,Africa,171,5044,48
2020-05-27T00:00:00Z,27,5,2020,318,4,Cameroon,CM,CMR,25216237,Africa,175,5362,49
2020-03-20T00:00:00Z,20,3,2020,156,1,Canada,CA,CAN,37058856,America,10,846,1
2020-03-21T00:00:00Z,21,3,2020,125,2,Canada,CA,CAN,37058856,America,12,971,2
2020-03-22T00:00:00Z,22,3,2020,331,6,Canada,CA,CAN,37058856,America,18,1302,3
2020-03-23T00:00:00Z,23,3,2020,128,2,Canada,CA,CAN,37058856,America,20,1430,4
2020-03-24T00:00:00Z,24,3,2020,216,4,Canada,CA,CAN,37058856,America,24,1646,5
2020-03-25T00:00:00Z,25,3,2020,313,3,Canada,CA,CAN,37058856,America,27,1959,6
2020-03-26T00:00:00Z,26,3,2020,1426,8,Canada,CA,CAN,37058856,America,35,3385,7
2020-03-27T00:00:00Z,27,3,2020,633,4,Canada,CA,CAN,37058856,America,39,4018,8
2020-03-28T00:00:00Z,28,3,2020,657,14,Canada,CA,CAN,37058856,America,53,4675,9
2020-03-29T00:00:00Z,29,3,2020,711,7,Canada,CA,CAN,37058856,America,60,5386,10
2020-03-30T00:00:00Z,30,3,2020,869,1,Canada,CA,CAN,37058856,America,61,6255,11
2020-03-31T00:00:00Z,31,3,2020,1169,28,Canada,CA,CAN,37058856,America,89,7424,12
2020-04-01T00:00:00Z,1,4,2020,1112,7,Canada,CA,CAN,37058856,America,96,8536,13
2020-04-02T00:00:00Z,2,4,2020,1059,13,Canada,CA,CAN,37058856,America,109,9595,14
2020-04-03T00:00:00Z,3,4,2020,1673,29,Canada,CA,CAN,37058856,America,138,11268,15
2020-04-04T00:00:00Z,4,4,2020,1251,49,Canada,CA,CAN,37058856,America,187,12519,16
2020-04-05T00:00:00Z,5,4,2020,1363,44,Canada,CA,CAN,37058856,America,231,13882,17
2020-04-06T00:00:00Z,6,4,2020,1614,49,Canada,CA,CAN,37058856,America,280,15496,18
2020-04-07T00:00:00Z,7,4,2020,1157,43,Canada,CA,CAN,37058856,America,323,16653,19
2020-04-08T00:00:00Z,8,4,2020,1230,57,Canada,CA,CAN,37058856,America,380,17883,20
2020-04-09T00:00:00Z,9,4,2020,1391,55,Canada,CA,CAN,37058856,America,435,19274,21
2020-04-10T00:00:00Z,10,4,2020,1474,74,Canada,CA,CAN,37058856,America,509,20748,22
2020-04-11T00:00:00Z,11,4,2020,1385,60,Canada,CA,CAN,37058856,America,569,22133,23
2020-04-12T00:00:00Z,12,4,2020,1168,84,Canada,CA,CAN,37058856,America,653,23301,24
2020-04-13T00:00:00Z,13,4,2020,1064,64,Canada,CA,CAN,37058856,America,717,24365,25
2020-04-14T00:00:00Z,14,4,2020,1298,63,Canada,CA,CAN,37058856,America,780,25663,26
2020-04-15T00:00:00Z,15,4,2020,1383,123,Canada,CA,CAN,37058856,America,903,27046,27
2020-04-16T00:00:00Z,16,4,2020,1318,107,Canada,CA,CAN,37058856,America,1010,28364,28
2020-04-17T00:00:00Z,17,4,2020,1717,183,Canada,CA,CAN,37058856,America,1193,30081,29
2020-04-18T00:00:00Z,18,4,2020,1791,116,Canada,CA,CAN,37058856,America,1309,31872,30
2020-04-19T00:00:00Z,19,4,2020,1469,158,Canada,CA,CAN,37058856,America,1467,33341,31
2020-04-20T00:00:00Z,20,4,2020,1436,113,Canada,CA,CAN,37058856,America,1580,34777,32
2020-04-21T00:00:00Z,21,4,2020,2046,110,Canada,CA,CAN,37058856,America,1690,36823,33
2020-04-22T00:00:00Z,22,4,2020,1590,144,Canada,CA,CAN,37058856,America,1834,38413,34
2020-04-23T00:00:00Z,23,4,2020,1766,140,Canada,CA,CAN,37058856,America,1974,40179,35
2020-04-24T00:00:00Z,24,4,2020,1920,172,Canada,CA,CAN,37058856,America,2146,42099,36
2020-04-25T00:00:00Z,25,4,2020,1778,156,Canada,CA,CAN,37058856,America,2302,43877,37
2020-04-26T00:00:00Z,26,4,2020,1464,163,Canada,CA,CAN,37058856,America,2465,45341,38
2020-04-27T00:00:00Z,27,4,2020,1543,95,Canada,CA,CAN,37058856,America,2560,46884,39
2020-04-28T00:00:00Z,28,4,2020,1605,147,Canada,CA,CAN,37058856,America,2707,48489,40
2020-04-29T00:00:00Z,29,4,2020,1526,152,Canada,CA,CAN,37058856,America,2859,50015,41
2020-04-30T00:00:00Z,30,4,2020,1572,137,Canada,CA,CAN,37058856,America,2996,51587,42
2020-05-01T00:00:00Z,1,5,2020,1649,188,Canada,CA,CAN,37058856,America,3184,53236,43
2020-05-02T00:00:00Z,2,5,2020,1825,207,Canada,CA,CAN,37058856,America,3391,55061,44
2020-05-03T00:00:00Z,3,5,2020,1653,175,Canada,CA,CAN,37058856,America,3566,56714,45
2020-05-04T00:00:00Z,4,5,2020,2760,116,Canada,CA,CAN,37058856,America,3682,59474,46
2020-05-05T00:00:00Z,5,5,2020,1298,172,Canada,CA,CAN,37058856,America,3854,60772,47
2020-05-06T00:00:00Z,6,5,2020,1274,189,Canada,CA,CAN,37058856,America,4043,62046,48
2020-05-07T00:00:00Z,7,5,2020,1450,189,Canada,CA,CAN,37058856,America,4232,63496,49
2020-05-08T00:00:00Z,8,5,2020,1426,176,Canada,CA,CAN,37058856,America,4408,64922,50
2020-05-09T00:00:00Z,9,5,2020,1512,161,Canada,CA,CAN,37058856,America,4569,66434,51
2020-05-10T00:00:00Z,10,5,2020,1268,124,Canada,CA,CAN,37058856,America,4693,67702,52
2020-05-11T00:00:00Z,11,5,2020,1146,178,Canada,CA,CAN,37058856,America,4871,68848,53
2020-05-12T00:00:00Z,12,5,2020,1133,122,Canada,CA,CAN,37058856,America,4993,69981,54
2020-05-13T00:00:00Z,13,5,2020,1176,176,Canada,CA,CAN,37058856,America,5169,71157,55
2020-05-14T00:00:00Z,14,5,2020,1121,135,Canada,CA,CAN,37058856,America,5304,72278,56
2020-05-15T00:00:00Z,15,5,2020,1123,168,Canada,CA,CAN,37058856,America,5472,73401,57
2020-05-16T00:00:00Z,16,5,2020,1201,90,Canada,CA,CAN,37058856,America,5562,74602,58
2020-05-17T00:00:00Z,17,5,2020,1251,117,Canada,CA,CAN,37058856,America,5679,75853,59
2020-05-18T00:00:00Z,18,5,2020,1138,103,Canada,CA,CAN,37058856,America,5782,76991,60
2020-05-19T00:00:00Z,19,5,2020,1070,60,Canada,CA,CAN,37058856,America,5842,78061,61
2020-05-20T00:00:00Z,20,5,2020,1040,70,Canada,CA,CAN,37058856,America,5912,79101,62
2020-05-21T00:00:00Z,21,5,2020,990,118,Canada,CA,CAN,37058856,America,6030,80091,63
2020-05-22T00:00:00Z,22,5,2020,1222,122,Canada,CA,CAN,37058856,America,6152,81313,64
2020-05-23T00:00:00Z,23,5,2020,1156,98,Canada,CA,CAN,37058856,America,6250,82469,65
2020-05-24T00:00:00Z,24,5,2020,1141,105,Canada,CA,CAN,37058856,America,6355,83610,66
2020-05-25T00:00:00Z,25,5,2020,1078,69,Canada,CA,CAN,37058856,America,6424,84688,67
2020-05-26T00:00:00Z,26,5,2020,1012,121,Canada,CA,CAN,37058856,America,6545,85700,68
2020-05-27T00:00:00Z,27,5,2020,936,94,Canada,CA,CAN,37058856,America,6639,86636,69
2020-05-03T00:00:00Z,3,5,2020,44,5,Chad,TD,TCD,15477751,Africa,10,117,1
2020-05-04T00:00:00Z,4,5,2020,0,0,Chad,TD,TCD,15477751,Africa,10,117,2
2020-05-05T00:00:00Z,5,5,2020,0,0,Chad,TD,TCD,15477751,Africa,10,117,3
2020-05-06T00:00:00Z,6,5,2020,53,7,Chad,TD,TCD,15477751,Africa,17,170,4
2020-05-07T00:00:00Z,7,5,2020,0,0,Chad,TD,TCD,15477751,Africa,17,170,5
2020-05-08T00:00:00Z,8,5,2020,83,10,Chad,TD,TCD,15477751,Africa,27,253,6
2020-05-09T00:00:00Z,9,5,2020,7,1,Chad,TD,TCD,15477751,Africa,28,260,7
2020-05-10T00:00:00Z,10,5,2020,62,3,Chad,TD,TCD,15477751,Africa,31,322,8
2020-05-11T00:00:00Z,11,5,2020,0,0,Chad,TD,TCD,15477751,Africa,31,322,9
2020-05-12T00:00:00Z,12,5,2020,0,0,Chad,TD,TCD,15477751,Africa,31,322,10
2020-05-13T00:00:00Z,13,5,2020,35,9,Chad,TD,TCD,15477751,Africa,40,357,11
2020-05-14T00:00:00Z,14,5,2020,15,2,Chad,TD,TCD,15477751,Africa,42,372,12
2020-05-15T00:00:00Z,15,5,2020,27,4,Chad,TD,TCD,15477751,Africa,46,399,13
2020-05-16T00:00:00Z,16,5,2020,29,2,Chad,TD,TCD,15477751,Africa,48,428,14
2020-05-17T00:00:00Z,17,5,2020,46,2,Chad,TD,TCD,15477751,Africa,50,474,15
2020-05-18T00:00:00Z,18,5,2020,29,3,Chad,TD,TCD,15477751,Africa,53,503,16
2020-05-19T00:00:00Z,19,5,2020,16,0,Chad,TD,TCD,15477751,Africa,53,519,17
2020-05-20T00:00:00Z,20,5,2020,26,3,Chad,TD,TCD,15477751,Africa,56,545,18
2020-05-21T00:00:00Z,21,5,2020,20,1,Chad,TD,TCD,15477751,Africa,57,565,19
2020-05-22T00:00:00Z,22,5,2020,23,1,Chad,TD,TCD,15477751,Africa,58,588,20
2020-05-23T00:00:00Z,23,5,2020,23,1,Chad,TD,TCD,15477751,Africa,59,611,21
2020-05-24T00:00:00Z,24,5,2020,37,1,Chad,TD,TCD,15477751,Africa,60,648,22
2020-05-25T00:00:00Z,25,5,2020,27,0,Chad,TD,TCD,15477751,Africa,60,675,23
2020-05-26T00:00:00Z,26,5,2020,12,1,Chad,TD,TCD,15477751,Africa,61,687,24
2020-05-27T00:00:00Z,27,5,2020,13,1,Chad,TD,TCD,15477751,Africa,62,700,25
2020-04-01T00:00:00Z,1,4,2020,289,4,Chile,CL,CHL,18729160,America,12,2738,1
2020-04-02T00:00:00Z,2,4,2020,293,4,Chile,CL,CHL,18729160,America,16,3031,2
2020-04-03T00:00:00Z,3,4,2020,373,2,Chile,CL,CHL,18729160,America,18,3404,3
2020-04-04T00:00:00Z,4,4,2020,333,4,Chile,CL,CHL,18729160,America,22,3737,4
2020-04-05T00:00:00Z,5,4,2020,424,5,Chile,CL,CHL,18729160,America,27,4161,5
2020-04-06T00:00:00Z,6,4,2020,310,7,Chile,CL,CHL,18729160,America,34,4471,6
2020-04-07T00:00:00Z,7,4,2020,344,3,Chile,CL,CHL,18729160,America,37,4815,7
2020-04-08T00:00:00Z,8,4,2020,301,6,Chile,CL,CHL,18729160,America,43,5116,8
2020-04-09T00:00:00Z,9,4,2020,430,5,Chile,CL,CHL,18729160,America,48,5546,9
2020-04-10T00:00:00Z,10,4,2020,426,9,Chile,CL,CHL,18729160,America,57,5972,10
2020-04-11T00:00:00Z,11,4,2020,529,8,Chile,CL,CHL,18729160,America,65,6501,11
2020-04-12T00:00:00Z,12,4,2020,426,8,Chile,CL,CHL,18729160,America,73,6927,12
2020-04-13T00:00:00Z,13,4,2020,286,7,Chile,CL,CHL,18729160,America,80,7213,13
2020-04-14T00:00:00Z,14,4,2020,312,2,Chile,CL,CHL,18729160,America,82,7525,14
2020-04-15T00:00:00Z,15,4,2020,392,10,Chile,CL,CHL,18729160,America,92,7917,15
2020-04-16T00:00:00Z,16,4,2020,356,2,Chile,CL,CHL,18729160,America,94,8273,16
2020-04-17T00:00:00Z,17,4,2020,534,11,Chile,CL,CHL,18729160,America,105,8807,17
2020-04-18T00:00:00Z,18,4,2020,445,11,Chile,CL,CHL,18729160,America,116,9252,18
2020-04-19T00:00:00Z,19,4,2020,478,10,Chile,CL,CHL,18729160,America,126,9730,19
2020-04-20T00:00:00Z,20,4,2020,358,7,Chile,CL,CHL,18729160,America,133,10088,20
2020-04-21T00:00:00Z,21,4,2020,419,6,Chile,CL,CHL,18729160,America,139,10507,21
2020-04-22T00:00:00Z,22,4,2020,325,8,Chile,CL,CHL,18729160,America,147,10832,22
2020-04-23T00:00:00Z,23,4,2020,464,13,Chile,CL,CHL,18729160,America,160,11296,23
2020-04-24T00:00:00Z,24,4,2020,516,8,Chile,CL,CHL,18729160,America,168,11812,24
2020-04-25T00:00:00Z,25,4,2020,494,6,Chile,CL,CHL,18729160,America,174,12306,25
2020-04-26T00:00:00Z,26,4,2020,552,7,Chile,CL,CHL,18729160,America,181,12858,26
2020-04-27T00:00:00Z,27,4,2020,473,8,Chile,CL,CHL,18729160,America,189,13331,27
2020-04-28T00:00:00Z,28,4,2020,482,9,Chile,CL,CHL,18729160,America,198,13813,28
2020-04-29T00:00:00Z,29,4,2020,552,9,Chile,CL,CHL,18729160,America,207,14365,29
2020-04-30T00:00:00Z,30,4,2020,520,9,Chile,CL,CHL,18729160,America,216,14885,30
2020-05-01T00:00:00Z,1,5,2020,1138,11,Chile,CL,CHL,18729160,America,227,16023,31
2020-05-02T00:00:00Z,2,5,2020,985,7,Chile,CL,CHL,18729160,America,234,17008,32
2020-05-03T00:00:00Z,3,5,2020,1427,13,Chile,CL,CHL,18729160,America,247,18435,33
2020-05-04T00:00:00Z,4,5,2020,1228,13,Chile,CL,CHL,18729160,America,260,19663,34
2020-05-05T00:00:00Z,5,5,2020,980,10,Chile,CL,CHL,18729160,America,270,20643,35
2020-05-06T00:00:00Z,6,5,2020,1373,5,Chile,CL,CHL,18729160,America,275,22016,36
2020-05-07T00:00:00Z,7,5,2020,1032,6,Chile,CL,CHL,18729160,America,281,23048,37
2020-05-08T00:00:00Z,8,5,2020,1533,4,Chile,CL,CHL,18729160,America,285,24581,38
2020-05-09T00:00:00Z,9,5,2020,1391,9,Chile,CL,CHL,18729160,America,294,25972,39
2020-05-10T00:00:00Z,10,5,2020,1247,10,Chile,CL,CHL,18729160,America,304,27219,40
2020-05-11T00:00:00Z,11,5,2020,1647,8,Chile,CL,CHL,18729160,America,312,28866,41
2020-05-12T00:00:00Z,12,5,2020,1197,11,Chile,CL,CHL,18729160,America,323,30063,42
2020-05-13T00:00:00Z,13,5,2020,1658,12,Chile,CL,CHL,18729160,America,335,31721,43
2020-05-14T00:00:00Z,14,5,2020,2660,11,Chile,CL,CHL,18729160,America,346,34381,44
2020-05-15T00:00:00Z,15,5,2020,2659,12,Chile,CL,CHL,18729160,America,358,37040,45
2020-05-16T00:00:00Z,16,5,2020,2502,36,Chile,CL,CHL,18729160,America,394,39542,46
2020-05-17T00:00:00Z,17,5,2020,1886,27,Chile,CL,CHL,18729160,America,421,41428,47
2020-05-18T00:00:00Z,18,5,2020,2353,29,Chile,CL,CHL,18729160,America,450,43781,48
2020-05-19T00:00:00Z,19,5,2020,2278,28,Chile,CL,CHL,18729160,America,478,46059,49
2020-05-20T00:00:00Z,20,5,2020,3520,31,Chile,CL,CHL,18729160,America,509,49579,50
2020-05-21T00:00:00Z,21,5,2020,4038,35,Chile,CL,CHL,18729160,America,544,53617,51
2020-05-22T00:00:00Z,22,5,2020,3964,45,Chile,CL,CHL,18729160,America,589,57581,52
2020-05-23T00:00:00Z,23,5,2020,4276,41,Chile,CL,CHL,18729160,America,630,61857,53
2020-05-24T00:00:00Z,24,5,2020,3536,43,Chile,CL,CHL,18729160,America,673,65393,54
2020-05-25T00:00:00Z,25,5,2020,3709,45,Chile,CL,CHL,18729160,America,718,69102,55
2020-05-26T00:00:00Z,26,5,2020,4895,43,Chile,CL,CHL,18729160,America,761,73997,56
2020-05-27T00:00:00Z,27,5,2020,3964,45,Chile,CL,CHL,18729160,America,806,77961,57
2020-01-22T00:00:00Z,22,1,2020,140,11,China,CN,CHN,1392730000,Asia,17,526,1
2020-01-23T00:00:00Z,23,1,2020,97,0,China,CN,CHN,1392730000,Asia,17,623,2
2020-01-24T00:00:00Z,24,1,2020,259,9,China,CN,CHN,1392730000,Asia,26,882,3
2020-01-25T00:00:00Z,25,1,2020,441,15,China,CN,CHN,1392730000,Asia,41,1323,4
2020-01-26T00:00:00Z,26,1,2020,665,15,China,CN,CHN,1392730000,Asia,56,1988,5
2020-01-27T00:00:00Z,27,1,2020,787,25,China,CN,CHN,1392730000,Asia,81,2775,6
2020-01-28T00:00:00Z,28,1,2020,1753,25,China,CN,CHN,1392730000,Asia,106,4528,7
2020-01-29T00:00:00Z,29,1,2020,1466,26,China,CN,CHN,1392730000,Asia,132,5994,8
2020-01-30T00:00:00Z,30,1,2020,1740,38,China,CN,CHN,1392730000,Asia,170,7734,9
2020-01-31T00:00:00Z,31,1,2020,1980,43,China,CN,CHN,1392730000,Asia,213,9714,10
2020-02-01T00:00:00Z,1,2,2020,2095,46,China,CN,CHN,1392730000,Asia,259,11809,11
2020-02-02T00:00:00Z,2,2,2020,2590,45,China,CN,CHN,1392730000,Asia,304,14399,12
2020-02-03T00:00:00Z,3,2,2020,2812,57,China,CN,CHN,1392730000,Asia,361,17211,13
2020-02-04T00:00:00Z,4,2,2020,3237,65,China,CN,CHN,1392730000,Asia,426,20448,14
2020-02-05T00:00:00Z,5,2,2020,3872,66,China,CN,CHN,1392730000,Asia,492,24320,15
2020-02-06T00:00:00Z,6,2,2020,3727,72,China,CN,CHN,1392730000,Asia,564,28047,16
2020-02-07T00:00:00Z,7,2,2020,3160,73,China,CN,CHN,1392730000,Asia,637,31207,17
2020-02-08T00:00:00Z,8,2,2020,3418,86,China,CN,CHN,1392730000,Asia,723,34625,18
2020-02-09T00:00:00Z,9,2,2020,2607,89,China,CN,CHN,1392730000,Asia,812,37232,19
2020-02-10T00:00:00Z,10,2,2020,2974,97,China,CN,CHN,1392730000,Asia,909,40206,20
2020-02-11T00:00:00Z,11,2,2020,2490,108,China,CN,CHN,1392730000,Asia,1017,42696,21
2020-02-12T00:00:00Z,12,2,2020,2028,97,China,CN,CHN,1392730000,Asia,1114,44724,22
2020-02-13T00:00:00Z,13,2,2020,15141,254,China,CN,CHN,1392730000,Asia,1368,59865,23
2020-02-14T00:00:00Z,14,2,2020,4156,13,China,CN,CHN,1392730000,Asia,1381,64021,24
2020-02-15T00:00:00Z,15,2,2020,2538,143,China,CN,CHN,1392730000,Asia,1524,66559,25
2020-02-16T00:00:00Z,16,2,2020,2007,142,China,CN,CHN,1392730000,Asia,1666,68566,26
2020-02-17T00:00:00Z,17,2,2020,2052,105,China,CN,CHN,1392730000,Asia,1771,70618,27
2020-02-18T00:00:00Z,18,2,2020,1890,98,China,CN,CHN,1392730000,Asia,1869,72508,28
2020-02-19T00:00:00Z,19,2,2020,1750,139,China,CN,CHN,1392730000,Asia,2008,74258,29
2020-02-20T00:00:00Z,20,2,2020,394,112,China,CN,CHN,1392730000,Asia,2120,74652,30
2020-02-21T00:00:00Z,21,2,2020,891,118,China,CN,CHN,1392730000,Asia,2238,75543,31
2020-02-22T00:00:00Z,22,2,2020,826,109,China,CN,CHN,1392730000,Asia,2347,76369,32
2020-02-23T00:00:00Z,23,2,2020,647,98,China,CN,CHN,1392730000,Asia,2445,77016,33
2020-02-24T00:00:00Z,24,2,2020,218,150,China,CN,CHN,1392730000,Asia,2595,77234,34
2020-02-25T00:00:00Z,25,2,2020,515,70,China,CN,CHN,1392730000,Asia,2665,77749,35
2020-02-26T00:00:00Z,26,2,2020,410,52,China,CN,CHN,1392730000,Asia,2717,78159,36
2020-02-27T00:00:00Z,27,2,2020,439,29,China,CN,CHN,1392730000,Asia,2746,78598,37
2020-02-28T00:00:00Z,28,2,2020,329,44,China,CN,CHN,1392730000,Asia,2790,78927,38
2020-02-29T00:00:00Z,29,2,2020,428,47,China,CN,CHN,1392730000,Asia,2837,79355,39
2020-03-01T00:00:00Z,1,3,2020,574,35,China,CN,CHN,1392730000,Asia,2872,79929,40
2020-03-02T00:00:00Z,2,3,2020,205,42,China,CN,CHN,1392730000,Asia,2914,80134,41
2020-03-03T00:00:00Z,3,3,2020,127,32,China,CN,CHN,1392730000,Asia,2946,80261,42
2020-03-04T00:00:00Z,4,3,2020,119,37,China,CN,CHN,1392730000,Asia,2983,80380,43
2020-03-05T00:00:00Z,5,3,2020,117,31,China,CN,CHN,1392730000,Asia,3014,80497,44
2020-03-06T00:00:00Z,6,3,2020,170,30,China,CN,CHN,1392730000,Asia,3044,80667,45
2020-03-07T00:00:00Z,7,3,2020,101,28,China,CN,CHN,1392730000,Asia,3072,80768,46
2020-03-08T00:00:00Z,8,3,2020,46,27,China,CN,CHN,1392730000,Asia,3099,80814,47
2020-03-09T00:00:00Z,9,3,2020,45,23,China,CN,CHN,1392730000,Asia,3122,80859,48
2020-03-10T00:00:00Z,10,3,2020,20,17,China,CN,CHN,1392730000,Asia,3139,80879,49
2020-03-11T00:00:00Z,11,3,2020,29,22,China,CN,CHN,1392730000,Asia,3161,80908,50
2020-03-12T00:00:00Z,12,3,2020,24,11,China,CN,CHN,1392730000,Asia,3172,80932,51
2020-03-13T00:00:00Z,13,3,2020,22,7,China,CN,CHN,1392730000,Asia,3179,80954,52
2020-03-14T00:00:00Z,14,3,2020,19,15,China,CN,CHN,1392730000,Asia,3194,80973,53
2020-03-15T00:00:00Z,15,3,2020,22,9,China,CN,CHN,1392730000,Asia,3203,80995,54
2020-03-16T00:00:00Z,16,3,2020,25,13,China,CN,CHN,1392730000,Asia,3216,81020,55
2020-03-17T00:00:00Z,17,3,2020,43,9,China,CN,CHN,1392730000,Asia,3225,81063,56
2020-03-18T00:00:00Z,18,3,2020,23,16,China,CN,CHN,1392730000,Asia,3241,81086,57
2020-03-19T00:00:00Z,19,3,2020,44,8,China,CN,CHN,1392730000,Asia,3249,81130,58
2020-03-20T00:00:00Z,20,3,2020,99,4,China,CN,CHN,1392730000,Asia,3253,81229,59
2020-03-21T00:00:00Z,21,3,2020,52,6,China,CN,CHN,1392730000,Asia,3259,81281,60
2020-03-22T00:00:00Z,22,3,2020,65,6,China,CN,CHN,1392730000,Asia,3265,81346,61
2020-03-23T00:00:00Z,23,3,2020,138,9,China,CN,CHN,1392730000,Asia,3274,81484,62
2020-03-24T00:00:00Z,24,3,2020,69,7,China,CN,CHN,1392730000,Asia,3281,81553,63
2020-03-25T00:00:00Z,25,3,2020,78,4,China,CN,CHN,1392730000,Asia,3285,81631,64
2020-03-26T00:00:00Z,26,3,2020,102,6,China,CN,CHN,1392730000,Asia,3291,81733,65
2020-03-27T00:00:00Z,27,3,2020,94,5,China,CN,CHN,1392730000,Asia,3296,81827,66
2020-03-28T00:00:00Z,28,3,2020,119,3,China,CN,CHN,1392730000,Asia,3299,81946,67
2020-03-29T00:00:00Z,29,3,2020,113,5,China,CN,CHN,1392730000,Asia,3304,82059,68
2020-03-30T00:00:00Z,30,3,2020,98,2,China,CN,CHN,1392730000,Asia,3306,82157,69
2020-03-31T00:00:00Z,31,3,2020,84,3,China,CN,CHN,1392730000,Asia,3309,82241,70
2020-04-01T00:00:00Z,1,4,2020,54,1,China,CN,CHN,1392730000,Asia,3310,82295,71
2020-04-02T00:00:00Z,2,4,2020,100,6,China,CN,CHN,1392730000,Asia,3316,82395,72
2020-04-03T00:00:00Z,3,4,2020,70,10,China,CN,CHN,1392730000,Asia,3326,82465,73
2020-04-04T00:00:00Z,4,4,2020,62,4,China,CN,CHN,1392730000,Asia,3330,82527,74
2020-04-05T00:00:00Z,5,4,2020,48,3,China,CN,CHN,1392730000,Asia,3333,82575,75
2020-04-06T00:00:00Z,6,4,2020,67,2,China,CN,CHN,1392730000,Asia,3335,82642,76
2020-04-07T00:00:00Z,7,4,2020,56,0,China,CN,CHN,1392730000,Asia,3335,82698,77
2020-04-08T00:00:00Z,8,4,2020,86,2,China,CN,CHN,1392730000,Asia,3337,82784,78
2020-04-09T00:00:00Z,9,4,2020,86,2,China,CN,CHN,1392730000,Asia,3339,82870,79
2020-04-10T00:00:00Z,10,4,2020,55,1,China,CN,CHN,1392730000,Asia,3340,82925,80
2020-04-11T00:00:00Z,11,4,2020,79,3,China,CN,CHN,1392730000,Asia,3343,83004,81
2020-04-12T00:00:00Z,12,4,2020,93,0,China,CN,CHN,1392730000,Asia,3343,83097,82
2020-04-13T00:00:00Z,13,4,2020,112,2,China,CN,CHN,1392730000,Asia,3345,83209,83
2020-04-14T00:00:00Z,14,4,2020,94,0,China,CN,CHN,1392730000,Asia,3345,83303,84
2020-04-15T00:00:00Z,15,4,2020,49,1,China,CN,CHN,1392730000,Asia,3346,83352,85
2020-04-16T00:00:00Z,16,4,2020,50,0,China,CN,CHN,1392730000,Asia,3346,83402,86
2020-04-17T00:00:00Z,17,4,2020,352,1290,China,CN,CHN,1392730000,Asia,4636,83754,87
2020-04-18T00:00:00Z,18,4,2020,31,0,China,CN,CHN,1392730000,Asia,4636,83785,88
2020-04-19T00:00:00Z,19,4,2020,18,0,China,CN,CHN,1392730000,Asia,4636,83803,89
2020-04-20T00:00:00Z,20,4,2020,14,0,China,CN,CHN,1392730000,Asia,4636,83817,90
2020-04-21T00:00:00Z,21,4,2020,32,0,China,CN,CHN,1392730000,Asia,4636,83849,91
2020-04-22T00:00:00Z,22,4,2020,15,0,China,CN,CHN,1392730000,Asia,4636,83864,92
2020-04-23T00:00:00Z,23,4,2020,12,0,China,CN,CHN,1392730000,Asia,4636,83876,93
2020-04-24T00:00:00Z,24,4,2020,8,0,China,CN,CHN,1392730000,Asia,4636,83884,94
2020-04-25T00:00:00Z,25,4,2020,15,0,China,CN,CHN,1392730000,Asia,4636,83899,95
2020-04-26T00:00:00Z,26,4,2020,10,0,China,CN,CHN,1392730000,Asia,4636,83909,96
2020-04-27T00:00:00Z,27,4,2020,3,1,China,CN,CHN,1392730000,Asia,4637,83912,97
2020-04-28T00:00:00Z,28,4,2020,26,0,China,CN,CHN,1392730000,Asia,4637,83938,98
2020-04-29T00:00:00Z,29,4,2020,2,0,China,CN,CHN,1392730000,Asia,4637,83940,99
2020-04-30T00:00:00Z,30,4,2020,4,0,China,CN,CHN,1392730000,Asia,4637,83944,100
2020-05-01T00:00:00Z,1,5,2020,12,0,China,CN,CHN,1392730000,Asia,4637,83956,101
2020-05-02T00:00:00Z,2,5,2020,3,0,China,CN,CHN,1392730000,Asia,4637,83959,102
2020-05-03T00:00:00Z,3,5,2020,2,0,China,CN,CHN,1392730000,Asia,4637,83961,103
2020-05-04T00:00:00Z,4,5,2020,3,0,China,CN,CHN,1392730000,Asia,4637,83964,104
2020-05-05T00:00:00Z,5,5,2020,2,0,China,CN,CHN,1392730000,Asia,4637,83966,105
2020-05-06T00:00:00Z,6,5,2020,2,0,China,CN,CHN,1392730000,Asia,4637,83968,106
2020-05-07T00:00:00Z,7,5,2020,2,0,China,CN,CHN,1392730000,Asia,4637,83970,107
2020-05-08T00:00:00Z,8,5,2020,6,0,China,CN,CHN,1392730000,Asia,4637,83976,108
2020-05-09T00:00:00Z,9,5,2020,0,0,China,CN,CHN,1392730000,Asia,4637,83976,109
2020-05-10T00:00:00Z,10,5,2020,15,0,China,CN,CHN,1392730000,Asia,4637,83991,110
2020-05-11T00:00:00Z,11,5,2020,19,0,China,CN,CHN,1392730000,Asia,4637,84010,111
2020-05-12T00:00:00Z,12,5,2020,1,0,China,CN,CHN,1392730000,Asia,4637,84011,112
2020-05-13T00:00:00Z,13,5,2020,7,0,China,CN,CHN,1392730000,Asia,4637,84018,113
2020-05-14T00:00:00Z,14,5,2020,6,0,China,CN,CHN,1392730000,Asia,4637,84024,114
2020-05-15T00:00:00Z,15,5,2020,5,0,China,CN,CHN,1392730000,Asia,4637,84029,115
2020-05-16T00:00:00Z,16,5,2020,9,0,China,CN,CHN,1392730000,Asia,4637,84038,116
2020-05-17T00:00:00Z,17,5,2020,6,1,China,CN,CHN,1392730000,Asia,4638,84044,117
2020-05-18T00:00:00Z,18,5,2020,10,0,China,CN,CHN,1392730000,Asia,4638,84054,118
2020-05-19T00:00:00Z,19,5,2020,9,0,China,CN,CHN,1392730000,Asia,4638,84063,119
2020-05-20T00:00:00Z,20,5,2020,2,0,China,CN,CHN,1392730000,Asia,4638,84065,120
2020-05-21T00:00:00Z,21,5,2020,2,0,China,CN,CHN,1392730000,Asia,4638,84067,121
2020-05-22T00:00:00Z,22,5,2020,12,0,China,CN,CHN,1392730000,Asia,4638,84079,122
2020-05-23T00:00:00Z,23,5,2020,2,0,China,CN,CHN,1392730000,Asia,4638,84081,123
2020-05-24T00:00:00Z,24,5,2020,3,0,China,CN,CHN,1392730000,Asia,4638,84084,124
2020-05-25T00:00:00Z,25,5,2020,11,0,China,CN,CHN,1392730000,Asia,4638,84095,125
2020-05-26T00:00:00Z,26,5,2020,7,0,China,CN,CHN,1392730000,Asia,4638,84102,126
2020-05-27T00:00:00Z,27,5,2020,1,0,China,CN,CHN,1392730000,Asia,4638,84103,127
2020-03-30T00:00:00Z,30,3,2020,94,4,Colombia,CO,COL,49648685,America,10,702,1
2020-03-31T00:00:00Z,31,3,2020,96,4,Colombia,CO,COL,49648685,America,14,798,2
2020-04-01T00:00:00Z,1,4,2020,108,2,Colombia,CO,COL,49648685,America,16,906,3
2020-04-02T00:00:00Z,2,4,2020,159,1,Colombia,CO,COL,49648685,America,17,1065,4
2020-04-03T00:00:00Z,3,4,2020,96,2,Colombia,CO,COL,49648685,America,19,1161,5
2020-04-04T00:00:00Z,4,4,2020,106,6,Colombia,CO,COL,49648685,America,25,1267,6
2020-04-05T00:00:00Z,5,4,2020,139,7,Colombia,CO,COL,49648685,America,32,1406,7
2020-04-06T00:00:00Z,6,4,2020,79,3,Colombia,CO,COL,49648685,America,35,1485,8
2020-04-07T00:00:00Z,7,4,2020,94,11,Colombia,CO,COL,49648685,America,46,1579,9
2020-04-08T00:00:00Z,8,4,2020,201,4,Colombia,CO,COL,49648685,America,50,1780,10
2020-04-09T00:00:00Z,9,4,2020,274,5,Colombia,CO,COL,49648685,America,55,2054,11
2020-04-10T00:00:00Z,10,4,2020,169,14,Colombia,CO,COL,49648685,America,69,2223,12
2020-04-11T00:00:00Z,11,4,2020,250,11,Colombia,CO,COL,49648685,America,80,2473,13
2020-04-12T00:00:00Z,12,4,2020,236,20,Colombia,CO,COL,49648685,America,100,2709,14
2020-04-13T00:00:00Z,13,4,2020,67,9,Colombia,CO,COL,49648685,America,109,2776,15
2020-04-14T00:00:00Z,14,4,2020,76,3,Colombia,CO,COL,49648685,America,112,2852,16
2020-04-15T00:00:00Z,15,4,2020,127,15,Colombia,CO,COL,49648685,America,127,2979,17
2020-04-16T00:00:00Z,16,4,2020,126,4,Colombia,CO,COL,49648685,America,131,3105,18
2020-04-17T00:00:00Z,17,4,2020,128,13,Colombia,CO,COL,49648685,America,144,3233,19
2020-04-18T00:00:00Z,18,4,2020,206,9,Colombia,CO,COL,49648685,America,153,3439,20
2020-04-19T00:00:00Z,19,4,2020,182,13,Colombia,CO,COL,49648685,America,166,3621,21
2020-04-20T00:00:00Z,20,4,2020,171,13,Colombia,CO,COL,49648685,America,179,3792,22
2020-04-21T00:00:00Z,21,4,2020,185,10,Colombia,CO,COL,49648685,America,189,3977,23
2020-04-22T00:00:00Z,22,4,2020,172,7,Colombia,CO,COL,49648685,America,196,4149,24
2020-04-23T00:00:00Z,23,4,2020,207,10,Colombia,CO,COL,49648685,America,206,4356,25
2020-04-24T00:00:00Z,24,4,2020,205,9,Colombia,CO,COL,49648685,America,215,4561,26
2020-04-25T00:00:00Z,25,4,2020,320,10,Colombia,CO,COL,49648685,America,225,4881,27
2020-04-26T00:00:00Z,26,4,2020,261,8,Colombia,CO,COL,49648685,America,233,5142,28
2020-04-27T00:00:00Z,27,4,2020,237,10,Colombia,CO,COL,49648685,America,243,5379,29
2020-04-28T00:00:00Z,28,4,2020,218,10,Colombia,CO,COL,49648685,America,253,5597,30
2020-04-29T00:00:00Z,29,4,2020,352,16,Colombia,CO,COL,49648685,America,269,5949,31
2020-04-30T00:00:00Z,30,4,2020,262,9,Colombia,CO,COL,49648685,America,278,6211,32
2020-05-01T00:00:00Z,1,5,2020,296,15,Colombia,CO,COL,49648685,America,293,6507,33
2020-05-02T00:00:00Z,2,5,2020,499,21,Colombia,CO,COL,49648685,America,314,7006,34
2020-05-03T00:00:00Z,3,5,2020,279,10,Colombia,CO,COL,49648685,America,324,7285,35
2020-05-04T00:00:00Z,4,5,2020,383,16,Colombia,CO,COL,49648685,America,340,7668,36
2020-05-05T00:00:00Z,5,5,2020,305,18,Colombia,CO,COL,49648685,America,358,7973,37
2020-05-06T00:00:00Z,6,5,2020,640,20,Colombia,CO,COL,49648685,America,378,8613,38
2020-05-07T00:00:00Z,7,5,2020,346,19,Colombia,CO,COL,49648685,America,397,8959,39
2020-05-08T00:00:00Z,8,5,2020,497,10,Colombia,CO,COL,49648685,America,407,9456,40
2020-05-09T00:00:00Z,9,5,2020,595,21,Colombia,CO,COL,49648685,America,428,10051,41
2020-05-10T00:00:00Z,10,5,2020,444,17,Colombia,CO,COL,49648685,America,445,10495,42
2020-05-11T00:00:00Z,11,5,2020,568,18,Colombia,CO,COL,49648685,America,463,11063,43
2020-05-12T00:00:00Z,12,5,2020,550,16,Colombia,CO,COL,49648685,America,479,11613,44
2020-05-13T00:00:00Z,13,5,2020,659,14,Colombia,CO,COL,49648685,America,493,12272,45
2020-05-14T00:00:00Z,14,5,2020,658,16,Colombia,CO,COL,49648685,America,509,12930,46
2020-05-15T00:00:00Z,15,5,2020,680,16,Colombia,CO,COL,49648685,America,525,13610,47
2020-05-16T00:00:00Z,16,5,2020,606,21,Colombia,CO,COL,49648685,America,546,14216,48
2020-05-17T00:00:00Z,17,5,2020,723,16,Colombia,CO,COL,49648685,America,562,14939,49
2020-05-18T00:00:00Z,18,5,2020,635,12,Colombia,CO,COL,49648685,America,574,15574,50
2020-05-19T00:00:00Z,19,5,2020,721,18,Colombia,CO,COL,49648685,America,592,16295,51
2020-05-20T00:00:00Z,20,5,2020,640,21,Colombia,CO,COL,49648685,America,613,16935,52
2020-05-21T00:00:00Z,21,5,2020,752,17,Colombia,CO,COL,49648685,America,630,17687,53
2020-05-22T00:00:00Z,22,5,2020,643,22,Colombia,CO,COL,49648685,America,652,18330,54
2020-05-23T00:00:00Z,23,5,2020,801,30,Colombia,CO,COL,49648685,America,682,19131,55
2020-05-24T00:00:00Z,24,5,2020,1046,23,Colombia,CO,COL,49648685,America,705,20177,56
2020-05-25T00:00:00Z,25,5,2020,998,22,Colombia,CO,COL,49648685,America,727,21175,57
2020-05-26T00:00:00Z,26,5,2020,806,23,Colombia,CO,COL,49648685,America,750,21981,58
2020-05-27T00:00:00Z,27,5,2020,1022,26,Colombia,CO,COL,49648685,America,776,23003,59
2020-05-02T00:00:00Z,2,5,2020,9,1,Congo,CG,COG,5244363,Africa,10,229,1
2020-05-03T00:00:00Z,3,5,2020,0,0,Congo,CG,COG,5244363,Africa,10,229,2
2020-05-04T00:00:00Z,4,5,2020,0,0,Congo,CG,COG,5244363,Africa,10,229,3
2020-05-05T00:00:00Z,5,5,2020,7,0,Congo,CG,COG,5244363,Africa,10,236,4
2020-05-06T00:00:00Z,6,5,2020,0,0,Congo,CG,COG,5244363,Africa,10,236,5
2020-05-07T00:00:00Z,7,5,2020,28,0,Congo,CG,COG,5244363,Africa,10,264,6
2020-05-08T00:00:00Z,8,5,2020,10,0,Congo,CG,COG,5244363,Africa,10,274,7
2020-05-09T00:00:00Z,9,5,2020,13,0,Congo,CG,COG,5244363,Africa,10,287,8
2020-05-10T00:00:00Z,10,5,2020,0,0,Congo,CG,COG,5244363,Africa,10,287,9
2020-05-11T00:00:00Z,11,5,2020,0,0,Congo,CG,COG,5244363,Africa,10,287,10
2020-05-12T00:00:00Z,12,5,2020,46,1,Congo,CG,COG,5244363,Africa,11,333,11
2020-05-13T00:00:00Z,13,5,2020,0,0,Congo,CG,COG,5244363,Africa,11,333,12
2020-05-14T00:00:00Z,14,5,2020,8,0,Congo,CG,COG,5244363,Africa,11,341,13
2020-05-15T00:00:00Z,15,5,2020,50,4,Congo,CG,COG,5244363,Africa,15,391,14
2020-05-16T00:00:00Z,16,5,2020,0,0,Congo,CG,COG,5244363,Africa,15,391,15
2020-05-17T00:00:00Z,17,5,2020,21,0,Congo,CG,COG,5244363,Africa,15,412,16
2020-05-18T00:00:00Z,18,5,2020,0,0,Congo,CG,COG,5244363,Africa,15,412,17
2020-05-19T00:00:00Z,19,5,2020,0,0,Congo,CG,COG,5244363,Africa,15,412,18
2020-05-20T00:00:00Z,20,5,2020,8,0,Congo,CG,COG,5244363,Africa,15,420,19
2020-05-21T00:00:00Z,21,5,2020,0,0,Congo,CG,COG,5244363,Africa,15,420,20
2020-05-22T00:00:00Z,22,5,2020,49,1,Congo,CG,COG,5244363,Africa,16,469,21
2020-05-23T00:00:00Z,23,5,2020,0,0,Congo,CG,COG,5244363,Africa,16,469,22
2020-05-24T00:00:00Z,24,5,2020,18,0,Congo,CG,COG,5244363,Africa,16,487,23
2020-05-25T00:00:00Z,25,5,2020,0,0,Congo,CG,COG,5244363,Africa,16,487,24
2020-05-26T00:00:00Z,26,5,2020,44,1,Congo,CG,COG,5244363,Africa,17,531,25
2020-05-27T00:00:00Z,27,5,2020,38,2,Congo,CG,COG,5244363,Africa,19,569,26
2020-05-17T00:00:00Z,17,5,2020,10,2,Costa_Rica,CR,CRI,4999441,America,10,853,1
2020-05-18T00:00:00Z,18,5,2020,10,0,Costa_Rica,CR,CRI,4999441,America,10,863,2
2020-05-19T00:00:00Z,19,5,2020,3,0,Costa_Rica,CR,CRI,4999441,America,10,866,3
2020-05-20T00:00:00Z,20,5,2020,16,0,Costa_Rica,CR,CRI,4999441,America,10,882,4
2020-05-21T00:00:00Z,21,5,2020,15,0,Costa_Rica,CR,CRI,4999441,America,10,897,5
2020-05-22T00:00:00Z,22,5,2020,6,0,Costa_Rica,CR,CRI,4999441,America,10,903,6
2020-05-23T00:00:00Z,23,5,2020,8,0,Costa_Rica,CR,CRI,4999441,America,10,911,7
2020-05-24T00:00:00Z,24,5,2020,7,0,Costa_Rica,CR,CRI,4999441,America,10,918,8
2020-05-25T00:00:00Z,25,5,2020,12,0,Costa_Rica,CR,CRI,4999441,America,10,930,9
2020-05-26T00:00:00Z,26,5,2020,21,0,Costa_Rica,CR,CRI,4999441,America,10,951,10
2020-05-27T00:00:00Z,27,5,2020,5,0,Costa_Rica,CR,CRI,4999441,America,10,956,11
2020-04-21T00:00:00Z,21,4,2020,32,1,Cote_dIvoire,CI,CIV,25069229,Africa,10,879,1
2020-04-22T00:00:00Z,22,4,2020,37,3,Cote_dIvoire,CI,CIV,25069229,Africa,13,916,2
2020-04-23T00:00:00Z,23,4,2020,36,1,Cote_dIvoire,CI,CIV,25069229,Africa,14,952,3
2020-04-24T00:00:00Z,24,4,2020,52,0,Cote_dIvoire,CI,CIV,25069229,Africa,14,1004,4
2020-04-25T00:00:00Z,25,4,2020,73,0,Cote_dIvoire,CI,CIV,25069229,Africa,14,1077,5
2020-04-26T00:00:00Z,26,4,2020,34,0,Cote_dIvoire,CI,CIV,25069229,Africa,14,1111,6
2020-04-27T00:00:00Z,27,4,2020,39,0,Cote_dIvoire,CI,CIV,25069229,Africa,14,1150,7
2020-04-28T00:00:00Z,28,4,2020,14,0,Cote_dIvoire,CI,CIV,25069229,Africa,14,1164,8
2020-04-29T00:00:00Z,29,4,2020,19,0,Cote_dIvoire,CI,CIV,25069229,Africa,14,1183,9
2020-04-30T00:00:00Z,30,4,2020,55,0,Cote_dIvoire,CI,CIV,25069229,Africa,14,1238,10
2020-05-01T00:00:00Z,1,5,2020,37,0,Cote_dIvoire,CI,CIV,25069229,Africa,14,1275,11
2020-05-02T00:00:00Z,2,5,2020,58,1,Cote_dIvoire,CI,CIV,25069229,Africa,15,1333,12
2020-05-03T00:00:00Z,3,5,2020,29,0,Cote_dIvoire,CI,CIV,25069229,Africa,15,1362,13
2020-05-04T00:00:00Z,4,5,2020,36,2,Cote_dIvoire,CI,CIV,25069229,Africa,17,1398,14
2020-05-05T00:00:00Z,5,5,2020,34,0,Cote_dIvoire,CI,CIV,25069229,Africa,17,1432,15
2020-05-06T00:00:00Z,6,5,2020,32,1,Cote_dIvoire,CI,CIV,25069229,Africa,18,1464,16
2020-05-07T00:00:00Z,7,5,2020,52,0,Cote_dIvoire,CI,CIV,25069229,Africa,18,1516,17
2020-05-08T00:00:00Z,8,5,2020,55,2,Cote_dIvoire,CI,CIV,25069229,Africa,20,1571,18
2020-05-09T00:00:00Z,9,5,2020,31,0,Cote_dIvoire,CI,CIV,25069229,Africa,20,1602,19
2020-05-10T00:00:00Z,10,5,2020,65,1,Cote_dIvoire,CI,CIV,25069229,Africa,21,1667,20
2020-05-11T00:00:00Z,11,5,2020,33,0,Cote_dIvoire,CI,CIV,25069229,Africa,21,1700,21
2020-05-12T00:00:00Z,12,5,2020,30,0,Cote_dIvoire,CI,CIV,25069229,Africa,21,1730,22
2020-05-13T00:00:00Z,13,5,2020,127,0,Cote_dIvoire,CI,CIV,25069229,Africa,21,1857,23
2020-05-14T00:00:00Z,14,5,2020,55,3,Cote_dIvoire,CI,CIV,25069229,Africa,24,1912,24
2020-05-15T00:00:00Z,15,5,2020,59,0,Cote_dIvoire,CI,CIV,25069229,Africa,24,1971,25
2020-05-16T00:00:00Z,16,5,2020,46,0,Cote_dIvoire,CI,CIV,25069229,Africa,24,2017,26
2020-05-17T00:00:00Z,17,5,2020,44,1,Cote_dIvoire,CI,CIV,25069229,Africa,25,2061,27
2020-05-18T00:00:00Z,18,5,2020,48,2,Cote_dIvoire,CI,CIV,25069229,Africa,27,2109,28
2020-05-19T00:00:00Z,19,5,2020,10,1,Cote_dIvoire,CI,CIV,25069229,Africa,28,2119,29
2020-05-20T00:00:00Z,20,5,2020,34,0,Cote_dIvoire,CI,CIV,25069229,Africa,28,2153,30
2020-05-21T00:00:00Z,21,5,2020,78,1,Cote_dIvoire,CI,CIV,25069229,Africa,29,2231,31
2020-05-22T00:00:00Z,22,5,2020,0,0,Cote_dIvoire,CI,CIV,25069229,Africa,29,2231,32
2020-05-23T00:00:00Z,23,5,2020,70,0,Cote_dIvoire,CI,CIV,25069229,Africa,29,2301,33
2020-05-24T00:00:00Z,24,5,2020,65,1,Cote_dIvoire,CI,CIV,25069229,Africa,30,2366,34
2020-05-25T00:00:00Z,25,5,2020,10,0,Cote_dIvoire,CI,CIV,25069229,Africa,30,2376,35
2020-05-26T00:00:00Z,26,5,2020,47,0,Cote_dIvoire,CI,CIV,25069229,Africa,30,2423,36
2020-05-27T00:00:00Z,27,5,2020,54,0,Cote_dIvoire,CI,CIV,25069229,Africa,30,2477,37
2020-04-05T00:00:00Z,5,4,2020,47,4,Croatia,HR,HRV,4089400,Europe,12,1126,1
2020-04-06T00:00:00Z,6,4,2020,56,3,Croatia,HR,HRV,4089400,Europe,15,1182,2
2020-04-07T00:00:00Z,7,4,2020,40,1,Croatia,HR,HRV,4089400,Europe,16,1222,3
2020-04-08T00:00:00Z,8,4,2020,60,2,Croatia,HR,HRV,4089400,Europe,18,1282,4
2020-04-09T00:00:00Z,9,4,2020,61,1,Croatia,HR,HRV,4089400,Europe,19,1343,5
2020-04-10T00:00:00Z,10,4,2020,64,1,Croatia,HR,HRV,4089400,Europe,20,1407,6
2020-04-11T00:00:00Z,11,4,2020,88,1,Croatia,HR,HRV,4089400,Europe,21,1495,7
2020-04-12T00:00:00Z,12,4,2020,39,0,Croatia,HR,HRV,4089400,Europe,21,1534,8
2020-04-13T00:00:00Z,13,4,2020,66,2,Croatia,HR,HRV,4089400,Europe,23,1600,9
2020-04-14T00:00:00Z,14,4,2020,50,2,Croatia,HR,HRV,4089400,Europe,25,1650,10
2020-04-15T00:00:00Z,15,4,2020,54,6,Croatia,HR,HRV,4089400,Europe,31,1704,11
2020-04-16T00:00:00Z,16,4,2020,37,3,Croatia,HR,HRV,4089400,Europe,34,1741,12
2020-04-17T00:00:00Z,17,4,2020,50,1,Croatia,HR,HRV,4089400,Europe,35,1791,13
2020-04-18T00:00:00Z,18,4,2020,23,1,Croatia,HR,HRV,4089400,Europe,36,1814,14
2020-04-19T00:00:00Z,19,4,2020,18,3,Croatia,HR,HRV,4089400,Europe,39,1832,15
2020-04-20T00:00:00Z,20,4,2020,39,8,Croatia,HR,HRV,4089400,Europe,47,1871,16
2020-04-21T00:00:00Z,21,4,2020,10,0,Croatia,HR,HRV,4089400,Europe,47,1881,17
2020-04-22T00:00:00Z,22,4,2020,27,1,Croatia,HR,HRV,4089400,Europe,48,1908,18
2020-04-23T00:00:00Z,23,4,2020,42,0,Croatia,HR,HRV,4089400,Europe,48,1950,19
2020-04-24T00:00:00Z,24,4,2020,31,2,Croatia,HR,HRV,4089400,Europe,50,1981,20
2020-04-25T00:00:00Z,25,4,2020,28,1,Croatia,HR,HRV,4089400,Europe,51,2009,21
2020-04-26T00:00:00Z,26,4,2020,7,3,Croatia,HR,HRV,4089400,Europe,54,2016,22
2020-04-27T00:00:00Z,27,4,2020,14,1,Croatia,HR,HRV,4089400,Europe,55,2030,23
2020-04-28T00:00:00Z,28,4,2020,9,4,Croatia,HR,HRV,4089400,Europe,59,2039,24
2020-04-29T00:00:00Z,29,4,2020,8,4,Croatia,HR,HRV,4089400,Europe,63,2047,25
2020-04-30T00:00:00Z,30,4,2020,15,4,Croatia,HR,HRV,4089400,Europe,67,2062,26
2020-05-01T00:00:00Z,1,5,2020,14,2,Croatia,HR,HRV,4089400,Europe,69,2076,27
2020-05-02T00:00:00Z,2,5,2020,9,6,Croatia,HR,HRV,4089400,Europe,75,2085,28
2020-05-03T00:00:00Z,3,5,2020,3,2,Croatia,HR,HRV,4089400,Europe,77,2088,29
2020-05-04T00:00:00Z,4,5,2020,8,2,Croatia,HR,HRV,4089400,Europe,79,2096,30
2020-05-05T00:00:00Z,5,5,2020,5,1,Croatia,HR,HRV,4089400,Europe,80,2101,31
2020-05-06T00:00:00Z,6,5,2020,11,3,Croatia,HR,HRV,4089400,Europe,83,2112,32
2020-05-07T00:00:00Z,7,5,2020,7,2,Croatia,HR,HRV,4089400,Europe,85,2119,33
2020-05-08T00:00:00Z,8,5,2020,6,1,Croatia,HR,HRV,4089400,Europe,86,2125,34
2020-05-09T00:00:00Z,9,5,2020,36,0,Croatia,HR,HRV,4089400,Europe,86,2161,35
2020-05-10T00:00:00Z,10,5,2020,15,1,Croatia,HR,HRV,4089400,Europe,87,2176,36
2020-05-11T00:00:00Z,11,5,2020,11,3,Croatia,HR,HRV,4089400,Europe,90,2187,37
2020-05-12T00:00:00Z,12,5,2020,9,1,Croatia,HR,HRV,4089400,Europe,91,2196,38
2020-05-13T00:00:00Z,13,5,2020,11,0,Croatia,HR,HRV,4089400,Europe,91,2207,39
2020-05-14T00:00:00Z,14,5,2020,6,3,Croatia,HR,HRV,4089400,Europe,94,2213,40
2020-05-15T00:00:00Z,15,5,2020,8,0,Croatia,HR,HRV,4089400,Europe,94,2221,41
2020-05-16T00:00:00Z,16,5,2020,1,1,Croatia,HR,HRV,4089400,Europe,95,2222,42
2020-05-17T00:00:00Z,17,5,2020,2,0,Croatia,HR,HRV,4089400,Europe,95,2224,43
2020-05-18T00:00:00Z,18,5,2020,2,0,Croatia,HR,HRV,4089400,Europe,95,2226,44
2020-05-19T00:00:00Z,19,5,2020,2,0,Croatia,HR,HRV,4089400,Europe,95,2228,45
2020-05-20T00:00:00Z,20,5,2020,4,1,Croatia,HR,HRV,4089400,Europe,96,2232,46
2020-05-21T00:00:00Z,21,5,2020,2,0,Croatia,HR,HRV,4089400,Europe,96,2234,47
2020-05-22T00:00:00Z,22,5,2020,3,1,Croatia,HR,HRV,4089400,Europe,97,2237,48
2020-05-23T00:00:00Z,23,5,2020,6,2,Croatia,HR,HRV,4089400,Europe,99,2243,49
2020-05-24T00:00:00Z,24,5,2020,0,0,Croatia,HR,HRV,4089400,Europe,99,2243,50
2020-05-25T00:00:00Z,25,5,2020,1,0,Croatia,HR,HRV,4089400,Europe,99,2244,51
2020-05-26T00:00:00Z,26,5,2020,0,1,Croatia,HR,HRV,4089400,Europe,100,2244,52
2020-05-27T00:00:00Z,27,5,2020,0,1,Croatia,HR,HRV,4089400,Europe,101,2244,53
2020-04-08T00:00:00Z,8,4,2020,46,2,Cuba,CU,CUB,11338138,America,11,396,1
2020-04-09T00:00:00Z,9,4,2020,61,1,Cuba,CU,CUB,11338138,America,12,457,2
2020-04-10T00:00:00Z,10,4,2020,58,3,Cuba,CU,CUB,11338138,America,15,515,3
2020-04-11T00:00:00Z,11,4,2020,49,0,Cuba,CU,CUB,11338138,America,15,564,4
2020-04-12T00:00:00Z,12,4,2020,56,1,Cuba,CU,CUB,11338138,America,16,620,5
2020-04-13T00:00:00Z,13,4,2020,49,2,Cuba,CU,CUB,11338138,America,18,669,6
2020-04-14T00:00:00Z,14,4,2020,57,3,Cuba,CU,CUB,11338138,America,21,726,7
2020-04-15T00:00:00Z,15,4,2020,40,0,Cuba,CU,CUB,11338138,America,21,766,8
2020-04-16T00:00:00Z,16,4,2020,48,3,Cuba,CU,CUB,11338138,America,24,814,9
2020-04-17T00:00:00Z,17,4,2020,48,3,Cuba,CU,CUB,11338138,America,27,862,10
2020-04-18T00:00:00Z,18,4,2020,61,4,Cuba,CU,CUB,11338138,America,31,923,11
2020-04-19T00:00:00Z,19,4,2020,63,1,Cuba,CU,CUB,11338138,America,32,986,12
2020-04-20T00:00:00Z,20,4,2020,49,2,Cuba,CU,CUB,11338138,America,34,1035,13
2020-04-21T00:00:00Z,21,4,2020,52,2,Cuba,CU,CUB,11338138,America,36,1087,14
2020-04-22T00:00:00Z,22,4,2020,50,2,Cuba,CU,CUB,11338138,America,38,1137,15
2020-04-23T00:00:00Z,23,4,2020,52,2,Cuba,CU,CUB,11338138,America,40,1189,16
2020-04-24T00:00:00Z,24,4,2020,46,3,Cuba,CU,CUB,11338138,America,43,1235,17
2020-04-25T00:00:00Z,25,4,2020,50,6,Cuba,CU,CUB,11338138,America,49,1285,18
2020-04-26T00:00:00Z,26,4,2020,52,2,Cuba,CU,CUB,11338138,America,51,1337,19
2020-04-27T00:00:00Z,27,4,2020,32,3,Cuba,CU,CUB,11338138,America,54,1369,20
2020-04-28T00:00:00Z,28,4,2020,20,2,Cuba,CU,CUB,11338138,America,56,1389,21
2020-04-29T00:00:00Z,29,4,2020,48,2,Cuba,CU,CUB,11338138,America,58,1437,22
2020-04-30T00:00:00Z,30,4,2020,30,0,Cuba,CU,CUB,11338138,America,58,1467,23
2020-05-01T00:00:00Z,1,5,2020,34,3,Cuba,CU,CUB,11338138,America,61,1501,24
2020-05-02T00:00:00Z,2,5,2020,36,3,Cuba,CU,CUB,11338138,America,64,1537,25
2020-05-03T00:00:00Z,3,5,2020,74,2,Cuba,CU,CUB,11338138,America,66,1611,26
2020-05-04T00:00:00Z,4,5,2020,38,1,Cuba,CU,CUB,11338138,America,67,1649,27
2020-05-05T00:00:00Z,5,5,2020,19,2,Cuba,CU,CUB,11338138,America,69,1668,28
2020-05-06T00:00:00Z,6,5,2020,17,0,Cuba,CU,CUB,11338138,America,69,1685,29
2020-05-07T00:00:00Z,7,5,2020,18,0,Cuba,CU,CUB,11338138,America,69,1703,30
2020-05-08T00:00:00Z,8,5,2020,26,4,Cuba,CU,CUB,11338138,America,73,1729,31
2020-05-09T00:00:00Z,9,5,2020,12,1,Cuba,CU,CUB,11338138,America,74,1741,32
2020-05-10T00:00:00Z,10,5,2020,13,0,Cuba,CU,CUB,11338138,America,74,1754,33
2020-05-11T00:00:00Z,11,5,2020,12,3,Cuba,CU,CUB,11338138,America,77,1766,34
2020-05-12T00:00:00Z,12,5,2020,17,0,Cuba,CU,CUB,11338138,America,77,1783,35
2020-05-13T00:00:00Z,13,5,2020,21,1,Cuba,CU,CUB,11338138,America,78,1804,36
2020-05-14T00:00:00Z,14,5,2020,6,1,Cuba,CU,CUB,11338138,America,79,1810,37
2020-05-15T00:00:00Z,15,5,2020,20,0,Cuba,CU,CUB,11338138,America,79,1830,38
2020-05-16T00:00:00Z,16,5,2020,10,0,Cuba,CU,CUB,11338138,America,79,1840,39
2020-05-17T00:00:00Z,17,5,2020,22,0,Cuba,CU,CUB,11338138,America,79,1862,40
2020-05-18T00:00:00Z,18,5,2020,10,0,Cuba,CU,CUB,11338138,America,79,1872,41
2020-05-19T00:00:00Z,19,5,2020,9,0,Cuba,CU,CUB,11338138,America,79,1881,42
2020-05-20T00:00:00Z,20,5,2020,6,0,Cuba,CU,CUB,11338138,America,79,1887,43
2020-05-21T00:00:00Z,21,5,2020,13,0,Cuba,CU,CUB,11338138,America,79,1900,44
2020-05-22T00:00:00Z,22,5,2020,8,1,Cuba,CU,CUB,11338138,America,80,1908,45
2020-05-23T00:00:00Z,23,5,2020,8,1,Cuba,CU,CUB,11338138,America,81,1916,46
2020-05-24T00:00:00Z,24,5,2020,15,0,Cuba,CU,CUB,11338138,America,81,1931,47
2020-05-25T00:00:00Z,25,5,2020,10,1,Cuba,CU,CUB,11338138,America,82,1941,48
2020-05-26T00:00:00Z,26,5,2020,6,0,Cuba,CU,CUB,11338138,America,82,1947,49
2020-05-27T00:00:00Z,27,5,2020,16,0,Cuba,CU,CUB,11338138,America,82,1963,50
2020-04-10T00:00:00Z,10,4,2020,38,1,Cyprus,CY,CYP,1189265,Europe,10,564,1
2020-04-11T00:00:00Z,11,4,2020,31,0,Cyprus,CY,CYP,1189265,Europe,10,595,2
2020-04-12T00:00:00Z,12,4,2020,21,0,Cyprus,CY,CYP,1189265,Europe,10,616,3
2020-04-13T00:00:00Z,13,4,2020,17,1,Cyprus,CY,CYP,1189265,Europe,11,633,4
2020-04-14T00:00:00Z,14,4,2020,29,1,Cyprus,CY,CYP,1189265,Europe,12,662,5
2020-04-15T00:00:00Z,15,4,2020,33,0,Cyprus,CY,CYP,1189265,Europe,12,695,6
2020-04-16T00:00:00Z,16,4,2020,20,0,Cyprus,CY,CYP,1189265,Europe,12,715,7
2020-04-17T00:00:00Z,17,4,2020,20,0,Cyprus,CY,CYP,1189265,Europe,12,735,8
2020-04-18T00:00:00Z,18,4,2020,0,0,Cyprus,CY,CYP,1189265,Europe,12,735,9
2020-04-19T00:00:00Z,19,4,2020,26,0,Cyprus,CY,CYP,1189265,Europe,12,761,10
2020-04-20T00:00:00Z,20,4,2020,6,0,Cyprus,CY,CYP,1189265,Europe,12,767,11
2020-04-21T00:00:00Z,21,4,2020,5,0,Cyprus,CY,CYP,1189265,Europe,12,772,12
2020-04-22T00:00:00Z,22,4,2020,12,0,Cyprus,CY,CYP,1189265,Europe,12,784,13
2020-04-23T00:00:00Z,23,4,2020,6,2,Cyprus,CY,CYP,1189265,Europe,14,790,14
2020-04-24T00:00:00Z,24,4,2020,5,0,Cyprus,CY,CYP,1189265,Europe,14,795,15
2020-04-25T00:00:00Z,25,4,2020,9,0,Cyprus,CY,CYP,1189265,Europe,14,804,16
2020-04-26T00:00:00Z,26,4,2020,6,0,Cyprus,CY,CYP,1189265,Europe,14,810,17
2020-04-27T00:00:00Z,27,4,2020,7,0,Cyprus,CY,CYP,1189265,Europe,14,817,18
2020-04-28T00:00:00Z,28,4,2020,5,1,Cyprus,CY,CYP,1189265,Europe,15,822,19
2020-04-29T00:00:00Z,29,4,2020,15,0,Cyprus,CY,CYP,1189265,Europe,15,837,20
2020-04-30T00:00:00Z,30,4,2020,6,0,Cyprus,CY,CYP,1189265,Europe,15,843,21
2020-05-01T00:00:00Z,1,5,2020,7,0,Cyprus,CY,CYP,1189265,Europe,15,850,22
2020-05-02T00:00:00Z,2,5,2020,7,0,Cyprus,CY,CYP,1189265,Europe,15,857,23
2020-05-03T00:00:00Z,3,5,2020,7,0,Cyprus,CY,CYP,1189265,Europe,15,864,24
2020-05-04T00:00:00Z,4,5,2020,8,0,Cyprus,CY,CYP,1189265,Europe,15,872,25
2020-05-05T00:00:00Z,5,5,2020,2,0,Cyprus,CY,CYP,1189265,Europe,15,874,26
2020-05-06T00:00:00Z,6,5,2020,4,0,Cyprus,CY,CYP,1189265,Europe,15,878,27
2020-05-07T00:00:00Z,7,5,2020,5,0,Cyprus,CY,CYP,1189265,Europe,15,883,28
2020-05-08T00:00:00Z,8,5,2020,6,0,Cyprus,CY,CYP,1189265,Europe,15,889,29
2020-05-09T00:00:00Z,9,5,2020,2,0,Cyprus,CY,CYP,1189265,Europe,15,891,30
2020-05-10T00:00:00Z,10,5,2020,1,0,Cyprus,CY,CYP,1189265,Europe,15,892,31
2020-05-11T00:00:00Z,11,5,2020,6,1,Cyprus,CY,CYP,1189265,Europe,16,898,32
2020-05-12T00:00:00Z,12,5,2020,3,0,Cyprus,CY,CYP,1189265,Europe,16,901,33
2020-05-13T00:00:00Z,13,5,2020,2,0,Cyprus,CY,CYP,1189265,Europe,16,903,34
2020-05-14T00:00:00Z,14,5,2020,2,1,Cyprus,CY,CYP,1189265,Europe,17,905,35
2020-05-15T00:00:00Z,15,5,2020,2,0,Cyprus,CY,CYP,1189265,Europe,17,907,36
2020-05-16T00:00:00Z,16,5,2020,3,0,Cyprus,CY,CYP,1189265,Europe,17,910,37
2020-05-17T00:00:00Z,17,5,2020,4,0,Cyprus,CY,CYP,1189265,Europe,17,914,38
2020-05-18T00:00:00Z,18,5,2020,2,0,Cyprus,CY,CYP,1189265,Europe,17,916,39
2020-05-19T00:00:00Z,19,5,2020,1,0,Cyprus,CY,CYP,1189265,Europe,17,917,40
2020-05-20T00:00:00Z,20,5,2020,1,0,Cyprus,CY,CYP,1189265,Europe,17,918,41
2020-05-21T00:00:00Z,21,5,2020,4,0,Cyprus,CY,CYP,1189265,Europe,17,922,42
2020-05-22T00:00:00Z,22,5,2020,1,0,Cyprus,CY,CYP,1189265,Europe,17,923,43
2020-05-23T00:00:00Z,23,5,2020,4,0,Cyprus,CY,CYP,1189265,Europe,17,927,44
2020-05-24T00:00:00Z,24,5,2020,0,0,Cyprus,CY,CYP,1189265,Europe,17,927,45
2020-05-25T00:00:00Z,25,5,2020,8,0,Cyprus,CY,CYP,1189265,Europe,17,935,46
2020-05-26T00:00:00Z,26,5,2020,2,0,Cyprus,CY,CYP,1189265,Europe,17,937,47
2020-05-27T00:00:00Z,27,5,2020,2,0,Cyprus,CY,CYP,1189265,Europe,17,939,48
2020-03-29T00:00:00Z,29,3,2020,384,2,Czechia,CZ,CZE,10625695,Europe,11,2663,1
2020-03-30T00:00:00Z,30,3,2020,166,5,Czechia,CZ,CZE,10625695,Europe,16,2829,2
2020-03-31T00:00:00Z,31,3,2020,173,8,Czechia,CZ,CZE,10625695,Europe,24,3002,3
2020-04-01T00:00:00Z,1,4,2020,306,7,Czechia,CZ,CZE,10625695,Europe,31,3308,4
2020-04-02T00:00:00Z,2,4,2020,281,8,Czechia,CZ,CZE,10625695,Europe,39,3589,5
2020-04-03T00:00:00Z,3,4,2020,269,5,Czechia,CZ,CZE,10625695,Europe,44,3858,6
2020-04-04T00:00:00Z,4,4,2020,332,9,Czechia,CZ,CZE,10625695,Europe,53,4190,7
2020-04-05T00:00:00Z,5,4,2020,282,6,Czechia,CZ,CZE,10625695,Europe,59,4472,8
2020-04-06T00:00:00Z,6,4,2020,115,8,Czechia,CZ,CZE,10625695,Europe,67,4587,9
2020-04-07T00:00:00Z,7,4,2020,235,11,Czechia,CZ,CZE,10625695,Europe,78,4822,10
2020-04-08T00:00:00Z,8,4,2020,195,10,Czechia,CZ,CZE,10625695,Europe,88,5017,11
2020-04-09T00:00:00Z,9,4,2020,295,11,Czechia,CZ,CZE,10625695,Europe,99,5312,12
2020-04-10T00:00:00Z,10,4,2020,257,13,Czechia,CZ,CZE,10625695,Europe,112,5569,13
2020-04-11T00:00:00Z,11,4,2020,163,7,Czechia,CZ,CZE,10625695,Europe,119,5732,14
2020-04-12T00:00:00Z,12,4,2020,170,10,Czechia,CZ,CZE,10625695,Europe,129,5902,15
2020-04-13T00:00:00Z,13,4,2020,89,9,Czechia,CZ,CZE,10625695,Europe,138,5991,16
2020-04-14T00:00:00Z,14,4,2020,68,5,Czechia,CZ,CZE,10625695,Europe,143,6059,17
2020-04-15T00:00:00Z,15,4,2020,82,18,Czechia,CZ,CZE,10625695,Europe,161,6141,18
2020-04-16T00:00:00Z,16,4,2020,162,5,Czechia,CZ,CZE,10625695,Europe,166,6303,19
2020-04-17T00:00:00Z,17,4,2020,130,3,Czechia,CZ,CZE,10625695,Europe,169,6433,20
2020-04-18T00:00:00Z,18,4,2020,116,4,Czechia,CZ,CZE,10625695,Europe,173,6549,21
2020-04-19T00:00:00Z,19,4,2020,105,8,Czechia,CZ,CZE,10625695,Europe,181,6654,22
2020-04-20T00:00:00Z,20,4,2020,133,7,Czechia,CZ,CZE,10625695,Europe,188,6787,23
2020-04-21T00:00:00Z,21,4,2020,127,8,Czechia,CZ,CZE,10625695,Europe,196,6914,24
2020-04-22T00:00:00Z,22,4,2020,127,5,Czechia,CZ,CZE,10625695,Europe,201,7041,25
2020-04-23T00:00:00Z,23,4,2020,95,9,Czechia,CZ,CZE,10625695,Europe,210,7136,26
2020-04-24T00:00:00Z,24,4,2020,52,3,Czechia,CZ,CZE,10625695,Europe,213,7188,27
2020-04-25T00:00:00Z,25,4,2020,85,2,Czechia,CZ,CZE,10625695,Europe,215,7273,28
2020-04-26T00:00:00Z,26,4,2020,79,3,Czechia,CZ,CZE,10625695,Europe,218,7352,29
2020-04-27T00:00:00Z,27,4,2020,52,3,Czechia,CZ,CZE,10625695,Europe,221,7404,30
2020-04-28T00:00:00Z,28,4,2020,45,2,Czechia,CZ,CZE,10625695,Europe,223,7449,31
2020-04-29T00:00:00Z,29,4,2020,55,4,Czechia,CZ,CZE,10625695,Europe,227,7504,32
2020-04-30T00:00:00Z,30,4,2020,75,0,Czechia,CZ,CZE,10625695,Europe,227,7579,33
2020-05-01T00:00:00Z,1,5,2020,103,9,Czechia,CZ,CZE,10625695,Europe,236,7682,34
2020-05-02T00:00:00Z,2,5,2020,55,4,Czechia,CZ,CZE,10625695,Europe,240,7737,35
2020-05-03T00:00:00Z,3,5,2020,18,5,Czechia,CZ,CZE,10625695,Europe,245,7755,36
2020-05-04T00:00:00Z,4,5,2020,26,3,Czechia,CZ,CZE,10625695,Europe,248,7781,37
2020-05-05T00:00:00Z,5,5,2020,38,4,Czechia,CZ,CZE,10625695,Europe,252,7819,38
2020-05-06T00:00:00Z,6,5,2020,77,5,Czechia,CZ,CZE,10625695,Europe,257,7896,39
2020-05-07T00:00:00Z,7,5,2020,78,5,Czechia,CZ,CZE,10625695,Europe,262,7974,40
2020-05-08T00:00:00Z,8,5,2020,57,8,Czechia,CZ,CZE,10625695,Europe,270,8031,41
2020-05-09T00:00:00Z,9,5,2020,46,3,Czechia,CZ,CZE,10625695,Europe,273,8077,42
2020-05-10T00:00:00Z,10,5,2020,18,3,Czechia,CZ,CZE,10625695,Europe,276,8095,43
2020-05-11T00:00:00Z,11,5,2020,28,4,Czechia,CZ,CZE,10625695,Europe,280,8123,44
2020-05-12T00:00:00Z,12,5,2020,53,2,Czechia,CZ,CZE,10625695,Europe,282,8176,45
2020-05-13T00:00:00Z,13,5,2020,45,1,Czechia,CZ,CZE,10625695,Europe,283,8221,46
2020-05-14T00:00:00Z,14,5,2020,48,7,Czechia,CZ,CZE,10625695,Europe,290,8269,47
2020-05-15T00:00:00Z,15,5,2020,82,3,Czechia,CZ,CZE,10625695,Europe,293,8351,48
2020-05-16T00:00:00Z,16,5,2020,55,2,Czechia,CZ,CZE,10625695,Europe,295,8406,49
2020-05-17T00:00:00Z,17,5,2020,49,1,Czechia,CZ,CZE,10625695,Europe,296,8455,50
2020-05-18T00:00:00Z,18,5,2020,20,1,Czechia,CZ,CZE,10625695,Europe,297,8475,51
2020-05-19T00:00:00Z,19,5,2020,111,0,Czechia,CZ,CZE,10625695,Europe,297,8586,52
2020-05-20T00:00:00Z,20,5,2020,61,5,Czechia,CZ,CZE,10625695,Europe,302,8647,53
2020-05-21T00:00:00Z,21,5,2020,74,2,Czechia,CZ,CZE,10625695,Europe,304,8721,54
2020-05-22T00:00:00Z,22,5,2020,33,2,Czechia,CZ,CZE,10625695,Europe,306,8754,55
2020-05-23T00:00:00Z,23,5,2020,59,6,Czechia,CZ,CZE,10625695,Europe,312,8813,56
2020-05-24T00:00:00Z,24,5,2020,77,2,Czechia,CZ,CZE,10625695,Europe,314,8890,57
2020-05-25T00:00:00Z,25,5,2020,67,1,Czechia,CZ,CZE,10625695,Europe,315,8957,58
2020-05-26T00:00:00Z,26,5,2020,47,2,Czechia,CZ,CZE,10625695,Europe,317,9004,59
2020-05-27T00:00:00Z,27,5,2020,46,0,Czechia,CZ,CZE,10625695,Europe,317,9050,60
2020-04-02T00:00:00Z,2,4,2020,25,3,Democratic_Republic_of_the_Congo,CD,COD,84068091,Africa,11,123,1
2020-04-03T00:00:00Z,3,4,2020,0,0,Democratic_Republic_of_the_Congo,CD,COD,84068091,Africa,11,123,2
2020-04-04T00:00:00Z,4,4,2020,11,2,Democratic_Republic_of_the_Congo,CD,COD,84068091,Africa,13,134,3
2020-04-05T00:00:00Z,5,4,2020,20,5,Democratic_Republic_of_the_Congo,CD,COD,84068091,Africa,18,154,4
2020-04-06T00:00:00Z,6,4,2020,0,0,Democratic_Republic_of_the_Congo,CD,COD,84068091,Africa,18,154,5
2020-04-07T00:00:00Z,7,4,2020,7,0,Democratic_Republic_of_the_Congo,CD,COD,84068091,Africa,18,161,6
2020-04-08T00:00:00Z,8,4,2020,19,0,Democratic_Republic_of_the_Congo,CD,COD,84068091,Africa,18,180,7
2020-04-09T00:00:00Z,9,4,2020,3,2,Democratic_Republic_of_the_Congo,CD,COD,84068091,Africa,20,183,8
2020-04-10T00:00:00Z,10,4,2020,32,0,Democratic_Republic_of_the_Congo,CD,COD,84068091,Africa,20,215,9
2020-04-11T00:00:00Z,11,4,2020,8,0,Democratic_Republic_of_the_Congo,CD,COD,84068091,Africa,20,223,10
2020-04-12T00:00:00Z,12,4,2020,11,0,Democratic_Republic_of_the_Congo,CD,COD,84068091,Africa,20,234,11
2020-04-13T00:00:00Z,13,4,2020,0,0,Democratic_Republic_of_the_Congo,CD,COD,84068091,Africa,20,234,12
2020-04-14T00:00:00Z,14,4,2020,1,0,Democratic_Republic_of_the_Congo,CD,COD,84068091,Africa,20,235,13
2020-04-15T00:00:00Z,15,4,2020,19,1,Democratic_Republic_of_the_Congo,CD,COD,84068091,Africa,21,254,14
2020-04-16T00:00:00Z,16,4,2020,13,1,Democratic_Republic_of_the_Congo,CD,COD,84068091,Africa,22,267,15
2020-04-17T00:00:00Z,17,4,2020,20,1,Democratic_Republic_of_the_Congo,CD,COD,84068091,Africa,23,287,16
2020-04-18T00:00:00Z,18,4,2020,20,2,Democratic_Republic_of_the_Congo,CD,COD,84068091,Africa,25,307,17
2020-04-19T00:00:00Z,19,4,2020,20,0,Democratic_Republic_of_the_Congo,CD,COD,84068091,Africa,25,327,18
2020-04-20T00:00:00Z,20,4,2020,5,0,Democratic_Republic_of_the_Congo,CD,COD,84068091,Africa,25,332,19
2020-04-21T00:00:00Z,21,4,2020,18,0,Democratic_Republic_of_the_Congo,CD,COD,84068091,Africa,25,350,20
2020-04-22T00:00:00Z,22,4,2020,9,0,Democratic_Republic_of_the_Congo,CD,COD,84068091,Africa,25,359,21
2020-04-23T00:00:00Z,23,4,2020,18,0,Democratic_Republic_of_the_Congo,CD,COD,84068091,Africa,25,377,22
2020-04-24T00:00:00Z,24,4,2020,17,0,Democratic_Republic_of_the_Congo,CD,COD,84068091,Africa,25,394,23
2020-04-25T00:00:00Z,25,4,2020,22,3,Democratic_Republic_of_the_Congo,CD,COD,84068091,Africa,28,416,24
2020-04-26T00:00:00Z,26,4,2020,26,0,Democratic_Republic_of_the_Congo,CD,COD,84068091,Africa,28,442,25
2020-04-27T00:00:00Z,27,4,2020,17,0,Democratic_Republic_of_the_Congo,CD,COD,84068091,Africa,28,459,26
2020-04-28T00:00:00Z,28,4,2020,12,2,Democratic_Republic_of_the_Congo,CD,COD,84068091,Africa,30,471,27
2020-04-29T00:00:00Z,29,4,2020,20,0,Democratic_Republic_of_the_Congo,CD,COD,84068091,Africa,30,491,28
2020-04-30T00:00:00Z,30,4,2020,9,1,Democratic_Republic_of_the_Congo,CD,COD,84068091,Africa,31,500,29
2020-05-01T00:00:00Z,1,5,2020,72,0,Democratic_Republic_of_the_Congo,CD,COD,84068091,Africa,31,572,30
2020-05-02T00:00:00Z,2,5,2020,32,1,Democratic_Republic_of_the_Congo,CD,COD,84068091,Africa,32,604,31
2020-05-03T00:00:00Z,3,5,2020,70,1,Democratic_Republic_of_the_Congo,CD,COD,84068091,Africa,33,674,32
2020-05-04T00:00:00Z,4,5,2020,10,1,Democratic_Republic_of_the_Congo,CD,COD,84068091,Africa,34,684,33
2020-05-05T00:00:00Z,5,5,2020,0,0,Democratic_Republic_of_the_Congo,CD,COD,84068091,Africa,34,684,34
2020-05-06T00:00:00Z,6,5,2020,21,0,Democratic_Republic_of_the_Congo,CD,COD,84068091,Africa,34,705,35
2020-05-07T00:00:00Z,7,5,2020,158,2,Democratic_Republic_of_the_Congo,CD,COD,84068091,Africa,36,863,36
2020-05-08T00:00:00Z,8,5,2020,34,0,Democratic_Republic_of_the_Congo,CD,COD,84068091,Africa,36,897,37
2020-05-09T00:00:00Z,9,5,2020,40,3,Democratic_Republic_of_the_Congo,CD,COD,84068091,Africa,39,937,38
2020-05-10T00:00:00Z,10,5,2020,54,2,Democratic_Republic_of_the_Congo,CD,COD,84068091,Africa,41,991,39
2020-05-11T00:00:00Z,11,5,2020,33,0,Democratic_Republic_of_the_Congo,CD,COD,84068091,Africa,41,1024,40
2020-05-12T00:00:00Z,12,5,2020,78,3,Democratic_Republic_of_the_Congo,CD,COD,84068091,Africa,44,1102,41
2020-05-13T00:00:00Z,13,5,2020,67,6,Democratic_Republic_of_the_Congo,CD,COD,84068091,Africa,50,1169,42
2020-05-14T00:00:00Z,14,5,2020,73,0,Democratic_Republic_of_the_Congo,CD,COD,84068091,Africa,50,1242,43
2020-05-15T00:00:00Z,15,5,2020,56,0,Democratic_Republic_of_the_Congo,CD,COD,84068091,Africa,50,1298,44
2020-05-16T00:00:00Z,16,5,2020,71,10,Democratic_Republic_of_the_Congo,CD,COD,84068091,Africa,60,1369,45
2020-05-17T00:00:00Z,17,5,2020,85,0,Democratic_Republic_of_the_Congo,CD,COD,84068091,Africa,60,1454,46
2020-05-18T00:00:00Z,18,5,2020,0,0,Democratic_Republic_of_the_Congo,CD,COD,84068091,Africa,60,1454,47
2020-05-19T00:00:00Z,19,5,2020,175,1,Democratic_Republic_of_the_Congo,CD,COD,84068091,Africa,61,1629,48
2020-05-20T00:00:00Z,20,5,2020,102,0,Democratic_Republic_of_the_Congo,CD,COD,84068091,Africa,61,1731,49
2020-05-21T00:00:00Z,21,5,2020,104,0,Democratic_Republic_of_the_Congo,CD,COD,84068091,Africa,61,1835,50
2020-05-22T00:00:00Z,22,5,2020,110,2,Democratic_Republic_of_the_Congo,CD,COD,84068091,Africa,63,1945,51
2020-05-23T00:00:00Z,23,5,2020,80,0,Democratic_Republic_of_the_Congo,CD,COD,84068091,Africa,63,2025,52
2020-05-24T00:00:00Z,24,5,2020,116,0,Democratic_Republic_of_the_Congo,CD,COD,84068091,Africa,63,2141,53
2020-05-25T00:00:00Z,25,5,2020,156,4,Democratic_Republic_of_the_Congo,CD,COD,84068091,Africa,67,2297,54
2020-05-26T00:00:00Z,26,5,2020,0,0,Democratic_Republic_of_the_Congo,CD,COD,84068091,Africa,67,2297,55
2020-05-27T00:00:00Z,27,5,2020,248,0,Democratic_Republic_of_the_Congo,CD,COD,84068091,Africa,67,2545,56
2020-03-22T00:00:00Z,22,3,2020,71,4,Denmark,DK,DNK,5797446,Europe,13,1326,1
2020-03-23T00:00:00Z,23,3,2020,69,0,Denmark,DK,DNK,5797446,Europe,13,1395,2
2020-03-24T00:00:00Z,24,3,2020,65,11,Denmark,DK,DNK,5797446,Europe,24,1460,3
2020-03-25T00:00:00Z,25,3,2020,131,8,Denmark,DK,DNK,5797446,Europe,32,1591,4
2020-03-26T00:00:00Z,26,3,2020,133,2,Denmark,DK,DNK,5797446,Europe,34,1724,5
2020-03-27T00:00:00Z,27,3,2020,153,7,Denmark,DK,DNK,5797446,Europe,41,1877,6
2020-03-28T00:00:00Z,28,3,2020,169,11,Denmark,DK,DNK,5797446,Europe,52,2046,7
2020-03-29T00:00:00Z,29,3,2020,155,13,Denmark,DK,DNK,5797446,Europe,65,2201,8
2020-03-30T00:00:00Z,30,3,2020,194,7,Denmark,DK,DNK,5797446,Europe,72,2395,9
2020-03-31T00:00:00Z,31,3,2020,182,5,Denmark,DK,DNK,5797446,Europe,77,2577,10
2020-04-01T00:00:00Z,1,4,2020,283,13,Denmark,DK,DNK,5797446,Europe,90,2860,11
2020-04-02T00:00:00Z,2,4,2020,247,14,Denmark,DK,DNK,5797446,Europe,104,3107,12
2020-04-03T00:00:00Z,3,4,2020,279,19,Denmark,DK,DNK,5797446,Europe,123,3386,13
2020-04-04T00:00:00Z,4,4,2020,371,16,Denmark,DK,DNK,5797446,Europe,139,3757,14
2020-04-05T00:00:00Z,5,4,2020,320,22,Denmark,DK,DNK,5797446,Europe,161,4077,15
2020-04-06T00:00:00Z,6,4,2020,292,18,Denmark,DK,DNK,5797446,Europe,179,4369,16
2020-04-07T00:00:00Z,7,4,2020,312,8,Denmark,DK,DNK,5797446,Europe,187,4681,17
2020-04-08T00:00:00Z,8,4,2020,390,16,Denmark,DK,DNK,5797446,Europe,203,5071,18
2020-04-09T00:00:00Z,9,4,2020,331,15,Denmark,DK,DNK,5797446,Europe,218,5402,19
2020-04-10T00:00:00Z,10,4,2020,233,19,Denmark,DK,DNK,5797446,Europe,237,5635,20
2020-04-11T00:00:00Z,11,4,2020,184,10,Denmark,DK,DNK,5797446,Europe,247,5819,21
2020-04-12T00:00:00Z,12,4,2020,177,13,Denmark,DK,DNK,5797446,Europe,260,5996,22
2020-04-13T00:00:00Z,13,4,2020,178,13,Denmark,DK,DNK,5797446,Europe,273,6174,23
2020-04-14T00:00:00Z,14,4,2020,144,12,Denmark,DK,DNK,5797446,Europe,285,6318,24
2020-04-15T00:00:00Z,15,4,2020,193,14,Denmark,DK,DNK,5797446,Europe,299,6511,25
2020-04-16T00:00:00Z,16,4,2020,170,10,Denmark,DK,DNK,5797446,Europe,309,6681,26
2020-04-17T00:00:00Z,17,4,2020,198,12,Denmark,DK,DNK,5797446,Europe,321,6879,27
2020-04-18T00:00:00Z,18,4,2020,194,15,Denmark,DK,DNK,5797446,Europe,336,7073,28
2020-04-19T00:00:00Z,19,4,2020,169,10,Denmark,DK,DNK,5797446,Europe,346,7242,29
2020-04-20T00:00:00Z,20,4,2020,142,9,Denmark,DK,DNK,5797446,Europe,355,7384,30
2020-04-21T00:00:00Z,21,4,2020,131,9,Denmark,DK,DNK,5797446,Europe,364,7515,31
2020-04-22T00:00:00Z,22,4,2020,180,6,Denmark,DK,DNK,5797446,Europe,370,7695,32
2020-04-23T00:00:00Z,23,4,2020,217,14,Denmark,DK,DNK,5797446,Europe,384,7912,33
2020-04-24T00:00:00Z,24,4,2020,161,10,Denmark,DK,DNK,5797446,Europe,394,8073,34
2020-04-25T00:00:00Z,25,4,2020,137,9,Denmark,DK,DNK,5797446,Europe,403,8210,35
2020-04-26T00:00:00Z,26,4,2020,235,15,Denmark,DK,DNK,5797446,Europe,418,8445,36
2020-04-27T00:00:00Z,27,4,2020,130,4,Denmark,DK,DNK,5797446,Europe,422,8575,37
2020-04-28T00:00:00Z,28,4,2020,123,5,Denmark,DK,DNK,5797446,Europe,427,8698,38
2020-04-29T00:00:00Z,29,4,2020,153,7,Denmark,DK,DNK,5797446,Europe,434,8851,39
2020-04-30T00:00:00Z,30,4,2020,157,9,Denmark,DK,DNK,5797446,Europe,443,9008,40
2020-05-01T00:00:00Z,1,5,2020,150,9,Denmark,DK,DNK,5797446,Europe,452,9158,41
2020-05-02T00:00:00Z,2,5,2020,153,10,Denmark,DK,DNK,5797446,Europe,462,9311,42
2020-05-03T00:00:00Z,3,5,2020,96,11,Denmark,DK,DNK,5797446,Europe,473,9407,43
2020-05-04T00:00:00Z,4,5,2020,116,8,Denmark,DK,DNK,5797446,Europe,481,9523,44
2020-05-05T00:00:00Z,5,5,2020,147,9,Denmark,DK,DNK,5797446,Europe,490,9670,45
2020-05-06T00:00:00Z,6,5,2020,151,7,Denmark,DK,DNK,5797446,Europe,497,9821,46
2020-05-07T00:00:00Z,7,5,2020,162,3,Denmark,DK,DNK,5797446,Europe,500,9983,47
2020-05-08T00:00:00Z,8,5,2020,100,6,Denmark,DK,DNK,5797446,Europe,506,10083,48
2020-05-09T00:00:00Z,9,5,2020,135,6,Denmark,DK,DNK,5797446,Europe,512,10218,49
2020-05-10T00:00:00Z,10,5,2020,101,4,Denmark,DK,DNK,5797446,Europe,516,10319,50
2020-05-11T00:00:00Z,11,5,2020,110,3,Denmark,DK,DNK,5797446,Europe,519,10429,51
2020-05-12T00:00:00Z,12,5,2020,84,5,Denmark,DK,DNK,5797446,Europe,524,10513,52
2020-05-13T00:00:00Z,13,5,2020,78,4,Denmark,DK,DNK,5797446,Europe,528,10591,53
2020-05-14T00:00:00Z,14,5,2020,76,6,Denmark,DK,DNK,5797446,Europe,534,10667,54
2020-05-15T00:00:00Z,15,5,2020,46,4,Denmark,DK,DNK,5797446,Europe,538,10713,55
2020-05-16T00:00:00Z,16,5,2020,78,0,Denmark,DK,DNK,5797446,Europe,538,10791,56
2020-05-17T00:00:00Z,17,5,2020,67,5,Denmark,DK,DNK,5797446,Europe,543,10858,57
2020-05-18T00:00:00Z,18,5,2020,69,4,Denmark,DK,DNK,5797446,Europe,547,10927,58
2020-05-19T00:00:00Z,19,5,2020,41,1,Denmark,DK,DNK,5797446,Europe,548,10968,59
2020-05-20T00:00:00Z,20,5,2020,76,3,Denmark,DK,DNK,5797446,Europe,551,11044,60
2020-05-21T00:00:00Z,21,5,2020,73,3,Denmark,DK,DNK,5797446,Europe,554,11117,61
2020-05-22T00:00:00Z,22,5,2020,65,7,Denmark,DK,DNK,5797446,Europe,561,11182,62
2020-05-23T00:00:00Z,23,5,2020,48,0,Denmark,DK,DNK,5797446,Europe,561,11230,63
2020-05-24T00:00:00Z,24,5,2020,59,0,Denmark,DK,DNK,5797446,Europe,561,11289,64
2020-05-25T00:00:00Z,25,5,2020,71,1,Denmark,DK,DNK,5797446,Europe,562,11360,65
2020-05-26T00:00:00Z,26,5,2020,27,1,Denmark,DK,DNK,5797446,Europe,563,11387,66
2020-05-27T00:00:00Z,27,5,2020,41,0,Denmark,DK,DNK,5797446,Europe,563,11428,67
2020-05-22T00:00:00Z,22,5,2020,219,1,Djibouti,DJ,DJI,958920,Africa,10,2047,1
2020-05-23T00:00:00Z,23,5,2020,223,0,Djibouti,DJ,DJI,958920,Africa,10,2270,2
2020-05-24T00:00:00Z,24,5,2020,0,0,Djibouti,DJ,DJI,958920,Africa,10,2270,3
2020-05-25T00:00:00Z,25,5,2020,0,0,Djibouti,DJ,DJI,958920,Africa,10,2270,4
2020-05-26T00:00:00Z,26,5,2020,198,4,Djibouti,DJ,DJI,958920,Africa,14,2468,5
2020-05-27T00:00:00Z,27,5,2020,0,0,Djibouti,DJ,DJI,958920,Africa,14,2468,6
2020-03-26T00:00:00Z,26,3,2020,80,4,Dominican_Republic,DO,DOM,10627165,America,10,392,1
2020-03-27T00:00:00Z,27,3,2020,96,0,Dominican_Republic,DO,DOM,10627165,America,10,488,2
2020-03-28T00:00:00Z,28,3,2020,93,10,Dominican_Republic,DO,DOM,10627165,America,20,581,3
2020-03-29T00:00:00Z,29,3,2020,138,8,Dominican_Republic,DO,DOM,10627165,America,28,719,4
2020-03-30T00:00:00Z,30,3,2020,140,11,Dominican_Republic,DO,DOM,10627165,America,39,859,5
2020-03-31T00:00:00Z,31,3,2020,42,3,Dominican_Republic,DO,DOM,10627165,America,42,901,6
2020-04-01T00:00:00Z,1,4,2020,208,9,Dominican_Republic,DO,DOM,10627165,America,51,1109,7
2020-04-02T00:00:00Z,2,4,2020,175,6,Dominican_Republic,DO,DOM,10627165,America,57,1284,8
2020-04-03T00:00:00Z,3,4,2020,96,3,Dominican_Republic,DO,DOM,10627165,America,60,1380,9
2020-04-04T00:00:00Z,4,4,2020,108,8,Dominican_Republic,DO,DOM,10627165,America,68,1488,10
2020-04-05T00:00:00Z,5,4,2020,90,9,Dominican_Republic,DO,DOM,10627165,America,77,1578,11
2020-04-06T00:00:00Z,6,4,2020,167,5,Dominican_Republic,DO,DOM,10627165,America,82,1745,12
2020-04-07T00:00:00Z,7,4,2020,83,4,Dominican_Republic,DO,DOM,10627165,America,86,1828,13
2020-04-08T00:00:00Z,8,4,2020,128,12,Dominican_Republic,DO,DOM,10627165,America,98,1956,14
2020-04-09T00:00:00Z,9,4,2020,155,10,Dominican_Republic,DO,DOM,10627165,America,108,2111,15
2020-04-10T00:00:00Z,10,4,2020,238,10,Dominican_Republic,DO,DOM,10627165,America,118,2349,16
2020-04-11T00:00:00Z,11,4,2020,271,8,Dominican_Republic,DO,DOM,10627165,America,126,2620,17
2020-04-12T00:00:00Z,12,4,2020,139,9,Dominican_Republic,DO,DOM,10627165,America,135,2759,18
2020-04-13T00:00:00Z,13,4,2020,208,38,Dominican_Republic,DO,DOM,10627165,America,173,2967,19
2020-04-14T00:00:00Z,14,4,2020,200,4,Dominican_Republic,DO,DOM,10627165,America,177,3167,20
2020-04-15T00:00:00Z,15,4,2020,119,6,Dominican_Republic,DO,DOM,10627165,America,183,3286,21
2020-04-16T00:00:00Z,16,4,2020,328,6,Dominican_Republic,DO,DOM,10627165,America,189,3614,22
2020-04-17T00:00:00Z,17,4,2020,141,7,Dominican_Republic,DO,DOM,10627165,America,196,3755,23
2020-04-18T00:00:00Z,18,4,2020,371,4,Dominican_Republic,DO,DOM,10627165,America,200,4126,24
2020-04-19T00:00:00Z,19,4,2020,209,17,Dominican_Republic,DO,DOM,10627165,America,217,4335,25
2020-04-20T00:00:00Z,20,4,2020,345,9,Dominican_Republic,DO,DOM,10627165,America,226,4680,26
2020-04-21T00:00:00Z,21,4,2020,284,9,Dominican_Republic,DO,DOM,10627165,America,235,4964,27
2020-04-22T00:00:00Z,22,4,2020,80,10,Dominican_Republic,DO,DOM,10627165,America,245,5044,28
2020-04-23T00:00:00Z,23,4,2020,256,15,Dominican_Republic,DO,DOM,10627165,America,260,5300,29
2020-04-24T00:00:00Z,24,4,2020,243,5,Dominican_Republic,DO,DOM,10627165,America,265,5543,30
2020-04-25T00:00:00Z,25,4,2020,206,2,Dominican_Republic,DO,DOM,10627165,America,267,5749,31
2020-04-26T00:00:00Z,26,4,2020,177,6,Dominican_Republic,DO,DOM,10627165,America,273,5926,32
2020-04-27T00:00:00Z,27,4,2020,209,5,Dominican_Republic,DO,DOM,10627165,America,278,6135,33
2020-04-28T00:00:00Z,28,4,2020,0,0,Dominican_Republic,DO,DOM,10627165,America,278,6135,34
2020-04-29T00:00:00Z,29,4,2020,281,8,Dominican_Republic,DO,DOM,10627165,America,286,6416,35
2020-04-30T00:00:00Z,30,4,2020,236,7,Dominican_Republic,DO,DOM,10627165,America,293,6652,36
2020-05-01T00:00:00Z,1,5,2020,320,8,Dominican_Republic,DO,DOM,10627165,America,301,6972,37
2020-05-02T00:00:00Z,2,5,2020,316,12,Dominican_Republic,DO,DOM,10627165,America,313,7288,38
2020-05-03T00:00:00Z,3,5,2020,290,13,Dominican_Republic,DO,DOM,10627165,America,326,7578,39
2020-05-04T00:00:00Z,4,5,2020,376,7,Dominican_Republic,DO,DOM,10627165,America,333,7954,40
2020-05-05T00:00:00Z,5,5,2020,281,13,Dominican_Republic,DO,DOM,10627165,America,346,8235,41
2020-05-06T00:00:00Z,6,5,2020,245,8,Dominican_Republic,DO,DOM,10627165,America,354,8480,42
2020-05-07T00:00:00Z,7,5,2020,327,8,Dominican_Republic,DO,DOM,10627165,America,362,8807,43
2020-05-08T00:00:00Z,8,5,2020,288,11,Dominican_Republic,DO,DOM,10627165,America,373,9095,44
2020-05-09T00:00:00Z,9,5,2020,281,7,Dominican_Republic,DO,DOM,10627165,America,380,9376,45
2020-05-10T00:00:00Z,10,5,2020,506,5,Dominican_Republic,DO,DOM,10627165,America,385,9882,46
2020-05-11T00:00:00Z,11,5,2020,465,3,Dominican_Republic,DO,DOM,10627165,America,388,10347,47
2020-05-12T00:00:00Z,12,5,2020,287,5,Dominican_Republic,DO,DOM,10627165,America,393,10634,48
2020-05-13T00:00:00Z,13,5,2020,266,9,Dominican_Republic,DO,DOM,10627165,America,402,10900,49
2020-05-14T00:00:00Z,14,5,2020,296,7,Dominican_Republic,DO,DOM,10627165,America,409,11196,50
2020-05-15T00:00:00Z,15,5,2020,124,13,Dominican_Republic,DO,DOM,10627165,America,422,11320,51
2020-05-16T00:00:00Z,16,5,2020,419,2,Dominican_Republic,DO,DOM,10627165,America,424,11739,52
2020-05-17T00:00:00Z,17,5,2020,154,0,Dominican_Republic,DO,DOM,10627165,America,424,11893,53
2020-05-18T00:00:00Z,18,5,2020,421,4,Dominican_Republic,DO,DOM,10627165,America,428,12314,54
2020-05-19T00:00:00Z,19,5,2020,411,6,Dominican_Republic,DO,DOM,10627165,America,434,12725,55
2020-05-20T00:00:00Z,20,5,2020,498,7,Dominican_Republic,DO,DOM,10627165,America,441,13223,56
2020-05-21T00:00:00Z,21,5,2020,254,5,Dominican_Republic,DO,DOM,10627165,America,446,13477,57
2020-05-22T00:00:00Z,22,5,2020,180,2,Dominican_Republic,DO,DOM,10627165,America,448,13657,58
2020-05-23T00:00:00Z,23,5,2020,332,8,Dominican_Republic,DO,DOM,10627165,America,456,13989,59
2020-05-24T00:00:00Z,24,5,2020,433,2,Dominican_Republic,DO,DOM,10627165,America,458,14422,60
2020-05-25T00:00:00Z,25,5,2020,0,0,Dominican_Republic,DO,DOM,10627165,America,458,14422,61
2020-05-26T00:00:00Z,26,5,2020,651,2,Dominican_Republic,DO,DOM,10627165,America,460,15073,62
2020-05-27T00:00:00Z,27,5,2020,191,8,Dominican_Republic,DO,DOM,10627165,America,468,15264,63
2020-03-23T00:00:00Z,23,3,2020,257,7,Ecuador,EC,ECU,17084357,America,14,789,1
2020-03-24T00:00:00Z,24,3,2020,192,4,Ecuador,EC,ECU,17084357,America,18,981,2
2020-03-25T00:00:00Z,25,3,2020,101,9,Ecuador,EC,ECU,17084357,America,27,1082,3
2020-03-26T00:00:00Z,26,3,2020,129,2,Ecuador,EC,ECU,17084357,America,29,1211,4
2020-03-27T00:00:00Z,27,3,2020,192,5,Ecuador,EC,ECU,17084357,America,34,1403,5
2020-03-28T00:00:00Z,28,3,2020,224,7,Ecuador,EC,ECU,17084357,America,41,1627,6
2020-03-29T00:00:00Z,29,3,2020,208,7,Ecuador,EC,ECU,17084357,America,48,1835,7
2020-03-30T00:00:00Z,30,3,2020,55,10,Ecuador,EC,ECU,17084357,America,58,1890,8
2020-03-31T00:00:00Z,31,3,2020,76,4,Ecuador,EC,ECU,17084357,America,62,1966,9
2020-04-01T00:00:00Z,1,4,2020,336,17,Ecuador,EC,ECU,17084357,America,79,2302,10
2020-04-02T00:00:00Z,2,4,2020,456,41,Ecuador,EC,ECU,17084357,America,120,2758,11
2020-04-03T00:00:00Z,3,4,2020,405,0,Ecuador,EC,ECU,17084357,America,120,3163,12
2020-04-04T00:00:00Z,4,4,2020,205,25,Ecuador,EC,ECU,17084357,America,145,3368,13
2020-04-05T00:00:00Z,5,4,2020,97,27,Ecuador,EC,ECU,17084357,America,172,3465,14
2020-04-06T00:00:00Z,6,4,2020,181,8,Ecuador,EC,ECU,17084357,America,180,3646,15
2020-04-07T00:00:00Z,7,4,2020,101,11,Ecuador,EC,ECU,17084357,America,191,3747,16
2020-04-08T00:00:00Z,8,4,2020,248,29,Ecuador,EC,ECU,17084357,America,220,3995,17
2020-04-09T00:00:00Z,9,4,2020,455,22,Ecuador,EC,ECU,17084357,America,242,4450,18
2020-04-10T00:00:00Z,10,4,2020,515,30,Ecuador,EC,ECU,17084357,America,272,4965,19
2020-04-11T00:00:00Z,11,4,2020,2196,25,Ecuador,EC,ECU,17084357,America,297,7161,20
2020-04-12T00:00:00Z,12,4,2020,96,18,Ecuador,EC,ECU,17084357,America,315,7257,21
2020-04-13T00:00:00Z,13,4,2020,209,18,Ecuador,EC,ECU,17084357,America,333,7466,22
2020-04-14T00:00:00Z,14,4,2020,63,22,Ecuador,EC,ECU,17084357,America,355,7529,23
2020-04-15T00:00:00Z,15,4,2020,74,0,Ecuador,EC,ECU,17084357,America,355,7603,24
2020-04-16T00:00:00Z,16,4,2020,255,33,Ecuador,EC,ECU,17084357,America,388,7858,25
2020-04-17T00:00:00Z,17,4,2020,367,15,Ecuador,EC,ECU,17084357,America,403,8225,26
2020-04-18T00:00:00Z,18,4,2020,225,18,Ecuador,EC,ECU,17084357,America,421,8450,27
2020-04-19T00:00:00Z,19,4,2020,572,35,Ecuador,EC,ECU,17084357,America,456,9022,28
2020-04-20T00:00:00Z,20,4,2020,446,18,Ecuador,EC,ECU,17084357,America,474,9468,29
2020-04-21T00:00:00Z,21,4,2020,660,33,Ecuador,EC,ECU,17084357,America,507,10128,30
2020-04-22T00:00:00Z,22,4,2020,270,13,Ecuador,EC,ECU,17084357,America,520,10398,31
2020-04-23T00:00:00Z,23,4,2020,452,17,Ecuador,EC,ECU,17084357,America,537,10850,32
2020-04-24T00:00:00Z,24,4,2020,333,23,Ecuador,EC,ECU,17084357,America,560,11183,33
2020-04-25T00:00:00Z,25,4,2020,0,16,Ecuador,EC,ECU,17084357,America,576,11183,34
2020-04-26T00:00:00Z,26,4,2020,0,0,Ecuador,EC,ECU,17084357,America,576,11183,35
2020-04-27T00:00:00Z,27,4,2020,11536,0,Ecuador,EC,ECU,17084357,America,576,22719,36
2020-04-28T00:00:00Z,28,4,2020,521,87,Ecuador,EC,ECU,17084357,America,663,23240,37
2020-04-29T00:00:00Z,29,4,2020,1018,208,Ecuador,EC,ECU,17084357,America,871,24258,38
2020-04-30T00:00:00Z,30,4,2020,417,12,Ecuador,EC,ECU,17084357,America,883,24675,39
2020-05-01T00:00:00Z,1,5,2020,259,17,Ecuador,EC,ECU,17084357,America,900,24934,40
2020-05-02T00:00:00Z,2,5,2020,1402,163,Ecuador,EC,ECU,17084357,America,1063,26336,41
2020-05-03T00:00:00Z,3,5,2020,1128,308,Ecuador,EC,ECU,17084357,America,1371,27464,42
2020-05-04T00:00:00Z,4,5,2020,2074,193,Ecuador,EC,ECU,17084357,America,1564,29538,43
2020-05-05T00:00:00Z,5,5,2020,2343,5,Ecuador,EC,ECU,17084357,America,1569,31881,44
2020-05-06T00:00:00Z,6,5,2020,0,0,Ecuador,EC,ECU,17084357,America,1569,31881,45
2020-05-07T00:00:00Z,7,5,2020,-2461,49,Ecuador,EC,ECU,17084357,America,1618,29420,46
2020-05-08T00:00:00Z,8,5,2020,878,36,Ecuador,EC,ECU,17084357,America,1654,30298,47
2020-05-09T00:00:00Z,9,5,2020,-1480,50,Ecuador,EC,ECU,17084357,America,1704,28818,48
2020-05-10T00:00:00Z,10,5,2020,253,13,Ecuador,EC,ECU,17084357,America,1717,29071,49
2020-05-11T00:00:00Z,11,5,2020,488,410,Ecuador,EC,ECU,17084357,America,2127,29559,50
2020-05-12T00:00:00Z,12,5,2020,-50,18,Ecuador,EC,ECU,17084357,America,2145,29509,51
2020-05-13T00:00:00Z,13,5,2020,910,182,Ecuador,EC,ECU,17084357,America,2327,30419,52
2020-05-14T00:00:00Z,14,5,2020,67,7,Ecuador,EC,ECU,17084357,America,2334,30486,53
2020-05-15T00:00:00Z,15,5,2020,16,4,Ecuador,EC,ECU,17084357,America,2338,30502,54
2020-05-16T00:00:00Z,16,5,2020,965,256,Ecuador,EC,ECU,17084357,America,2594,31467,55
2020-05-17T00:00:00Z,17,5,2020,1296,94,Ecuador,EC,ECU,17084357,America,2688,32763,56
2020-05-18T00:00:00Z,18,5,2020,419,48,Ecuador,EC,ECU,17084357,America,2736,33182,57
2020-05-19T00:00:00Z,19,5,2020,400,63,Ecuador,EC,ECU,17084357,America,2799,33582,58
2020-05-20T00:00:00Z,20,5,2020,569,40,Ecuador,EC,ECU,17084357,America,2839,34151,59
2020-05-21T00:00:00Z,21,5,2020,703,49,Ecuador,EC,ECU,17084357,America,2888,34854,60
2020-05-22T00:00:00Z,22,5,2020,452,51,Ecuador,EC,ECU,17084357,America,2939,35306,61
2020-05-23T00:00:00Z,23,5,2020,522,117,Ecuador,EC,ECU,17084357,America,3056,35828,62
2020-05-24T00:00:00Z,24,5,2020,430,40,Ecuador,EC,ECU,17084357,America,3096,36258,63
2020-05-25T00:00:00Z,25,5,2020,498,12,Ecuador,EC,ECU,17084357,America,3108,36756,64
2020-05-26T00:00:00Z,26,5,2020,599,95,Ecuador,EC,ECU,17084357,America,3203,37355,65
2020-05-27T00:00:00Z,27,5,2020,0,0,Ecuador,EC,ECU,17084357,America,3203,37355,66
2020-03-23T00:00:00Z,23,3,2020,9,2,Egypt,EG,EGY,98423595,Africa,10,294,1
2020-03-24T00:00:00Z,24,3,2020,33,4,Egypt,EG,EGY,98423595,Africa,14,327,2
2020-03-25T00:00:00Z,25,3,2020,39,5,Egypt,EG,EGY,98423595,Africa,19,366,3
2020-03-26T00:00:00Z,26,3,2020,76,2,Egypt,EG,EGY,98423595,Africa,21,442,4
2020-03-27T00:00:00Z,27,3,2020,14,0,Egypt,EG,EGY,98423595,Africa,21,456,5
2020-03-28T00:00:00Z,28,3,2020,39,3,Egypt,EG,EGY,98423595,Africa,24,495,6
2020-03-29T00:00:00Z,29,3,2020,41,6,Egypt,EG,EGY,98423595,Africa,30,536,7
2020-03-30T00:00:00Z,30,3,2020,40,6,Egypt,EG,EGY,98423595,Africa,36,576,8
2020-03-31T00:00:00Z,31,3,2020,33,4,Egypt,EG,EGY,98423595,Africa,40,609,9
2020-04-01T00:00:00Z,1,4,2020,47,1,Egypt,EG,EGY,98423595,Africa,41,656,10
2020-04-02T00:00:00Z,2,4,2020,54,5,Egypt,EG,EGY,98423595,Africa,46,710,11
2020-04-03T00:00:00Z,3,4,2020,69,6,Egypt,EG,EGY,98423595,Africa,52,779,12
2020-04-04T00:00:00Z,4,4,2020,0,0,Egypt,EG,EGY,98423595,Africa,52,779,13
2020-04-05T00:00:00Z,5,4,2020,206,14,Egypt,EG,EGY,98423595,Africa,66,985,14
2020-04-06T00:00:00Z,6,4,2020,85,5,Egypt,EG,EGY,98423595,Africa,71,1070,15
2020-04-07T00:00:00Z,7,4,2020,3,7,Egypt,EG,EGY,98423595,Africa,78,1073,16
2020-04-08T00:00:00Z,8,4,2020,249,7,Egypt,EG,EGY,98423595,Africa,85,1322,17
2020-04-09T00:00:00Z,9,4,2020,238,18,Egypt,EG,EGY,98423595,Africa,103,1560,18
2020-04-10T00:00:00Z,10,4,2020,139,15,Egypt,EG,EGY,98423595,Africa,118,1699,19
2020-04-11T00:00:00Z,11,4,2020,95,17,Egypt,EG,EGY,98423595,Africa,135,1794,20
2020-04-12T00:00:00Z,12,4,2020,145,11,Egypt,EG,EGY,98423595,Africa,146,1939,21
2020-04-13T00:00:00Z,13,4,2020,126,13,Egypt,EG,EGY,98423595,Africa,159,2065,22
2020-04-14T00:00:00Z,14,4,2020,125,5,Egypt,EG,EGY,98423595,Africa,164,2190,23
2020-04-15T00:00:00Z,15,4,2020,160,14,Egypt,EG,EGY,98423595,Africa,178,2350,24
2020-04-16T00:00:00Z,16,4,2020,155,5,Egypt,EG,EGY,98423595,Africa,183,2505,25
2020-04-17T00:00:00Z,17,4,2020,168,13,Egypt,EG,EGY,98423595,Africa,196,2673,26
2020-04-18T00:00:00Z,18,4,2020,171,9,Egypt,EG,EGY,98423595,Africa,205,2844,27
2020-04-19T00:00:00Z,19,4,2020,188,19,Egypt,EG,EGY,98423595,Africa,224,3032,28
2020-04-20T00:00:00Z,20,4,2020,112,15,Egypt,EG,EGY,98423595,Africa,239,3144,29
2020-04-21T00:00:00Z,21,4,2020,189,11,Egypt,EG,EGY,98423595,Africa,250,3333,30
2020-04-22T00:00:00Z,22,4,2020,157,14,Egypt,EG,EGY,98423595,Africa,264,3490,31
2020-04-23T00:00:00Z,23,4,2020,0,0,Egypt,EG,EGY,98423595,Africa,264,3490,32
2020-04-24T00:00:00Z,24,4,2020,169,12,Egypt,EG,EGY,98423595,Africa,276,3659,33
2020-04-25T00:00:00Z,25,4,2020,433,18,Egypt,EG,EGY,98423595,Africa,294,4092,34
2020-04-26T00:00:00Z,26,4,2020,227,13,Egypt,EG,EGY,98423595,Africa,307,4319,35
2020-04-27T00:00:00Z,27,4,2020,0,0,Egypt,EG,EGY,98423595,Africa,307,4319,36
2020-04-28T00:00:00Z,28,4,2020,463,30,Egypt,EG,EGY,98423595,Africa,337,4782,37
2020-04-29T00:00:00Z,29,4,2020,260,22,Egypt,EG,EGY,98423595,Africa,359,5042,38
2020-04-30T00:00:00Z,30,4,2020,226,21,Egypt,EG,EGY,98423595,Africa,380,5268,39
2020-05-01T00:00:00Z,1,5,2020,269,12,Egypt,EG,EGY,98423595,Africa,392,5537,40
2020-05-02T00:00:00Z,2,5,2020,358,14,Egypt,EG,EGY,98423595,Africa,406,5895,41
2020-05-03T00:00:00Z,3,5,2020,298,9,Egypt,EG,EGY,98423595,Africa,415,6193,42
2020-05-04T00:00:00Z,4,5,2020,272,14,Egypt,EG,EGY,98423595,Africa,429,6465,43
2020-05-05T00:00:00Z,5,5,2020,348,7,Egypt,EG,EGY,98423595,Africa,436,6813,44
2020-05-06T00:00:00Z,6,5,2020,388,16,Egypt,EG,EGY,98423595,Africa,452,7201,45
2020-05-07T00:00:00Z,7,5,2020,387,17,Egypt,EG,EGY,98423595,Africa,469,7588,46
2020-05-08T00:00:00Z,8,5,2020,393,13,Egypt,EG,EGY,98423595,Africa,482,7981,47
2020-05-09T00:00:00Z,9,5,2020,495,21,Egypt,EG,EGY,98423595,Africa,503,8476,48
2020-05-10T00:00:00Z,10,5,2020,488,11,Egypt,EG,EGY,98423595,Africa,514,8964,49
2020-05-11T00:00:00Z,11,5,2020,436,11,Egypt,EG,EGY,98423595,Africa,525,9400,50
2020-05-12T00:00:00Z,12,5,2020,346,8,Egypt,EG,EGY,98423595,Africa,533,9746,51
2020-05-13T00:00:00Z,13,5,2020,347,11,Egypt,EG,EGY,98423595,Africa,544,10093,52
2020-05-14T00:00:00Z,14,5,2020,338,12,Egypt,EG,EGY,98423595,Africa,556,10431,53
2020-05-15T00:00:00Z,15,5,2020,398,15,Egypt,EG,EGY,98423595,Africa,571,10829,54
2020-05-16T00:00:00Z,16,5,2020,399,21,Egypt,EG,EGY,98423595,Africa,592,11228,55
2020-05-17T00:00:00Z,17,5,2020,491,20,Egypt,EG,EGY,98423595,Africa,612,11719,56
2020-05-18T00:00:00Z,18,5,2020,510,18,Egypt,EG,EGY,98423595,Africa,630,12229,57
2020-05-19T00:00:00Z,19,5,2020,535,15,Egypt,EG,EGY,98423595,Africa,645,12764,58
2020-05-20T00:00:00Z,20,5,2020,720,14,Egypt,EG,EGY,98423595,Africa,659,13484,59
2020-05-21T00:00:00Z,21,5,2020,745,21,Egypt,EG,EGY,98423595,Africa,680,14229,60
2020-05-22T00:00:00Z,22,5,2020,774,16,Egypt,EG,EGY,98423595,Africa,696,15003,61
2020-05-23T00:00:00Z,23,5,2020,783,11,Egypt,EG,EGY,98423595,Africa,707,15786,62
2020-05-24T00:00:00Z,24,5,2020,827,28,Egypt,EG,EGY,98423595,Africa,735,16613,63
2020-05-25T00:00:00Z,25,5,2020,652,29,Egypt,EG,EGY,98423595,Africa,764,17265,64
2020-05-26T00:00:00Z,26,5,2020,702,19,Egypt,EG,EGY,98423595,Africa,783,17967,65
2020-05-27T00:00:00Z,27,5,2020,789,14,Egypt,EG,EGY,98423595,Africa,797,18756,66
2020-05-01T00:00:00Z,1,5,2020,47,1,El_Salvador,SV,SLV,6420744,America,10,424,1
2020-05-02T00:00:00Z,2,5,2020,22,0,El_Salvador,SV,SLV,6420744,America,10,446,2
2020-05-03T00:00:00Z,3,5,2020,0,1,El_Salvador,SV,SLV,6420744,America,11,446,3
2020-05-04T00:00:00Z,4,5,2020,109,1,El_Salvador,SV,SLV,6420744,America,12,555,4
2020-05-05T00:00:00Z,5,5,2020,32,1,El_Salvador,SV,SLV,6420744,America,13,587,5
2020-05-06T00:00:00Z,6,5,2020,0,1,El_Salvador,SV,SLV,6420744,America,14,587,6
2020-05-07T00:00:00Z,7,5,2020,108,1,El_Salvador,SV,SLV,6420744,America,15,695,7
2020-05-08T00:00:00Z,8,5,2020,0,0,El_Salvador,SV,SLV,6420744,America,15,695,8
2020-05-09T00:00:00Z,9,5,2020,89,1,El_Salvador,SV,SLV,6420744,America,16,784,9
2020-05-10T00:00:00Z,10,5,2020,105,1,El_Salvador,SV,SLV,6420744,America,17,889,10
2020-05-11T00:00:00Z,11,5,2020,69,0,El_Salvador,SV,SLV,6420744,America,17,958,11
2020-05-12T00:00:00Z,12,5,2020,40,1,El_Salvador,SV,SLV,6420744,America,18,998,12
2020-05-13T00:00:00Z,13,5,2020,39,2,El_Salvador,SV,SLV,6420744,America,20,1037,13
2020-05-14T00:00:00Z,14,5,2020,75,0,El_Salvador,SV,SLV,6420744,America,20,1112,14
2020-05-15T00:00:00Z,15,5,2020,98,3,El_Salvador,SV,SLV,6420744,America,23,1210,15
2020-05-16T00:00:00Z,16,5,2020,55,2,El_Salvador,SV,SLV,6420744,America,25,1265,16
2020-05-17T00:00:00Z,17,5,2020,0,1,El_Salvador,SV,SLV,6420744,America,26,1265,17
2020-05-18T00:00:00Z,18,5,2020,73,4,El_Salvador,SV,SLV,6420744,America,30,1338,18
2020-05-19T00:00:00Z,19,5,2020,75,0,El_Salvador,SV,SLV,6420744,America,30,1413,19
2020-05-20T00:00:00Z,20,5,2020,85,1,El_Salvador,SV,SLV,6420744,America,31,1498,20
2020-05-21T00:00:00Z,21,5,2020,73,1,El_Salvador,SV,SLV,6420744,America,32,1571,21
2020-05-22T00:00:00Z,22,5,2020,69,1,El_Salvador,SV,SLV,6420744,America,33,1640,22
2020-05-23T00:00:00Z,23,5,2020,85,0,El_Salvador,SV,SLV,6420744,America,33,1725,23
2020-05-24T00:00:00Z,24,5,2020,94,2,El_Salvador,SV,SLV,6420744,America,35,1819,24
2020-05-25T00:00:00Z,25,5,2020,96,0,El_Salvador,SV,SLV,6420744,America,35,1915,25
2020-05-26T00:00:00Z,26,5,2020,68,1,El_Salvador,SV,SLV,6420744,America,36,1983,26
2020-05-27T00:00:00Z,27,5,2020,59,0,El_Salvador,SV,SLV,6420744,America,36,2042,27
2020-05-22T00:00:00Z,22,5,2020,13,3,Equatorial_Guinea,GQ,GNQ,1308974,Africa,10,903,1
2020-05-23T00:00:00Z,23,5,2020,0,0,Equatorial_Guinea,GQ,GNQ,1308974,Africa,10,903,2
2020-05-24T00:00:00Z,24,5,2020,140,2,Equatorial_Guinea,GQ,GNQ,1308974,Africa,12,1043,3
2020-05-25T00:00:00Z,25,5,2020,0,0,Equatorial_Guinea,GQ,GNQ,1308974,Africa,12,1043,4
2020-05-26T00:00:00Z,26,5,2020,0,0,Equatorial_Guinea,GQ,GNQ,1308974,Africa,12,1043,5
2020-05-27T00:00:00Z,27,5,2020,0,0,Equatorial_Guinea,GQ,GNQ,1308974,Africa,12,1043,6
2020-04-03T00:00:00Z,3,4,2020,79,6,Estonia,EE,EST,1320884,Europe,11,858,1
2020-04-04T00:00:00Z,4,4,2020,103,1,Estonia,EE,EST,1320884,Europe,12,961,2
2020-04-05T00:00:00Z,5,4,2020,57,1,Estonia,EE,EST,1320884,Europe,13,1018,3
2020-04-06T00:00:00Z,6,4,2020,79,2,Estonia,EE,EST,1320884,Europe,15,1097,4
2020-04-07T00:00:00Z,7,4,2020,11,4,Estonia,EE,EST,1320884,Europe,19,1108,5
2020-04-08T00:00:00Z,8,4,2020,41,2,Estonia,EE,EST,1320884,Europe,21,1149,6
2020-04-09T00:00:00Z,9,4,2020,36,3,Estonia,EE,EST,1320884,Europe,24,1185,7
2020-04-10T00:00:00Z,10,4,2020,22,0,Estonia,EE,EST,1320884,Europe,24,1207,8
2020-04-11T00:00:00Z,11,4,2020,51,0,Estonia,EE,EST,1320884,Europe,24,1258,9
2020-04-12T00:00:00Z,12,4,2020,46,0,Estonia,EE,EST,1320884,Europe,24,1304,10
2020-04-13T00:00:00Z,13,4,2020,5,1,Estonia,EE,EST,1320884,Europe,25,1309,11
2020-04-14T00:00:00Z,14,4,2020,23,3,Estonia,EE,EST,1320884,Europe,28,1332,12
2020-04-15T00:00:00Z,15,4,2020,41,3,Estonia,EE,EST,1320884,Europe,31,1373,13
2020-04-16T00:00:00Z,16,4,2020,29,4,Estonia,EE,EST,1320884,Europe,35,1402,14
2020-04-17T00:00:00Z,17,4,2020,32,1,Estonia,EE,EST,1320884,Europe,36,1434,15
2020-04-18T00:00:00Z,18,4,2020,25,2,Estonia,EE,EST,1320884,Europe,38,1459,16
2020-04-19T00:00:00Z,19,4,2020,53,0,Estonia,EE,EST,1320884,Europe,38,1512,17
2020-04-20T00:00:00Z,20,4,2020,16,2,Estonia,EE,EST,1320884,Europe,40,1528,18
2020-04-21T00:00:00Z,21,4,2020,7,0,Estonia,EE,EST,1320884,Europe,40,1535,19
2020-04-22T00:00:00Z,22,4,2020,17,3,Estonia,EE,EST,1320884,Europe,43,1552,20
2020-04-23T00:00:00Z,23,4,2020,7,1,Estonia,EE,EST,1320884,Europe,44,1559,21
2020-04-24T00:00:00Z,24,4,2020,33,1,Estonia,EE,EST,1320884,Europe,45,1592,22
2020-04-25T00:00:00Z,25,4,2020,13,1,Estonia,EE,EST,1320884,Europe,46,1605,23
2020-04-26T00:00:00Z,26,4,2020,30,0,Estonia,EE,EST,1320884,Europe,46,1635,24
2020-04-27T00:00:00Z,27,4,2020,8,3,Estonia,EE,EST,1320884,Europe,49,1643,25
2020-04-28T00:00:00Z,28,4,2020,4,1,Estonia,EE,EST,1320884,Europe,50,1647,26
2020-04-29T00:00:00Z,29,4,2020,13,0,Estonia,EE,EST,1320884,Europe,50,1660,27
2020-04-30T00:00:00Z,30,4,2020,6,0,Estonia,EE,EST,1320884,Europe,50,1666,28
2020-05-01T00:00:00Z,1,5,2020,23,2,Estonia,EE,EST,1320884,Europe,52,1689,29
2020-05-02T00:00:00Z,2,5,2020,5,0,Estonia,EE,EST,1320884,Europe,52,1694,30
2020-05-03T00:00:00Z,3,5,2020,5,1,Estonia,EE,EST,1320884,Europe,53,1699,31
2020-05-04T00:00:00Z,4,5,2020,1,2,Estonia,EE,EST,1320884,Europe,55,1700,32
2020-05-05T00:00:00Z,5,5,2020,3,0,Estonia,EE,EST,1320884,Europe,55,1703,33
2020-05-06T00:00:00Z,6,5,2020,8,0,Estonia,EE,EST,1320884,Europe,55,1711,34
2020-05-07T00:00:00Z,7,5,2020,2,0,Estonia,EE,EST,1320884,Europe,55,1713,35
2020-05-08T00:00:00Z,8,5,2020,7,1,Estonia,EE,EST,1320884,Europe,56,1720,36
2020-05-09T00:00:00Z,9,5,2020,5,0,Estonia,EE,EST,1320884,Europe,56,1725,37
2020-05-10T00:00:00Z,10,5,2020,8,4,Estonia,EE,EST,1320884,Europe,60,1733,38
2020-05-11T00:00:00Z,11,5,2020,6,0,Estonia,EE,EST,1320884,Europe,60,1739,39
2020-05-12T00:00:00Z,12,5,2020,2,1,Estonia,EE,EST,1320884,Europe,61,1741,40
2020-05-13T00:00:00Z,13,5,2020,5,0,Estonia,EE,EST,1320884,Europe,61,1746,41
2020-05-14T00:00:00Z,14,5,2020,5,0,Estonia,EE,EST,1320884,Europe,61,1751,42
2020-05-15T00:00:00Z,15,5,2020,7,1,Estonia,EE,EST,1320884,Europe,62,1758,43
2020-05-16T00:00:00Z,16,5,2020,8,1,Estonia,EE,EST,1320884,Europe,63,1766,44
2020-05-17T00:00:00Z,17,5,2020,4,0,Estonia,EE,EST,1320884,Europe,63,1770,45
2020-05-18T00:00:00Z,18,5,2020,4,0,Estonia,EE,EST,1320884,Europe,63,1774,46
2020-05-19T00:00:00Z,19,5,2020,10,1,Estonia,EE,EST,1320884,Europe,64,1784,47
2020-05-20T00:00:00Z,20,5,2020,7,0,Estonia,EE,EST,1320884,Europe,64,1791,48
2020-05-21T00:00:00Z,21,5,2020,3,0,Estonia,EE,EST,1320884,Europe,64,1794,49
2020-05-22T00:00:00Z,22,5,2020,6,0,Estonia,EE,EST,1320884,Europe,64,1800,50
2020-05-23T00:00:00Z,23,5,2020,7,0,Estonia,EE,EST,1320884,Europe,64,1807,51
2020-05-24T00:00:00Z,24,5,2020,14,0,Estonia,EE,EST,1320884,Europe,64,1821,52
2020-05-25T00:00:00Z,25,5,2020,2,0,Estonia,EE,EST,1320884,Europe,64,1823,53
2020-05-26T00:00:00Z,26,5,2020,1,1,Estonia,EE,EST,1320884,Europe,65,1824,54
2020-05-27T00:00:00Z,27,5,2020,10,0,Estonia,EE,EST,1320884,Europe,65,1834,55
2020-03-30T00:00:00Z,30,3,2020,0,2,Finland,FI,FIN,5518050,Europe,11,1218,1
2020-03-31T00:00:00Z,31,3,2020,95,2,Finland,FI,FIN,5518050,Europe,13,1313,2
2020-04-01T00:00:00Z,1,4,2020,71,4,Finland,FI,FIN,5518050,Europe,17,1384,3
2020-04-02T00:00:00Z,2,4,2020,62,0,Finland,FI,FIN,5518050,Europe,17,1446,4
2020-04-03T00:00:00Z,3,4,2020,72,2,Finland,FI,FIN,5518050,Europe,19,1518,5
2020-04-04T00:00:00Z,4,4,2020,97,1,Finland,FI,FIN,5518050,Europe,20,1615,6
2020-04-05T00:00:00Z,5,4,2020,267,5,Finland,FI,FIN,5518050,Europe,25,1882,7
2020-04-06T00:00:00Z,6,4,2020,45,2,Finland,FI,FIN,5518050,Europe,27,1927,8
2020-04-07T00:00:00Z,7,4,2020,249,0,Finland,FI,FIN,5518050,Europe,27,2176,9
2020-04-08T00:00:00Z,8,4,2020,132,7,Finland,FI,FIN,5518050,Europe,34,2308,10
2020-04-09T00:00:00Z,9,4,2020,179,6,Finland,FI,FIN,5518050,Europe,40,2487,11
2020-04-10T00:00:00Z,10,4,2020,118,2,Finland,FI,FIN,5518050,Europe,42,2605,12
2020-04-11T00:00:00Z,11,4,2020,164,6,Finland,FI,FIN,5518050,Europe,48,2769,13
2020-04-12T00:00:00Z,12,4,2020,136,1,Finland,FI,FIN,5518050,Europe,49,2905,14
2020-04-13T00:00:00Z,13,4,2020,69,7,Finland,FI,FIN,5518050,Europe,56,2974,15
2020-04-14T00:00:00Z,14,4,2020,90,3,Finland,FI,FIN,5518050,Europe,59,3064,16
2020-04-15T00:00:00Z,15,4,2020,97,5,Finland,FI,FIN,5518050,Europe,64,3161,17
2020-04-16T00:00:00Z,16,4,2020,76,8,Finland,FI,FIN,5518050,Europe,72,3237,18
2020-04-17T00:00:00Z,17,4,2020,132,3,Finland,FI,FIN,5518050,Europe,75,3369,19
2020-04-18T00:00:00Z,18,4,2020,120,7,Finland,FI,FIN,5518050,Europe,82,3489,20
2020-04-19T00:00:00Z,19,4,2020,192,8,Finland,FI,FIN,5518050,Europe,90,3681,21
2020-04-20T00:00:00Z,20,4,2020,102,4,Finland,FI,FIN,5518050,Europe,94,3783,22
2020-04-21T00:00:00Z,21,4,2020,85,4,Finland,FI,FIN,5518050,Europe,98,3868,23
2020-04-22T00:00:00Z,22,4,2020,146,43,Finland,FI,FIN,5518050,Europe,141,4014,24
2020-04-23T00:00:00Z,23,4,2020,115,8,Finland,FI,FIN,5518050,Europe,149,4129,25
2020-04-24T00:00:00Z,24,4,2020,155,23,Finland,FI,FIN,5518050,Europe,172,4284,26
2020-04-25T00:00:00Z,25,4,2020,111,5,Finland,FI,FIN,5518050,Europe,177,4395,27
2020-04-26T00:00:00Z,26,4,2020,80,9,Finland,FI,FIN,5518050,Europe,186,4475,28
2020-04-27T00:00:00Z,27,4,2020,101,4,Finland,FI,FIN,5518050,Europe,190,4576,29
2020-04-28T00:00:00Z,28,4,2020,119,3,Finland,FI,FIN,5518050,Europe,193,4695,30
2020-04-29T00:00:00Z,29,4,2020,45,6,Finland,FI,FIN,5518050,Europe,199,4740,31
2020-04-30T00:00:00Z,30,4,2020,166,7,Finland,FI,FIN,5518050,Europe,206,4906,32
2020-05-01T00:00:00Z,1,5,2020,89,5,Finland,FI,FIN,5518050,Europe,211,4995,33
2020-05-02T00:00:00Z,2,5,2020,56,7,Finland,FI,FIN,5518050,Europe,218,5051,34
2020-05-03T00:00:00Z,3,5,2020,128,2,Finland,FI,FIN,5518050,Europe,220,5179,35
2020-05-04T00:00:00Z,4,5,2020,75,10,Finland,FI,FIN,5518050,Europe,230,5254,36
2020-05-05T00:00:00Z,5,5,2020,73,10,Finland,FI,FIN,5518050,Europe,240,5327,37
2020-05-06T00:00:00Z,6,5,2020,85,6,Finland,FI,FIN,5518050,Europe,246,5412,38
2020-05-07T00:00:00Z,7,5,2020,161,6,Finland,FI,FIN,5518050,Europe,252,5573,39
2020-05-08T00:00:00Z,8,5,2020,100,3,Finland,FI,FIN,5518050,Europe,255,5673,40
2020-05-09T00:00:00Z,9,5,2020,65,5,Finland,FI,FIN,5518050,Europe,260,5738,41
2020-05-10T00:00:00Z,10,5,2020,142,5,Finland,FI,FIN,5518050,Europe,265,5880,42
2020-05-11T00:00:00Z,11,5,2020,82,2,Finland,FI,FIN,5518050,Europe,267,5962,43
2020-05-12T00:00:00Z,12,5,2020,22,4,Finland,FI,FIN,5518050,Europe,271,5984,44
2020-05-13T00:00:00Z,13,5,2020,19,4,Finland,FI,FIN,5518050,Europe,275,6003,45
2020-05-14T00:00:00Z,14,5,2020,51,9,Finland,FI,FIN,5518050,Europe,284,6054,46
2020-05-15T00:00:00Z,15,5,2020,91,3,Finland,FI,FIN,5518050,Europe,287,6145,47
2020-05-16T00:00:00Z,16,5,2020,83,6,Finland,FI,FIN,5518050,Europe,293,6228,48
2020-05-17T00:00:00Z,17,5,2020,58,4,Finland,FI,FIN,5518050,Europe,297,6286,49
2020-05-18T00:00:00Z,18,5,2020,61,1,Finland,FI,FIN,5518050,Europe,298,6347,50
2020-05-19T00:00:00Z,19,5,2020,33,2,Finland,FI,FIN,5518050,Europe,300,6380,51
2020-05-20T00:00:00Z,20,5,2020,19,1,Finland,FI,FIN,5518050,Europe,301,6399,52
2020-05-21T00:00:00Z,21,5,2020,44,3,Finland,FI,FIN,5518050,Europe,304,6443,53
2020-05-22T00:00:00Z,22,5,2020,50,2,Finland,FI,FIN,5518050,Europe,306,6493,54
2020-05-23T00:00:00Z,23,5,2020,44,0,Finland,FI,FIN,5518050,Europe,306,6537,55
2020-05-24T00:00:00Z,24,5,2020,31,0,Finland,FI,FIN,5518050,Europe,306,6568,56
2020-05-25T00:00:00Z,25,5,2020,11,1,Finland,FI,FIN,5518050,Europe,307,6579,57
2020-05-26T00:00:00Z,26,5,2020,20,1,Finland,FI,FIN,5518050,Europe,308,6599,58
2020-05-27T00:00:00Z,27,5,2020,29,4,Finland,FI,FIN,5518050,Europe,312,6628,59
2020-03-08T00:00:00Z,8,3,2020,103,1,France,FR,FRA,66987244,Europe,10,716,1
2020-03-09T00:00:00Z,9,3,2020,410,9,France,FR,FRA,66987244,Europe,19,1126,2
2020-03-10T00:00:00Z,10,3,2020,286,11,France,FR,FRA,66987244,Europe,30,1412,3
2020-03-11T00:00:00Z,11,3,2020,372,3,France,FR,FRA,66987244,Europe,33,1784,4
2020-03-12T00:00:00Z,12,3,2020,497,15,France,FR,FRA,66987244,Europe,48,2281,5
2020-03-13T00:00:00Z,13,3,2020,595,13,France,FR,FRA,66987244,Europe,61,2876,6
2020-03-14T00:00:00Z,14,3,2020,785,18,France,FR,FRA,66987244,Europe,79,3661,7
2020-03-15T00:00:00Z,15,3,2020,838,12,France,FR,FRA,66987244,Europe,91,4499,8
2020-03-16T00:00:00Z,16,3,2020,924,36,France,FR,FRA,66987244,Europe,127,5423,9
2020-03-17T00:00:00Z,17,3,2020,1210,21,France,FR,FRA,66987244,Europe,148,6633,10
2020-03-18T00:00:00Z,18,3,2020,1097,27,France,FR,FRA,66987244,Europe,175,7730,11
2020-03-19T00:00:00Z,19,3,2020,1404,69,France,FR,FRA,66987244,Europe,244,9134,12
2020-03-20T00:00:00Z,20,3,2020,1861,128,France,FR,FRA,66987244,Europe,372,10995,13
2020-03-21T00:00:00Z,21,3,2020,1617,78,France,FR,FRA,66987244,Europe,450,12612,14
2020-03-22T00:00:00Z,22,3,2020,1847,112,France,FR,FRA,66987244,Europe,562,14459,15
2020-03-23T00:00:00Z,23,3,2020,1559,112,France,FR,FRA,66987244,Europe,674,16018,16
2020-03-24T00:00:00Z,24,3,2020,3838,186,France,FR,FRA,66987244,Europe,860,19856,17
2020-03-25T00:00:00Z,25,3,2020,2446,240,France,FR,FRA,66987244,Europe,1100,22302,18
2020-03-26T00:00:00Z,26,3,2020,2931,231,France,FR,FRA,66987244,Europe,1331,25233,19
2020-03-27T00:00:00Z,27,3,2020,3922,365,France,FR,FRA,66987244,Europe,1696,29155,20
2020-03-28T00:00:00Z,28,3,2020,3809,299,France,FR,FRA,66987244,Europe,1995,32964,21
2020-03-29T00:00:00Z,29,3,2020,4611,319,France,FR,FRA,66987244,Europe,2314,37575,22
2020-03-30T00:00:00Z,30,3,2020,2599,292,France,FR,FRA,66987244,Europe,2606,40174,23
2020-03-31T00:00:00Z,31,3,2020,4376,418,France,FR,FRA,66987244,Europe,3024,44550,24
2020-04-01T00:00:00Z,1,4,2020,7578,499,France,FR,FRA,66987244,Europe,3523,52128,25
2020-04-02T00:00:00Z,2,4,2020,4861,509,France,FR,FRA,66987244,Europe,4032,56989,26
2020-04-03T00:00:00Z,3,4,2020,2116,471,France,FR,FRA,66987244,Europe,4503,59105,27
2020-04-04T00:00:00Z,4,4,2020,5233,2004,France,FR,FRA,66987244,Europe,6507,64338,28
2020-04-05T00:00:00Z,5,4,2020,4267,1053,France,FR,FRA,66987244,Europe,7560,68605,29
2020-04-06T00:00:00Z,6,4,2020,1873,518,France,FR,FRA,66987244,Europe,8078,70478,30
2020-04-07T00:00:00Z,7,4,2020,3912,833,France,FR,FRA,66987244,Europe,8911,74390,31
2020-04-08T00:00:00Z,8,4,2020,3777,1417,France,FR,FRA,66987244,Europe,10328,78167,32
2020-04-09T00:00:00Z,9,4,2020,3881,541,France,FR,FRA,66987244,Europe,10869,82048,33
2020-04-10T00:00:00Z,10,4,2020,4286,1341,France,FR,FRA,66987244,Europe,12210,86334,34
2020-04-11T00:00:00Z,11,4,2020,4342,987,France,FR,FRA,66987244,Europe,13197,90676,35
2020-04-12T00:00:00Z,12,4,2020,3114,635,France,FR,FRA,66987244,Europe,13832,93790,36
2020-04-13T00:00:00Z,13,4,2020,1613,561,France,FR,FRA,66987244,Europe,14393,95403,37
2020-04-14T00:00:00Z,14,4,2020,2673,574,France,FR,FRA,66987244,Europe,14967,98076,38
2020-04-15T00:00:00Z,15,4,2020,5497,762,France,FR,FRA,66987244,Europe,15729,103573,39
2020-04-16T00:00:00Z,16,4,2020,2633,1438,France,FR,FRA,66987244,Europe,17167,106206,40
2020-04-17T00:00:00Z,17,4,2020,2641,753,France,FR,FRA,66987244,Europe,17920,108847,41
2020-04-18T00:00:00Z,18,4,2020,405,761,France,FR,FRA,66987244,Europe,18681,109252,42
2020-04-19T00:00:00Z,19,4,2020,2569,642,France,FR,FRA,66987244,Europe,19323,111821,43
2020-04-20T00:00:00Z,20,4,2020,785,395,France,FR,FRA,66987244,Europe,19718,112606,44
2020-04-21T00:00:00Z,21,4,2020,2051,547,France,FR,FRA,66987244,Europe,20265,114657,45
2020-04-22T00:00:00Z,22,4,2020,2667,531,France,FR,FRA,66987244,Europe,20796,117324,46
2020-04-23T00:00:00Z,23,4,2020,1827,544,France,FR,FRA,66987244,Europe,21340,119151,47
2020-04-24T00:00:00Z,24,4,2020,1653,516,France,FR,FRA,66987244,Europe,21856,120804,48
2020-04-25T00:00:00Z,25,4,2020,1773,389,France,FR,FRA,66987244,Europe,22245,122577,49
2020-04-26T00:00:00Z,26,4,2020,1537,369,France,FR,FRA,66987244,Europe,22614,124114,50
2020-04-27T00:00:00Z,27,4,2020,461,242,France,FR,FRA,66987244,Europe,22856,124575,51
2020-04-28T00:00:00Z,28,4,2020,1195,437,France,FR,FRA,66987244,Europe,23293,125770,52
2020-04-29T00:00:00Z,29,4,2020,1065,367,France,FR,FRA,66987244,Europe,23660,126835,53
2020-04-30T00:00:00Z,30,4,2020,1607,427,France,FR,FRA,66987244,Europe,24087,128442,54
2020-05-01T00:00:00Z,1,5,2020,1139,289,France,FR,FRA,66987244,Europe,24376,129581,55
2020-05-02T00:00:00Z,2,5,2020,604,218,France,FR,FRA,66987244,Europe,24594,130185,56
2020-05-03T00:00:00Z,3,5,2020,794,166,France,FR,FRA,66987244,Europe,24760,130979,57
2020-05-04T00:00:00Z,4,5,2020,308,135,France,FR,FRA,66987244,Europe,24895,131287,58
2020-05-05T00:00:00Z,5,5,2020,576,306,France,FR,FRA,66987244,Europe,25201,131863,59
2020-05-06T00:00:00Z,6,5,2020,1104,330,France,FR,FRA,66987244,Europe,25531,132967,60
2020-05-07T00:00:00Z,7,5,2020,4183,278,France,FR,FRA,66987244,Europe,25809,137150,61
2020-05-08T00:00:00Z,8,5,2020,629,178,France,FR,FRA,66987244,Europe,25987,137779,62
2020-05-09T00:00:00Z,9,5,2020,642,243,France,FR,FRA,66987244,Europe,26230,138421,63
2020-05-10T00:00:00Z,10,5,2020,433,80,France,FR,FRA,66987244,Europe,26310,138854,64
2020-05-11T00:00:00Z,11,5,2020,209,70,France,FR,FRA,66987244,Europe,26380,139063,65
2020-05-12T00:00:00Z,12,5,2020,456,263,France,FR,FRA,66987244,Europe,26643,139519,66
2020-05-13T00:00:00Z,13,5,2020,708,348,France,FR,FRA,66987244,Europe,26991,140227,67
2020-05-14T00:00:00Z,14,5,2020,507,83,France,FR,FRA,66987244,Europe,27074,140734,68
2020-05-15T00:00:00Z,15,5,2020,622,351,France,FR,FRA,66987244,Europe,27425,141356,69
2020-05-16T00:00:00Z,16,5,2020,563,130,France,FR,FRA,66987244,Europe,27555,141919,70
2020-05-17T00:00:00Z,17,5,2020,372,88,France,FR,FRA,66987244,Europe,27643,142291,71
2020-05-18T00:00:00Z,18,5,2020,120,68,France,FR,FRA,66987244,Europe,27711,142411,72
2020-05-19T00:00:00Z,19,5,2020,492,186,France,FR,FRA,66987244,Europe,27897,142903,73
2020-05-20T00:00:00Z,20,5,2020,524,125,France,FR,FRA,66987244,Europe,28022,143427,74
2020-05-21T00:00:00Z,21,5,2020,418,110,France,FR,FRA,66987244,Europe,28132,143845,75
2020-05-22T00:00:00Z,22,5,2020,318,83,France,FR,FRA,66987244,Europe,28215,144163,76
2020-05-23T00:00:00Z,23,5,2020,403,74,France,FR,FRA,66987244,Europe,28289,144566,77
2020-05-24T00:00:00Z,24,5,2020,240,43,France,FR,FRA,66987244,Europe,28332,144806,78
2020-05-25T00:00:00Z,25,5,2020,115,35,France,FR,FRA,66987244,Europe,28367,144921,79
2020-05-26T00:00:00Z,26,5,2020,358,65,France,FR,FRA,66987244,Europe,28432,145279,80
2020-05-27T00:00:00Z,27,5,2020,276,98,France,FR,FRA,66987244,Europe,28530,145555,81
2020-05-15T00:00:00Z,15,5,2020,100,1,Gabon,GA,GAB,2119275,Africa,10,1104,1
2020-05-16T00:00:00Z,16,5,2020,105,0,Gabon,GA,GAB,2119275,Africa,10,1209,2
2020-05-17T00:00:00Z,17,5,2020,111,1,Gabon,GA,GAB,2119275,Africa,11,1320,3
2020-05-18T00:00:00Z,18,5,2020,0,0,Gabon,GA,GAB,2119275,Africa,11,1320,4
2020-05-19T00:00:00Z,19,5,2020,112,0,Gabon,GA,GAB,2119275,Africa,11,1432,5
2020-05-20T00:00:00Z,20,5,2020,70,1,Gabon,GA,GAB,2119275,Africa,12,1502,6
2020-05-21T00:00:00Z,21,5,2020,65,0,Gabon,GA,GAB,2119275,Africa,12,1567,7
2020-05-22T00:00:00Z,22,5,2020,0,0,Gabon,GA,GAB,2119275,Africa,12,1567,8
2020-05-23T00:00:00Z,23,5,2020,161,0,Gabon,GA,GAB,2119275,Africa,12,1728,9
2020-05-24T00:00:00Z,24,5,2020,206,0,Gabon,GA,GAB,2119275,Africa,12,1934,10
2020-05-25T00:00:00Z,25,5,2020,0,0,Gabon,GA,GAB,2119275,Africa,12,1934,11
2020-05-26T00:00:00Z,26,5,2020,201,2,Gabon,GA,GAB,2119275,Africa,14,2135,12
2020-05-27T00:00:00Z,27,5,2020,103,0,Gabon,GA,GAB,2119275,Africa,14,2238,13
2020-05-09T00:00:00Z,9,5,2020,8,1,Georgia,GE,GEO,3731000,Europe,10,623,1
2020-05-10T00:00:00Z,10,5,2020,3,0,Georgia,GE,GEO,3731000,Europe,10,626,2
2020-05-11T00:00:00Z,11,5,2020,9,0,Georgia,GE,GEO,3731000,Europe,10,635,3
2020-05-12T00:00:00Z,12,5,2020,3,1,Georgia,GE,GEO,3731000,Europe,11,638,4
2020-05-13T00:00:00Z,13,5,2020,4,0,Georgia,GE,GEO,3731000,Europe,11,642,5
2020-05-14T00:00:00Z,14,5,2020,5,0,Georgia,GE,GEO,3731000,Europe,11,647,6
2020-05-15T00:00:00Z,15,5,2020,20,1,Georgia,GE,GEO,3731000,Europe,12,667,7
2020-05-16T00:00:00Z,16,5,2020,4,0,Georgia,GE,GEO,3731000,Europe,12,671,8
2020-05-17T00:00:00Z,17,5,2020,24,0,Georgia,GE,GEO,3731000,Europe,12,695,9
2020-05-18T00:00:00Z,18,5,2020,6,0,Georgia,GE,GEO,3731000,Europe,12,701,10
2020-05-19T00:00:00Z,19,5,2020,1,0,Georgia,GE,GEO,3731000,Europe,12,702,11
2020-05-20T00:00:00Z,20,5,2020,5,0,Georgia,GE,GEO,3731000,Europe,12,707,12
2020-05-21T00:00:00Z,21,5,2020,6,0,Georgia,GE,GEO,3731000,Europe,12,713,13
2020-05-22T00:00:00Z,22,5,2020,8,0,Georgia,GE,GEO,3731000,Europe,12,721,14
2020-05-23T00:00:00Z,23,5,2020,2,0,Georgia,GE,GEO,3731000,Europe,12,723,15
2020-05-24T00:00:00Z,24,5,2020,5,0,Georgia,GE,GEO,3731000,Europe,12,728,16
2020-05-25T00:00:00Z,25,5,2020,2,0,Georgia,GE,GEO,3731000,Europe,12,730,17
2020-05-26T00:00:00Z,26,5,2020,1,0,Georgia,GE,GEO,3731000,Europe,12,731,18
2020-05-27T00:00:00Z,27,5,2020,1,0,Georgia,GE,GEO,3731000,Europe,12,732,19
2020-03-16T00:00:00Z,16,3,2020,1043,4,Germany,DE,DEU,82927922,Europe,12,4838,1
2020-03-17T00:00:00Z,17,3,2020,1174,1,Germany,DE,DEU,82927922,Europe,13,6012,2
2020-03-18T00:00:00Z,18,3,2020,1144,0,Germany,DE,DEU,82927922,Europe,13,7156,3
2020-03-19T00:00:00Z,19,3,2020,1042,0,Germany,DE,DEU,82927922,Europe,13,8198,4
2020-03-20T00:00:00Z,20,3,2020,5940,30,Germany,DE,DEU,82927922,Europe,43,14138,5
2020-03-21T00:00:00Z,21,3,2020,4049,2,Germany,DE,DEU,82927922,Europe,45,18187,6
2020-03-22T00:00:00Z,22,3,2020,3276,22,Germany,DE,DEU,82927922,Europe,67,21463,7
2020-03-23T00:00:00Z,23,3,2020,3311,27,Germany,DE,DEU,82927922,Europe,94,24774,8
2020-03-24T00:00:00Z,24,3,2020,4438,32,Germany,DE,DEU,82927922,Europe,126,29212,9
2020-03-25T00:00:00Z,25,3,2020,2342,23,Germany,DE,DEU,82927922,Europe,149,31554,10
2020-03-26T00:00:00Z,26,3,2020,4954,49,Germany,DE,DEU,82927922,Europe,198,36508,11
2020-03-27T00:00:00Z,27,3,2020,5780,55,Germany,DE,DEU,82927922,Europe,253,42288,12
2020-03-28T00:00:00Z,28,3,2020,6294,72,Germany,DE,DEU,82927922,Europe,325,48582,13
2020-03-29T00:00:00Z,29,3,2020,3965,64,Germany,DE,DEU,82927922,Europe,389,52547,14
2020-03-30T00:00:00Z,30,3,2020,4751,66,Germany,DE,DEU,82927922,Europe,455,57298,15
2020-03-31T00:00:00Z,31,3,2020,4615,128,Germany,DE,DEU,82927922,Europe,583,61913,16
2020-04-01T00:00:00Z,1,4,2020,5453,149,Germany,DE,DEU,82927922,Europe,732,67366,17
2020-04-02T00:00:00Z,2,4,2020,6156,140,Germany,DE,DEU,82927922,Europe,872,73522,18
2020-04-03T00:00:00Z,3,4,2020,6174,145,Germany,DE,DEU,82927922,Europe,1017,79696,19
2020-04-04T00:00:00Z,4,4,2020,6082,141,Germany,DE,DEU,82927922,Europe,1158,85778,20
2020-04-05T00:00:00Z,5,4,2020,5936,184,Germany,DE,DEU,82927922,Europe,1342,91714,21
2020-04-06T00:00:00Z,6,4,2020,3677,92,Germany,DE,DEU,82927922,Europe,1434,95391,22
2020-04-07T00:00:00Z,7,4,2020,3834,173,Germany,DE,DEU,82927922,Europe,1607,99225,23
2020-04-08T00:00:00Z,8,4,2020,4003,254,Germany,DE,DEU,82927922,Europe,1861,103228,24
2020-04-09T00:00:00Z,9,4,2020,4974,246,Germany,DE,DEU,82927922,Europe,2107,108202,25
2020-04-10T00:00:00Z,10,4,2020,5323,266,Germany,DE,DEU,82927922,Europe,2373,113525,26
2020-04-11T00:00:00Z,11,4,2020,4133,171,Germany,DE,DEU,82927922,Europe,2544,117658,27
2020-04-12T00:00:00Z,12,4,2020,2821,129,Germany,DE,DEU,82927922,Europe,2673,120479,28
2020-04-13T00:00:00Z,13,4,2020,2537,126,Germany,DE,DEU,82927922,Europe,2799,123016,29
2020-04-14T00:00:00Z,14,4,2020,2082,170,Germany,DE,DEU,82927922,Europe,2969,125098,30
2020-04-15T00:00:00Z,15,4,2020,2486,285,Germany,DE,DEU,82927922,Europe,3254,127584,31
2020-04-16T00:00:00Z,16,4,2020,2866,315,Germany,DE,DEU,82927922,Europe,3569,130450,32
2020-04-17T00:00:00Z,17,4,2020,3380,299,Germany,DE,DEU,82927922,Europe,3868,133830,33
2020-04-18T00:00:00Z,18,4,2020,3609,242,Germany,DE,DEU,82927922,Europe,4110,137439,34
2020-04-19T00:00:00Z,19,4,2020,2458,184,Germany,DE,DEU,82927922,Europe,4294,139897,35
2020-04-20T00:00:00Z,20,4,2020,1775,110,Germany,DE,DEU,82927922,Europe,4404,141672,36
2020-04-21T00:00:00Z,21,4,2020,1785,194,Germany,DE,DEU,82927922,Europe,4598,143457,37
2020-04-22T00:00:00Z,22,4,2020,2237,281,Germany,DE,DEU,82927922,Europe,4879,145694,38
2020-04-23T00:00:00Z,23,4,2020,2352,215,Germany,DE,DEU,82927922,Europe,5094,148046,39
2020-04-24T00:00:00Z,24,4,2020,2337,227,Germany,DE,DEU,82927922,Europe,5321,150383,40
2020-04-25T00:00:00Z,25,4,2020,2055,179,Germany,DE,DEU,82927922,Europe,5500,152438,41
2020-04-26T00:00:00Z,26,4,2020,1737,140,Germany,DE,DEU,82927922,Europe,5640,154175,42
2020-04-27T00:00:00Z,27,4,2020,1018,110,Germany,DE,DEU,82927922,Europe,5750,155193,43
2020-04-28T00:00:00Z,28,4,2020,1144,163,Germany,DE,DEU,82927922,Europe,5913,156337,44
2020-04-29T00:00:00Z,29,4,2020,1304,202,Germany,DE,DEU,82927922,Europe,6115,157641,45
2020-04-30T00:00:00Z,30,4,2020,1478,173,Germany,DE,DEU,82927922,Europe,6288,159119,46
2020-05-01T00:00:00Z,1,5,2020,0,0,Germany,DE,DEU,82927922,Europe,6288,159119,47
2020-05-02T00:00:00Z,2,5,2020,2584,287,Germany,DE,DEU,82927922,Europe,6575,161703,48
2020-05-03T00:00:00Z,3,5,2020,793,74,Germany,DE,DEU,82927922,Europe,6649,162496,49
2020-05-04T00:00:00Z,4,5,2020,679,43,Germany,DE,DEU,82927922,Europe,6692,163175,50
2020-05-05T00:00:00Z,5,5,2020,685,139,Germany,DE,DEU,82927922,Europe,6831,163860,51
2020-05-06T00:00:00Z,6,5,2020,1037,165,Germany,DE,DEU,82927922,Europe,6996,164897,52
2020-05-07T00:00:00Z,7,5,2020,1194,123,Germany,DE,DEU,82927922,Europe,7119,166091,53
2020-05-08T00:00:00Z,8,5,2020,1209,147,Germany,DE,DEU,82927922,Europe,7266,167300,54
2020-05-09T00:00:00Z,9,5,2020,1251,103,Germany,DE,DEU,82927922,Europe,7369,168551,55
2020-05-10T00:00:00Z,10,5,2020,667,26,Germany,DE,DEU,82927922,Europe,7395,169218,56
2020-05-11T00:00:00Z,11,5,2020,357,22,Germany,DE,DEU,82927922,Europe,7417,169575,57
2020-05-12T00:00:00Z,12,5,2020,933,116,Germany,DE,DEU,82927922,Europe,7533,170508,58
2020-05-13T00:00:00Z,13,5,2020,798,101,Germany,DE,DEU,82927922,Europe,7634,171306,59
2020-05-14T00:00:00Z,14,5,2020,933,89,Germany,DE,DEU,82927922,Europe,7723,172239,60
2020-05-15T00:00:00Z,15,5,2020,913,101,Germany,DE,DEU,82927922,Europe,7824,173152,61
2020-05-16T00:00:00Z,16,5,2020,620,57,Germany,DE,DEU,82927922,Europe,7881,173772,62
2020-05-17T00:00:00Z,17,5,2020,583,33,Germany,DE,DEU,82927922,Europe,7914,174355,63
2020-05-18T00:00:00Z,18,5,2020,342,21,Germany,DE,DEU,82927922,Europe,7935,174697,64
2020-05-19T00:00:00Z,19,5,2020,513,72,Germany,DE,DEU,82927922,Europe,8007,175210,65
2020-05-20T00:00:00Z,20,5,2020,797,83,Germany,DE,DEU,82927922,Europe,8090,176007,66
2020-05-21T00:00:00Z,21,5,2020,745,57,Germany,DE,DEU,82927922,Europe,8147,176752,67
2020-05-22T00:00:00Z,22,5,2020,460,27,Germany,DE,DEU,82927922,Europe,8174,177212,68
2020-05-23T00:00:00Z,23,5,2020,638,42,Germany,DE,DEU,82927922,Europe,8216,177850,69
2020-05-24T00:00:00Z,24,5,2020,431,31,Germany,DE,DEU,82927922,Europe,8247,178281,70
2020-05-25T00:00:00Z,25,5,2020,289,10,Germany,DE,DEU,82927922,Europe,8257,178570,71
2020-05-26T00:00:00Z,26,5,2020,432,45,Germany,DE,DEU,82927922,Europe,8302,179002,72
2020-05-27T00:00:00Z,27,5,2020,362,47,Germany,DE,DEU,82927922,Europe,8349,179364,73
2020-04-25T00:00:00Z,25,4,2020,125,1,Ghana,GH,GHA,29767108,Africa,10,1279,1
2020-04-26T00:00:00Z,26,4,2020,0,0,Ghana,GH,GHA,29767108,Africa,10,1279,2
2020-04-27T00:00:00Z,27,4,2020,271,1,Ghana,GH,GHA,29767108,Africa,11,1550,3
2020-04-28T00:00:00Z,28,4,2020,0,0,Ghana,GH,GHA,29767108,Africa,11,1550,4
2020-04-29T00:00:00Z,29,4,2020,121,5,Ghana,GH,GHA,29767108,Africa,16,1671,5
2020-04-30T00:00:00Z,30,4,2020,0,0,Ghana,GH,GHA,29767108,Africa,16,1671,6
2020-05-01T00:00:00Z,1,5,2020,403,1,Ghana,GH,GHA,29767108,Africa,17,2074,7
2020-05-02T00:00:00Z,2,5,2020,0,0,Ghana,GH,GHA,29767108,Africa,17,2074,8
2020-05-03T00:00:00Z,3,5,2020,95,1,Ghana,GH,GHA,29767108,Africa,18,2169,9
2020-05-04T00:00:00Z,4,5,2020,0,0,Ghana,GH,GHA,29767108,Africa,18,2169,10
2020-05-05T00:00:00Z,5,5,2020,550,0,Ghana,GH,GHA,29767108,Africa,18,2719,11
2020-05-06T00:00:00Z,6,5,2020,0,0,Ghana,GH,GHA,29767108,Africa,18,2719,12
2020-05-07T00:00:00Z,7,5,2020,372,0,Ghana,GH,GHA,29767108,Africa,18,3091,13
2020-05-08T00:00:00Z,8,5,2020,0,0,Ghana,GH,GHA,29767108,Africa,18,3091,14
2020-05-09T00:00:00Z,9,5,2020,921,0,Ghana,GH,GHA,29767108,Africa,18,4012,15
2020-05-10T00:00:00Z,10,5,2020,251,4,Ghana,GH,GHA,29767108,Africa,22,4263,16
2020-05-11T00:00:00Z,11,5,2020,0,0,Ghana,GH,GHA,29767108,Africa,22,4263,17
2020-05-12T00:00:00Z,12,5,2020,437,0,Ghana,GH,GHA,29767108,Africa,22,4700,18
2020-05-13T00:00:00Z,13,5,2020,427,0,Ghana,GH,GHA,29767108,Africa,22,5127,19
2020-05-14T00:00:00Z,14,5,2020,281,2,Ghana,GH,GHA,29767108,Africa,24,5408,20
2020-05-15T00:00:00Z,15,5,2020,122,0,Ghana,GH,GHA,29767108,Africa,24,5530,21
2020-05-16T00:00:00Z,16,5,2020,108,4,Ghana,GH,GHA,29767108,Africa,28,5638,22
2020-05-17T00:00:00Z,17,5,2020,97,1,Ghana,GH,GHA,29767108,Africa,29,5735,23
2020-05-18T00:00:00Z,18,5,2020,0,0,Ghana,GH,GHA,29767108,Africa,29,5735,24
2020-05-19T00:00:00Z,19,5,2020,0,0,Ghana,GH,GHA,29767108,Africa,29,5735,25
2020-05-20T00:00:00Z,20,5,2020,361,2,Ghana,GH,GHA,29767108,Africa,31,6096,26
2020-05-21T00:00:00Z,21,5,2020,173,0,Ghana,GH,GHA,29767108,Africa,31,6269,27
2020-05-22T00:00:00Z,22,5,2020,217,0,Ghana,GH,GHA,29767108,Africa,31,6486,28
2020-05-23T00:00:00Z,23,5,2020,131,0,Ghana,GH,GHA,29767108,Africa,31,6617,29
2020-05-24T00:00:00Z,24,5,2020,0,0,Ghana,GH,GHA,29767108,Africa,31,6617,30
2020-05-25T00:00:00Z,25,5,2020,66,1,Ghana,GH,GHA,29767108,Africa,32,6683,31
2020-05-26T00:00:00Z,26,5,2020,125,0,Ghana,GH,GHA,29767108,Africa,32,6808,32
2020-05-27T00:00:00Z,27,5,2020,309,2,Ghana,GH,GHA,29767108,Africa,34,7117,33
2020-03-22T00:00:00Z,22,3,2020,35,5,Greece,EL,GRC,10727668,Europe,13,530,1
2020-03-23T00:00:00Z,23,3,2020,94,2,Greece,EL,GRC,10727668,Europe,15,624,2
2020-03-24T00:00:00Z,24,3,2020,71,2,Greece,EL,GRC,10727668,Europe,17,695,3
2020-03-25T00:00:00Z,25,3,2020,48,3,Greece,EL,GRC,10727668,Europe,20,743,4
2020-03-26T00:00:00Z,26,3,2020,78,2,Greece,EL,GRC,10727668,Europe,22,821,5
2020-03-27T00:00:00Z,27,3,2020,71,4,Greece,EL,GRC,10727668,Europe,26,892,6
2020-03-28T00:00:00Z,28,3,2020,74,2,Greece,EL,GRC,10727668,Europe,28,966,7
2020-03-29T00:00:00Z,29,3,2020,95,4,Greece,EL,GRC,10727668,Europe,32,1061,8
2020-03-30T00:00:00Z,30,3,2020,95,6,Greece,EL,GRC,10727668,Europe,38,1156,9
2020-03-31T00:00:00Z,31,3,2020,56,5,Greece,EL,GRC,10727668,Europe,43,1212,10
2020-04-01T00:00:00Z,1,4,2020,102,6,Greece,EL,GRC,10727668,Europe,49,1314,11
2020-04-02T00:00:00Z,2,4,2020,61,1,Greece,EL,GRC,10727668,Europe,50,1375,12
2020-04-03T00:00:00Z,3,4,2020,139,3,Greece,EL,GRC,10727668,Europe,53,1514,13
2020-04-04T00:00:00Z,4,4,2020,99,6,Greece,EL,GRC,10727668,Europe,59,1613,14
2020-04-05T00:00:00Z,5,4,2020,60,9,Greece,EL,GRC,10727668,Europe,68,1673,15
2020-04-06T00:00:00Z,6,4,2020,62,5,Greece,EL,GRC,10727668,Europe,73,1735,16
2020-04-07T00:00:00Z,7,4,2020,20,6,Greece,EL,GRC,10727668,Europe,79,1755,17
2020-04-08T00:00:00Z,8,4,2020,77,2,Greece,EL,GRC,10727668,Europe,81,1832,18
2020-04-09T00:00:00Z,9,4,2020,52,2,Greece,EL,GRC,10727668,Europe,83,1884,19
2020-04-10T00:00:00Z,10,4,2020,71,3,Greece,EL,GRC,10727668,Europe,86,1955,20
2020-04-11T00:00:00Z,11,4,2020,56,4,Greece,EL,GRC,10727668,Europe,90,2011,21
2020-04-12T00:00:00Z,12,4,2020,70,3,Greece,EL,GRC,10727668,Europe,93,2081,22
2020-04-13T00:00:00Z,13,4,2020,33,5,Greece,EL,GRC,10727668,Europe,98,2114,23
2020-04-14T00:00:00Z,14,4,2020,31,1,Greece,EL,GRC,10727668,Europe,99,2145,24
2020-04-15T00:00:00Z,15,4,2020,25,2,Greece,EL,GRC,10727668,Europe,101,2170,25
2020-04-16T00:00:00Z,16,4,2020,22,1,Greece,EL,GRC,10727668,Europe,102,2192,26
2020-04-17T00:00:00Z,17,4,2020,15,3,Greece,EL,GRC,10727668,Europe,105,2207,27
2020-04-18T00:00:00Z,18,4,2020,0,0,Greece,EL,GRC,10727668,Europe,105,2207,28
2020-04-19T00:00:00Z,19,4,2020,0,0,Greece,EL,GRC,10727668,Europe,105,2207,29
2020-04-20T00:00:00Z,20,4,2020,28,5,Greece,EL,GRC,10727668,Europe,110,2235,30
2020-04-21T00:00:00Z,21,4,2020,10,6,Greece,EL,GRC,10727668,Europe,116,2245,31
2020-04-22T00:00:00Z,22,4,2020,156,5,Greece,EL,GRC,10727668,Europe,121,2401,32
2020-04-23T00:00:00Z,23,4,2020,7,0,Greece,EL,GRC,10727668,Europe,121,2408,33
2020-04-24T00:00:00Z,24,4,2020,55,4,Greece,EL,GRC,10727668,Europe,125,2463,34
2020-04-25T00:00:00Z,25,4,2020,27,5,Greece,EL,GRC,10727668,Europe,130,2490,35
2020-04-26T00:00:00Z,26,4,2020,16,0,Greece,EL,GRC,10727668,Europe,130,2506,36
2020-04-27T00:00:00Z,27,4,2020,0,0,Greece,EL,GRC,10727668,Europe,130,2506,37
2020-04-28T00:00:00Z,28,4,2020,28,6,Greece,EL,GRC,10727668,Europe,136,2534,38
2020-04-29T00:00:00Z,29,4,2020,0,0,Greece,EL,GRC,10727668,Europe,136,2534,39
2020-04-30T00:00:00Z,30,4,2020,42,3,Greece,EL,GRC,10727668,Europe,139,2576,40
2020-05-01T00:00:00Z,1,5,2020,15,1,Greece,EL,GRC,10727668,Europe,140,2591,41
2020-05-02T00:00:00Z,2,5,2020,0,0,Greece,EL,GRC,10727668,Europe,140,2591,42
2020-05-03T00:00:00Z,3,5,2020,29,3,Greece,EL,GRC,10727668,Europe,143,2620,43
2020-05-04T00:00:00Z,4,5,2020,6,1,Greece,EL,GRC,10727668,Europe,144,2626,44
2020-05-05T00:00:00Z,5,5,2020,6,2,Greece,EL,GRC,10727668,Europe,146,2632,45
2020-05-06T00:00:00Z,6,5,2020,10,0,Greece,EL,GRC,10727668,Europe,146,2642,46
2020-05-07T00:00:00Z,7,5,2020,21,1,Greece,EL,GRC,10727668,Europe,147,2663,47
2020-05-08T00:00:00Z,8,5,2020,15,1,Greece,EL,GRC,10727668,Europe,148,2678,48
2020-05-09T00:00:00Z,9,5,2020,13,2,Greece,EL,GRC,10727668,Europe,150,2691,49
2020-05-10T00:00:00Z,10,5,2020,19,1,Greece,EL,GRC,10727668,Europe,151,2710,50
2020-05-11T00:00:00Z,11,5,2020,6,0,Greece,EL,GRC,10727668,Europe,151,2716,51
2020-05-12T00:00:00Z,12,5,2020,10,0,Greece,EL,GRC,10727668,Europe,151,2726,52
2020-05-13T00:00:00Z,13,5,2020,18,1,Greece,EL,GRC,10727668,Europe,152,2744,53
2020-05-14T00:00:00Z,14,5,2020,16,3,Greece,EL,GRC,10727668,Europe,155,2760,54
2020-05-15T00:00:00Z,15,5,2020,10,1,Greece,EL,GRC,10727668,Europe,156,2770,55
2020-05-16T00:00:00Z,16,5,2020,40,4,Greece,EL,GRC,10727668,Europe,160,2810,56
2020-05-17T00:00:00Z,17,5,2020,9,2,Greece,EL,GRC,10727668,Europe,162,2819,57
2020-05-18T00:00:00Z,18,5,2020,15,1,Greece,EL,GRC,10727668,Europe,163,2834,58
2020-05-19T00:00:00Z,19,5,2020,2,2,Greece,EL,GRC,10727668,Europe,165,2836,59
2020-05-20T00:00:00Z,20,5,2020,4,0,Greece,EL,GRC,10727668,Europe,165,2840,60
2020-05-21T00:00:00Z,21,5,2020,10,1,Greece,EL,GRC,10727668,Europe,166,2850,61
2020-05-22T00:00:00Z,22,5,2020,3,2,Greece,EL,GRC,10727668,Europe,168,2853,62
2020-05-23T00:00:00Z,23,5,2020,20,1,Greece,EL,GRC,10727668,Europe,169,2873,63
2020-05-24T00:00:00Z,24,5,2020,3,2,Greece,EL,GRC,10727668,Europe,171,2876,64
2020-05-25T00:00:00Z,25,5,2020,2,0,Greece,EL,GRC,10727668,Europe,171,2878,65
2020-05-26T00:00:00Z,26,5,2020,4,1,Greece,EL,GRC,10727668,Europe,172,2882,66
2020-05-27T00:00:00Z,27,5,2020,10,1,Greece,EL,GRC,10727668,Europe,173,2892,67
2020-04-23T00:00:00Z,23,4,2020,26,2,Guatemala,GT,GTM,17247807,America,10,342,1
2020-04-24T00:00:00Z,24,4,2020,42,1,Guatemala,GT,GTM,17247807,America,11,384,2
2020-04-25T00:00:00Z,25,4,2020,46,0,Guatemala,GT,GTM,17247807,America,11,430,3
2020-04-26T00:00:00Z,26,4,2020,43,2,Guatemala,GT,GTM,17247807,America,13,473,4
2020-04-27T00:00:00Z,27,4,2020,27,2,Guatemala,GT,GTM,17247807,America,15,500,5
2020-04-28T00:00:00Z,28,4,2020,30,0,Guatemala,GT,GTM,17247807,America,15,530,6
2020-04-29T00:00:00Z,29,4,2020,27,1,Guatemala,GT,GTM,17247807,America,16,557,7
2020-04-30T00:00:00Z,30,4,2020,28,0,Guatemala,GT,GTM,17247807,America,16,585,8
2020-05-01T00:00:00Z,1,5,2020,14,0,Guatemala,GT,GTM,17247807,America,16,599,9
2020-05-02T00:00:00Z,2,5,2020,45,0,Guatemala,GT,GTM,17247807,America,16,644,10
2020-05-03T00:00:00Z,3,5,2020,44,1,Guatemala,GT,GTM,17247807,America,17,688,11
2020-05-04T00:00:00Z,4,5,2020,15,0,Guatemala,GT,GTM,17247807,America,17,703,12
2020-05-05T00:00:00Z,5,5,2020,27,2,Guatemala,GT,GTM,17247807,America,19,730,13
2020-05-06T00:00:00Z,6,5,2020,33,0,Guatemala,GT,GTM,17247807,America,19,763,14
2020-05-07T00:00:00Z,7,5,2020,35,2,Guatemala,GT,GTM,17247807,America,21,798,15
2020-05-08T00:00:00Z,8,5,2020,34,2,Guatemala,GT,GTM,17247807,America,23,832,16
2020-05-09T00:00:00Z,9,5,2020,68,1,Guatemala,GT,GTM,17247807,America,24,900,17
2020-05-10T00:00:00Z,10,5,2020,67,0,Guatemala,GT,GTM,17247807,America,24,967,18
2020-05-11T00:00:00Z,11,5,2020,85,2,Guatemala,GT,GTM,17247807,America,26,1052,19
2020-05-12T00:00:00Z,12,5,2020,62,0,Guatemala,GT,GTM,17247807,America,26,1114,20
2020-05-13T00:00:00Z,13,5,2020,85,1,Guatemala,GT,GTM,17247807,America,27,1199,21
2020-05-14T00:00:00Z,14,5,2020,143,2,Guatemala,GT,GTM,17247807,America,29,1342,22
2020-05-15T00:00:00Z,15,5,2020,176,0,Guatemala,GT,GTM,17247807,America,29,1518,23
2020-05-16T00:00:00Z,16,5,2020,125,1,Guatemala,GT,GTM,17247807,America,30,1643,24
2020-05-17T00:00:00Z,17,5,2020,120,3,Guatemala,GT,GTM,17247807,America,33,1763,25
2020-05-18T00:00:00Z,18,5,2020,149,2,Guatemala,GT,GTM,17247807,America,35,1912,26
2020-05-19T00:00:00Z,19,5,2020,89,3,Guatemala,GT,GTM,17247807,America,38,2001,27
2020-05-20T00:00:00Z,20,5,2020,132,5,Guatemala,GT,GTM,17247807,America,43,2133,28
2020-05-21T00:00:00Z,21,5,2020,132,2,Guatemala,GT,GTM,17247807,America,45,2265,29
2020-05-22T00:00:00Z,22,5,2020,247,3,Guatemala,GT,GTM,17247807,America,48,2512,30
2020-05-23T00:00:00Z,23,5,2020,231,3,Guatemala,GT,GTM,17247807,America,51,2743,31
2020-05-24T00:00:00Z,24,5,2020,311,4,Guatemala,GT,GTM,17247807,America,55,3054,32
2020-05-25T00:00:00Z,25,5,2020,370,3,Guatemala,GT,GTM,17247807,America,58,3424,33
2020-05-26T00:00:00Z,26,5,2020,336,1,Guatemala,GT,GTM,17247807,America,59,3760,34
2020-05-27T00:00:00Z,27,5,2020,194,4,Guatemala,GT,GTM,17247807,America,63,3954,35
2020-04-21T00:00:00Z,21,4,2020,0,1,Guernsey,GG,GGY,63026,Europe,10,239,1
2020-04-22T00:00:00Z,22,4,2020,0,0,Guernsey,GG,GGY,63026,Europe,10,239,2
2020-04-23T00:00:00Z,23,4,2020,4,0,Guernsey,GG,GGY,63026,Europe,10,243,3
2020-04-24T00:00:00Z,24,4,2020,2,0,Guernsey,GG,GGY,63026,Europe,10,245,4
2020-04-25T00:00:00Z,25,4,2020,0,1,Guernsey,GG,GGY,63026,Europe,11,245,5
2020-04-26T00:00:00Z,26,4,2020,0,1,Guernsey,GG,GGY,63026,Europe,12,245,6
2020-04-27T00:00:00Z,27,4,2020,2,1,Guernsey,GG,GGY,63026,Europe,13,247,7
2020-04-28T00:00:00Z,28,4,2020,0,0,Guernsey,GG,GGY,63026,Europe,13,247,8
2020-04-29T00:00:00Z,29,4,2020,0,0,Guernsey,GG,GGY,63026,Europe,13,247,9
2020-04-30T00:00:00Z,30,4,2020,4,0,Guernsey,GG,GGY,63026,Europe,13,251,10
2020-05-01T00:00:00Z,1,5,2020,0,0,Guernsey,GG,GGY,63026,Europe,13,251,11
2020-05-02T00:00:00Z,2,5,2020,1,0,Guernsey,GG,GGY,63026,Europe,13,252,12
2020-05-03T00:00:00Z,3,5,2020,0,0,Guernsey,GG,GGY,63026,Europe,13,252,13
2020-05-04T00:00:00Z,4,5,2020,0,0,Guernsey,GG,GGY,63026,Europe,13,252,14
2020-05-05T00:00:00Z,5,5,2020,0,0,Guernsey,GG,GGY,63026,Europe,13,252,15
2020-05-06T00:00:00Z,6,5,2020,0,0,Guernsey,GG,GGY,63026,Europe,13,252,16
2020-05-07T00:00:00Z,7,5,2020,0,0,Guernsey,GG,GGY,63026,Europe,13,252,17
2020-05-08T00:00:00Z,8,5,2020,0,0,Guernsey,GG,GGY,63026,Europe,13,252,18
2020-05-09T00:00:00Z,9,5,2020,0,0,Guernsey,GG,GGY,63026,Europe,13,252,19
2020-05-10T00:00:00Z,10,5,2020,0,0,Guernsey,GG,GGY,63026,Europe,13,252,20
2020-05-11T00:00:00Z,11,5,2020,0,0,Guernsey,GG,GGY,63026,Europe,13,252,21
2020-05-12T00:00:00Z,12,5,2020,0,0,Guernsey,GG,GGY,63026,Europe,13,252,22
2020-05-13T00:00:00Z,13,5,2020,0,0,Guernsey,GG,GGY,63026,Europe,13,252,23
2020-05-14T00:00:00Z,14,5,2020,0,0,Guernsey,GG,GGY,63026,Europe,13,252,24
2020-05-15T00:00:00Z,15,5,2020,0,0,Guernsey,GG,GGY,63026,Europe,13,252,25
2020-05-16T00:00:00Z,16,5,2020,0,0,Guernsey,GG,GGY,63026,Europe,13,252,26
2020-05-17T00:00:00Z,17,5,2020,0,0,Guernsey,GG,GGY,63026,Europe,13,252,27
2020-05-18T00:00:00Z,18,5,2020,0,0,Guernsey,GG,GGY,63026,Europe,13,252,28
2020-05-19T00:00:00Z,19,5,2020,0,0,Guernsey,GG,GGY,63026,Europe,13,252,29
2020-05-20T00:00:00Z,20,5,2020,0,0,Guernsey,GG,GGY,63026,Europe,13,252,30
2020-05-21T00:00:00Z,21,5,2020,0,0,Guernsey,GG,GGY,63026,Europe,13,252,31
2020-05-22T00:00:00Z,22,5,2020,0,0,Guernsey,GG,GGY,63026,Europe,13,252,32
2020-05-23T00:00:00Z,23,5,2020,0,0,Guernsey,GG,GGY,63026,Europe,13,252,33
2020-05-24T00:00:00Z,24,5,2020,0,0,Guernsey,GG,GGY,63026,Europe,13,252,34
2020-05-25T00:00:00Z,25,5,2020,0,0,Guernsey,GG,GGY,63026,Europe,13,252,35
2020-05-26T00:00:00Z,26,5,2020,0,0,Guernsey,GG,GGY,63026,Europe,13,252,36
2020-05-27T00:00:00Z,27,5,2020,0,0,Guernsey,GG,GGY,63026,Europe,13,252,37
2020-05-06T00:00:00Z,6,5,2020,101,1,Guinea,GN,GIN,12414318,Africa,10,1811,1
2020-05-07T00:00:00Z,7,5,2020,45,1,Guinea,GN,GIN,12414318,Africa,11,1856,2
2020-05-08T00:00:00Z,8,5,2020,71,0,Guinea,GN,GIN,12414318,Africa,11,1927,3
2020-05-09T00:00:00Z,9,5,2020,82,0,Guinea,GN,GIN,12414318,Africa,11,2009,4
2020-05-10T00:00:00Z,10,5,2020,33,0,Guinea,GN,GIN,12414318,Africa,11,2042,5
2020-05-11T00:00:00Z,11,5,2020,104,0,Guinea,GN,GIN,12414318,Africa,11,2146,6
2020-05-12T00:00:00Z,12,5,2020,67,0,Guinea,GN,GIN,12414318,Africa,11,2213,7
2020-05-13T00:00:00Z,13,5,2020,0,0,Guinea,GN,GIN,12414318,Africa,11,2213,8
2020-05-14T00:00:00Z,14,5,2020,161,3,Guinea,GN,GIN,12414318,Africa,14,2374,9
2020-05-15T00:00:00Z,15,5,2020,99,0,Guinea,GN,GIN,12414318,Africa,14,2473,10
2020-05-16T00:00:00Z,16,5,2020,58,1,Guinea,GN,GIN,12414318,Africa,15,2531,11
2020-05-17T00:00:00Z,17,5,2020,127,1,Guinea,GN,GIN,12414318,Africa,16,2658,12
2020-05-18T00:00:00Z,18,5,2020,0,0,Guinea,GN,GIN,12414318,Africa,16,2658,13
2020-05-19T00:00:00Z,19,5,2020,138,0,Guinea,GN,GIN,12414318,Africa,16,2796,14
2020-05-20T00:00:00Z,20,5,2020,67,2,Guinea,GN,GIN,12414318,Africa,18,2863,15
2020-05-21T00:00:00Z,21,5,2020,0,0,Guinea,GN,GIN,12414318,Africa,18,2863,16
2020-05-22T00:00:00Z,22,5,2020,204,1,Guinea,GN,GIN,12414318,Africa,19,3067,17
2020-05-23T00:00:00Z,23,5,2020,0,0,Guinea,GN,GIN,12414318,Africa,19,3067,18
2020-05-24T00:00:00Z,24,5,2020,109,1,Guinea,GN,GIN,12414318,Africa,20,3176,19
2020-05-25T00:00:00Z,25,5,2020,99,0,Guinea,GN,GIN,12414318,Africa,20,3275,20
2020-05-26T00:00:00Z,26,5,2020,0,0,Guinea,GN,GIN,12414318,Africa,20,3275,21
2020-05-27T00:00:00Z,27,5,2020,83,0,Guinea,GN,GIN,12414318,Africa,20,3358,22
2020-05-06T00:00:00Z,6,5,2020,1,1,Guyana,GY,GUY,779004,America,10,93,1
2020-05-07T00:00:00Z,7,5,2020,0,0,Guyana,GY,GUY,779004,America,10,93,2
2020-05-08T00:00:00Z,8,5,2020,0,0,Guyana,GY,GUY,779004,America,10,93,3
2020-05-09T00:00:00Z,9,5,2020,1,0,Guyana,GY,GUY,779004,America,10,94,4
2020-05-10T00:00:00Z,10,5,2020,3,0,Guyana,GY,GUY,779004,America,10,97,5
2020-05-11T00:00:00Z,11,5,2020,7,0,Guyana,GY,GUY,779004,America,10,104,6
2020-05-12T00:00:00Z,12,5,2020,5,0,Guyana,GY,GUY,779004,America,10,109,7
2020-05-13T00:00:00Z,13,5,2020,4,0,Guyana,GY,GUY,779004,America,10,113,8
2020-05-14T00:00:00Z,14,5,2020,0,0,Guyana,GY,GUY,779004,America,10,113,9
2020-05-15T00:00:00Z,15,5,2020,0,0,Guyana,GY,GUY,779004,America,10,113,10
2020-05-16T00:00:00Z,16,5,2020,3,0,Guyana,GY,GUY,779004,America,10,116,11
2020-05-17T00:00:00Z,17,5,2020,1,0,Guyana,GY,GUY,779004,America,10,117,12
2020-05-18T00:00:00Z,18,5,2020,0,0,Guyana,GY,GUY,779004,America,10,117,13
2020-05-19T00:00:00Z,19,5,2020,7,0,Guyana,GY,GUY,779004,America,10,124,14
2020-05-20T00:00:00Z,20,5,2020,1,0,Guyana,GY,GUY,779004,America,10,125,15
2020-05-21T00:00:00Z,21,5,2020,0,0,Guyana,GY,GUY,779004,America,10,125,16
2020-05-22T00:00:00Z,22,5,2020,2,0,Guyana,GY,GUY,779004,America,10,127,17
2020-05-23T00:00:00Z,23,5,2020,0,0,Guyana,GY,GUY,779004,America,10,127,18
2020-05-24T00:00:00Z,24,5,2020,0,0,Guyana,GY,GUY,779004,America,10,127,19
2020-05-25T00:00:00Z,25,5,2020,8,0,Guyana,GY,GUY,779004,America,10,135,20
2020-05-26T00:00:00Z,26,5,2020,2,1,Guyana,GY,GUY,779004,America,11,137,21
2020-05-27T00:00:00Z,27,5,2020,2,0,Guyana,GY,GUY,779004,America,11,139,22
2020-05-05T00:00:00Z,5,5,2020,15,3,Haiti,HT,HTI,11123176,America,11,100,1
2020-05-06T00:00:00Z,6,5,2020,1,1,Haiti,HT,HTI,11123176,America,12,101,2
2020-05-07T00:00:00Z,7,5,2020,7,0,Haiti,HT,HTI,11123176,America,12,108,3
2020-05-08T00:00:00Z,8,5,2020,21,0,Haiti,HT,HTI,11123176,America,12,129,4
2020-05-09T00:00:00Z,9,5,2020,17,0,Haiti,HT,HTI,11123176,America,12,146,5
2020-05-10T00:00:00Z,10,5,2020,5,0,Haiti,HT,HTI,11123176,America,12,151,6
2020-05-11T00:00:00Z,11,5,2020,31,3,Haiti,HT,HTI,11123176,America,15,182,7
2020-05-12T00:00:00Z,12,5,2020,27,1,Haiti,HT,HTI,11123176,America,16,209,8
2020-05-13T00:00:00Z,13,5,2020,10,2,Haiti,HT,HTI,11123176,America,18,219,9
2020-05-14T00:00:00Z,14,5,2020,15,0,Haiti,HT,HTI,11123176,America,18,234,10
2020-05-15T00:00:00Z,15,5,2020,39,2,Haiti,HT,HTI,11123176,America,20,273,11
2020-05-16T00:00:00Z,16,5,2020,37,0,Haiti,HT,HTI,11123176,America,20,310,12
2020-05-17T00:00:00Z,17,5,2020,48,0,Haiti,HT,HTI,11123176,America,20,358,13
2020-05-18T00:00:00Z,18,5,2020,98,0,Haiti,HT,HTI,11123176,America,20,456,14
2020-05-19T00:00:00Z,19,5,2020,77,1,Haiti,HT,HTI,11123176,America,21,533,15
2020-05-20T00:00:00Z,20,5,2020,63,1,Haiti,HT,HTI,11123176,America,22,596,16
2020-05-21T00:00:00Z,21,5,2020,0,0,Haiti,HT,HTI,11123176,America,22,596,17
2020-05-22T00:00:00Z,22,5,2020,138,3,Haiti,HT,HTI,11123176,America,25,734,18
2020-05-23T00:00:00Z,23,5,2020,78,0,Haiti,HT,HTI,11123176,America,25,812,19
2020-05-24T00:00:00Z,24,5,2020,53,1,Haiti,HT,HTI,11123176,America,26,865,20
2020-05-25T00:00:00Z,25,5,2020,93,1,Haiti,HT,HTI,11123176,America,27,958,21
2020-05-26T00:00:00Z,26,5,2020,105,4,Haiti,HT,HTI,11123176,America,31,1063,22
2020-05-27T00:00:00Z,27,5,2020,111,2,Haiti,HT,HTI,11123176,America,33,1174,23
2020-04-01T00:00:00Z,1,4,2020,31,3,Honduras,HN,HND,9587522,America,10,172,1
2020-04-02T00:00:00Z,2,4,2020,47,4,Honduras,HN,HND,9587522,America,14,219,2
2020-04-03T00:00:00Z,3,4,2020,3,1,Honduras,HN,HND,9587522,America,15,222,3
2020-04-04T00:00:00Z,4,4,2020,42,0,Honduras,HN,HND,9587522,America,15,264,4
2020-04-05T00:00:00Z,5,4,2020,4,7,Honduras,HN,HND,9587522,America,22,268,5
2020-04-06T00:00:00Z,6,4,2020,30,0,Honduras,HN,HND,9587522,America,22,298,6
2020-04-07T00:00:00Z,7,4,2020,7,0,Honduras,HN,HND,9587522,America,22,305,7
2020-04-08T00:00:00Z,8,4,2020,7,0,Honduras,HN,HND,9587522,America,22,312,8
2020-04-09T00:00:00Z,9,4,2020,31,1,Honduras,HN,HND,9587522,America,23,343,9
2020-04-10T00:00:00Z,10,4,2020,39,0,Honduras,HN,HND,9587522,America,23,382,10
2020-04-11T00:00:00Z,11,4,2020,10,1,Honduras,HN,HND,9587522,America,24,392,11
2020-04-12T00:00:00Z,12,4,2020,1,1,Honduras,HN,HND,9587522,America,25,393,12
2020-04-13T00:00:00Z,13,4,2020,4,0,Honduras,HN,HND,9587522,America,25,397,13
2020-04-14T00:00:00Z,14,4,2020,10,1,Honduras,HN,HND,9587522,America,26,407,14
2020-04-15T00:00:00Z,15,4,2020,12,5,Honduras,HN,HND,9587522,America,31,419,15
2020-04-16T00:00:00Z,16,4,2020,7,4,Honduras,HN,HND,9587522,America,35,426,16
2020-04-17T00:00:00Z,17,4,2020,16,6,Honduras,HN,HND,9587522,America,41,442,17
2020-04-18T00:00:00Z,18,4,2020,15,5,Honduras,HN,HND,9587522,America,46,457,18
2020-04-19T00:00:00Z,19,4,2020,15,0,Honduras,HN,HND,9587522,America,46,472,19
2020-04-20T00:00:00Z,20,4,2020,5,0,Honduras,HN,HND,9587522,America,46,477,20
2020-04-21T00:00:00Z,21,4,2020,17,0,Honduras,HN,HND,9587522,America,46,494,21
2020-04-22T00:00:00Z,22,4,2020,16,0,Honduras,HN,HND,9587522,America,46,510,22
2020-04-23T00:00:00Z,23,4,2020,9,1,Honduras,HN,HND,9587522,America,47,519,23
2020-04-24T00:00:00Z,24,4,2020,0,0,Honduras,HN,HND,9587522,America,47,519,24
2020-04-25T00:00:00Z,25,4,2020,72,0,Honduras,HN,HND,9587522,America,47,591,25
2020-04-26T00:00:00Z,26,4,2020,36,12,Honduras,HN,HND,9587522,America,59,627,26
2020-04-27T00:00:00Z,27,4,2020,34,2,Honduras,HN,HND,9587522,America,61,661,27
2020-04-28T00:00:00Z,28,4,2020,32,0,Honduras,HN,HND,9587522,America,61,693,28
2020-04-29T00:00:00Z,29,4,2020,45,5,Honduras,HN,HND,9587522,America,66,738,29
2020-04-30T00:00:00Z,30,4,2020,33,5,Honduras,HN,HND,9587522,America,71,771,30
2020-05-01T00:00:00Z,1,5,2020,33,4,Honduras,HN,HND,9587522,America,75,804,31
2020-05-02T00:00:00Z,2,5,2020,95,0,Honduras,HN,HND,9587522,America,75,899,32
2020-05-03T00:00:00Z,3,5,2020,111,1,Honduras,HN,HND,9587522,America,76,1010,33
2020-05-04T00:00:00Z,4,5,2020,45,6,Honduras,HN,HND,9587522,America,82,1055,34
2020-05-05T00:00:00Z,5,5,2020,123,0,Honduras,HN,HND,9587522,America,82,1178,35
2020-05-06T00:00:00Z,6,5,2020,92,11,Honduras,HN,HND,9587522,America,93,1270,36
2020-05-07T00:00:00Z,7,5,2020,191,6,Honduras,HN,HND,9587522,America,99,1461,37
2020-05-08T00:00:00Z,8,5,2020,224,6,Honduras,HN,HND,9587522,America,105,1685,38
2020-05-09T00:00:00Z,9,5,2020,86,2,Honduras,HN,HND,9587522,America,107,1771,39
2020-05-10T00:00:00Z,10,5,2020,59,1,Honduras,HN,HND,9587522,America,108,1830,40
2020-05-11T00:00:00Z,11,5,2020,142,0,Honduras,HN,HND,9587522,America,108,1972,41
2020-05-12T00:00:00Z,12,5,2020,34,8,Honduras,HN,HND,9587522,America,116,2006,42
2020-05-13T00:00:00Z,13,5,2020,74,5,Honduras,HN,HND,9587522,America,121,2080,43
2020-05-14T00:00:00Z,14,5,2020,175,2,Honduras,HN,HND,9587522,America,123,2255,44
2020-05-15T00:00:00Z,15,5,2020,63,10,Honduras,HN,HND,9587522,America,133,2318,45
2020-05-16T00:00:00Z,16,5,2020,142,1,Honduras,HN,HND,9587522,America,134,2460,46
2020-05-17T00:00:00Z,17,5,2020,105,4,Honduras,HN,HND,9587522,America,138,2565,47
2020-05-18T00:00:00Z,18,5,2020,81,4,Honduras,HN,HND,9587522,America,142,2646,48
2020-05-19T00:00:00Z,19,5,2020,152,4,Honduras,HN,HND,9587522,America,146,2798,49
2020-05-20T00:00:00Z,20,5,2020,157,1,Honduras,HN,HND,9587522,America,147,2955,50
2020-05-21T00:00:00Z,21,5,2020,145,4,Honduras,HN,HND,9587522,America,151,3100,51
2020-05-22T00:00:00Z,22,5,2020,104,5,Honduras,HN,HND,9587522,America,156,3204,52
2020-05-23T00:00:00Z,23,5,2020,273,11,Honduras,HN,HND,9587522,America,167,3477,53
2020-05-24T00:00:00Z,24,5,2020,266,7,Honduras,HN,HND,9587522,America,174,3743,54
2020-05-25T00:00:00Z,25,5,2020,207,6,Honduras,HN,HND,9587522,America,180,3950,55
2020-05-26T00:00:00Z,26,5,2020,239,2,Honduras,HN,HND,9587522,America,182,4189,56
2020-05-27T00:00:00Z,27,5,2020,212,6,Honduras,HN,HND,9587522,America,188,4401,57
2020-03-25T00:00:00Z,25,3,2020,39,2,Hungary,HU,HUN,9768785,Europe,10,226,1
2020-03-26T00:00:00Z,26,3,2020,35,0,Hungary,HU,HUN,9768785,Europe,10,261,2
2020-03-27T00:00:00Z,27,3,2020,39,0,Hungary,HU,HUN,9768785,Europe,10,300,3
2020-03-28T00:00:00Z,28,3,2020,43,1,Hungary,HU,HUN,9768785,Europe,11,343,4
2020-03-29T00:00:00Z,29,3,2020,65,2,Hungary,HU,HUN,9768785,Europe,13,408,5
2020-03-30T00:00:00Z,30,3,2020,39,2,Hungary,HU,HUN,9768785,Europe,15,447,6
2020-03-31T00:00:00Z,31,3,2020,45,1,Hungary,HU,HUN,9768785,Europe,16,492,7
2020-04-01T00:00:00Z,1,4,2020,33,4,Hungary,HU,HUN,9768785,Europe,20,525,8
2020-04-02T00:00:00Z,2,4,2020,60,1,Hungary,HU,HUN,9768785,Europe,21,585,9
2020-04-03T00:00:00Z,3,4,2020,38,5,Hungary,HU,HUN,9768785,Europe,26,623,10
2020-04-04T00:00:00Z,4,4,2020,55,6,Hungary,HU,HUN,9768785,Europe,32,678,11
2020-04-05T00:00:00Z,5,4,2020,55,2,Hungary,HU,HUN,9768785,Europe,34,733,12
2020-04-06T00:00:00Z,6,4,2020,11,4,Hungary,HU,HUN,9768785,Europe,38,744,13
2020-04-07T00:00:00Z,7,4,2020,73,9,Hungary,HU,HUN,9768785,Europe,47,817,14
2020-04-08T00:00:00Z,8,4,2020,78,11,Hungary,HU,HUN,9768785,Europe,58,895,15
2020-04-09T00:00:00Z,9,4,2020,85,8,Hungary,HU,HUN,9768785,Europe,66,980,16
2020-04-10T00:00:00Z,10,4,2020,210,11,Hungary,HU,HUN,9768785,Europe,77,1190,17
2020-04-11T00:00:00Z,11,4,2020,120,8,Hungary,HU,HUN,9768785,Europe,85,1310,18
2020-04-12T00:00:00Z,12,4,2020,100,14,Hungary,HU,HUN,9768785,Europe,99,1410,19
2020-04-13T00:00:00Z,13,4,2020,48,10,Hungary,HU,HUN,9768785,Europe,109,1458,20
2020-04-14T00:00:00Z,14,4,2020,54,13,Hungary,HU,HUN,9768785,Europe,122,1512,21
2020-04-15T00:00:00Z,15,4,2020,67,12,Hungary,HU,HUN,9768785,Europe,134,1579,22
2020-04-16T00:00:00Z,16,4,2020,73,8,Hungary,HU,HUN,9768785,Europe,142,1652,23
2020-04-17T00:00:00Z,17,4,2020,111,14,Hungary,HU,HUN,9768785,Europe,156,1763,24
2020-04-18T00:00:00Z,18,4,2020,71,16,Hungary,HU,HUN,9768785,Europe,172,1834,25
2020-04-19T00:00:00Z,19,4,2020,82,17,Hungary,HU,HUN,9768785,Europe,189,1916,26
2020-04-20T00:00:00Z,20,4,2020,68,10,Hungary,HU,HUN,9768785,Europe,199,1984,27
2020-04-21T00:00:00Z,21,4,2020,114,14,Hungary,HU,HUN,9768785,Europe,213,2098,28
2020-04-22T00:00:00Z,22,4,2020,70,12,Hungary,HU,HUN,9768785,Europe,225,2168,29
2020-04-23T00:00:00Z,23,4,2020,116,0,Hungary,HU,HUN,9768785,Europe,225,2284,30
2020-04-24T00:00:00Z,24,4,2020,99,25,Hungary,HU,HUN,9768785,Europe,250,2383,31
2020-04-25T00:00:00Z,25,4,2020,60,12,Hungary,HU,HUN,9768785,Europe,262,2443,32
2020-04-26T00:00:00Z,26,4,2020,57,10,Hungary,HU,HUN,9768785,Europe,272,2500,33
2020-04-27T00:00:00Z,27,4,2020,83,8,Hungary,HU,HUN,9768785,Europe,280,2583,34
2020-04-28T00:00:00Z,28,4,2020,66,11,Hungary,HU,HUN,9768785,Europe,291,2649,35
2020-04-29T00:00:00Z,29,4,2020,78,9,Hungary,HU,HUN,9768785,Europe,300,2727,36
2020-04-30T00:00:00Z,30,4,2020,48,12,Hungary,HU,HUN,9768785,Europe,312,2775,37
2020-05-01T00:00:00Z,1,5,2020,88,11,Hungary,HU,HUN,9768785,Europe,323,2863,38
2020-05-02T00:00:00Z,2,5,2020,79,12,Hungary,HU,HUN,9768785,Europe,335,2942,39
2020-05-03T00:00:00Z,3,5,2020,56,5,Hungary,HU,HUN,9768785,Europe,340,2998,40
2020-05-04T00:00:00Z,4,5,2020,37,11,Hungary,HU,HUN,9768785,Europe,351,3035,41
2020-05-05T00:00:00Z,5,5,2020,30,12,Hungary,HU,HUN,9768785,Europe,363,3065,42
2020-05-06T00:00:00Z,6,5,2020,46,10,Hungary,HU,HUN,9768785,Europe,373,3111,43
2020-05-07T00:00:00Z,7,5,2020,39,10,Hungary,HU,HUN,9768785,Europe,383,3150,44
2020-05-08T00:00:00Z,8,5,2020,28,9,Hungary,HU,HUN,9768785,Europe,392,3178,45
2020-05-09T00:00:00Z,9,5,2020,35,13,Hungary,HU,HUN,9768785,Europe,405,3213,46
2020-05-10T00:00:00Z,10,5,2020,50,8,Hungary,HU,HUN,9768785,Europe,413,3263,47
2020-05-11T00:00:00Z,11,5,2020,21,8,Hungary,HU,HUN,9768785,Europe,421,3284,48
2020-05-12T00:00:00Z,12,5,2020,29,4,Hungary,HU,HUN,9768785,Europe,425,3313,49
2020-05-13T00:00:00Z,13,5,2020,28,5,Hungary,HU,HUN,9768785,Europe,430,3341,50
2020-05-14T00:00:00Z,14,5,2020,39,6,Hungary,HU,HUN,9768785,Europe,436,3380,51
2020-05-15T00:00:00Z,15,5,2020,37,6,Hungary,HU,HUN,9768785,Europe,442,3417,52
2020-05-16T00:00:00Z,16,5,2020,56,6,Hungary,HU,HUN,9768785,Europe,448,3473,53
2020-05-17T00:00:00Z,17,5,2020,36,3,Hungary,HU,HUN,9768785,Europe,451,3509,54
2020-05-18T00:00:00Z,18,5,2020,26,11,Hungary,HU,HUN,9768785,Europe,462,3535,55
2020-05-19T00:00:00Z,19,5,2020,21,5,Hungary,HU,HUN,9768785,Europe,467,3556,56
2020-05-20T00:00:00Z,20,5,2020,42,3,Hungary,HU,HUN,9768785,Europe,470,3598,57
2020-05-21T00:00:00Z,21,5,2020,43,3,Hungary,HU,HUN,9768785,Europe,473,3641,58
2020-05-22T00:00:00Z,22,5,2020,37,3,Hungary,HU,HUN,9768785,Europe,476,3678,59
2020-05-23T00:00:00Z,23,5,2020,35,6,Hungary,HU,HUN,9768785,Europe,482,3713,60
2020-05-24T00:00:00Z,24,5,2020,28,4,Hungary,HU,HUN,9768785,Europe,486,3741,61
2020-05-25T00:00:00Z,25,5,2020,15,5,Hungary,HU,HUN,9768785,Europe,491,3756,62
2020-05-26T00:00:00Z,26,5,2020,15,8,Hungary,HU,HUN,9768785,Europe,499,3771,63
2020-05-27T00:00:00Z,27,5,2020,22,6,Hungary,HU,HUN,9768785,Europe,505,3793,64
2020-04-21T00:00:00Z,21,4,2020,2,1,Iceland,IS,ISL,353574,Europe,10,1773,1
2020-04-22T00:00:00Z,22,4,2020,5,0,Iceland,IS,ISL,353574,Europe,10,1778,2
2020-04-23T00:00:00Z,23,4,2020,7,0,Iceland,IS,ISL,353574,Europe,10,1785,3
2020-04-24T00:00:00Z,24,4,2020,4,0,Iceland,IS,ISL,353574,Europe,10,1789,4
2020-04-25T00:00:00Z,25,4,2020,0,0,Iceland,IS,ISL,353574,Europe,10,1789,5
2020-04-26T00:00:00Z,26,4,2020,1,0,Iceland,IS,ISL,353574,Europe,10,1790,6
2020-04-27T00:00:00Z,27,4,2020,2,0,Iceland,IS,ISL,353574,Europe,10,1792,7
2020-04-28T00:00:00Z,28,4,2020,0,0,Iceland,IS,ISL,353574,Europe,10,1792,8
2020-04-29T00:00:00Z,29,4,2020,3,0,Iceland,IS,ISL,353574,Europe,10,1795,9
2020-04-30T00:00:00Z,30,4,2020,2,0,Iceland,IS,ISL,353574,Europe,10,1797,10
2020-05-01T00:00:00Z,1,5,2020,0,0,Iceland,IS,ISL,353574,Europe,10,1797,11
2020-05-02T00:00:00Z,2,5,2020,1,0,Iceland,IS,ISL,353574,Europe,10,1798,12
2020-05-03T00:00:00Z,3,5,2020,0,0,Iceland,IS,ISL,353574,Europe,10,1798,13
2020-05-04T00:00:00Z,4,5,2020,1,0,Iceland,IS,ISL,353574,Europe,10,1799,14
2020-05-05T00:00:00Z,5,5,2020,0,0,Iceland,IS,ISL,353574,Europe,10,1799,15
2020-05-06T00:00:00Z,6,5,2020,0,0,Iceland,IS,ISL,353574,Europe,10,1799,16
2020-05-07T00:00:00Z,7,5,2020,0,0,Iceland,IS,ISL,353574,Europe,10,1799,17
2020-05-08T00:00:00Z,8,5,2020,2,0,Iceland,IS,ISL,353574,Europe,10,1801,18
2020-05-09T00:00:00Z,9,5,2020,0,0,Iceland,IS,ISL,353574,Europe,10,1801,19
2020-05-10T00:00:00Z,10,5,2020,0,0,Iceland,IS,ISL,353574,Europe,10,1801,20
2020-05-11T00:00:00Z,11,5,2020,0,0,Iceland,IS,ISL,353574,Europe,10,1801,21
2020-05-12T00:00:00Z,12,5,2020,0,0,Iceland,IS,ISL,353574,Europe,10,1801,22
2020-05-13T00:00:00Z,13,5,2020,0,0,Iceland,IS,ISL,353574,Europe,10,1801,23
2020-05-14T00:00:00Z,14,5,2020,1,0,Iceland,IS,ISL,353574,Europe,10,1802,24
2020-05-15T00:00:00Z,15,5,2020,0,0,Iceland,IS,ISL,353574,Europe,10,1802,25
2020-05-16T00:00:00Z,16,5,2020,0,0,Iceland,IS,ISL,353574,Europe,10,1802,26
2020-05-17T00:00:00Z,17,5,2020,0,0,Iceland,IS,ISL,353574,Europe,10,1802,27
2020-05-18T00:00:00Z,18,5,2020,0,0,Iceland,IS,ISL,353574,Europe,10,1802,28
2020-05-19T00:00:00Z,19,5,2020,0,0,Iceland,IS,ISL,353574,Europe,10,1802,29
2020-05-20T00:00:00Z,20,5,2020,0,0,Iceland,IS,ISL,353574,Europe,10,1802,30
2020-05-21T00:00:00Z,21,5,2020,1,0,Iceland,IS,ISL,353574,Europe,10,1803,31
2020-05-22T00:00:00Z,22,5,2020,0,0,Iceland,IS,ISL,353574,Europe,10,1803,32
2020-05-23T00:00:00Z,23,5,2020,0,0,Iceland,IS,ISL,353574,Europe,10,1803,33
2020-05-24T00:00:00Z,24,5,2020,1,0,Iceland,IS,ISL,353574,Europe,10,1804,34
2020-05-25T00:00:00Z,25,5,2020,0,0,Iceland,IS,ISL,353574,Europe,10,1804,35
2020-05-26T00:00:00Z,26,5,2020,0,0,Iceland,IS,ISL,353574,Europe,10,1804,36
2020-05-27T00:00:00Z,27,5,2020,0,0,Iceland,IS,ISL,353574,Europe,10,1804,37
2020-03-26T00:00:00Z,26,3,2020,87,4,India,IN,IND,1352617328,Asia,13,649,1
2020-03-27T00:00:00Z,27,3,2020,75,4,India,IN,IND,1352617328,Asia,17,724,2
2020-03-28T00:00:00Z,28,3,2020,149,2,India,IN,IND,1352617328,Asia,19,873,3
2020-03-29T00:00:00Z,29,3,2020,106,6,India,IN,IND,1352617328,Asia,25,979,4
2020-03-30T00:00:00Z,30,3,2020,92,4,India,IN,IND,1352617328,Asia,29,1071,5
2020-03-31T00:00:00Z,31,3,2020,180,3,India,IN,IND,1352617328,Asia,32,1251,6
2020-04-01T00:00:00Z,1,4,2020,146,3,India,IN,IND,1352617328,Asia,35,1397,7
2020-04-02T00:00:00Z,2,4,2020,568,15,India,IN,IND,1352617328,Asia,50,1965,8
2020-04-03T00:00:00Z,3,4,2020,336,6,India,IN,IND,1352617328,Asia,56,2301,9
2020-04-04T00:00:00Z,4,4,2020,601,12,India,IN,IND,1352617328,Asia,68,2902,10
2020-04-05T00:00:00Z,5,4,2020,472,9,India,IN,IND,1352617328,Asia,77,3374,11
2020-04-06T00:00:00Z,6,4,2020,693,32,India,IN,IND,1352617328,Asia,109,4067,12
2020-04-07T00:00:00Z,7,4,2020,354,5,India,IN,IND,1352617328,Asia,114,4421,13
2020-04-08T00:00:00Z,8,4,2020,773,35,India,IN,IND,1352617328,Asia,149,5194,14
2020-04-09T00:00:00Z,9,4,2020,540,17,India,IN,IND,1352617328,Asia,166,5734,15
2020-04-10T00:00:00Z,10,4,2020,678,33,India,IN,IND,1352617328,Asia,199,6412,16
2020-04-11T00:00:00Z,11,4,2020,1035,40,India,IN,IND,1352617328,Asia,239,7447,17
2020-04-12T00:00:00Z,12,4,2020,909,34,India,IN,IND,1352617328,Asia,273,8356,18
2020-04-13T00:00:00Z,13,4,2020,796,35,India,IN,IND,1352617328,Asia,308,9152,19
2020-04-14T00:00:00Z,14,4,2020,1211,31,India,IN,IND,1352617328,Asia,339,10363,20
2020-04-15T00:00:00Z,15,4,2020,1075,38,India,IN,IND,1352617328,Asia,377,11438,21
2020-04-16T00:00:00Z,16,4,2020,942,37,India,IN,IND,1352617328,Asia,414,12380,22
2020-04-17T00:00:00Z,17,4,2020,1007,23,India,IN,IND,1352617328,Asia,437,13387,23
2020-04-18T00:00:00Z,18,4,2020,991,43,India,IN,IND,1352617328,Asia,480,14378,24
2020-04-19T00:00:00Z,19,4,2020,1334,27,India,IN,IND,1352617328,Asia,507,15712,25
2020-04-20T00:00:00Z,20,4,2020,1553,36,India,IN,IND,1352617328,Asia,543,17265,26
2020-04-21T00:00:00Z,21,4,2020,1335,47,India,IN,IND,1352617328,Asia,590,18600,27
2020-04-22T00:00:00Z,22,4,2020,1384,50,India,IN,IND,1352617328,Asia,640,19984,28
2020-04-23T00:00:00Z,23,4,2020,1409,41,India,IN,IND,1352617328,Asia,681,21393,29
2020-04-24T00:00:00Z,24,4,2020,1684,37,India,IN,IND,1352617328,Asia,718,23077,30
2020-04-25T00:00:00Z,25,4,2020,1429,57,India,IN,IND,1352617328,Asia,775,24506,31
2020-04-26T00:00:00Z,26,4,2020,1990,49,India,IN,IND,1352617328,Asia,824,26496,32
2020-04-27T00:00:00Z,27,4,2020,1396,48,India,IN,IND,1352617328,Asia,872,27892,33
2020-04-28T00:00:00Z,28,4,2020,1543,62,India,IN,IND,1352617328,Asia,934,29435,34
2020-04-29T00:00:00Z,29,4,2020,1897,73,India,IN,IND,1352617328,Asia,1007,31332,35
2020-04-30T00:00:00Z,30,4,2020,1718,67,India,IN,IND,1352617328,Asia,1074,33050,36
2020-05-01T00:00:00Z,1,5,2020,1993,73,India,IN,IND,1352617328,Asia,1147,35043,37
2020-05-02T00:00:00Z,2,5,2020,2293,71,India,IN,IND,1352617328,Asia,1218,37336,38
2020-05-03T00:00:00Z,3,5,2020,2644,83,India,IN,IND,1352617328,Asia,1301,39980,39
2020-05-04T00:00:00Z,4,5,2020,2553,72,India,IN,IND,1352617328,Asia,1373,42533,40
2020-05-05T00:00:00Z,5,5,2020,3900,195,India,IN,IND,1352617328,Asia,1568,46433,41
2020-05-06T00:00:00Z,6,5,2020,2958,126,India,IN,IND,1352617328,Asia,1694,49391,42
2020-05-07T00:00:00Z,7,5,2020,3561,89,India,IN,IND,1352617328,Asia,1783,52952,43
2020-05-08T00:00:00Z,8,5,2020,3390,103,India,IN,IND,1352617328,Asia,1886,56342,44
2020-05-09T00:00:00Z,9,5,2020,3320,95,India,IN,IND,1352617328,Asia,1981,59662,45
2020-05-10T00:00:00Z,10,5,2020,3277,128,India,IN,IND,1352617328,Asia,2109,62939,46
2020-05-11T00:00:00Z,11,5,2020,4213,97,India,IN,IND,1352617328,Asia,2206,67152,47
2020-05-12T00:00:00Z,12,5,2020,3604,87,India,IN,IND,1352617328,Asia,2293,70756,48
2020-05-13T00:00:00Z,13,5,2020,3525,122,India,IN,IND,1352617328,Asia,2415,74281,49
2020-05-14T00:00:00Z,14,5,2020,3722,134,India,IN,IND,1352617328,Asia,2549,78003,50
2020-05-15T00:00:00Z,15,5,2020,3967,100,India,IN,IND,1352617328,Asia,2649,81970,51
2020-05-16T00:00:00Z,16,5,2020,3970,103,India,IN,IND,1352617328,Asia,2752,85940,52
2020-05-17T00:00:00Z,17,5,2020,4987,120,India,IN,IND,1352617328,Asia,2872,90927,53
2020-05-18T00:00:00Z,18,5,2020,5242,157,India,IN,IND,1352617328,Asia,3029,96169,54
2020-05-19T00:00:00Z,19,5,2020,4970,134,India,IN,IND,1352617328,Asia,3163,101139,55
2020-05-20T00:00:00Z,20,5,2020,5611,140,India,IN,IND,1352617328,Asia,3303,106750,56
2020-05-21T00:00:00Z,21,5,2020,5609,132,India,IN,IND,1352617328,Asia,3435,112359,57
2020-05-22T00:00:00Z,22,5,2020,6088,148,India,IN,IND,1352617328,Asia,3583,118447,58
2020-05-23T00:00:00Z,23,5,2020,6654,137,India,IN,IND,1352617328,Asia,3720,125101,59
2020-05-24T00:00:00Z,24,5,2020,6767,147,India,IN,IND,1352617328,Asia,3867,131868,60
2020-05-25T00:00:00Z,25,5,2020,6977,154,India,IN,IND,1352617328,Asia,4021,138845,61
2020-05-26T00:00:00Z,26,5,2020,6535,146,India,IN,IND,1352617328,Asia,4167,145380,62
2020-05-27T00:00:00Z,27,5,2020,6387,170,India,IN,IND,1352617328,Asia,4337,151767,63
2020-03-20T00:00:00Z,20,3,2020,55,14,Indonesia,ID,IDN,267663435,Asia,19,227,1
2020-03-21T00:00:00Z,21,3,2020,82,6,Indonesia,ID,IDN,267663435,Asia,25,309,2
2020-03-22T00:00:00Z,22,3,2020,141,13,Indonesia,ID,IDN,267663435,Asia,38,450,3
2020-03-23T00:00:00Z,23,3,2020,64,10,Indonesia,ID,IDN,267663435,Asia,48,514,4
2020-03-24T00:00:00Z,24,3,2020,65,1,Indonesia,ID,IDN,267663435,Asia,49,579,5
2020-03-25T00:00:00Z,25,3,2020,107,6,Indonesia,ID,IDN,267663435,Asia,55,686,6
2020-03-26T00:00:00Z,26,3,2020,104,3,Indonesia,ID,IDN,267663435,Asia,58,790,7
2020-03-27T00:00:00Z,27,3,2020,103,20,Indonesia,ID,IDN,267663435,Asia,78,893,8
2020-03-28T00:00:00Z,28,3,2020,153,9,Indonesia,ID,IDN,267663435,Asia,87,1046,9
2020-03-29T00:00:00Z,29,3,2020,109,15,Indonesia,ID,IDN,267663435,Asia,102,1155,10
2020-03-30T00:00:00Z,30,3,2020,130,12,Indonesia,ID,IDN,267663435,Asia,114,1285,11
2020-03-31T00:00:00Z,31,3,2020,129,8,Indonesia,ID,IDN,267663435,Asia,122,1414,12
2020-04-01T00:00:00Z,1,4,2020,114,14,Indonesia,ID,IDN,267663435,Asia,136,1528,13
2020-04-02T00:00:00Z,2,4,2020,149,21,Indonesia,ID,IDN,267663435,Asia,157,1677,14
2020-04-03T00:00:00Z,3,4,2020,113,13,Indonesia,ID,IDN,267663435,Asia,170,1790,15
2020-04-04T00:00:00Z,4,4,2020,196,11,Indonesia,ID,IDN,267663435,Asia,181,1986,16
2020-04-05T00:00:00Z,5,4,2020,106,10,Indonesia,ID,IDN,267663435,Asia,191,2092,17
2020-04-06T00:00:00Z,6,4,2020,181,7,Indonesia,ID,IDN,267663435,Asia,198,2273,18
2020-04-07T00:00:00Z,7,4,2020,218,11,Indonesia,ID,IDN,267663435,Asia,209,2491,19
2020-04-08T00:00:00Z,8,4,2020,247,12,Indonesia,ID,IDN,267663435,Asia,221,2738,20
2020-04-09T00:00:00Z,9,4,2020,218,19,Indonesia,ID,IDN,267663435,Asia,240,2956,21
2020-04-10T00:00:00Z,10,4,2020,337,40,Indonesia,ID,IDN,267663435,Asia,280,3293,22
2020-04-11T00:00:00Z,11,4,2020,219,26,Indonesia,ID,IDN,267663435,Asia,306,3512,23
2020-04-12T00:00:00Z,12,4,2020,330,21,Indonesia,ID,IDN,267663435,Asia,327,3842,24
2020-04-13T00:00:00Z,13,4,2020,399,46,Indonesia,ID,IDN,267663435,Asia,373,4241,25
2020-04-14T00:00:00Z,14,4,2020,316,26,Indonesia,ID,IDN,267663435,Asia,399,4557,26
2020-04-15T00:00:00Z,15,4,2020,282,60,Indonesia,ID,IDN,267663435,Asia,459,4839,27
2020-04-16T00:00:00Z,16,4,2020,297,10,Indonesia,ID,IDN,267663435,Asia,469,5136,28
2020-04-17T00:00:00Z,17,4,2020,380,27,Indonesia,ID,IDN,267663435,Asia,496,5516,29
2020-04-18T00:00:00Z,18,4,2020,407,24,Indonesia,ID,IDN,267663435,Asia,520,5923,30
2020-04-19T00:00:00Z,19,4,2020,325,15,Indonesia,ID,IDN,267663435,Asia,535,6248,31
2020-04-20T00:00:00Z,20,4,2020,327,47,Indonesia,ID,IDN,267663435,Asia,582,6575,32
2020-04-21T00:00:00Z,21,4,2020,185,8,Indonesia,ID,IDN,267663435,Asia,590,6760,33
2020-04-22T00:00:00Z,22,4,2020,375,26,Indonesia,ID,IDN,267663435,Asia,616,7135,34
2020-04-23T00:00:00Z,23,4,2020,283,19,Indonesia,ID,IDN,267663435,Asia,635,7418,35
2020-04-24T00:00:00Z,24,4,2020,357,12,Indonesia,ID,IDN,267663435,Asia,647,7775,36
2020-04-25T00:00:00Z,25,4,2020,436,42,Indonesia,ID,IDN,267663435,Asia,689,8211,37
2020-04-26T00:00:00Z,26,4,2020,396,31,Indonesia,ID,IDN,267663435,Asia,720,8607,38
2020-04-27T00:00:00Z,27,4,2020,275,23,Indonesia,ID,IDN,267663435,Asia,743,8882,39
2020-04-28T00:00:00Z,28,4,2020,214,22,Indonesia,ID,IDN,267663435,Asia,765,9096,40
2020-04-29T00:00:00Z,29,4,2020,415,8,Indonesia,ID,IDN,267663435,Asia,773,9511,41
2020-04-30T00:00:00Z,30,4,2020,260,11,Indonesia,ID,IDN,267663435,Asia,784,9771,42
2020-05-01T00:00:00Z,1,5,2020,347,8,Indonesia,ID,IDN,267663435,Asia,792,10118,43
2020-05-02T00:00:00Z,2,5,2020,433,8,Indonesia,ID,IDN,267663435,Asia,800,10551,44
2020-05-03T00:00:00Z,3,5,2020,292,31,Indonesia,ID,IDN,267663435,Asia,831,10843,45
2020-05-04T00:00:00Z,4,5,2020,349,14,Indonesia,ID,IDN,267663435,Asia,845,11192,46
2020-05-05T00:00:00Z,5,5,2020,395,19,Indonesia,ID,IDN,267663435,Asia,864,11587,47
2020-05-06T00:00:00Z,6,5,2020,484,8,Indonesia,ID,IDN,267663435,Asia,872,12071,48
2020-05-07T00:00:00Z,7,5,2020,367,23,Indonesia,ID,IDN,267663435,Asia,895,12438,49
2020-05-08T00:00:00Z,8,5,2020,338,35,Indonesia,ID,IDN,267663435,Asia,930,12776,50
2020-05-09T00:00:00Z,9,5,2020,336,13,Indonesia,ID,IDN,267663435,Asia,943,13112,51
2020-05-10T00:00:00Z,10,5,2020,533,16,Indonesia,ID,IDN,267663435,Asia,959,13645,52
2020-05-11T00:00:00Z,11,5,2020,387,14,Indonesia,ID,IDN,267663435,Asia,973,14032,53
2020-05-12T00:00:00Z,12,5,2020,233,18,Indonesia,ID,IDN,267663435,Asia,991,14265,54
2020-05-13T00:00:00Z,13,5,2020,484,16,Indonesia,ID,IDN,267663435,Asia,1007,14749,55
2020-05-14T00:00:00Z,14,5,2020,689,21,Indonesia,ID,IDN,267663435,Asia,1028,15438,56
2020-05-15T00:00:00Z,15,5,2020,568,15,Indonesia,ID,IDN,267663435,Asia,1043,16006,57
2020-05-16T00:00:00Z,16,5,2020,490,33,Indonesia,ID,IDN,267663435,Asia,1076,16496,58
2020-05-17T00:00:00Z,17,5,2020,529,13,Indonesia,ID,IDN,267663435,Asia,1089,17025,59
2020-05-18T00:00:00Z,18,5,2020,489,59,Indonesia,ID,IDN,267663435,Asia,1148,17514,60
2020-05-19T00:00:00Z,19,5,2020,496,43,Indonesia,ID,IDN,267663435,Asia,1191,18010,61
2020-05-20T00:00:00Z,20,5,2020,486,30,Indonesia,ID,IDN,267663435,Asia,1221,18496,62
2020-05-21T00:00:00Z,21,5,2020,693,21,Indonesia,ID,IDN,267663435,Asia,1242,19189,63
2020-05-22T00:00:00Z,22,5,2020,973,36,Indonesia,ID,IDN,267663435,Asia,1278,20162,64
2020-05-23T00:00:00Z,23,5,2020,634,48,Indonesia,ID,IDN,267663435,Asia,1326,20796,65
2020-05-24T00:00:00Z,24,5,2020,949,25,Indonesia,ID,IDN,267663435,Asia,1351,21745,66
2020-05-25T00:00:00Z,25,5,2020,526,21,Indonesia,ID,IDN,267663435,Asia,1372,22271,67
2020-05-26T00:00:00Z,26,5,2020,479,19,Indonesia,ID,IDN,267663435,Asia,1391,22750,68
2020-05-27T00:00:00Z,27,5,2020,415,27,Indonesia,ID,IDN,267663435,Asia,1418,23165,69
2020-02-25T00:00:00Z,25,2,2020,18,4,Iran,IR,IRN,81800269,Asia,12,61,1
2020-02-26T00:00:00Z,26,2,2020,34,3,Iran,IR,IRN,81800269,Asia,15,95,2
2020-02-27T00:00:00Z,27,2,2020,44,4,Iran,IR,IRN,81800269,Asia,19,139,3
2020-02-28T00:00:00Z,28,2,2020,106,7,Iran,IR,IRN,81800269,Asia,26,245,4
2020-02-29T00:00:00Z,29,2,2020,143,8,Iran,IR,IRN,81800269,Asia,34,388,5
2020-03-01T00:00:00Z,1,3,2020,205,9,Iran,IR,IRN,81800269,Asia,43,593,6
2020-03-02T00:00:00Z,2,3,2020,385,11,Iran,IR,IRN,81800269,Asia,54,978,7
2020-03-03T00:00:00Z,3,3,2020,523,12,Iran,IR,IRN,81800269,Asia,66,1501,8
2020-03-04T00:00:00Z,4,3,2020,835,11,Iran,IR,IRN,81800269,Asia,77,2336,9
2020-03-05T00:00:00Z,5,3,2020,586,15,Iran,IR,IRN,81800269,Asia,92,2922,10
2020-03-06T00:00:00Z,6,3,2020,591,15,Iran,IR,IRN,81800269,Asia,107,3513,11
2020-03-07T00:00:00Z,7,3,2020,1234,17,Iran,IR,IRN,81800269,Asia,124,4747,12
2020-03-08T00:00:00Z,8,3,2020,1076,21,Iran,IR,IRN,81800269,Asia,145,5823,13
2020-03-09T00:00:00Z,9,3,2020,743,49,Iran,IR,IRN,81800269,Asia,194,6566,14
2020-03-10T00:00:00Z,10,3,2020,595,43,Iran,IR,IRN,81800269,Asia,237,7161,15
2020-03-11T00:00:00Z,11,3,2020,881,54,Iran,IR,IRN,81800269,Asia,291,8042,16
2020-03-12T00:00:00Z,12,3,2020,958,63,Iran,IR,IRN,81800269,Asia,354,9000,17
2020-03-13T00:00:00Z,13,3,2020,1075,75,Iran,IR,IRN,81800269,Asia,429,10075,18
2020-03-14T00:00:00Z,14,3,2020,1289,85,Iran,IR,IRN,81800269,Asia,514,11364,19
2020-03-15T00:00:00Z,15,3,2020,1365,97,Iran,IR,IRN,81800269,Asia,611,12729,20
2020-03-16T00:00:00Z,16,3,2020,1209,113,Iran,IR,IRN,81800269,Asia,724,13938,21
2020-03-17T00:00:00Z,17,3,2020,1053,129,Iran,IR,IRN,81800269,Asia,853,14991,22
2020-03-18T00:00:00Z,18,3,2020,1178,135,Iran,IR,IRN,81800269,Asia,988,16169,23
2020-03-19T00:00:00Z,19,3,2020,1192,147,Iran,IR,IRN,81800269,Asia,1135,17361,24
2020-03-20T00:00:00Z,20,3,2020,1046,149,Iran,IR,IRN,81800269,Asia,1284,18407,25
2020-03-21T00:00:00Z,21,3,2020,1237,149,Iran,IR,IRN,81800269,Asia,1433,19644,26
2020-03-22T00:00:00Z,22,3,2020,966,123,Iran,IR,IRN,81800269,Asia,1556,20610,27
2020-03-23T00:00:00Z,23,3,2020,1028,129,Iran,IR,IRN,81800269,Asia,1685,21638,28
2020-03-24T00:00:00Z,24,3,2020,1411,127,Iran,IR,IRN,81800269,Asia,1812,23049,29
2020-03-25T00:00:00Z,25,3,2020,1762,122,Iran,IR,IRN,81800269,Asia,1934,24811,30
2020-03-26T00:00:00Z,26,3,2020,2206,143,Iran,IR,IRN,81800269,Asia,2077,27017,31
2020-03-27T00:00:00Z,27,3,2020,2389,157,Iran,IR,IRN,81800269,Asia,2234,29406,32
2020-03-28T00:00:00Z,28,3,2020,2926,144,Iran,IR,IRN,81800269,Asia,2378,32332,33
2020-03-29T00:00:00Z,29,3,2020,3076,139,Iran,IR,IRN,81800269,Asia,2517,35408,34
2020-03-30T00:00:00Z,30,3,2020,2901,123,Iran,IR,IRN,81800269,Asia,2640,38309,35
2020-03-31T00:00:00Z,31,3,2020,3186,117,Iran,IR,IRN,81800269,Asia,2757,41495,36
2020-04-01T00:00:00Z,1,4,2020,3111,141,Iran,IR,IRN,81800269,Asia,2898,44606,37
2020-04-02T00:00:00Z,2,4,2020,2987,138,Iran,IR,IRN,81800269,Asia,3036,47593,38
2020-04-03T00:00:00Z,3,4,2020,2875,124,Iran,IR,IRN,81800269,Asia,3160,50468,39
2020-04-04T00:00:00Z,4,4,2020,0,0,Iran,IR,IRN,81800269,Asia,3160,50468,40
2020-04-05T00:00:00Z,5,4,2020,5275,292,Iran,IR,IRN,81800269,Asia,3452,55743,41
2020-04-06T00:00:00Z,6,4,2020,2483,151,Iran,IR,IRN,81800269,Asia,3603,58226,42
2020-04-07T00:00:00Z,7,4,2020,2274,136,Iran,IR,IRN,81800269,Asia,3739,60500,43
2020-04-08T00:00:00Z,8,4,2020,2089,133,Iran,IR,IRN,81800269,Asia,3872,62589,44
2020-04-09T00:00:00Z,9,4,2020,1997,121,Iran,IR,IRN,81800269,Asia,3993,64586,45
2020-04-10T00:00:00Z,10,4,2020,1634,117,Iran,IR,IRN,81800269,Asia,4110,66220,46
2020-04-11T00:00:00Z,11,4,2020,1972,122,Iran,IR,IRN,81800269,Asia,4232,68192,47
2020-04-12T00:00:00Z,12,4,2020,1837,125,Iran,IR,IRN,81800269,Asia,4357,70029,48
2020-04-13T00:00:00Z,13,4,2020,1657,117,Iran,IR,IRN,81800269,Asia,4474,71686,49
2020-04-14T00:00:00Z,14,4,2020,1617,111,Iran,IR,IRN,81800269,Asia,4585,73303,50
2020-04-15T00:00:00Z,15,4,2020,1574,98,Iran,IR,IRN,81800269,Asia,4683,74877,51
2020-04-16T00:00:00Z,16,4,2020,1512,94,Iran,IR,IRN,81800269,Asia,4777,76389,52
2020-04-17T00:00:00Z,17,4,2020,1606,92,Iran,IR,IRN,81800269,Asia,4869,77995,53
2020-04-18T00:00:00Z,18,4,2020,1499,89,Iran,IR,IRN,81800269,Asia,4958,79494,54
2020-04-19T00:00:00Z,19,4,2020,1374,73,Iran,IR,IRN,81800269,Asia,5031,80868,55
2020-04-20T00:00:00Z,20,4,2020,1343,87,Iran,IR,IRN,81800269,Asia,5118,82211,56
2020-04-21T00:00:00Z,21,4,2020,1294,91,Iran,IR,IRN,81800269,Asia,5209,83505,57
2020-04-22T00:00:00Z,22,4,2020,1297,88,Iran,IR,IRN,81800269,Asia,5297,84802,58
2020-04-23T00:00:00Z,23,4,2020,1194,94,Iran,IR,IRN,81800269,Asia,5391,85996,59
2020-04-24T00:00:00Z,24,4,2020,1030,90,Iran,IR,IRN,81800269,Asia,5481,87026,60
2020-04-25T00:00:00Z,25,4,2020,1168,93,Iran,IR,IRN,81800269,Asia,5574,88194,61
2020-04-26T00:00:00Z,26,4,2020,1134,76,Iran,IR,IRN,81800269,Asia,5650,89328,62
2020-04-27T00:00:00Z,27,4,2020,1153,60,Iran,IR,IRN,81800269,Asia,5710,90481,63
2020-04-28T00:00:00Z,28,4,2020,991,96,Iran,IR,IRN,81800269,Asia,5806,91472,64
2020-04-29T00:00:00Z,29,4,2020,1112,71,Iran,IR,IRN,81800269,Asia,5877,92584,65
2020-04-30T00:00:00Z,30,4,2020,1073,80,Iran,IR,IRN,81800269,Asia,5957,93657,66
2020-05-01T00:00:00Z,1,5,2020,983,71,Iran,IR,IRN,81800269,Asia,6028,94640,67
2020-05-02T00:00:00Z,2,5,2020,1006,63,Iran,IR,IRN,81800269,Asia,6091,95646,68
2020-05-03T00:00:00Z,3,5,2020,802,65,Iran,IR,IRN,81800269,Asia,6156,96448,69
2020-05-04T00:00:00Z,4,5,2020,976,47,Iran,IR,IRN,81800269,Asia,6203,97424,70
2020-05-05T00:00:00Z,5,5,2020,1223,74,Iran,IR,IRN,81800269,Asia,6277,98647,71
2020-05-06T00:00:00Z,6,5,2020,1323,63,Iran,IR,IRN,81800269,Asia,6340,99970,72
2020-05-07T00:00:00Z,7,5,2020,1680,78,Iran,IR,IRN,81800269,Asia,6418,101650,73
2020-05-08T00:00:00Z,8,5,2020,1485,68,Iran,IR,IRN,81800269,Asia,6486,103135,74
2020-05-09T00:00:00Z,9,5,2020,1556,55,Iran,IR,IRN,81800269,Asia,6541,104691,75
2020-05-10T00:00:00Z,10,5,2020,1529,48,Iran,IR,IRN,81800269,Asia,6589,106220,76
2020-05-11T00:00:00Z,11,5,2020,1383,51,Iran,IR,IRN,81800269,Asia,6640,107603,77
2020-05-12T00:00:00Z,12,5,2020,1683,45,Iran,IR,IRN,81800269,Asia,6685,109286,78
2020-05-13T00:00:00Z,13,5,2020,1481,48,Iran,IR,IRN,81800269,Asia,6733,110767,79
2020-05-14T00:00:00Z,14,5,2020,1958,50,Iran,IR,IRN,81800269,Asia,6783,112725,80
2020-05-15T00:00:00Z,15,5,2020,1808,71,Iran,IR,IRN,81800269,Asia,6854,114533,81
2020-05-16T00:00:00Z,16,5,2020,2102,48,Iran,IR,IRN,81800269,Asia,6902,116635,82
2020-05-17T00:00:00Z,17,5,2020,1757,35,Iran,IR,IRN,81800269,Asia,6937,118392,83
2020-05-18T00:00:00Z,18,5,2020,1806,51,Iran,IR,IRN,81800269,Asia,6988,120198,84
2020-05-19T00:00:00Z,19,5,2020,2294,69,Iran,IR,IRN,81800269,Asia,7057,122492,85
2020-05-20T00:00:00Z,20,5,2020,2111,62,Iran,IR,IRN,81800269,Asia,7119,124603,86
2020-05-21T00:00:00Z,21,5,2020,2346,64,Iran,IR,IRN,81800269,Asia,7183,126949,87
2020-05-22T00:00:00Z,22,5,2020,2392,66,Iran,IR,IRN,81800269,Asia,7249,129341,88
2020-05-23T00:00:00Z,23,5,2020,2311,51,Iran,IR,IRN,81800269,Asia,7300,131652,89
2020-05-24T00:00:00Z,24,5,2020,1869,59,Iran,IR,IRN,81800269,Asia,7359,133521,90
2020-05-25T00:00:00Z,25,5,2020,2180,58,Iran,IR,IRN,81800269,Asia,7417,135701,91
2020-05-26T00:00:00Z,26,5,2020,2023,34,Iran,IR,IRN,81800269,Asia,7451,137724,92
2020-05-27T00:00:00Z,27,5,2020,1787,57,Iran,IR,IRN,81800269,Asia,7508,139511,93
2020-03-18T00:00:00Z,18,3,2020,30,2,Iraq,IQ,IRQ,38433600,Asia,11,154,1
2020-03-19T00:00:00Z,19,3,2020,10,1,Iraq,IQ,IRQ,38433600,Asia,12,164,2
2020-03-20T00:00:00Z,20,3,2020,13,0,Iraq,IQ,IRQ,38433600,Asia,12,177,3
2020-03-21T00:00:00Z,21,3,2020,16,2,Iraq,IQ,IRQ,38433600,Asia,14,193,4
2020-03-22T00:00:00Z,22,3,2020,21,3,Iraq,IQ,IRQ,38433600,Asia,17,214,5
2020-03-23T00:00:00Z,23,3,2020,19,3,Iraq,IQ,IRQ,38433600,Asia,20,233,6
2020-03-24T00:00:00Z,24,3,2020,33,3,Iraq,IQ,IRQ,38433600,Asia,23,266,7
2020-03-25T00:00:00Z,25,3,2020,50,4,Iraq,IQ,IRQ,38433600,Asia,27,316,8
2020-03-26T00:00:00Z,26,3,2020,30,2,Iraq,IQ,IRQ,38433600,Asia,29,346,9
2020-03-27T00:00:00Z,27,3,2020,36,7,Iraq,IQ,IRQ,38433600,Asia,36,382,10
2020-03-28T00:00:00Z,28,3,2020,76,4,Iraq,IQ,IRQ,38433600,Asia,40,458,11
2020-03-29T00:00:00Z,29,3,2020,48,2,Iraq,IQ,IRQ,38433600,Asia,42,506,12
2020-03-30T00:00:00Z,30,3,2020,41,0,Iraq,IQ,IRQ,38433600,Asia,42,547,13
2020-03-31T00:00:00Z,31,3,2020,83,4,Iraq,IQ,IRQ,38433600,Asia,46,630,14
2020-04-01T00:00:00Z,1,4,2020,64,4,Iraq,IQ,IRQ,38433600,Asia,50,694,15
2020-04-02T00:00:00Z,2,4,2020,0,0,Iraq,IQ,IRQ,38433600,Asia,50,694,16
2020-04-03T00:00:00Z,3,4,2020,78,4,Iraq,IQ,IRQ,38433600,Asia,54,772,17
2020-04-04T00:00:00Z,4,4,2020,0,0,Iraq,IQ,IRQ,38433600,Asia,54,772,18
2020-04-05T00:00:00Z,5,4,2020,106,2,Iraq,IQ,IRQ,38433600,Asia,56,878,19
2020-04-06T00:00:00Z,6,4,2020,83,5,Iraq,IQ,IRQ,38433600,Asia,61,961,20
2020-04-07T00:00:00Z,7,4,2020,70,3,Iraq,IQ,IRQ,38433600,Asia,64,1031,21
2020-04-08T00:00:00Z,8,4,2020,0,0,Iraq,IQ,IRQ,38433600,Asia,64,1031,22
2020-04-09T00:00:00Z,9,4,2020,171,5,Iraq,IQ,IRQ,38433600,Asia,69,1202,23
2020-04-10T00:00:00Z,10,4,2020,30,0,Iraq,IQ,IRQ,38433600,Asia,69,1232,24
2020-04-11T00:00:00Z,11,4,2020,47,1,Iraq,IQ,IRQ,38433600,Asia,70,1279,25
2020-04-12T00:00:00Z,12,4,2020,39,2,Iraq,IQ,IRQ,38433600,Asia,72,1318,26
2020-04-13T00:00:00Z,13,4,2020,34,4,Iraq,IQ,IRQ,38433600,Asia,76,1352,27
2020-04-14T00:00:00Z,14,4,2020,26,2,Iraq,IQ,IRQ,38433600,Asia,78,1378,28
2020-04-15T00:00:00Z,15,4,2020,22,0,Iraq,IQ,IRQ,38433600,Asia,78,1400,29
2020-04-16T00:00:00Z,16,4,2020,15,1,Iraq,IQ,IRQ,38433600,Asia,79,1415,30
2020-04-17T00:00:00Z,17,4,2020,19,1,Iraq,IQ,IRQ,38433600,Asia,80,1434,31
2020-04-18T00:00:00Z,18,4,2020,48,1,Iraq,IQ,IRQ,38433600,Asia,81,1482,32
2020-04-19T00:00:00Z,19,4,2020,0,0,Iraq,IQ,IRQ,38433600,Asia,81,1482,33
2020-04-20T00:00:00Z,20,4,2020,57,1,Iraq,IQ,IRQ,38433600,Asia,82,1539,34
2020-04-21T00:00:00Z,21,4,2020,35,0,Iraq,IQ,IRQ,38433600,Asia,82,1574,35
2020-04-22T00:00:00Z,22,4,2020,28,1,Iraq,IQ,IRQ,38433600,Asia,83,1602,36
2020-04-23T00:00:00Z,23,4,2020,0,0,Iraq,IQ,IRQ,38433600,Asia,83,1602,37
2020-04-24T00:00:00Z,24,4,2020,75,0,Iraq,IQ,IRQ,38433600,Asia,83,1677,38
2020-04-25T00:00:00Z,25,4,2020,31,3,Iraq,IQ,IRQ,38433600,Asia,86,1708,39
2020-04-26T00:00:00Z,26,4,2020,55,0,Iraq,IQ,IRQ,38433600,Asia,86,1763,40
2020-04-27T00:00:00Z,27,4,2020,57,1,Iraq,IQ,IRQ,38433600,Asia,87,1820,41
2020-04-28T00:00:00Z,28,4,2020,27,1,Iraq,IQ,IRQ,38433600,Asia,88,1847,42
2020-04-29T00:00:00Z,29,4,2020,0,0,Iraq,IQ,IRQ,38433600,Asia,88,1847,43
2020-04-30T00:00:00Z,30,4,2020,156,4,Iraq,IQ,IRQ,38433600,Asia,92,2003,44
2020-05-01T00:00:00Z,1,5,2020,82,1,Iraq,IQ,IRQ,38433600,Asia,93,2085,45
2020-05-02T00:00:00Z,2,5,2020,68,1,Iraq,IQ,IRQ,38433600,Asia,94,2153,46
2020-05-03T00:00:00Z,3,5,2020,66,1,Iraq,IQ,IRQ,38433600,Asia,95,2219,47
2020-05-04T00:00:00Z,4,5,2020,77,2,Iraq,IQ,IRQ,38433600,Asia,97,2296,48
2020-05-05T00:00:00Z,5,5,2020,50,1,Iraq,IQ,IRQ,38433600,Asia,98,2346,49
2020-05-06T00:00:00Z,6,5,2020,85,4,Iraq,IQ,IRQ,38433600,Asia,102,2431,50
2020-05-07T00:00:00Z,7,5,2020,49,0,Iraq,IQ,IRQ,38433600,Asia,102,2480,51
2020-05-08T00:00:00Z,8,5,2020,63,0,Iraq,IQ,IRQ,38433600,Asia,102,2543,52
2020-05-09T00:00:00Z,9,5,2020,60,2,Iraq,IQ,IRQ,38433600,Asia,104,2603,53
2020-05-10T00:00:00Z,10,5,2020,76,3,Iraq,IQ,IRQ,38433600,Asia,107,2679,54
2020-05-11T00:00:00Z,11,5,2020,88,2,Iraq,IQ,IRQ,38433600,Asia,109,2767,55
2020-05-12T00:00:00Z,12,5,2020,51,1,Iraq,IQ,IRQ,38433600,Asia,110,2818,56
2020-05-13T00:00:00Z,13,5,2020,95,2,Iraq,IQ,IRQ,38433600,Asia,112,2913,57
2020-05-14T00:00:00Z,14,5,2020,119,3,Iraq,IQ,IRQ,38433600,Asia,115,3032,58
2020-05-15T00:00:00Z,15,5,2020,111,0,Iraq,IQ,IRQ,38433600,Asia,115,3143,59
2020-05-16T00:00:00Z,16,5,2020,50,2,Iraq,IQ,IRQ,38433600,Asia,117,3193,60
2020-05-17T00:00:00Z,17,5,2020,67,4,Iraq,IQ,IRQ,38433600,Asia,121,3260,61
2020-05-18T00:00:00Z,18,5,2020,144,2,Iraq,IQ,IRQ,38433600,Asia,123,3404,62
2020-05-19T00:00:00Z,19,5,2020,150,4,Iraq,IQ,IRQ,38433600,Asia,127,3554,63
2020-05-20T00:00:00Z,20,5,2020,57,4,Iraq,IQ,IRQ,38433600,Asia,131,3611,64
2020-05-21T00:00:00Z,21,5,2020,113,3,Iraq,IQ,IRQ,38433600,Asia,134,3724,65
2020-05-22T00:00:00Z,22,5,2020,153,6,Iraq,IQ,IRQ,38433600,Asia,140,3877,66
2020-05-23T00:00:00Z,23,5,2020,87,7,Iraq,IQ,IRQ,38433600,Asia,147,3964,67
2020-05-24T00:00:00Z,24,5,2020,308,5,Iraq,IQ,IRQ,38433600,Asia,152,4272,68
2020-05-25T00:00:00Z,25,5,2020,197,8,Iraq,IQ,IRQ,38433600,Asia,160,4469,69
2020-05-26T00:00:00Z,26,5,2020,163,3,Iraq,IQ,IRQ,38433600,Asia,163,4632,70
2020-05-27T00:00:00Z,27,5,2020,216,6,Iraq,IQ,IRQ,38433600,Asia,169,4848,71
2020-03-27T00:00:00Z,27,3,2020,255,10,Ireland,IE,IRL,4853506,Europe,19,1819,1
2020-03-28T00:00:00Z,28,3,2020,302,3,Ireland,IE,IRL,4853506,Europe,22,2121,2
2020-03-29T00:00:00Z,29,3,2020,294,14,Ireland,IE,IRL,4853506,Europe,36,2415,3
2020-03-30T00:00:00Z,30,3,2020,200,10,Ireland,IE,IRL,4853506,Europe,46,2615,4
2020-03-31T00:00:00Z,31,3,2020,295,8,Ireland,IE,IRL,4853506,Europe,54,2910,5
2020-04-01T00:00:00Z,1,4,2020,325,17,Ireland,IE,IRL,4853506,Europe,71,3235,6
2020-04-02T00:00:00Z,2,4,2020,212,14,Ireland,IE,IRL,4853506,Europe,85,3447,7
2020-04-03T00:00:00Z,3,4,2020,402,13,Ireland,IE,IRL,4853506,Europe,98,3849,8
2020-04-04T00:00:00Z,4,4,2020,424,22,Ireland,IE,IRL,4853506,Europe,120,4273,9
2020-04-05T00:00:00Z,5,4,2020,331,17,Ireland,IE,IRL,4853506,Europe,137,4604,10
2020-04-06T00:00:00Z,6,4,2020,507,21,Ireland,IE,IRL,4853506,Europe,158,5111,11
2020-04-07T00:00:00Z,7,4,2020,253,16,Ireland,IE,IRL,4853506,Europe,174,5364,12
2020-04-08T00:00:00Z,8,4,2020,345,36,Ireland,IE,IRL,4853506,Europe,210,5709,13
2020-04-09T00:00:00Z,9,4,2020,515,25,Ireland,IE,IRL,4853506,Europe,235,6224,14
2020-04-10T00:00:00Z,10,4,2020,1169,28,Ireland,IE,IRL,4853506,Europe,263,7393,15
2020-04-11T00:00:00Z,11,4,2020,696,24,Ireland,IE,IRL,4853506,Europe,287,8089,16
2020-04-12T00:00:00Z,12,4,2020,839,33,Ireland,IE,IRL,4853506,Europe,320,8928,17
2020-04-13T00:00:00Z,13,4,2020,727,14,Ireland,IE,IRL,4853506,Europe,334,9655,18
2020-04-14T00:00:00Z,14,4,2020,992,31,Ireland,IE,IRL,4853506,Europe,365,10647,19
2020-04-15T00:00:00Z,15,4,2020,832,41,Ireland,IE,IRL,4853506,Europe,406,11479,20
2020-04-16T00:00:00Z,16,4,2020,1068,38,Ireland,IE,IRL,4853506,Europe,444,12547,21
2020-04-17T00:00:00Z,17,4,2020,724,42,Ireland,IE,IRL,4853506,Europe,486,13271,22
2020-04-18T00:00:00Z,18,4,2020,709,44,Ireland,IE,IRL,4853506,Europe,530,13980,23
2020-04-19T00:00:00Z,19,4,2020,778,41,Ireland,IE,IRL,4853506,Europe,571,14758,24
2020-04-20T00:00:00Z,20,4,2020,493,39,Ireland,IE,IRL,4853506,Europe,610,15251,25
2020-04-21T00:00:00Z,21,4,2020,401,77,Ireland,IE,IRL,4853506,Europe,687,15652,26
2020-04-22T00:00:00Z,22,4,2020,388,43,Ireland,IE,IRL,4853506,Europe,730,16040,27
2020-04-23T00:00:00Z,23,4,2020,631,39,Ireland,IE,IRL,4853506,Europe,769,16671,28
2020-04-24T00:00:00Z,24,4,2020,936,25,Ireland,IE,IRL,4853506,Europe,794,17607,29
2020-04-25T00:00:00Z,25,4,2020,577,35,Ireland,IE,IRL,4853506,Europe,829,18184,30
2020-04-26T00:00:00Z,26,4,2020,377,234,Ireland,IE,IRL,4853506,Europe,1063,18561,31
2020-04-27T00:00:00Z,27,4,2020,701,24,Ireland,IE,IRL,4853506,Europe,1087,19262,32
2020-04-28T00:00:00Z,28,4,2020,386,15,Ireland,IE,IRL,4853506,Europe,1102,19648,33
2020-04-29T00:00:00Z,29,4,2020,229,57,Ireland,IE,IRL,4853506,Europe,1159,19877,34
2020-04-30T00:00:00Z,30,4,2020,376,31,Ireland,IE,IRL,4853506,Europe,1190,20253,35
2020-05-01T00:00:00Z,1,5,2020,359,42,Ireland,IE,IRL,4853506,Europe,1232,20612,36
2020-05-02T00:00:00Z,2,5,2020,221,33,Ireland,IE,IRL,4853506,Europe,1265,20833,37
2020-05-03T00:00:00Z,3,5,2020,343,0,Ireland,IE,IRL,4853506,Europe,1265,21176,38
2020-05-04T00:00:00Z,4,5,2020,330,38,Ireland,IE,IRL,4853506,Europe,1303,21506,39
2020-05-05T00:00:00Z,5,5,2020,216,16,Ireland,IE,IRL,4853506,Europe,1319,21722,40
2020-05-06T00:00:00Z,6,5,2020,261,20,Ireland,IE,IRL,4853506,Europe,1339,21983,41
2020-05-07T00:00:00Z,7,5,2020,265,36,Ireland,IE,IRL,4853506,Europe,1375,22248,42
2020-05-08T00:00:00Z,8,5,2020,137,28,Ireland,IE,IRL,4853506,Europe,1403,22385,43
2020-05-09T00:00:00Z,9,5,2020,156,26,Ireland,IE,IRL,4853506,Europe,1429,22541,44
2020-05-10T00:00:00Z,10,5,2020,219,17,Ireland,IE,IRL,4853506,Europe,1446,22760,45
2020-05-11T00:00:00Z,11,5,2020,236,12,Ireland,IE,IRL,4853506,Europe,1458,22996,46
2020-05-12T00:00:00Z,12,5,2020,139,9,Ireland,IE,IRL,4853506,Europe,1467,23135,47
2020-05-13T00:00:00Z,13,5,2020,107,21,Ireland,IE,IRL,4853506,Europe,1488,23242,48
2020-05-14T00:00:00Z,14,5,2020,159,9,Ireland,IE,IRL,4853506,Europe,1497,23401,49
2020-05-15T00:00:00Z,15,5,2020,426,9,Ireland,IE,IRL,4853506,Europe,1506,23827,50
2020-05-16T00:00:00Z,16,5,2020,129,12,Ireland,IE,IRL,4853506,Europe,1518,23956,51
2020-05-17T00:00:00Z,17,5,2020,92,15,Ireland,IE,IRL,4853506,Europe,1533,24048,52
2020-05-18T00:00:00Z,18,5,2020,64,10,Ireland,IE,IRL,4853506,Europe,1543,24112,53
2020-05-19T00:00:00Z,19,5,2020,88,4,Ireland,IE,IRL,4853506,Europe,1547,24200,54
2020-05-20T00:00:00Z,20,5,2020,51,14,Ireland,IE,IRL,4853506,Europe,1561,24251,55
2020-05-21T00:00:00Z,21,5,2020,64,10,Ireland,IE,IRL,4853506,Europe,1571,24315,56
2020-05-22T00:00:00Z,22,5,2020,76,12,Ireland,IE,IRL,4853506,Europe,1583,24391,57
2020-05-23T00:00:00Z,23,5,2020,115,9,Ireland,IE,IRL,4853506,Europe,1592,24506,58
2020-05-24T00:00:00Z,24,5,2020,76,12,Ireland,IE,IRL,4853506,Europe,1604,24582,59
2020-05-25T00:00:00Z,25,5,2020,57,2,Ireland,IE,IRL,4853506,Europe,1606,24639,60
2020-05-26T00:00:00Z,26,5,2020,59,0,Ireland,IE,IRL,4853506,Europe,1606,24698,61
2020-05-27T00:00:00Z,27,5,2020,37,9,Ireland,IE,IRL,4853506,Europe,1615,24735,62
2020-04-22T00:00:00Z,22,4,2020,7,1,Isle_of_Man,IM,IMN,84077,Europe,10,307,1
2020-04-23T00:00:00Z,23,4,2020,0,5,Isle_of_Man,IM,IMN,84077,Europe,15,307,2
2020-04-24T00:00:00Z,24,4,2020,0,1,Isle_of_Man,IM,IMN,84077,Europe,16,307,3
2020-04-25T00:00:00Z,25,4,2020,1,2,Isle_of_Man,IM,IMN,84077,Europe,18,308,4
2020-04-26T00:00:00Z,26,4,2020,0,0,Isle_of_Man,IM,IMN,84077,Europe,18,308,5
2020-04-27T00:00:00Z,27,4,2020,0,0,Isle_of_Man,IM,IMN,84077,Europe,18,308,6
2020-04-28T00:00:00Z,28,4,2020,0,0,Isle_of_Man,IM,IMN,84077,Europe,18,308,7
2020-04-29T00:00:00Z,29,4,2020,1,3,Isle_of_Man,IM,IMN,84077,Europe,21,309,8
2020-04-30T00:00:00Z,30,4,2020,4,0,Isle_of_Man,IM,IMN,84077,Europe,21,313,9
2020-05-01T00:00:00Z,1,5,2020,2,0,Isle_of_Man,IM,IMN,84077,Europe,21,315,10
2020-05-02T00:00:00Z,2,5,2020,1,1,Isle_of_Man,IM,IMN,84077,Europe,22,316,11
2020-05-03T00:00:00Z,3,5,2020,4,0,Isle_of_Man,IM,IMN,84077,Europe,22,320,12
2020-05-04T00:00:00Z,4,5,2020,1,0,Isle_of_Man,IM,IMN,84077,Europe,22,321,13
2020-05-05T00:00:00Z,5,5,2020,4,1,Isle_of_Man,IM,IMN,84077,Europe,23,325,14
2020-05-06T00:00:00Z,6,5,2020,1,0,Isle_of_Man,IM,IMN,84077,Europe,23,326,15
2020-05-07T00:00:00Z,7,5,2020,1,0,Isle_of_Man,IM,IMN,84077,Europe,23,327,16
2020-05-08T00:00:00Z,8,5,2020,2,0,Isle_of_Man,IM,IMN,84077,Europe,23,329,17
2020-05-09T00:00:00Z,9,5,2020,0,0,Isle_of_Man,IM,IMN,84077,Europe,23,329,18
2020-05-10T00:00:00Z,10,5,2020,1,0,Isle_of_Man,IM,IMN,84077,Europe,23,330,19
2020-05-11T00:00:00Z,11,5,2020,0,0,Isle_of_Man,IM,IMN,84077,Europe,23,330,20
2020-05-12T00:00:00Z,12,5,2020,0,0,Isle_of_Man,IM,IMN,84077,Europe,23,330,21
2020-05-13T00:00:00Z,13,5,2020,1,0,Isle_of_Man,IM,IMN,84077,Europe,23,331,22
2020-05-14T00:00:00Z,14,5,2020,1,0,Isle_of_Man,IM,IMN,84077,Europe,23,332,23
2020-05-15T00:00:00Z,15,5,2020,0,0,Isle_of_Man,IM,IMN,84077,Europe,23,332,24
2020-05-16T00:00:00Z,16,5,2020,2,1,Isle_of_Man,IM,IMN,84077,Europe,24,334,25
2020-05-17T00:00:00Z,17,5,2020,1,0,Isle_of_Man,IM,IMN,84077,Europe,24,335,26
2020-05-18T00:00:00Z,18,5,2020,0,0,Isle_of_Man,IM,IMN,84077,Europe,24,335,27
2020-05-19T00:00:00Z,19,5,2020,0,0,Isle_of_Man,IM,IMN,84077,Europe,24,335,28
2020-05-20T00:00:00Z,20,5,2020,0,0,Isle_of_Man,IM,IMN,84077,Europe,24,335,29
2020-05-21T00:00:00Z,21,5,2020,1,0,Isle_of_Man,IM,IMN,84077,Europe,24,336,30
2020-05-22T00:00:00Z,22,5,2020,0,0,Isle_of_Man,IM,IMN,84077,Europe,24,336,31
2020-05-23T00:00:00Z,23,5,2020,0,0,Isle_of_Man,IM,IMN,84077,Europe,24,336,32
2020-05-24T00:00:00Z,24,5,2020,0,0,Isle_of_Man,IM,IMN,84077,Europe,24,336,33
2020-05-25T00:00:00Z,25,5,2020,0,0,Isle_of_Man,IM,IMN,84077,Europe,24,336,34
2020-05-26T00:00:00Z,26,5,2020,0,0,Isle_of_Man,IM,IMN,84077,Europe,24,336,35
2020-05-27T00:00:00Z,27,5,2020,0,0,Isle_of_Man,IM,IMN,84077,Europe,24,336,36
2020-03-28T00:00:00Z,28,3,2020,369,2,Israel,IL,ISR,8883800,Asia,10,3035,1
2020-03-29T00:00:00Z,29,3,2020,584,2,Israel,IL,ISR,8883800,Asia,12,3619,2
2020-03-30T00:00:00Z,30,3,2020,628,3,Israel,IL,ISR,8883800,Asia,15,4247,3
2020-03-31T00:00:00Z,31,3,2020,226,2,Israel,IL,ISR,8883800,Asia,17,4473,4
2020-04-01T00:00:00Z,1,4,2020,443,3,Israel,IL,ISR,8883800,Asia,20,4916,5
2020-04-02T00:00:00Z,2,4,2020,675,1,Israel,IL,ISR,8883800,Asia,21,5591,6
2020-04-03T00:00:00Z,3,4,2020,661,13,Israel,IL,ISR,8883800,Asia,34,6252,7
2020-04-04T00:00:00Z,4,4,2020,1176,5,Israel,IL,ISR,8883800,Asia,39,7428,8
2020-04-05T00:00:00Z,5,4,2020,590,7,Israel,IL,ISR,8883800,Asia,46,8018,9
2020-04-06T00:00:00Z,6,4,2020,412,3,Israel,IL,ISR,8883800,Asia,49,8430,10
2020-04-07T00:00:00Z,7,4,2020,474,8,Israel,IL,ISR,8883800,Asia,57,8904,11
2020-04-08T00:00:00Z,8,4,2020,344,8,Israel,IL,ISR,8883800,Asia,65,9248,12
2020-04-09T00:00:00Z,9,4,2020,156,6,Israel,IL,ISR,8883800,Asia,71,9404,13
2020-04-10T00:00:00Z,10,4,2020,564,15,Israel,IL,ISR,8883800,Asia,86,9968,14
2020-04-11T00:00:00Z,11,4,2020,440,9,Israel,IL,ISR,8883800,Asia,95,10408,15
2020-04-12T00:00:00Z,12,4,2020,335,6,Israel,IL,ISR,8883800,Asia,101,10743,16
2020-04-13T00:00:00Z,13,4,2020,402,2,Israel,IL,ISR,8883800,Asia,103,11145,17
2020-04-14T00:00:00Z,14,4,2020,441,13,Israel,IL,ISR,8883800,Asia,116,11586,18
2020-04-15T00:00:00Z,15,4,2020,460,7,Israel,IL,ISR,8883800,Asia,123,12046,19
2020-04-16T00:00:00Z,16,4,2020,455,7,Israel,IL,ISR,8883800,Asia,130,12501,20
2020-04-17T00:00:00Z,17,4,2020,257,12,Israel,IL,ISR,8883800,Asia,142,12758,21
2020-04-18T00:00:00Z,18,4,2020,224,9,Israel,IL,ISR,8883800,Asia,151,12982,22
2020-04-19T00:00:00Z,19,4,2020,283,13,Israel,IL,ISR,8883800,Asia,164,13265,23
2020-04-20T00:00:00Z,20,4,2020,226,8,Israel,IL,ISR,8883800,Asia,172,13491,24
2020-04-21T00:00:00Z,21,4,2020,222,5,Israel,IL,ISR,8883800,Asia,177,13713,25
2020-04-22T00:00:00Z,22,4,2020,229,7,Israel,IL,ISR,8883800,Asia,184,13942,26
2020-04-23T00:00:00Z,23,4,2020,650,7,Israel,IL,ISR,8883800,Asia,191,14592,27
2020-04-24T00:00:00Z,24,4,2020,290,2,Israel,IL,ISR,8883800,Asia,193,14882,28
2020-04-25T00:00:00Z,25,4,2020,176,1,Israel,IL,ISR,8883800,Asia,194,15058,29
2020-04-26T00:00:00Z,26,4,2020,240,5,Israel,IL,ISR,8883800,Asia,199,15298,30
2020-04-27T00:00:00Z,27,4,2020,100,0,Israel,IL,ISR,8883800,Asia,199,15398,31
2020-04-28T00:00:00Z,28,4,2020,68,3,Israel,IL,ISR,8883800,Asia,202,15466,32
2020-04-29T00:00:00Z,29,4,2020,123,6,Israel,IL,ISR,8883800,Asia,208,15589,33
2020-04-30T00:00:00Z,30,4,2020,245,7,Israel,IL,ISR,8883800,Asia,215,15834,34
2020-05-01T00:00:00Z,1,5,2020,112,7,Israel,IL,ISR,8883800,Asia,222,15946,35
2020-05-02T00:00:00Z,2,5,2020,155,3,Israel,IL,ISR,8883800,Asia,225,16101,36
2020-05-03T00:00:00Z,3,5,2020,84,4,Israel,IL,ISR,8883800,Asia,229,16185,37
2020-05-04T00:00:00Z,4,5,2020,23,3,Israel,IL,ISR,8883800,Asia,232,16208,38
2020-05-05T00:00:00Z,5,5,2020,38,3,Israel,IL,ISR,8883800,Asia,235,16246,39
2020-05-06T00:00:00Z,6,5,2020,43,3,Israel,IL,ISR,8883800,Asia,238,16289,40
2020-05-07T00:00:00Z,7,5,2020,21,1,Israel,IL,ISR,8883800,Asia,239,16310,41
2020-05-08T00:00:00Z,8,5,2020,71,1,Israel,IL,ISR,8883800,Asia,240,16381,42
2020-05-09T00:00:00Z,9,5,2020,55,5,Israel,IL,ISR,8883800,Asia,245,16436,43
2020-05-10T00:00:00Z,10,5,2020,18,2,Israel,IL,ISR,8883800,Asia,247,16454,44
2020-05-11T00:00:00Z,11,5,2020,23,5,Israel,IL,ISR,8883800,Asia,252,16477,45
2020-05-12T00:00:00Z,12,5,2020,29,6,Israel,IL,ISR,8883800,Asia,258,16506,46
2020-05-13T00:00:00Z,13,5,2020,23,2,Israel,IL,ISR,8883800,Asia,260,16529,47
2020-05-14T00:00:00Z,14,5,2020,19,4,Israel,IL,ISR,8883800,Asia,264,16548,48
2020-05-15T00:00:00Z,15,5,2020,31,1,Israel,IL,ISR,8883800,Asia,265,16579,49
2020-05-16T00:00:00Z,16,5,2020,10,1,Israel,IL,ISR,8883800,Asia,266,16589,50
2020-05-17T00:00:00Z,17,5,2020,19,2,Israel,IL,ISR,8883800,Asia,268,16608,51
2020-05-18T00:00:00Z,18,5,2020,9,4,Israel,IL,ISR,8883800,Asia,272,16617,52
2020-05-19T00:00:00Z,19,5,2020,4,0,Israel,IL,ISR,8883800,Asia,272,16621,53
2020-05-20T00:00:00Z,20,5,2020,29,5,Israel,IL,ISR,8883800,Asia,277,16650,54
2020-05-21T00:00:00Z,21,5,2020,20,2,Israel,IL,ISR,8883800,Asia,279,16670,55
2020-05-22T00:00:00Z,22,5,2020,20,0,Israel,IL,ISR,8883800,Asia,279,16690,56
2020-05-23T00:00:00Z,23,5,2020,0,0,Israel,IL,ISR,8883800,Asia,279,16690,57
2020-05-24T00:00:00Z,24,5,2020,0,0,Israel,IL,ISR,8883800,Asia,279,16690,58
2020-05-25T00:00:00Z,25,5,2020,30,1,Israel,IL,ISR,8883800,Asia,280,16720,59
2020-05-26T00:00:00Z,26,5,2020,14,1,Israel,IL,ISR,8883800,Asia,281,16734,60
2020-05-27T00:00:00Z,27,5,2020,23,0,Israel,IL,ISR,8883800,Asia,281,16757,61
2020-02-26T00:00:00Z,26,2,2020,93,5,Italy,IT,ITA,60431283,Europe,11,322,1
2020-02-27T00:00:00Z,27,2,2020,78,1,Italy,IT,ITA,60431283,Europe,12,400,2
2020-02-28T00:00:00Z,28,2,2020,250,5,Italy,IT,ITA,60431283,Europe,17,650,3
2020-02-29T00:00:00Z,29,2,2020,238,4,Italy,IT,ITA,60431283,Europe,21,888,4
2020-03-01T00:00:00Z,1,3,2020,240,8,Italy,IT,ITA,60431283,Europe,29,1128,5
2020-03-02T00:00:00Z,2,3,2020,561,6,Italy,IT,ITA,60431283,Europe,35,1689,6
2020-03-03T00:00:00Z,3,3,2020,347,17,Italy,IT,ITA,60431283,Europe,52,2036,7
2020-03-04T00:00:00Z,4,3,2020,466,28,Italy,IT,ITA,60431283,Europe,80,2502,8
2020-03-05T00:00:00Z,5,3,2020,587,27,Italy,IT,ITA,60431283,Europe,107,3089,9
2020-03-06T00:00:00Z,6,3,2020,769,41,Italy,IT,ITA,60431283,Europe,148,3858,10
2020-03-07T00:00:00Z,7,3,2020,778,49,Italy,IT,ITA,60431283,Europe,197,4636,11
2020-03-08T00:00:00Z,8,3,2020,1247,36,Italy,IT,ITA,60431283,Europe,233,5883,12
2020-03-09T00:00:00Z,9,3,2020,1492,133,Italy,IT,ITA,60431283,Europe,366,7375,13
2020-03-10T00:00:00Z,10,3,2020,1797,98,Italy,IT,ITA,60431283,Europe,464,9172,14
2020-03-11T00:00:00Z,11,3,2020,977,167,Italy,IT,ITA,60431283,Europe,631,10149,15
2020-03-12T00:00:00Z,12,3,2020,2313,196,Italy,IT,ITA,60431283,Europe,827,12462,16
2020-03-13T00:00:00Z,13,3,2020,2651,189,Italy,IT,ITA,60431283,Europe,1016,15113,17
2020-03-14T00:00:00Z,14,3,2020,2547,252,Italy,IT,ITA,60431283,Europe,1268,17660,18
2020-03-15T00:00:00Z,15,3,2020,3497,173,Italy,IT,ITA,60431283,Europe,1441,21157,19
2020-03-16T00:00:00Z,16,3,2020,2823,370,Italy,IT,ITA,60431283,Europe,1811,23980,20
2020-03-17T00:00:00Z,17,3,2020,4000,347,Italy,IT,ITA,60431283,Europe,2158,27980,21
2020-03-18T00:00:00Z,18,3,2020,3526,347,Italy,IT,ITA,60431283,Europe,2505,31506,22
2020-03-19T00:00:00Z,19,3,2020,4207,473,Italy,IT,ITA,60431283,Europe,2978,35713,23
2020-03-20T00:00:00Z,20,3,2020,5322,429,Italy,IT,ITA,60431283,Europe,3407,41035,24
2020-03-21T00:00:00Z,21,3,2020,5986,625,Italy,IT,ITA,60431283,Europe,4032,47021,25
2020-03-22T00:00:00Z,22,3,2020,6557,795,Italy,IT,ITA,60431283,Europe,4827,53578,26
2020-03-23T00:00:00Z,23,3,2020,5560,649,Italy,IT,ITA,60431283,Europe,5476,59138,27
2020-03-24T00:00:00Z,24,3,2020,4789,601,Italy,IT,ITA,60431283,Europe,6077,63927,28
2020-03-25T00:00:00Z,25,3,2020,5249,743,Italy,IT,ITA,60431283,Europe,6820,69176,29
2020-03-26T00:00:00Z,26,3,2020,5210,685,Italy,IT,ITA,60431283,Europe,7505,74386,30
2020-03-27T00:00:00Z,27,3,2020,6153,660,Italy,IT,ITA,60431283,Europe,8165,80539,31
2020-03-28T00:00:00Z,28,3,2020,5959,971,Italy,IT,ITA,60431283,Europe,9136,86498,32
2020-03-29T00:00:00Z,29,3,2020,5974,887,Italy,IT,ITA,60431283,Europe,10023,92472,33
2020-03-30T00:00:00Z,30,3,2020,5217,758,Italy,IT,ITA,60431283,Europe,10781,97689,34
2020-03-31T00:00:00Z,31,3,2020,4050,810,Italy,IT,ITA,60431283,Europe,11591,101739,35
2020-04-01T00:00:00Z,1,4,2020,4053,839,Italy,IT,ITA,60431283,Europe,12430,105792,36
2020-04-02T00:00:00Z,2,4,2020,4782,727,Italy,IT,ITA,60431283,Europe,13157,110574,37
2020-04-03T00:00:00Z,3,4,2020,4668,760,Italy,IT,ITA,60431283,Europe,13917,115242,38
2020-04-04T00:00:00Z,4,4,2020,4585,764,Italy,IT,ITA,60431283,Europe,14681,119827,39
2020-04-05T00:00:00Z,5,4,2020,4805,681,Italy,IT,ITA,60431283,Europe,15362,124632,40
2020-04-06T00:00:00Z,6,4,2020,4316,527,Italy,IT,ITA,60431283,Europe,15889,128948,41
2020-04-07T00:00:00Z,7,4,2020,3599,636,Italy,IT,ITA,60431283,Europe,16525,132547,42
2020-04-08T00:00:00Z,8,4,2020,3039,604,Italy,IT,ITA,60431283,Europe,17129,135586,43
2020-04-09T00:00:00Z,9,4,2020,3836,540,Italy,IT,ITA,60431283,Europe,17669,139422,44
2020-04-10T00:00:00Z,10,4,2020,4204,612,Italy,IT,ITA,60431283,Europe,18281,143626,45
2020-04-11T00:00:00Z,11,4,2020,3951,570,Italy,IT,ITA,60431283,Europe,18851,147577,46
2020-04-12T00:00:00Z,12,4,2020,4694,619,Italy,IT,ITA,60431283,Europe,19470,152271,47
2020-04-13T00:00:00Z,13,4,2020,4092,431,Italy,IT,ITA,60431283,Europe,19901,156363,48
2020-04-14T00:00:00Z,14,4,2020,3153,564,Italy,IT,ITA,60431283,Europe,20465,159516,49
2020-04-15T00:00:00Z,15,4,2020,2972,604,Italy,IT,ITA,60431283,Europe,21069,162488,50
2020-04-16T00:00:00Z,16,4,2020,2667,578,Italy,IT,ITA,60431283,Europe,21647,165155,51
2020-04-17T00:00:00Z,17,4,2020,3786,525,Italy,IT,ITA,60431283,Europe,22172,168941,52
2020-04-18T00:00:00Z,18,4,2020,3493,575,Italy,IT,ITA,60431283,Europe,22747,172434,53
2020-04-19T00:00:00Z,19,4,2020,3491,480,Italy,IT,ITA,60431283,Europe,23227,175925,54
2020-04-20T00:00:00Z,20,4,2020,3047,433,Italy,IT,ITA,60431283,Europe,23660,178972,55
2020-04-21T00:00:00Z,21,4,2020,2256,454,Italy,IT,ITA,60431283,Europe,24114,181228,56
2020-04-22T00:00:00Z,22,4,2020,2729,534,Italy,IT,ITA,60431283,Europe,24648,183957,57
2020-04-23T00:00:00Z,23,4,2020,3370,437,Italy,IT,ITA,60431283,Europe,25085,187327,58
2020-04-24T00:00:00Z,24,4,2020,2646,464,Italy,IT,ITA,60431283,Europe,25549,189973,59
2020-04-25T00:00:00Z,25,4,2020,3021,420,Italy,IT,ITA,60431283,Europe,25969,192994,60
2020-04-26T00:00:00Z,26,4,2020,2357,415,Italy,IT,ITA,60431283,Europe,26384,195351,61
2020-04-27T00:00:00Z,27,4,2020,2324,260,Italy,IT,ITA,60431283,Europe,26644,197675,62
2020-04-28T00:00:00Z,28,4,2020,1739,333,Italy,IT,ITA,60431283,Europe,26977,199414,63
2020-04-29T00:00:00Z,29,4,2020,2091,382,Italy,IT,ITA,60431283,Europe,27359,201505,64
2020-04-30T00:00:00Z,30,4,2020,2086,323,Italy,IT,ITA,60431283,Europe,27682,203591,65
2020-05-01T00:00:00Z,1,5,2020,1872,285,Italy,IT,ITA,60431283,Europe,27967,205463,66
2020-05-02T00:00:00Z,2,5,2020,1965,269,Italy,IT,ITA,60431283,Europe,28236,207428,67
2020-05-03T00:00:00Z,3,5,2020,1900,474,Italy,IT,ITA,60431283,Europe,28710,209328,68
2020-05-04T00:00:00Z,4,5,2020,1389,174,Italy,IT,ITA,60431283,Europe,28884,210717,69
2020-05-05T00:00:00Z,5,5,2020,1221,195,Italy,IT,ITA,60431283,Europe,29079,211938,70
2020-05-06T00:00:00Z,6,5,2020,1075,236,Italy,IT,ITA,60431283,Europe,29315,213013,71
2020-05-07T00:00:00Z,7,5,2020,1444,369,Italy,IT,ITA,60431283,Europe,29684,214457,72
2020-05-08T00:00:00Z,8,5,2020,1401,274,Italy,IT,ITA,60431283,Europe,29958,215858,73
2020-05-09T00:00:00Z,9,5,2020,1327,243,Italy,IT,ITA,60431283,Europe,30201,217185,74
2020-05-10T00:00:00Z,10,5,2020,1083,194,Italy,IT,ITA,60431283,Europe,30395,218268,75
2020-05-11T00:00:00Z,11,5,2020,802,165,Italy,IT,ITA,60431283,Europe,30560,219070,76
2020-05-12T00:00:00Z,12,5,2020,744,179,Italy,IT,ITA,60431283,Europe,30739,219814,77
2020-05-13T00:00:00Z,13,5,2020,1402,172,Italy,IT,ITA,60431283,Europe,30911,221216,78
2020-05-14T00:00:00Z,14,5,2020,888,195,Italy,IT,ITA,60431283,Europe,31106,222104,79
2020-05-15T00:00:00Z,15,5,2020,992,262,Italy,IT,ITA,60431283,Europe,31368,223096,80
2020-05-16T00:00:00Z,16,5,2020,789,242,Italy,IT,ITA,60431283,Europe,31610,223885,81
2020-05-17T00:00:00Z,17,5,2020,875,153,Italy,IT,ITA,60431283,Europe,31763,224760,82
2020-05-18T00:00:00Z,18,5,2020,675,145,Italy,IT,ITA,60431283,Europe,31908,225435,83
2020-05-19T00:00:00Z,19,5,2020,451,99,Italy,IT,ITA,60431283,Europe,32007,225886,84
2020-05-20T00:00:00Z,20,5,2020,813,162,Italy,IT,ITA,60431283,Europe,32169,226699,85
2020-05-21T00:00:00Z,21,5,2020,665,161,Italy,IT,ITA,60431283,Europe,32330,227364,86
2020-05-22T00:00:00Z,22,5,2020,642,156,Italy,IT,ITA,60431283,Europe,32486,228006,87
2020-05-23T00:00:00Z,23,5,2020,652,130,Italy,IT,ITA,60431283,Europe,32616,228658,88
2020-05-24T00:00:00Z,24,5,2020,669,119,Italy,IT,ITA,60431283,Europe,32735,229327,89
2020-05-25T00:00:00Z,25,5,2020,531,50,Italy,IT,ITA,60431283,Europe,32785,229858,90
2020-05-26T00:00:00Z,26,5,2020,300,92,Italy,IT,ITA,60431283,Europe,32877,230158,91
2020-05-27T00:00:00Z,27,5,2020,397,78,Italy,IT,ITA,60431283,Europe,32955,230555,92
2020-03-11T00:00:00Z,11,3,2020,54,3,Japan,JP,JPN,126529100,Asia,12,568,1
2020-03-12T00:00:00Z,12,3,2020,51,3,Japan,JP,JPN,126529100,Asia,15,619,2
2020-03-13T00:00:00Z,13,3,2020,56,4,Japan,JP,JPN,126529100,Asia,19,675,3
2020-03-14T00:00:00Z,14,3,2020,62,2,Japan,JP,JPN,126529100,Asia,21,737,4
2020-03-15T00:00:00Z,15,3,2020,43,1,Japan,JP,JPN,126529100,Asia,22,780,5
2020-03-16T00:00:00Z,16,3,2020,34,2,Japan,JP,JPN,126529100,Asia,24,814,6
2020-03-17T00:00:00Z,17,3,2020,10,4,Japan,JP,JPN,126529100,Asia,28,824,7
2020-03-18T00:00:00Z,18,3,2020,5,0,Japan,JP,JPN,126529100,Asia,28,829,8
2020-03-19T00:00:00Z,19,3,2020,44,1,Japan,JP,JPN,126529100,Asia,29,873,9
2020-03-20T00:00:00Z,20,3,2020,77,4,Japan,JP,JPN,126529100,Asia,33,950,10
2020-03-21T00:00:00Z,21,3,2020,57,2,Japan,JP,JPN,126529100,Asia,35,1007,11
2020-03-22T00:00:00Z,22,3,2020,39,1,Japan,JP,JPN,126529100,Asia,36,1046,12
2020-03-23T00:00:00Z,23,3,2020,43,5,Japan,JP,JPN,126529100,Asia,41,1089,13
2020-03-24T00:00:00Z,24,3,2020,39,1,Japan,JP,JPN,126529100,Asia,42,1128,14
2020-03-25T00:00:00Z,25,3,2020,65,1,Japan,JP,JPN,126529100,Asia,43,1193,15
2020-03-26T00:00:00Z,26,3,2020,75,2,Japan,JP,JPN,126529100,Asia,45,1268,16
2020-03-27T00:00:00Z,27,3,2020,96,1,Japan,JP,JPN,126529100,Asia,46,1364,17
2020-03-28T00:00:00Z,28,3,2020,135,3,Japan,JP,JPN,126529100,Asia,49,1499,18
2020-03-29T00:00:00Z,29,3,2020,194,3,Japan,JP,JPN,126529100,Asia,52,1693,19
2020-03-30T00:00:00Z,30,3,2020,173,2,Japan,JP,JPN,126529100,Asia,54,1866,20
2020-03-31T00:00:00Z,31,3,2020,87,2,Japan,JP,JPN,126529100,Asia,56,1953,21
2020-04-01T00:00:00Z,1,4,2020,0,0,Japan,JP,JPN,126529100,Asia,56,1953,22
2020-04-02T00:00:00Z,2,4,2020,225,1,Japan,JP,JPN,126529100,Asia,57,2178,23
2020-04-03T00:00:00Z,3,4,2020,439,6,Japan,JP,JPN,126529100,Asia,63,2617,24
2020-04-04T00:00:00Z,4,4,2020,318,6,Japan,JP,JPN,126529100,Asia,69,2935,25
2020-04-05T00:00:00Z,5,4,2020,336,1,Japan,JP,JPN,126529100,Asia,70,3271,26
2020-04-06T00:00:00Z,6,4,2020,383,3,Japan,JP,JPN,126529100,Asia,73,3654,27
2020-04-07T00:00:00Z,7,4,2020,163,7,Japan,JP,JPN,126529100,Asia,80,3817,28
2020-04-08T00:00:00Z,8,4,2020,89,0,Japan,JP,JPN,126529100,Asia,80,3906,29
2020-04-09T00:00:00Z,9,4,2020,351,1,Japan,JP,JPN,126529100,Asia,81,4257,30
2020-04-10T00:00:00Z,10,4,2020,410,4,Japan,JP,JPN,126529100,Asia,85,4667,31
2020-04-11T00:00:00Z,11,4,2020,680,3,Japan,JP,JPN,126529100,Asia,88,5347,32
2020-04-12T00:00:00Z,12,4,2020,1401,10,Japan,JP,JPN,126529100,Asia,98,6748,33
2020-04-13T00:00:00Z,13,4,2020,507,4,Japan,JP,JPN,126529100,Asia,102,7255,34
2020-04-14T00:00:00Z,14,4,2020,390,7,Japan,JP,JPN,126529100,Asia,109,7645,35
2020-04-15T00:00:00Z,15,4,2020,455,10,Japan,JP,JPN,126529100,Asia,119,8100,36
2020-04-16T00:00:00Z,16,4,2020,482,17,Japan,JP,JPN,126529100,Asia,136,8582,37
2020-04-17T00:00:00Z,17,4,2020,585,12,Japan,JP,JPN,126529100,Asia,148,9167,38
2020-04-18T00:00:00Z,18,4,2020,628,6,Japan,JP,JPN,126529100,Asia,154,9795,39
2020-04-19T00:00:00Z,19,4,2020,566,7,Japan,JP,JPN,126529100,Asia,161,10361,40
2020-04-20T00:00:00Z,20,4,2020,390,10,Japan,JP,JPN,126529100,Asia,171,10751,41
2020-04-21T00:00:00Z,21,4,2020,367,15,Japan,JP,JPN,126529100,Asia,186,11118,42
2020-04-22T00:00:00Z,22,4,2020,378,0,Japan,JP,JPN,126529100,Asia,186,11496,43
2020-04-23T00:00:00Z,23,4,2020,276,101,Japan,JP,JPN,126529100,Asia,287,11772,44
2020-04-24T00:00:00Z,24,4,2020,468,30,Japan,JP,JPN,126529100,Asia,317,12240,45
2020-04-25T00:00:00Z,25,4,2020,652,17,Japan,JP,JPN,126529100,Asia,334,12892,46
2020-04-26T00:00:00Z,26,4,2020,290,14,Japan,JP,JPN,126529100,Asia,348,13182,47
2020-04-27T00:00:00Z,27,4,2020,203,3,Japan,JP,JPN,126529100,Asia,351,13385,48
2020-04-28T00:00:00Z,28,4,2020,191,25,Japan,JP,JPN,126529100,Asia,376,13576,49
2020-04-29T00:00:00Z,29,4,2020,276,13,Japan,JP,JPN,126529100,Asia,389,13852,50
2020-04-30T00:00:00Z,30,4,2020,236,26,Japan,JP,JPN,126529100,Asia,415,14088,51
2020-05-01T00:00:00Z,1,5,2020,193,17,Japan,JP,JPN,126529100,Asia,432,14281,52
2020-05-02T00:00:00Z,2,5,2020,263,26,Japan,JP,JPN,126529100,Asia,458,14544,53
2020-05-03T00:00:00Z,3,5,2020,295,34,Japan,JP,JPN,126529100,Asia,492,14839,54
2020-05-04T00:00:00Z,4,5,2020,218,18,Japan,JP,JPN,126529100,Asia,510,15057,55
2020-05-05T00:00:00Z,5,5,2020,174,11,Japan,JP,JPN,126529100,Asia,521,15231,56
2020-05-06T00:00:00Z,6,5,2020,123,22,Japan,JP,JPN,126529100,Asia,543,15354,57
2020-05-07T00:00:00Z,7,5,2020,109,8,Japan,JP,JPN,126529100,Asia,551,15463,58
2020-05-08T00:00:00Z,8,5,2020,84,6,Japan,JP,JPN,126529100,Asia,557,15547,59
2020-05-09T00:00:00Z,9,5,2020,81,44,Japan,JP,JPN,126529100,Asia,601,15628,60
2020-05-10T00:00:00Z,10,5,2020,119,12,Japan,JP,JPN,126529100,Asia,613,15747,61
2020-05-11T00:00:00Z,11,5,2020,51,8,Japan,JP,JPN,126529100,Asia,621,15798,62
2020-05-12T00:00:00Z,12,5,2020,76,22,Japan,JP,JPN,126529100,Asia,643,15874,63
2020-05-13T00:00:00Z,13,5,2020,150,25,Japan,JP,JPN,126529100,Asia,668,16024,64
2020-05-14T00:00:00Z,14,5,2020,55,19,Japan,JP,JPN,126529100,Asia,687,16079,65
2020-05-15T00:00:00Z,15,5,2020,114,23,Japan,JP,JPN,126529100,Asia,710,16193,66
2020-05-16T00:00:00Z,16,5,2020,44,15,Japan,JP,JPN,126529100,Asia,725,16237,67
2020-05-17T00:00:00Z,17,5,2020,48,19,Japan,JP,JPN,126529100,Asia,744,16285,68
2020-05-18T00:00:00Z,18,5,2020,20,5,Japan,JP,JPN,126529100,Asia,749,16305,69
2020-05-19T00:00:00Z,19,5,2020,60,14,Japan,JP,JPN,126529100,Asia,763,16365,70
2020-05-20T00:00:00Z,20,5,2020,20,8,Japan,JP,JPN,126529100,Asia,771,16385,71
2020-05-21T00:00:00Z,21,5,2020,39,6,Japan,JP,JPN,126529100,Asia,777,16424,72
2020-05-22T00:00:00Z,22,5,2020,89,19,Japan,JP,JPN,126529100,Asia,796,16513,73
2020-05-23T00:00:00Z,23,5,2020,23,12,Japan,JP,JPN,126529100,Asia,808,16536,74
2020-05-24T00:00:00Z,24,5,2020,14,12,Japan,JP,JPN,126529100,Asia,820,16550,75
2020-05-25T00:00:00Z,25,5,2020,31,10,Japan,JP,JPN,126529100,Asia,830,16581,76
2020-05-26T00:00:00Z,26,5,2020,42,16,Japan,JP,JPN,126529100,Asia,846,16623,77
2020-05-27T00:00:00Z,27,5,2020,28,12,Japan,JP,JPN,126529100,Asia,858,16651,78
2020-04-17T00:00:00Z,17,4,2020,6,4,Jersey,JE,JEY,106800,Europe,10,223,1
2020-04-18T00:00:00Z,18,4,2020,1,1,Jersey,JE,JEY,106800,Europe,11,224,2
2020-04-19T00:00:00Z,19,4,2020,21,1,Jersey,JE,JEY,106800,Europe,12,245,3
2020-04-20T00:00:00Z,20,4,2020,4,0,Jersey,JE,JEY,106800,Europe,12,249,4
2020-04-21T00:00:00Z,21,4,2020,0,2,Jersey,JE,JEY,106800,Europe,14,249,5
2020-04-22T00:00:00Z,22,4,2020,6,0,Jersey,JE,JEY,106800,Europe,14,255,6
2020-04-23T00:00:00Z,23,4,2020,0,4,Jersey,JE,JEY,106800,Europe,18,255,7
2020-04-24T00:00:00Z,24,4,2020,21,1,Jersey,JE,JEY,106800,Europe,19,276,8
2020-04-25T00:00:00Z,25,4,2020,2,0,Jersey,JE,JEY,106800,Europe,19,278,9
2020-04-26T00:00:00Z,26,4,2020,2,0,Jersey,JE,JEY,106800,Europe,19,280,10
2020-04-27T00:00:00Z,27,4,2020,1,0,Jersey,JE,JEY,106800,Europe,19,281,11
2020-04-28T00:00:00Z,28,4,2020,2,0,Jersey,JE,JEY,106800,Europe,19,283,12
2020-04-29T00:00:00Z,29,4,2020,1,1,Jersey,JE,JEY,106800,Europe,20,284,13
2020-04-30T00:00:00Z,30,4,2020,2,1,Jersey,JE,JEY,106800,Europe,21,286,14
2020-05-01T00:00:00Z,1,5,2020,0,2,Jersey,JE,JEY,106800,Europe,23,286,15
2020-05-02T00:00:00Z,2,5,2020,0,1,Jersey,JE,JEY,106800,Europe,24,286,16
2020-05-03T00:00:00Z,3,5,2020,5,0,Jersey,JE,JEY,106800,Europe,24,291,17
2020-05-04T00:00:00Z,4,5,2020,1,0,Jersey,JE,JEY,106800,Europe,24,292,18
2020-05-05T00:00:00Z,5,5,2020,1,0,Jersey,JE,JEY,106800,Europe,24,293,19
2020-05-06T00:00:00Z,6,5,2020,0,0,Jersey,JE,JEY,106800,Europe,24,293,20
2020-05-07T00:00:00Z,7,5,2020,0,1,Jersey,JE,JEY,106800,Europe,25,293,21
2020-05-08T00:00:00Z,8,5,2020,0,0,Jersey,JE,JEY,106800,Europe,25,293,22
2020-05-09T00:00:00Z,9,5,2020,0,0,Jersey,JE,JEY,106800,Europe,25,293,23
2020-05-10T00:00:00Z,10,5,2020,0,0,Jersey,JE,JEY,106800,Europe,25,293,24
2020-05-11T00:00:00Z,11,5,2020,1,0,Jersey,JE,JEY,106800,Europe,25,294,25
2020-05-12T00:00:00Z,12,5,2020,0,0,Jersey,JE,JEY,106800,Europe,25,294,26
2020-05-13T00:00:00Z,13,5,2020,1,1,Jersey,JE,JEY,106800,Europe,26,295,27
2020-05-14T00:00:00Z,14,5,2020,1,1,Jersey,JE,JEY,106800,Europe,27,296,28
2020-05-15T00:00:00Z,15,5,2020,1,0,Jersey,JE,JEY,106800,Europe,27,297,29
2020-05-16T00:00:00Z,16,5,2020,0,0,Jersey,JE,JEY,106800,Europe,27,297,30
2020-05-17T00:00:00Z,17,5,2020,5,0,Jersey,JE,JEY,106800,Europe,27,302,31
2020-05-18T00:00:00Z,18,5,2020,0,0,Jersey,JE,JEY,106800,Europe,27,302,32
2020-05-19T00:00:00Z,19,5,2020,1,0,Jersey,JE,JEY,106800,Europe,27,303,33
2020-05-20T00:00:00Z,20,5,2020,0,1,Jersey,JE,JEY,106800,Europe,28,303,34
2020-05-21T00:00:00Z,21,5,2020,3,1,Jersey,JE,JEY,106800,Europe,29,306,35
2020-05-22T00:00:00Z,22,5,2020,0,0,Jersey,JE,JEY,106800,Europe,29,306,36
2020-05-23T00:00:00Z,23,5,2020,0,0,Jersey,JE,JEY,106800,Europe,29,306,37
2020-05-24T00:00:00Z,24,5,2020,0,0,Jersey,JE,JEY,106800,Europe,29,306,38
2020-05-25T00:00:00Z,25,5,2020,0,0,Jersey,JE,JEY,106800,Europe,29,306,39
2020-05-26T00:00:00Z,26,5,2020,1,0,Jersey,JE,JEY,106800,Europe,29,307,40
2020-05-27T00:00:00Z,27,5,2020,0,0,Jersey,JE,JEY,106800,Europe,29,307,41
2020-04-11T00:00:00Z,11,4,2020,38,1,Kazakhstan,KZ,KAZ,18276499,Asia,10,840,1
2020-04-12T00:00:00Z,12,4,2020,40,0,Kazakhstan,KZ,KAZ,18276499,Asia,10,880,2
2020-04-13T00:00:00Z,13,4,2020,81,0,Kazakhstan,KZ,KAZ,18276499,Asia,10,961,3
2020-04-14T00:00:00Z,14,4,2020,218,4,Kazakhstan,KZ,KAZ,18276499,Asia,14,1179,4
2020-04-15T00:00:00Z,15,4,2020,88,0,Kazakhstan,KZ,KAZ,18276499,Asia,14,1267,5
2020-04-16T00:00:00Z,16,4,2020,64,2,Kazakhstan,KZ,KAZ,18276499,Asia,16,1331,6
2020-04-17T00:00:00Z,17,4,2020,139,1,Kazakhstan,KZ,KAZ,18276499,Asia,17,1470,7
2020-04-18T00:00:00Z,18,4,2020,121,0,Kazakhstan,KZ,KAZ,18276499,Asia,17,1591,8
2020-04-19T00:00:00Z,19,4,2020,63,0,Kazakhstan,KZ,KAZ,18276499,Asia,17,1654,9
2020-04-20T00:00:00Z,20,4,2020,81,2,Kazakhstan,KZ,KAZ,18276499,Asia,19,1735,10
2020-04-21T00:00:00Z,21,4,2020,214,0,Kazakhstan,KZ,KAZ,18276499,Asia,19,1949,11
2020-04-22T00:00:00Z,22,4,2020,76,0,Kazakhstan,KZ,KAZ,18276499,Asia,19,2025,12
2020-04-23T00:00:00Z,23,4,2020,166,0,Kazakhstan,KZ,KAZ,18276499,Asia,19,2191,13
2020-04-24T00:00:00Z,24,4,2020,143,3,Kazakhstan,KZ,KAZ,18276499,Asia,22,2334,14
2020-04-25T00:00:00Z,25,4,2020,148,3,Kazakhstan,KZ,KAZ,18276499,Asia,25,2482,15
2020-04-26T00:00:00Z,26,4,2020,170,0,Kazakhstan,KZ,KAZ,18276499,Asia,25,2652,16
2020-04-27T00:00:00Z,27,4,2020,65,0,Kazakhstan,KZ,KAZ,18276499,Asia,25,2717,17
2020-04-28T00:00:00Z,28,4,2020,143,0,Kazakhstan,KZ,KAZ,18276499,Asia,25,2860,18
2020-04-29T00:00:00Z,29,4,2020,203,0,Kazakhstan,KZ,KAZ,18276499,Asia,25,3063,19
2020-04-30T00:00:00Z,30,4,2020,142,0,Kazakhstan,KZ,KAZ,18276499,Asia,25,3205,20
2020-05-01T00:00:00Z,1,5,2020,299,0,Kazakhstan,KZ,KAZ,18276499,Asia,25,3504,21
2020-05-02T00:00:00Z,2,5,2020,167,0,Kazakhstan,KZ,KAZ,18276499,Asia,25,3671,22
2020-05-03T00:00:00Z,3,5,2020,206,0,Kazakhstan,KZ,KAZ,18276499,Asia,25,3877,23
2020-05-04T00:00:00Z,4,5,2020,87,2,Kazakhstan,KZ,KAZ,18276499,Asia,27,3964,24
2020-05-05T00:00:00Z,5,5,2020,157,2,Kazakhstan,KZ,KAZ,18276499,Asia,29,4121,25
2020-05-06T00:00:00Z,6,5,2020,156,0,Kazakhstan,KZ,KAZ,18276499,Asia,29,4277,26
2020-05-07T00:00:00Z,7,5,2020,225,1,Kazakhstan,KZ,KAZ,18276499,Asia,30,4502,27
2020-05-08T00:00:00Z,8,5,2020,188,1,Kazakhstan,KZ,KAZ,18276499,Asia,31,4690,28
2020-05-09T00:00:00Z,9,5,2020,144,0,Kazakhstan,KZ,KAZ,18276499,Asia,31,4834,29
2020-05-10T00:00:00Z,10,5,2020,202,0,Kazakhstan,KZ,KAZ,18276499,Asia,31,5036,30
2020-05-11T00:00:00Z,11,5,2020,90,0,Kazakhstan,KZ,KAZ,18276499,Asia,31,5126,31
2020-05-12T00:00:00Z,12,5,2020,114,1,Kazakhstan,KZ,KAZ,18276499,Asia,32,5240,32
2020-05-13T00:00:00Z,13,5,2020,177,0,Kazakhstan,KZ,KAZ,18276499,Asia,32,5417,33
2020-05-14T00:00:00Z,14,5,2020,154,0,Kazakhstan,KZ,KAZ,18276499,Asia,32,5571,34
2020-05-15T00:00:00Z,15,5,2020,0,0,Kazakhstan,KZ,KAZ,18276499,Asia,32,5571,35
2020-05-16T00:00:00Z,16,5,2020,279,2,Kazakhstan,KZ,KAZ,18276499,Asia,34,5850,36
2020-05-17T00:00:00Z,17,5,2020,307,0,Kazakhstan,KZ,KAZ,18276499,Asia,34,6157,37
2020-05-18T00:00:00Z,18,5,2020,283,0,Kazakhstan,KZ,KAZ,18276499,Asia,34,6440,38
2020-05-19T00:00:00Z,19,5,2020,311,1,Kazakhstan,KZ,KAZ,18276499,Asia,35,6751,39
2020-05-20T00:00:00Z,20,5,2020,218,0,Kazakhstan,KZ,KAZ,18276499,Asia,35,6969,40
2020-05-21T00:00:00Z,21,5,2020,265,0,Kazakhstan,KZ,KAZ,18276499,Asia,35,7234,41
2020-05-22T00:00:00Z,22,5,2020,363,0,Kazakhstan,KZ,KAZ,18276499,Asia,35,7597,42
2020-05-23T00:00:00Z,23,5,2020,322,0,Kazakhstan,KZ,KAZ,18276499,Asia,35,7919,43
2020-05-24T00:00:00Z,24,5,2020,403,0,Kazakhstan,KZ,KAZ,18276499,Asia,35,8322,44
2020-05-25T00:00:00Z,25,5,2020,209,0,Kazakhstan,KZ,KAZ,18276499,Asia,35,8531,45
2020-05-26T00:00:00Z,26,5,2020,438,0,Kazakhstan,KZ,KAZ,18276499,Asia,35,8969,46
2020-05-27T00:00:00Z,27,5,2020,335,2,Kazakhstan,KZ,KAZ,18276499,Asia,37,9304,47
2020-04-16T00:00:00Z,16,4,2020,9,1,Kenya,KE,KEN,51393010,Africa,10,225,1
2020-04-17T00:00:00Z,17,4,2020,9,1,Kenya,KE,KEN,51393010,Africa,11,234,2
2020-04-18T00:00:00Z,18,4,2020,12,0,Kenya,KE,KEN,51393010,Africa,11,246,3
2020-04-19T00:00:00Z,19,4,2020,16,1,Kenya,KE,KEN,51393010,Africa,12,262,4
2020-04-20T00:00:00Z,20,4,2020,8,2,Kenya,KE,KEN,51393010,Africa,14,270,5
2020-04-21T00:00:00Z,21,4,2020,11,0,Kenya,KE,KEN,51393010,Africa,14,281,6
2020-04-22T00:00:00Z,22,4,2020,0,0,Kenya,KE,KEN,51393010,Africa,14,281,7
2020-04-23T00:00:00Z,23,4,2020,22,0,Kenya,KE,KEN,51393010,Africa,14,303,8
2020-04-24T00:00:00Z,24,4,2020,17,0,Kenya,KE,KEN,51393010,Africa,14,320,9
2020-04-25T00:00:00Z,25,4,2020,16,0,Kenya,KE,KEN,51393010,Africa,14,336,10
2020-04-26T00:00:00Z,26,4,2020,7,0,Kenya,KE,KEN,51393010,Africa,14,343,11
2020-04-27T00:00:00Z,27,4,2020,12,0,Kenya,KE,KEN,51393010,Africa,14,355,12
2020-04-28T00:00:00Z,28,4,2020,8,0,Kenya,KE,KEN,51393010,Africa,14,363,13
2020-04-29T00:00:00Z,29,4,2020,11,0,Kenya,KE,KEN,51393010,Africa,14,374,14
2020-04-30T00:00:00Z,30,4,2020,10,1,Kenya,KE,KEN,51393010,Africa,15,384,15
2020-05-01T00:00:00Z,1,5,2020,12,2,Kenya,KE,KEN,51393010,Africa,17,396,16
2020-05-02T00:00:00Z,2,5,2020,15,4,Kenya,KE,KEN,51393010,Africa,21,411,17
2020-05-03T00:00:00Z,3,5,2020,24,1,Kenya,KE,KEN,51393010,Africa,22,435,18
2020-05-04T00:00:00Z,4,5,2020,30,2,Kenya,KE,KEN,51393010,Africa,24,465,19
2020-05-05T00:00:00Z,5,5,2020,25,0,Kenya,KE,KEN,51393010,Africa,24,490,20
2020-05-06T00:00:00Z,6,5,2020,45,0,Kenya,KE,KEN,51393010,Africa,24,535,21
2020-05-07T00:00:00Z,7,5,2020,47,2,Kenya,KE,KEN,51393010,Africa,26,582,22
2020-05-08T00:00:00Z,8,5,2020,25,3,Kenya,KE,KEN,51393010,Africa,29,607,23
2020-05-09T00:00:00Z,9,5,2020,14,0,Kenya,KE,KEN,51393010,Africa,29,621,24
2020-05-10T00:00:00Z,10,5,2020,28,1,Kenya,KE,KEN,51393010,Africa,30,649,25
2020-05-11T00:00:00Z,11,5,2020,23,2,Kenya,KE,KEN,51393010,Africa,32,672,26
2020-05-12T00:00:00Z,12,5,2020,28,1,Kenya,KE,KEN,51393010,Africa,33,700,27
2020-05-13T00:00:00Z,13,5,2020,15,3,Kenya,KE,KEN,51393010,Africa,36,715,28
2020-05-14T00:00:00Z,14,5,2020,22,4,Kenya,KE,KEN,51393010,Africa,40,737,29
2020-05-15T00:00:00Z,15,5,2020,21,2,Kenya,KE,KEN,51393010,Africa,42,758,30
2020-05-16T00:00:00Z,16,5,2020,23,3,Kenya,KE,KEN,51393010,Africa,45,781,31
2020-05-17T00:00:00Z,17,5,2020,49,5,Kenya,KE,KEN,51393010,Africa,50,830,32
2020-05-18T00:00:00Z,18,5,2020,57,0,Kenya,KE,KEN,51393010,Africa,50,887,33
2020-05-19T00:00:00Z,19,5,2020,25,0,Kenya,KE,KEN,51393010,Africa,50,912,34
2020-05-20T00:00:00Z,20,5,2020,51,0,Kenya,KE,KEN,51393010,Africa,50,963,35
2020-05-21T00:00:00Z,21,5,2020,66,0,Kenya,KE,KEN,51393010,Africa,50,1029,36
2020-05-22T00:00:00Z,22,5,2020,80,0,Kenya,KE,KEN,51393010,Africa,50,1109,37
2020-05-23T00:00:00Z,23,5,2020,52,0,Kenya,KE,KEN,51393010,Africa,50,1161,38
2020-05-24T00:00:00Z,24,5,2020,31,0,Kenya,KE,KEN,51393010,Africa,50,1192,39
2020-05-25T00:00:00Z,25,5,2020,22,1,Kenya,KE,KEN,51393010,Africa,51,1214,40
2020-05-26T00:00:00Z,26,5,2020,72,1,Kenya,KE,KEN,51393010,Africa,52,1286,41
2020-05-27T00:00:00Z,27,5,2020,62,0,Kenya,KE,KEN,51393010,Africa,52,1348,42
2020-04-17T00:00:00Z,17,4,2020,26,2,Kosovo,XK,XKX,1845300,Europe,11,449,1
2020-04-18T00:00:00Z,18,4,2020,31,1,Kosovo,XK,XKX,1845300,Europe,12,480,2
2020-04-19T00:00:00Z,19,4,2020,30,0,Kosovo,XK,XKX,1845300,Europe,12,510,3
2020-04-20T00:00:00Z,20,4,2020,0,0,Kosovo,XK,XKX,1845300,Europe,12,510,4
2020-04-21T00:00:00Z,21,4,2020,88,3,Kosovo,XK,XKX,1845300,Europe,15,598,5
2020-04-22T00:00:00Z,22,4,2020,6,3,Kosovo,XK,XKX,1845300,Europe,18,604,6
2020-04-23T00:00:00Z,23,4,2020,26,0,Kosovo,XK,XKX,1845300,Europe,18,630,7
2020-04-24T00:00:00Z,24,4,2020,39,1,Kosovo,XK,XKX,1845300,Europe,19,669,8
2020-04-25T00:00:00Z,25,4,2020,34,0,Kosovo,XK,XKX,1845300,Europe,19,703,9
2020-04-26T00:00:00Z,26,4,2020,28,1,Kosovo,XK,XKX,1845300,Europe,20,731,10
2020-04-27T00:00:00Z,27,4,2020,32,1,Kosovo,XK,XKX,1845300,Europe,21,763,11
2020-04-28T00:00:00Z,28,4,2020,17,1,Kosovo,XK,XKX,1845300,Europe,22,780,12
2020-04-29T00:00:00Z,29,4,2020,10,0,Kosovo,XK,XKX,1845300,Europe,22,790,13
2020-04-30T00:00:00Z,30,4,2020,9,0,Kosovo,XK,XKX,1845300,Europe,22,799,14
2020-05-01T00:00:00Z,1,5,2020,0,0,Kosovo,XK,XKX,1845300,Europe,22,799,15
2020-05-02T00:00:00Z,2,5,2020,14,0,Kosovo,XK,XKX,1845300,Europe,22,813,16
2020-05-03T00:00:00Z,3,5,2020,10,0,Kosovo,XK,XKX,1845300,Europe,22,823,17
2020-05-04T00:00:00Z,4,5,2020,28,0,Kosovo,XK,XKX,1845300,Europe,22,851,18
2020-05-05T00:00:00Z,5,5,2020,4,4,Kosovo,XK,XKX,1845300,Europe,26,855,19
2020-05-06T00:00:00Z,6,5,2020,1,0,Kosovo,XK,XKX,1845300,Europe,26,856,20
2020-05-07T00:00:00Z,7,5,2020,4,0,Kosovo,XK,XKX,1845300,Europe,26,860,21
2020-05-08T00:00:00Z,8,5,2020,1,1,Kosovo,XK,XKX,1845300,Europe,27,861,22
2020-05-09T00:00:00Z,9,5,2020,1,1,Kosovo,XK,XKX,1845300,Europe,28,862,23
2020-05-10T00:00:00Z,10,5,2020,8,0,Kosovo,XK,XKX,1845300,Europe,28,870,24
2020-05-11T00:00:00Z,11,5,2020,0,0,Kosovo,XK,XKX,1845300,Europe,28,870,25
2020-05-12T00:00:00Z,12,5,2020,14,0,Kosovo,XK,XKX,1845300,Europe,28,884,26
2020-05-13T00:00:00Z,13,5,2020,35,1,Kosovo,XK,XKX,1845300,Europe,29,919,27
2020-05-14T00:00:00Z,14,5,2020,0,0,Kosovo,XK,XKX,1845300,Europe,29,919,28
2020-05-15T00:00:00Z,15,5,2020,25,0,Kosovo,XK,XKX,1845300,Europe,29,944,29
2020-05-16T00:00:00Z,16,5,2020,0,0,Kosovo,XK,XKX,1845300,Europe,29,944,30
2020-05-17T00:00:00Z,17,5,2020,0,0,Kosovo,XK,XKX,1845300,Europe,29,944,31
2020-05-18T00:00:00Z,18,5,2020,11,0,Kosovo,XK,XKX,1845300,Europe,29,955,32
2020-05-19T00:00:00Z,19,5,2020,0,0,Kosovo,XK,XKX,1845300,Europe,29,955,33
2020-05-20T00:00:00Z,20,5,2020,34,0,Kosovo,XK,XKX,1845300,Europe,29,989,34
2020-05-21T00:00:00Z,21,5,2020,0,0,Kosovo,XK,XKX,1845300,Europe,29,989,35
2020-05-22T00:00:00Z,22,5,2020,14,0,Kosovo,XK,XKX,1845300,Europe,29,1003,36
2020-05-23T00:00:00Z,23,5,2020,1,0,Kosovo,XK,XKX,1845300,Europe,29,1004,37
2020-05-24T00:00:00Z,24,5,2020,21,0,Kosovo,XK,XKX,1845300,Europe,29,1025,38
2020-05-25T00:00:00Z,25,5,2020,7,0,Kosovo,XK,XKX,1845300,Europe,29,1032,39
2020-05-26T00:00:00Z,26,5,2020,6,1,Kosovo,XK,XKX,1845300,Europe,30,1038,40
2020-05-27T00:00:00Z,27,5,2020,0,0,Kosovo,XK,XKX,1845300,Europe,30,1038,41
2020-04-22T00:00:00Z,22,4,2020,85,2,Kuwait,KW,KWT,4137309,Asia,11,2080,1
2020-04-23T00:00:00Z,23,4,2020,168,2,Kuwait,KW,KWT,4137309,Asia,13,2248,2
2020-04-24T00:00:00Z,24,4,2020,151,1,Kuwait,KW,KWT,4137309,Asia,14,2399,3
2020-04-25T00:00:00Z,25,4,2020,215,1,Kuwait,KW,KWT,4137309,Asia,15,2614,4
2020-04-26T00:00:00Z,26,4,2020,278,4,Kuwait,KW,KWT,4137309,Asia,19,2892,5
2020-04-27T00:00:00Z,27,4,2020,183,1,Kuwait,KW,KWT,4137309,Asia,20,3075,6
2020-04-28T00:00:00Z,28,4,2020,213,2,Kuwait,KW,KWT,4137309,Asia,22,3288,7
2020-04-29T00:00:00Z,29,4,2020,152,1,Kuwait,KW,KWT,4137309,Asia,23,3440,8
2020-04-30T00:00:00Z,30,4,2020,300,1,Kuwait,KW,KWT,4137309,Asia,24,3740,9
2020-05-01T00:00:00Z,1,5,2020,284,2,Kuwait,KW,KWT,4137309,Asia,26,4024,10
2020-05-02T00:00:00Z,2,5,2020,353,4,Kuwait,KW,KWT,4137309,Asia,30,4377,11
2020-05-03T00:00:00Z,3,5,2020,242,3,Kuwait,KW,KWT,4137309,Asia,33,4619,12
2020-05-04T00:00:00Z,4,5,2020,364,5,Kuwait,KW,KWT,4137309,Asia,38,4983,13
2020-05-05T00:00:00Z,5,5,2020,295,2,Kuwait,KW,KWT,4137309,Asia,40,5278,14
2020-05-06T00:00:00Z,6,5,2020,526,0,Kuwait,KW,KWT,4137309,Asia,40,5804,15
2020-05-07T00:00:00Z,7,5,2020,485,2,Kuwait,KW,KWT,4137309,Asia,42,6289,16
2020-05-08T00:00:00Z,8,5,2020,278,2,Kuwait,KW,KWT,4137309,Asia,44,6567,17
2020-05-09T00:00:00Z,9,5,2020,641,3,Kuwait,KW,KWT,4137309,Asia,47,7208,18
2020-05-10T00:00:00Z,10,5,2020,415,2,Kuwait,KW,KWT,4137309,Asia,49,7623,19
2020-05-11T00:00:00Z,11,5,2020,1065,9,Kuwait,KW,KWT,4137309,Asia,58,8688,20
2020-05-12T00:00:00Z,12,5,2020,598,7,Kuwait,KW,KWT,4137309,Asia,65,9286,21
2020-05-13T00:00:00Z,13,5,2020,991,10,Kuwait,KW,KWT,4137309,Asia,75,10277,22
2020-05-14T00:00:00Z,14,5,2020,751,7,Kuwait,KW,KWT,4137309,Asia,82,11028,23
2020-05-15T00:00:00Z,15,5,2020,947,6,Kuwait,KW,KWT,4137309,Asia,88,11975,24
2020-05-16T00:00:00Z,16,5,2020,885,8,Kuwait,KW,KWT,4137309,Asia,96,12860,25
2020-05-17T00:00:00Z,17,5,2020,942,11,Kuwait,KW,KWT,4137309,Asia,107,13802,26
2020-05-18T00:00:00Z,18,5,2020,1048,5,Kuwait,KW,KWT,4137309,Asia,112,14850,27
2020-05-19T00:00:00Z,19,5,2020,841,6,Kuwait,KW,KWT,4137309,Asia,118,15691,28
2020-05-20T00:00:00Z,20,5,2020,1073,3,Kuwait,KW,KWT,4137309,Asia,121,16764,29
2020-05-21T00:00:00Z,21,5,2020,804,3,Kuwait,KW,KWT,4137309,Asia,124,17568,30
2020-05-22T00:00:00Z,22,5,2020,1041,5,Kuwait,KW,KWT,4137309,Asia,129,18609,31
2020-05-23T00:00:00Z,23,5,2020,955,9,Kuwait,KW,KWT,4137309,Asia,138,19564,32
2020-05-24T00:00:00Z,24,5,2020,900,10,Kuwait,KW,KWT,4137309,Asia,148,20464,33
2020-05-25T00:00:00Z,25,5,2020,838,8,Kuwait,KW,KWT,4137309,Asia,156,21302,34
2020-05-26T00:00:00Z,26,5,2020,665,9,Kuwait,KW,KWT,4137309,Asia,165,21967,35
2020-05-27T00:00:00Z,27,5,2020,608,7,Kuwait,KW,KWT,4137309,Asia,172,22575,36
2020-05-03T00:00:00Z,3,5,2020,26,2,Kyrgyzstan,KG,KGZ,6315800,Asia,10,795,1
2020-05-04T00:00:00Z,4,5,2020,35,0,Kyrgyzstan,KG,KGZ,6315800,Asia,10,830,2
2020-05-05T00:00:00Z,5,5,2020,13,1,Kyrgyzstan,KG,KGZ,6315800,Asia,11,843,3
2020-05-06T00:00:00Z,6,5,2020,28,1,Kyrgyzstan,KG,KGZ,6315800,Asia,12,871,4
2020-05-07T00:00:00Z,7,5,2020,24,0,Kyrgyzstan,KG,KGZ,6315800,Asia,12,895,5
2020-05-08T00:00:00Z,8,5,2020,11,0,Kyrgyzstan,KG,KGZ,6315800,Asia,12,906,6
2020-05-09T00:00:00Z,9,5,2020,25,0,Kyrgyzstan,KG,KGZ,6315800,Asia,12,931,7
2020-05-10T00:00:00Z,10,5,2020,71,0,Kyrgyzstan,KG,KGZ,6315800,Asia,12,1002,8
2020-05-11T00:00:00Z,11,5,2020,14,0,Kyrgyzstan,KG,KGZ,6315800,Asia,12,1016,9
2020-05-12T00:00:00Z,12,5,2020,21,0,Kyrgyzstan,KG,KGZ,6315800,Asia,12,1037,10
2020-05-13T00:00:00Z,13,5,2020,7,0,Kyrgyzstan,KG,KGZ,6315800,Asia,12,1044,11
2020-05-14T00:00:00Z,14,5,2020,38,0,Kyrgyzstan,KG,KGZ,6315800,Asia,12,1082,12
2020-05-15T00:00:00Z,15,5,2020,29,2,Kyrgyzstan,KG,KGZ,6315800,Asia,14,1111,13
2020-05-16T00:00:00Z,16,5,2020,6,0,Kyrgyzstan,KG,KGZ,6315800,Asia,14,1117,14
2020-05-17T00:00:00Z,17,5,2020,21,0,Kyrgyzstan,KG,KGZ,6315800,Asia,14,1138,15
2020-05-18T00:00:00Z,18,5,2020,78,0,Kyrgyzstan,KG,KGZ,6315800,Asia,14,1216,16
2020-05-19T00:00:00Z,19,5,2020,27,0,Kyrgyzstan,KG,KGZ,6315800,Asia,14,1243,17
2020-05-20T00:00:00Z,20,5,2020,27,0,Kyrgyzstan,KG,KGZ,6315800,Asia,14,1270,18
2020-05-21T00:00:00Z,21,5,2020,43,0,Kyrgyzstan,KG,KGZ,6315800,Asia,14,1313,19
2020-05-22T00:00:00Z,22,5,2020,37,0,Kyrgyzstan,KG,KGZ,6315800,Asia,14,1350,20
2020-05-23T00:00:00Z,23,5,2020,14,0,Kyrgyzstan,KG,KGZ,6315800,Asia,14,1364,21
2020-05-24T00:00:00Z,24,5,2020,39,0,Kyrgyzstan,KG,KGZ,6315800,Asia,14,1403,22
2020-05-25T00:00:00Z,25,5,2020,30,2,Kyrgyzstan,KG,KGZ,6315800,Asia,16,1433,23
2020-05-26T00:00:00Z,26,5,2020,35,0,Kyrgyzstan,KG,KGZ,6315800,Asia,16,1468,24
2020-05-27T00:00:00Z,27,5,2020,52,0,Kyrgyzstan,KG,KGZ,6315800,Asia,16,1520,25
2020-04-23T00:00:00Z,23,4,2020,13,2,Latvia,LV,LVA,1926542,Europe,11,761,1
2020-04-24T00:00:00Z,24,4,2020,17,0,Latvia,LV,LVA,1926542,Europe,11,778,2
2020-04-25T00:00:00Z,25,4,2020,6,1,Latvia,LV,LVA,1926542,Europe,12,784,3
2020-04-26T00:00:00Z,26,4,2020,20,0,Latvia,LV,LVA,1926542,Europe,12,804,4
2020-04-27T00:00:00Z,27,4,2020,8,0,Latvia,LV,LVA,1926542,Europe,12,812,5
2020-04-28T00:00:00Z,28,4,2020,6,1,Latvia,LV,LVA,1926542,Europe,13,818,6
2020-04-29T00:00:00Z,29,4,2020,18,0,Latvia,LV,LVA,1926542,Europe,13,836,7
2020-04-30T00:00:00Z,30,4,2020,13,2,Latvia,LV,LVA,1926542,Europe,15,849,8
2020-05-01T00:00:00Z,1,5,2020,9,0,Latvia,LV,LVA,1926542,Europe,15,858,9
2020-05-02T00:00:00Z,2,5,2020,12,1,Latvia,LV,LVA,1926542,Europe,16,870,10
2020-05-03T00:00:00Z,3,5,2020,1,0,Latvia,LV,LVA,1926542,Europe,16,871,11
2020-05-04T00:00:00Z,4,5,2020,8,0,Latvia,LV,LVA,1926542,Europe,16,879,12
2020-05-05T00:00:00Z,5,5,2020,17,0,Latvia,LV,LVA,1926542,Europe,16,896,13
2020-05-06T00:00:00Z,6,5,2020,0,1,Latvia,LV,LVA,1926542,Europe,17,896,14
2020-05-07T00:00:00Z,7,5,2020,4,0,Latvia,LV,LVA,1926542,Europe,17,900,15
2020-05-08T00:00:00Z,8,5,2020,9,1,Latvia,LV,LVA,1926542,Europe,18,909,16
2020-05-09T00:00:00Z,9,5,2020,19,0,Latvia,LV,LVA,1926542,Europe,18,928,17
2020-05-10T00:00:00Z,10,5,2020,2,0,Latvia,LV,LVA,1926542,Europe,18,930,18
2020-05-11T00:00:00Z,11,5,2020,9,0,Latvia,LV,LVA,1926542,Europe,18,939,19
2020-05-12T00:00:00Z,12,5,2020,7,0,Latvia,LV,LVA,1926542,Europe,18,946,20
2020-05-13T00:00:00Z,13,5,2020,4,0,Latvia,LV,LVA,1926542,Europe,18,950,21
2020-05-14T00:00:00Z,14,5,2020,1,1,Latvia,LV,LVA,1926542,Europe,19,951,22
2020-05-15T00:00:00Z,15,5,2020,11,0,Latvia,LV,LVA,1926542,Europe,19,962,23
2020-05-16T00:00:00Z,16,5,2020,8,0,Latvia,LV,LVA,1926542,Europe,19,970,24
2020-05-17T00:00:00Z,17,5,2020,27,0,Latvia,LV,LVA,1926542,Europe,19,997,25
2020-05-18T00:00:00Z,18,5,2020,11,0,Latvia,LV,LVA,1926542,Europe,19,1008,26
2020-05-19T00:00:00Z,19,5,2020,1,0,Latvia,LV,LVA,1926542,Europe,19,1009,27
2020-05-20T00:00:00Z,20,5,2020,3,2,Latvia,LV,LVA,1926542,Europe,21,1012,28
2020-05-21T00:00:00Z,21,5,2020,4,0,Latvia,LV,LVA,1926542,Europe,21,1016,29
2020-05-22T00:00:00Z,22,5,2020,9,1,Latvia,LV,LVA,1926542,Europe,22,1025,30
2020-05-23T00:00:00Z,23,5,2020,5,0,Latvia,LV,LVA,1926542,Europe,22,1030,31
2020-05-24T00:00:00Z,24,5,2020,16,0,Latvia,LV,LVA,1926542,Europe,22,1046,32
2020-05-25T00:00:00Z,25,5,2020,1,0,Latvia,LV,LVA,1926542,Europe,22,1047,33
2020-05-26T00:00:00Z,26,5,2020,2,0,Latvia,LV,LVA,1926542,Europe,22,1049,34
2020-05-27T00:00:00Z,27,5,2020,4,0,Latvia,LV,LVA,1926542,Europe,22,1053,35
2020-03-30T00:00:00Z,30,3,2020,26,2,Lebanon,LB,LBN,6848925,Asia,10,438,1
2020-03-31T00:00:00Z,31,3,2020,8,1,Lebanon,LB,LBN,6848925,Asia,11,446,2
2020-04-01T00:00:00Z,1,4,2020,17,1,Lebanon,LB,LBN,6848925,Asia,12,463,3
2020-04-02T00:00:00Z,2,4,2020,16,0,Lebanon,LB,LBN,6848925,Asia,12,479,4
2020-04-03T00:00:00Z,3,4,2020,15,4,Lebanon,LB,LBN,6848925,Asia,16,494,5
2020-04-04T00:00:00Z,4,4,2020,0,0,Lebanon,LB,LBN,6848925,Asia,16,494,6
2020-04-05T00:00:00Z,5,4,2020,26,1,Lebanon,LB,LBN,6848925,Asia,17,520,7
2020-04-06T00:00:00Z,6,4,2020,7,1,Lebanon,LB,LBN,6848925,Asia,18,527,8
2020-04-07T00:00:00Z,7,4,2020,14,1,Lebanon,LB,LBN,6848925,Asia,19,541,9
2020-04-08T00:00:00Z,8,4,2020,7,0,Lebanon,LB,LBN,6848925,Asia,19,548,10
2020-04-09T00:00:00Z,9,4,2020,27,0,Lebanon,LB,LBN,6848925,Asia,19,575,11
2020-04-10T00:00:00Z,10,4,2020,7,0,Lebanon,LB,LBN,6848925,Asia,19,582,12
2020-04-11T00:00:00Z,11,4,2020,27,1,Lebanon,LB,LBN,6848925,Asia,20,609,13
2020-04-12T00:00:00Z,12,4,2020,10,0,Lebanon,LB,LBN,6848925,Asia,20,619,14
2020-04-13T00:00:00Z,13,4,2020,11,0,Lebanon,LB,LBN,6848925,Asia,20,630,15
2020-04-14T00:00:00Z,14,4,2020,2,0,Lebanon,LB,LBN,6848925,Asia,20,632,16
2020-04-15T00:00:00Z,15,4,2020,9,1,Lebanon,LB,LBN,6848925,Asia,21,641,17
2020-04-16T00:00:00Z,16,4,2020,17,0,Lebanon,LB,LBN,6848925,Asia,21,658,18
2020-04-17T00:00:00Z,17,4,2020,5,0,Lebanon,LB,LBN,6848925,Asia,21,663,19
2020-04-18T00:00:00Z,18,4,2020,5,0,Lebanon,LB,LBN,6848925,Asia,21,668,20
2020-04-19T00:00:00Z,19,4,2020,4,0,Lebanon,LB,LBN,6848925,Asia,21,672,21
2020-04-20T00:00:00Z,20,4,2020,1,0,Lebanon,LB,LBN,6848925,Asia,21,673,22
2020-04-21T00:00:00Z,21,4,2020,4,0,Lebanon,LB,LBN,6848925,Asia,21,677,23
2020-04-22T00:00:00Z,22,4,2020,0,0,Lebanon,LB,LBN,6848925,Asia,21,677,24
2020-04-23T00:00:00Z,23,4,2020,5,1,Lebanon,LB,LBN,6848925,Asia,22,682,25
2020-04-24T00:00:00Z,24,4,2020,6,0,Lebanon,LB,LBN,6848925,Asia,22,688,26
2020-04-25T00:00:00Z,25,4,2020,8,0,Lebanon,LB,LBN,6848925,Asia,22,696,27
2020-04-26T00:00:00Z,26,4,2020,8,2,Lebanon,LB,LBN,6848925,Asia,24,704,28
2020-04-27T00:00:00Z,27,4,2020,3,0,Lebanon,LB,LBN,6848925,Asia,24,707,29
2020-04-28T00:00:00Z,28,4,2020,3,0,Lebanon,LB,LBN,6848925,Asia,24,710,30
2020-04-29T00:00:00Z,29,4,2020,7,0,Lebanon,LB,LBN,6848925,Asia,24,717,31
2020-04-30T00:00:00Z,30,4,2020,4,0,Lebanon,LB,LBN,6848925,Asia,24,721,32
2020-05-01T00:00:00Z,1,5,2020,4,0,Lebanon,LB,LBN,6848925,Asia,24,725,33
2020-05-02T00:00:00Z,2,5,2020,4,0,Lebanon,LB,LBN,6848925,Asia,24,729,34
2020-05-03T00:00:00Z,3,5,2020,4,1,Lebanon,LB,LBN,6848925,Asia,25,733,35
2020-05-04T00:00:00Z,4,5,2020,4,0,Lebanon,LB,LBN,6848925,Asia,25,737,36
2020-05-05T00:00:00Z,5,5,2020,3,0,Lebanon,LB,LBN,6848925,Asia,25,740,37
2020-05-06T00:00:00Z,6,5,2020,1,0,Lebanon,LB,LBN,6848925,Asia,25,741,38
2020-05-07T00:00:00Z,7,5,2020,9,0,Lebanon,LB,LBN,6848925,Asia,25,750,39
2020-05-08T00:00:00Z,8,5,2020,34,0,Lebanon,LB,LBN,6848925,Asia,25,784,40
2020-05-09T00:00:00Z,9,5,2020,12,1,Lebanon,LB,LBN,6848925,Asia,26,796,41
2020-05-10T00:00:00Z,10,5,2020,13,0,Lebanon,LB,LBN,6848925,Asia,26,809,42
2020-05-11T00:00:00Z,11,5,2020,36,0,Lebanon,LB,LBN,6848925,Asia,26,845,43
2020-05-12T00:00:00Z,12,5,2020,14,0,Lebanon,LB,LBN,6848925,Asia,26,859,44
2020-05-13T00:00:00Z,13,5,2020,11,0,Lebanon,LB,LBN,6848925,Asia,26,870,45
2020-05-14T00:00:00Z,14,5,2020,8,0,Lebanon,LB,LBN,6848925,Asia,26,878,46
2020-05-15T00:00:00Z,15,5,2020,8,0,Lebanon,LB,LBN,6848925,Asia,26,886,47
2020-05-16T00:00:00Z,16,5,2020,5,0,Lebanon,LB,LBN,6848925,Asia,26,891,48
2020-05-17T00:00:00Z,17,5,2020,11,0,Lebanon,LB,LBN,6848925,Asia,26,902,49
2020-05-18T00:00:00Z,18,5,2020,9,0,Lebanon,LB,LBN,6848925,Asia,26,911,50
2020-05-19T00:00:00Z,19,5,2020,20,0,Lebanon,LB,LBN,6848925,Asia,26,931,51
2020-05-20T00:00:00Z,20,5,2020,23,0,Lebanon,LB,LBN,6848925,Asia,26,954,52
2020-05-21T00:00:00Z,21,5,2020,7,0,Lebanon,LB,LBN,6848925,Asia,26,961,53
2020-05-22T00:00:00Z,22,5,2020,63,0,Lebanon,LB,LBN,6848925,Asia,26,1024,54
2020-05-23T00:00:00Z,23,5,2020,62,0,Lebanon,LB,LBN,6848925,Asia,26,1086,55
2020-05-24T00:00:00Z,24,5,2020,11,0,Lebanon,LB,LBN,6848925,Asia,26,1097,56
2020-05-25T00:00:00Z,25,5,2020,17,0,Lebanon,LB,LBN,6848925,Asia,26,1114,57
2020-05-26T00:00:00Z,26,5,2020,5,0,Lebanon,LB,LBN,6848925,Asia,26,1119,58
2020-05-27T00:00:00Z,27,5,2020,21,0,Lebanon,LB,LBN,6848925,Asia,26,1140,59
2020-04-26T00:00:00Z,26,4,2020,3,3,Liberia,LR,LBR,4818977,Africa,11,120,1
2020-04-27T00:00:00Z,27,4,2020,4,1,Liberia,LR,LBR,4818977,Africa,12,124,2
2020-04-28T00:00:00Z,28,4,2020,9,4,Liberia,LR,LBR,4818977,Africa,16,133,3
2020-04-29T00:00:00Z,29,4,2020,8,0,Liberia,LR,LBR,4818977,Africa,16,141,4
2020-04-30T00:00:00Z,30,4,2020,0,0,Liberia,LR,LBR,4818977,Africa,16,141,5
2020-05-01T00:00:00Z,1,5,2020,0,0,Liberia,LR,LBR,4818977,Africa,16,141,6
2020-05-02T00:00:00Z,2,5,2020,11,2,Liberia,LR,LBR,4818977,Africa,18,152,7
2020-05-03T00:00:00Z,3,5,2020,2,0,Liberia,LR,LBR,4818977,Africa,18,154,8
2020-05-04T00:00:00Z,4,5,2020,4,0,Liberia,LR,LBR,4818977,Africa,18,158,9
2020-05-05T00:00:00Z,5,5,2020,8,0,Liberia,LR,LBR,4818977,Africa,18,166,10
2020-05-06T00:00:00Z,6,5,2020,4,2,Liberia,LR,LBR,4818977,Africa,20,170,11
2020-05-07T00:00:00Z,7,5,2020,8,0,Liberia,LR,LBR,4818977,Africa,20,178,12
2020-05-08T00:00:00Z,8,5,2020,11,0,Liberia,LR,LBR,4818977,Africa,20,189,13
2020-05-09T00:00:00Z,9,5,2020,10,0,Liberia,LR,LBR,4818977,Africa,20,199,14
2020-05-10T00:00:00Z,10,5,2020,0,0,Liberia,LR,LBR,4818977,Africa,20,199,15
2020-05-11T00:00:00Z,11,5,2020,0,0,Liberia,LR,LBR,4818977,Africa,20,199,16
2020-05-12T00:00:00Z,12,5,2020,12,0,Liberia,LR,LBR,4818977,Africa,20,211,17
2020-05-13T00:00:00Z,13,5,2020,1,0,Liberia,LR,LBR,4818977,Africa,20,212,18
2020-05-14T00:00:00Z,14,5,2020,1,0,Liberia,LR,LBR,4818977,Africa,20,213,19
2020-05-15T00:00:00Z,15,5,2020,2,0,Liberia,LR,LBR,4818977,Africa,20,215,20
2020-05-16T00:00:00Z,16,5,2020,4,0,Liberia,LR,LBR,4818977,Africa,20,219,21
2020-05-17T00:00:00Z,17,5,2020,4,0,Liberia,LR,LBR,4818977,Africa,20,223,22
2020-05-18T00:00:00Z,18,5,2020,3,1,Liberia,LR,LBR,4818977,Africa,21,226,23
2020-05-19T00:00:00Z,19,5,2020,3,1,Liberia,LR,LBR,4818977,Africa,22,229,24
2020-05-20T00:00:00Z,20,5,2020,4,1,Liberia,LR,LBR,4818977,Africa,23,233,25
2020-05-21T00:00:00Z,21,5,2020,5,0,Liberia,LR,LBR,4818977,Africa,23,238,26
2020-05-22T00:00:00Z,22,5,2020,2,0,Liberia,LR,LBR,4818977,Africa,23,240,27
2020-05-23T00:00:00Z,23,5,2020,9,1,Liberia,LR,LBR,4818977,Africa,24,249,28
2020-05-24T00:00:00Z,24,5,2020,6,2,Liberia,LR,LBR,4818977,Africa,26,255,29
2020-05-25T00:00:00Z,25,5,2020,10,0,Liberia,LR,LBR,4818977,Africa,26,265,30
2020-05-26T00:00:00Z,26,5,2020,0,0,Liberia,LR,LBR,4818977,Africa,26,265,31
2020-05-27T00:00:00Z,27,5,2020,1,0,Liberia,LR,LBR,4818977,Africa,26,266,32
2020-04-06T00:00:00Z,6,4,2020,40,4,Lithuania,LT,LTU,2789533,Europe,13,811,1
2020-04-07T00:00:00Z,7,4,2020,32,1,Lithuania,LT,LTU,2789533,Europe,14,843,2
2020-04-08T00:00:00Z,8,4,2020,37,1,Lithuania,LT,LTU,2789533,Europe,15,880,3
2020-04-09T00:00:00Z,9,4,2020,32,0,Lithuania,LT,LTU,2789533,Europe,15,912,4
2020-04-10T00:00:00Z,10,4,2020,43,0,Lithuania,LT,LTU,2789533,Europe,15,955,5
2020-04-11T00:00:00Z,11,4,2020,44,2,Lithuania,LT,LTU,2789533,Europe,17,999,6
2020-04-12T00:00:00Z,12,4,2020,54,6,Lithuania,LT,LTU,2789533,Europe,23,1053,7
2020-04-13T00:00:00Z,13,4,2020,9,1,Lithuania,LT,LTU,2789533,Europe,24,1062,8
2020-04-14T00:00:00Z,14,4,2020,8,0,Lithuania,LT,LTU,2789533,Europe,24,1070,9
2020-04-15T00:00:00Z,15,4,2020,0,0,Lithuania,LT,LTU,2789533,Europe,24,1070,10
2020-04-16T00:00:00Z,16,4,2020,21,5,Lithuania,LT,LTU,2789533,Europe,29,1091,11
2020-04-17T00:00:00Z,17,4,2020,58,3,Lithuania,LT,LTU,2789533,Europe,32,1149,12
2020-04-18T00:00:00Z,18,4,2020,90,1,Lithuania,LT,LTU,2789533,Europe,33,1239,13
2020-04-19T00:00:00Z,19,4,2020,59,0,Lithuania,LT,LTU,2789533,Europe,33,1298,14
2020-04-20T00:00:00Z,20,4,2020,28,3,Lithuania,LT,LTU,2789533,Europe,36,1326,15
2020-04-21T00:00:00Z,21,4,2020,24,1,Lithuania,LT,LTU,2789533,Europe,37,1350,16
2020-04-22T00:00:00Z,22,4,2020,20,1,Lithuania,LT,LTU,2789533,Europe,38,1370,17
2020-04-23T00:00:00Z,23,4,2020,28,0,Lithuania,LT,LTU,2789533,Europe,38,1398,18
2020-04-24T00:00:00Z,24,4,2020,12,2,Lithuania,LT,LTU,2789533,Europe,40,1410,19
2020-04-25T00:00:00Z,25,4,2020,0,0,Lithuania,LT,LTU,2789533,Europe,40,1410,20
2020-04-26T00:00:00Z,26,4,2020,16,1,Lithuania,LT,LTU,2789533,Europe,41,1426,21
2020-04-27T00:00:00Z,27,4,2020,12,0,Lithuania,LT,LTU,2789533,Europe,41,1438,22
2020-04-28T00:00:00Z,28,4,2020,11,0,Lithuania,LT,LTU,2789533,Europe,41,1449,23
2020-04-29T00:00:00Z,29,4,2020,-105,3,Lithuania,LT,LTU,2789533,Europe,44,1344,24
2020-04-30T00:00:00Z,30,4,2020,31,1,Lithuania,LT,LTU,2789533,Europe,45,1375,25
2020-05-01T00:00:00Z,1,5,2020,10,0,Lithuania,LT,LTU,2789533,Europe,45,1385,26
2020-05-02T00:00:00Z,2,5,2020,14,0,Lithuania,LT,LTU,2789533,Europe,45,1399,27
2020-05-03T00:00:00Z,3,5,2020,7,1,Lithuania,LT,LTU,2789533,Europe,46,1406,28
2020-05-04T00:00:00Z,4,5,2020,4,0,Lithuania,LT,LTU,2789533,Europe,46,1410,29
2020-05-05T00:00:00Z,5,5,2020,9,0,Lithuania,LT,LTU,2789533,Europe,46,1419,30
2020-05-06T00:00:00Z,6,5,2020,4,0,Lithuania,LT,LTU,2789533,Europe,46,1423,31
2020-05-07T00:00:00Z,7,5,2020,5,2,Lithuania,LT,LTU,2789533,Europe,48,1428,32
2020-05-08T00:00:00Z,8,5,2020,5,1,Lithuania,LT,LTU,2789533,Europe,49,1433,33
2020-05-09T00:00:00Z,9,5,2020,3,0,Lithuania,LT,LTU,2789533,Europe,49,1436,34
2020-05-10T00:00:00Z,10,5,2020,8,1,Lithuania,LT,LTU,2789533,Europe,50,1444,35
2020-05-11T00:00:00Z,11,5,2020,35,0,Lithuania,LT,LTU,2789533,Europe,50,1479,36
2020-05-12T00:00:00Z,12,5,2020,6,0,Lithuania,LT,LTU,2789533,Europe,50,1485,37
2020-05-13T00:00:00Z,13,5,2020,6,0,Lithuania,LT,LTU,2789533,Europe,50,1491,38
2020-05-14T00:00:00Z,14,5,2020,14,4,Lithuania,LT,LTU,2789533,Europe,54,1505,39
2020-05-15T00:00:00Z,15,5,2020,6,0,Lithuania,LT,LTU,2789533,Europe,54,1511,40
2020-05-16T00:00:00Z,16,5,2020,12,0,Lithuania,LT,LTU,2789533,Europe,54,1523,41
2020-05-17T00:00:00Z,17,5,2020,11,1,Lithuania,LT,LTU,2789533,Europe,55,1534,42
2020-05-18T00:00:00Z,18,5,2020,7,1,Lithuania,LT,LTU,2789533,Europe,56,1541,43
2020-05-19T00:00:00Z,19,5,2020,6,3,Lithuania,LT,LTU,2789533,Europe,59,1547,44
2020-05-20T00:00:00Z,20,5,2020,15,1,Lithuania,LT,LTU,2789533,Europe,60,1562,45
2020-05-21T00:00:00Z,21,5,2020,15,0,Lithuania,LT,LTU,2789533,Europe,60,1577,46
2020-05-22T00:00:00Z,22,5,2020,17,1,Lithuania,LT,LTU,2789533,Europe,61,1594,47
2020-05-23T00:00:00Z,23,5,2020,10,0,Lithuania,LT,LTU,2789533,Europe,61,1604,48
2020-05-24T00:00:00Z,24,5,2020,12,2,Lithuania,LT,LTU,2789533,Europe,63,1616,49
2020-05-25T00:00:00Z,25,5,2020,7,0,Lithuania,LT,LTU,2789533,Europe,63,1623,50
2020-05-26T00:00:00Z,26,5,2020,12,0,Lithuania,LT,LTU,2789533,Europe,63,1635,51
2020-05-27T00:00:00Z,27,5,2020,4,2,Lithuania,LT,LTU,2789533,Europe,65,1639,52
2020-03-28T00:00:00Z,28,3,2020,152,6,Luxembourg,LU,LUX,607728,Europe,15,1605,1
2020-03-29T00:00:00Z,29,3,2020,226,3,Luxembourg,LU,LUX,607728,Europe,18,1831,2
2020-03-30T00:00:00Z,30,3,2020,119,3,Luxembourg,LU,LUX,607728,Europe,21,1950,3
2020-03-31T00:00:00Z,31,3,2020,38,1,Luxembourg,LU,LUX,607728,Europe,22,1988,4
2020-04-01T00:00:00Z,1,4,2020,190,1,Luxembourg,LU,LUX,607728,Europe,23,2178,5
2020-04-02T00:00:00Z,2,4,2020,141,6,Luxembourg,LU,LUX,607728,Europe,29,2319,6
2020-04-03T00:00:00Z,3,4,2020,168,1,Luxembourg,LU,LUX,607728,Europe,30,2487,7
2020-04-04T00:00:00Z,4,4,2020,125,1,Luxembourg,LU,LUX,607728,Europe,31,2612,8
2020-04-05T00:00:00Z,5,4,2020,117,0,Luxembourg,LU,LUX,607728,Europe,31,2729,9
2020-04-06T00:00:00Z,6,4,2020,75,5,Luxembourg,LU,LUX,607728,Europe,36,2804,10
2020-04-07T00:00:00Z,7,4,2020,39,5,Luxembourg,LU,LUX,607728,Europe,41,2843,11
2020-04-08T00:00:00Z,8,4,2020,127,3,Luxembourg,LU,LUX,607728,Europe,44,2970,12
2020-04-09T00:00:00Z,9,4,2020,64,2,Luxembourg,LU,LUX,607728,Europe,46,3034,13
2020-04-10T00:00:00Z,10,4,2020,81,6,Luxembourg,LU,LUX,607728,Europe,52,3115,14
2020-04-11T00:00:00Z,11,4,2020,108,2,Luxembourg,LU,LUX,607728,Europe,54,3223,15
2020-04-12T00:00:00Z,12,4,2020,47,8,Luxembourg,LU,LUX,607728,Europe,62,3270,16
2020-04-13T00:00:00Z,13,4,2020,11,4,Luxembourg,LU,LUX,607728,Europe,66,3281,17
2020-04-14T00:00:00Z,14,4,2020,11,1,Luxembourg,LU,LUX,607728,Europe,67,3292,18
2020-04-15T00:00:00Z,15,4,2020,15,0,Luxembourg,LU,LUX,607728,Europe,67,3307,19
2020-04-16T00:00:00Z,16,4,2020,66,2,Luxembourg,LU,LUX,607728,Europe,69,3373,20
2020-04-17T00:00:00Z,17,4,2020,71,0,Luxembourg,LU,LUX,607728,Europe,69,3444,21
2020-04-18T00:00:00Z,18,4,2020,36,3,Luxembourg,LU,LUX,607728,Europe,72,3480,22
2020-04-19T00:00:00Z,19,4,2020,57,0,Luxembourg,LU,LUX,607728,Europe,72,3537,23
2020-04-20T00:00:00Z,20,4,2020,13,1,Luxembourg,LU,LUX,607728,Europe,73,3550,24
2020-04-21T00:00:00Z,21,4,2020,8,2,Luxembourg,LU,LUX,607728,Europe,75,3558,25
2020-04-22T00:00:00Z,22,4,2020,60,3,Luxembourg,LU,LUX,607728,Europe,78,3618,26
2020-04-23T00:00:00Z,23,4,2020,36,2,Luxembourg,LU,LUX,607728,Europe,80,3654,27
2020-04-24T00:00:00Z,24,4,2020,11,3,Luxembourg,LU,LUX,607728,Europe,83,3665,28
2020-04-25T00:00:00Z,25,4,2020,30,2,Luxembourg,LU,LUX,607728,Europe,85,3695,29
2020-04-26T00:00:00Z,26,4,2020,16,0,Luxembourg,LU,LUX,607728,Europe,85,3711,30
2020-04-27T00:00:00Z,27,4,2020,12,3,Luxembourg,LU,LUX,607728,Europe,88,3723,31
2020-04-28T00:00:00Z,28,4,2020,6,0,Luxembourg,LU,LUX,607728,Europe,88,3729,32
2020-04-29T00:00:00Z,29,4,2020,12,1,Luxembourg,LU,LUX,607728,Europe,89,3741,33
2020-04-30T00:00:00Z,30,4,2020,28,0,Luxembourg,LU,LUX,607728,Europe,89,3769,34
2020-05-01T00:00:00Z,1,5,2020,15,1,Luxembourg,LU,LUX,607728,Europe,90,3784,35
2020-05-02T00:00:00Z,2,5,2020,18,2,Luxembourg,LU,LUX,607728,Europe,92,3802,36
2020-05-03T00:00:00Z,3,5,2020,10,0,Luxembourg,LU,LUX,607728,Europe,92,3812,37
2020-05-04T00:00:00Z,4,5,2020,12,4,Luxembourg,LU,LUX,607728,Europe,96,3824,38
2020-05-05T00:00:00Z,5,5,2020,4,0,Luxembourg,LU,LUX,607728,Europe,96,3828,39
2020-05-06T00:00:00Z,6,5,2020,12,0,Luxembourg,LU,LUX,607728,Europe,96,3840,40
2020-05-07T00:00:00Z,7,5,2020,11,2,Luxembourg,LU,LUX,607728,Europe,98,3851,41
2020-05-08T00:00:00Z,8,5,2020,8,2,Luxembourg,LU,LUX,607728,Europe,100,3859,42
2020-05-09T00:00:00Z,9,5,2020,12,0,Luxembourg,LU,LUX,607728,Europe,100,3871,43
2020-05-10T00:00:00Z,10,5,2020,6,1,Luxembourg,LU,LUX,607728,Europe,101,3877,44
2020-05-11T00:00:00Z,11,5,2020,9,0,Luxembourg,LU,LUX,607728,Europe,101,3886,45
2020-05-12T00:00:00Z,12,5,2020,2,0,Luxembourg,LU,LUX,607728,Europe,101,3888,46
2020-05-13T00:00:00Z,13,5,2020,6,1,Luxembourg,LU,LUX,607728,Europe,102,3894,47
2020-05-14T00:00:00Z,14,5,2020,10,1,Luxembourg,LU,LUX,607728,Europe,103,3904,48
2020-05-15T00:00:00Z,15,5,2020,11,0,Luxembourg,LU,LUX,607728,Europe,103,3915,49
2020-05-16T00:00:00Z,16,5,2020,8,1,Luxembourg,LU,LUX,607728,Europe,104,3923,50
2020-05-17T00:00:00Z,17,5,2020,7,0,Luxembourg,LU,LUX,607728,Europe,104,3930,51
2020-05-18T00:00:00Z,18,5,2020,15,3,Luxembourg,LU,LUX,607728,Europe,107,3945,52
2020-05-19T00:00:00Z,19,5,2020,2,0,Luxembourg,LU,LUX,607728,Europe,107,3947,53
2020-05-20T00:00:00Z,20,5,2020,11,2,Luxembourg,LU,LUX,607728,Europe,109,3958,54
2020-05-21T00:00:00Z,21,5,2020,13,0,Luxembourg,LU,LUX,607728,Europe,109,3971,55
2020-05-22T00:00:00Z,22,5,2020,9,0,Luxembourg,LU,LUX,607728,Europe,109,3980,56
2020-05-23T00:00:00Z,23,5,2020,1,0,Luxembourg,LU,LUX,607728,Europe,109,3981,57
2020-05-24T00:00:00Z,24,5,2020,9,0,Luxembourg,LU,LUX,607728,Europe,109,3990,58
2020-05-25T00:00:00Z,25,5,2020,2,1,Luxembourg,LU,LUX,607728,Europe,110,3992,59
2020-05-26T00:00:00Z,26,5,2020,1,0,Luxembourg,LU,LUX,607728,Europe,110,3993,60
2020-05-27T00:00:00Z,27,5,2020,2,0,Luxembourg,LU,LUX,607728,Europe,110,3995,61
2020-03-23T00:00:00Z,23,3,2020,123,6,Malaysia,MY,MYS,31528585,Asia,10,1306,1
2020-03-24T00:00:00Z,24,3,2020,212,4,Malaysia,MY,MYS,31528585,Asia,14,1518,2
2020-03-25T00:00:00Z,25,3,2020,106,1,Malaysia,MY,MYS,31528585,Asia,15,1624,3
2020-03-26T00:00:00Z,26,3,2020,172,4,Malaysia,MY,MYS,31528585,Asia,19,1796,4
2020-03-27T00:00:00Z,27,3,2020,235,4,Malaysia,MY,MYS,31528585,Asia,23,2031,5
2020-03-28T00:00:00Z,28,3,2020,130,3,Malaysia,MY,MYS,31528585,Asia,26,2161,6
2020-03-29T00:00:00Z,29,3,2020,159,1,Malaysia,MY,MYS,31528585,Asia,27,2320,7
2020-03-30T00:00:00Z,30,3,2020,150,7,Malaysia,MY,MYS,31528585,Asia,34,2470,8
2020-03-31T00:00:00Z,31,3,2020,156,3,Malaysia,MY,MYS,31528585,Asia,37,2626,9
2020-04-01T00:00:00Z,1,4,2020,140,6,Malaysia,MY,MYS,31528585,Asia,43,2766,10
2020-04-02T00:00:00Z,2,4,2020,142,2,Malaysia,MY,MYS,31528585,Asia,45,2908,11
2020-04-03T00:00:00Z,3,4,2020,208,5,Malaysia,MY,MYS,31528585,Asia,50,3116,12
2020-04-04T00:00:00Z,4,4,2020,217,3,Malaysia,MY,MYS,31528585,Asia,53,3333,13
2020-04-05T00:00:00Z,5,4,2020,150,4,Malaysia,MY,MYS,31528585,Asia,57,3483,14
2020-04-06T00:00:00Z,6,4,2020,179,4,Malaysia,MY,MYS,31528585,Asia,61,3662,15
2020-04-07T00:00:00Z,7,4,2020,131,1,Malaysia,MY,MYS,31528585,Asia,62,3793,16
2020-04-08T00:00:00Z,8,4,2020,170,1,Malaysia,MY,MYS,31528585,Asia,63,3963,17
2020-04-09T00:00:00Z,9,4,2020,156,2,Malaysia,MY,MYS,31528585,Asia,65,4119,18
2020-04-10T00:00:00Z,10,4,2020,109,2,Malaysia,MY,MYS,31528585,Asia,67,4228,19
2020-04-11T00:00:00Z,11,4,2020,118,3,Malaysia,MY,MYS,31528585,Asia,70,4346,20
2020-04-12T00:00:00Z,12,4,2020,184,3,Malaysia,MY,MYS,31528585,Asia,73,4530,21
2020-04-13T00:00:00Z,13,4,2020,153,3,Malaysia,MY,MYS,31528585,Asia,76,4683,22
2020-04-14T00:00:00Z,14,4,2020,134,1,Malaysia,MY,MYS,31528585,Asia,77,4817,23
2020-04-15T00:00:00Z,15,4,2020,170,5,Malaysia,MY,MYS,31528585,Asia,82,4987,24
2020-04-16T00:00:00Z,16,4,2020,85,1,Malaysia,MY,MYS,31528585,Asia,83,5072,25
2020-04-17T00:00:00Z,17,4,2020,110,1,Malaysia,MY,MYS,31528585,Asia,84,5182,26
2020-04-18T00:00:00Z,18,4,2020,69,2,Malaysia,MY,MYS,31528585,Asia,86,5251,27
2020-04-19T00:00:00Z,19,4,2020,54,2,Malaysia,MY,MYS,31528585,Asia,88,5305,28
2020-04-20T00:00:00Z,20,4,2020,84,1,Malaysia,MY,MYS,31528585,Asia,89,5389,29
2020-04-21T00:00:00Z,21,4,2020,36,0,Malaysia,MY,MYS,31528585,Asia,89,5425,30
2020-04-22T00:00:00Z,22,4,2020,57,3,Malaysia,MY,MYS,31528585,Asia,92,5482,31
2020-04-23T00:00:00Z,23,4,2020,50,1,Malaysia,MY,MYS,31528585,Asia,93,5532,32
2020-04-24T00:00:00Z,24,4,2020,71,2,Malaysia,MY,MYS,31528585,Asia,95,5603,33
2020-04-25T00:00:00Z,25,4,2020,88,1,Malaysia,MY,MYS,31528585,Asia,96,5691,34
2020-04-26T00:00:00Z,26,4,2020,51,2,Malaysia,MY,MYS,31528585,Asia,98,5742,35
2020-04-27T00:00:00Z,27,4,2020,38,0,Malaysia,MY,MYS,31528585,Asia,98,5780,36
2020-04-28T00:00:00Z,28,4,2020,40,1,Malaysia,MY,MYS,31528585,Asia,99,5820,37
2020-04-29T00:00:00Z,29,4,2020,31,1,Malaysia,MY,MYS,31528585,Asia,100,5851,38
2020-04-30T00:00:00Z,30,4,2020,94,0,Malaysia,MY,MYS,31528585,Asia,100,5945,39
2020-05-01T00:00:00Z,1,5,2020,57,2,Malaysia,MY,MYS,31528585,Asia,102,6002,40
2020-05-02T00:00:00Z,2,5,2020,69,1,Malaysia,MY,MYS,31528585,Asia,103,6071,41
2020-05-03T00:00:00Z,3,5,2020,105,0,Malaysia,MY,MYS,31528585,Asia,103,6176,42
2020-05-04T00:00:00Z,4,5,2020,122,2,Malaysia,MY,MYS,31528585,Asia,105,6298,43
2020-05-05T00:00:00Z,5,5,2020,55,0,Malaysia,MY,MYS,31528585,Asia,105,6353,44
2020-05-06T00:00:00Z,6,5,2020,30,1,Malaysia,MY,MYS,31528585,Asia,106,6383,45
2020-05-07T00:00:00Z,7,5,2020,45,1,Malaysia,MY,MYS,31528585,Asia,107,6428,46
2020-05-08T00:00:00Z,8,5,2020,39,0,Malaysia,MY,MYS,31528585,Asia,107,6467,47
2020-05-09T00:00:00Z,9,5,2020,68,0,Malaysia,MY,MYS,31528585,Asia,107,6535,48
2020-05-10T00:00:00Z,10,5,2020,54,1,Malaysia,MY,MYS,31528585,Asia,108,6589,49
2020-05-11T00:00:00Z,11,5,2020,67,0,Malaysia,MY,MYS,31528585,Asia,108,6656,50
2020-05-12T00:00:00Z,12,5,2020,70,1,Malaysia,MY,MYS,31528585,Asia,109,6726,51
2020-05-13T00:00:00Z,13,5,2020,16,0,Malaysia,MY,MYS,31528585,Asia,109,6742,52
2020-05-14T00:00:00Z,14,5,2020,37,2,Malaysia,MY,MYS,31528585,Asia,111,6779,53
2020-05-15T00:00:00Z,15,5,2020,40,1,Malaysia,MY,MYS,31528585,Asia,112,6819,54
2020-05-16T00:00:00Z,16,5,2020,36,0,Malaysia,MY,MYS,31528585,Asia,112,6855,55
2020-05-17T00:00:00Z,17,5,2020,17,1,Malaysia,MY,MYS,31528585,Asia,113,6872,56
2020-05-18T00:00:00Z,18,5,2020,22,0,Malaysia,MY,MYS,31528585,Asia,113,6894,57
2020-05-19T00:00:00Z,19,5,2020,47,0,Malaysia,MY,MYS,31528585,Asia,113,6941,58
2020-05-20T00:00:00Z,20,5,2020,37,1,Malaysia,MY,MYS,31528585,Asia,114,6978,59
2020-05-21T00:00:00Z,21,5,2020,31,0,Malaysia,MY,MYS,31528585,Asia,114,7009,60
2020-05-22T00:00:00Z,22,5,2020,50,0,Malaysia,MY,MYS,31528585,Asia,114,7059,61
2020-05-23T00:00:00Z,23,5,2020,78,1,Malaysia,MY,MYS,31528585,Asia,115,7137,62
2020-05-24T00:00:00Z,24,5,2020,48,0,Malaysia,MY,MYS,31528585,Asia,115,7185,63
2020-05-25T00:00:00Z,25,5,2020,60,0,Malaysia,MY,MYS,31528585,Asia,115,7245,64
2020-05-26T00:00:00Z,26,5,2020,172,0,Malaysia,MY,MYS,31528585,Asia,115,7417,65
2020-05-27T00:00:00Z,27,5,2020,187,0,Malaysia,MY,MYS,31528585,Asia,115,7604,66
2020-04-14T00:00:00Z,14,4,2020,7,1,Mali,ML,MLI,19077690,Africa,10,123,1
2020-04-15T00:00:00Z,15,4,2020,21,3,Mali,ML,MLI,19077690,Africa,13,144,2
2020-04-16T00:00:00Z,16,4,2020,4,0,Mali,ML,MLI,19077690,Africa,13,148,3
2020-04-17T00:00:00Z,17,4,2020,23,0,Mali,ML,MLI,19077690,Africa,13,171,4
2020-04-18T00:00:00Z,18,4,2020,19,0,Mali,ML,MLI,19077690,Africa,13,190,5
2020-04-19T00:00:00Z,19,4,2020,26,0,Mali,ML,MLI,19077690,Africa,13,216,6
2020-04-20T00:00:00Z,20,4,2020,8,1,Mali,ML,MLI,19077690,Africa,14,224,7
2020-04-21T00:00:00Z,21,4,2020,22,0,Mali,ML,MLI,19077690,Africa,14,246,8
2020-04-22T00:00:00Z,22,4,2020,12,0,Mali,ML,MLI,19077690,Africa,14,258,9
2020-04-23T00:00:00Z,23,4,2020,35,3,Mali,ML,MLI,19077690,Africa,17,293,10
2020-04-24T00:00:00Z,24,4,2020,16,4,Mali,ML,MLI,19077690,Africa,21,309,11
2020-04-25T00:00:00Z,25,4,2020,16,0,Mali,ML,MLI,19077690,Africa,21,325,12
2020-04-26T00:00:00Z,26,4,2020,45,0,Mali,ML,MLI,19077690,Africa,21,370,13
2020-04-27T00:00:00Z,27,4,2020,19,2,Mali,ML,MLI,19077690,Africa,23,389,14
2020-04-28T00:00:00Z,28,4,2020,19,0,Mali,ML,MLI,19077690,Africa,23,408,15
2020-04-29T00:00:00Z,29,4,2020,16,1,Mali,ML,MLI,19077690,Africa,24,424,16
2020-04-30T00:00:00Z,30,4,2020,58,1,Mali,ML,MLI,19077690,Africa,25,482,17
2020-05-01T00:00:00Z,1,5,2020,8,1,Mali,ML,MLI,19077690,Africa,26,490,18
2020-05-02T00:00:00Z,2,5,2020,18,0,Mali,ML,MLI,19077690,Africa,26,508,19
2020-05-03T00:00:00Z,3,5,2020,36,0,Mali,ML,MLI,19077690,Africa,26,544,20
2020-05-04T00:00:00Z,4,5,2020,19,1,Mali,ML,MLI,19077690,Africa,27,563,21
2020-05-05T00:00:00Z,5,5,2020,17,2,Mali,ML,MLI,19077690,Africa,29,580,22
2020-05-06T00:00:00Z,6,5,2020,32,3,Mali,ML,MLI,19077690,Africa,32,612,23
2020-05-07T00:00:00Z,7,5,2020,19,0,Mali,ML,MLI,19077690,Africa,32,631,24
2020-05-08T00:00:00Z,8,5,2020,19,0,Mali,ML,MLI,19077690,Africa,32,650,25
2020-05-09T00:00:00Z,9,5,2020,18,3,Mali,ML,MLI,19077690,Africa,35,668,26
2020-05-10T00:00:00Z,10,5,2020,24,2,Mali,ML,MLI,19077690,Africa,37,692,27
2020-05-11T00:00:00Z,11,5,2020,12,1,Mali,ML,MLI,19077690,Africa,38,704,28
2020-05-12T00:00:00Z,12,5,2020,8,1,Mali,ML,MLI,19077690,Africa,39,712,29
2020-05-13T00:00:00Z,13,5,2020,18,1,Mali,ML,MLI,19077690,Africa,40,730,30
2020-05-14T00:00:00Z,14,5,2020,28,4,Mali,ML,MLI,19077690,Africa,44,758,31
2020-05-15T00:00:00Z,15,5,2020,21,2,Mali,ML,MLI,19077690,Africa,46,779,32
2020-05-16T00:00:00Z,16,5,2020,27,0,Mali,ML,MLI,19077690,Africa,46,806,33
2020-05-17T00:00:00Z,17,5,2020,29,2,Mali,ML,MLI,19077690,Africa,48,835,34
2020-05-18T00:00:00Z,18,5,2020,25,4,Mali,ML,MLI,19077690,Africa,52,860,35
2020-05-19T00:00:00Z,19,5,2020,14,0,Mali,ML,MLI,19077690,Africa,52,874,36
2020-05-20T00:00:00Z,20,5,2020,27,1,Mali,ML,MLI,19077690,Africa,53,901,37
2020-05-21T00:00:00Z,21,5,2020,30,2,Mali,ML,MLI,19077690,Africa,55,931,38
2020-05-22T00:00:00Z,22,5,2020,16,5,Mali,ML,MLI,19077690,Africa,60,947,39
2020-05-23T00:00:00Z,23,5,2020,22,2,Mali,ML,MLI,19077690,Africa,62,969,40
2020-05-24T00:00:00Z,24,5,2020,46,1,Mali,ML,MLI,19077690,Africa,63,1015,41
2020-05-25T00:00:00Z,25,5,2020,15,2,Mali,ML,MLI,19077690,Africa,65,1030,42
2020-05-26T00:00:00Z,26,5,2020,29,2,Mali,ML,MLI,19077690,Africa,67,1059,43
2020-05-27T00:00:00Z,27,5,2020,18,3,Mali,ML,MLI,19077690,Africa,70,1077,44
2020-04-28T00:00:00Z,28,4,2020,0,1,Mauritius,MU,MUS,1265303,Africa,10,332,1
2020-04-29T00:00:00Z,29,4,2020,0,0,Mauritius,MU,MUS,1265303,Africa,10,332,2
2020-04-30T00:00:00Z,30,4,2020,0,0,Mauritius,MU,MUS,1265303,Africa,10,332,3
2020-05-01T00:00:00Z,1,5,2020,0,0,Mauritius,MU,MUS,1265303,Africa,10,332,4
2020-05-02T00:00:00Z,2,5,2020,0,0,Mauritius,MU,MUS,1265303,Africa,10,332,5
2020-05-03T00:00:00Z,3,5,2020,0,0,Mauritius,MU,MUS,1265303,Africa,10,332,6
2020-05-04T00:00:00Z,4,5,2020,0,0,Mauritius,MU,MUS,1265303,Africa,10,332,7
2020-05-05T00:00:00Z,5,5,2020,0,0,Mauritius,MU,MUS,1265303,Africa,10,332,8
2020-05-06T00:00:00Z,6,5,2020,0,0,Mauritius,MU,MUS,1265303,Africa,10,332,9
2020-05-07T00:00:00Z,7,5,2020,0,0,Mauritius,MU,MUS,1265303,Africa,10,332,10
2020-05-08T00:00:00Z,8,5,2020,0,0,Mauritius,MU,MUS,1265303,Africa,10,332,11
2020-05-09T00:00:00Z,9,5,2020,0,0,Mauritius,MU,MUS,1265303,Africa,10,332,12
2020-05-10T00:00:00Z,10,5,2020,0,0,Mauritius,MU,MUS,1265303,Africa,10,332,13
2020-05-11T00:00:00Z,11,5,2020,0,0,Mauritius,MU,MUS,1265303,Africa,10,332,14
2020-05-12T00:00:00Z,12,5,2020,0,0,Mauritius,MU,MUS,1265303,Africa,10,332,15
2020-05-13T00:00:00Z,13,5,2020,0,0,Mauritius,MU,MUS,1265303,Africa,10,332,16
2020-05-14T00:00:00Z,14,5,2020,0,0,Mauritius,MU,MUS,1265303,Africa,10,332,17
2020-05-15T00:00:00Z,15,5,2020,0,0,Mauritius,MU,MUS,1265303,Africa,10,332,18
2020-05-16T00:00:00Z,16,5,2020,0,0,Mauritius,MU,MUS,1265303,Africa,10,332,19
2020-05-17T00:00:00Z,17,5,2020,0,0,Mauritius,MU,MUS,1265303,Africa,10,332,20
2020-05-18T00:00:00Z,18,5,2020,0,0,Mauritius,MU,MUS,1265303,Africa,10,332,21
2020-05-19T00:00:00Z,19,5,2020,0,0,Mauritius,MU,MUS,1265303,Africa,10,332,22
2020-05-20T00:00:00Z,20,5,2020,0,0,Mauritius,MU,MUS,1265303,Africa,10,332,23
2020-05-21T00:00:00Z,21,5,2020,0,0,Mauritius,MU,MUS,1265303,Africa,10,332,24
2020-05-22T00:00:00Z,22,5,2020,0,0,Mauritius,MU,MUS,1265303,Africa,10,332,25
2020-05-23T00:00:00Z,23,5,2020,0,0,Mauritius,MU,MUS,1265303,Africa,10,332,26
2020-05-24T00:00:00Z,24,5,2020,0,0,Mauritius,MU,MUS,1265303,Africa,10,332,27
2020-05-25T00:00:00Z,25,5,2020,2,0,Mauritius,MU,MUS,1265303,Africa,10,334,28
2020-05-26T00:00:00Z,26,5,2020,0,0,Mauritius,MU,MUS,1265303,Africa,10,334,29
2020-05-27T00:00:00Z,27,5,2020,0,0,Mauritius,MU,MUS,1265303,Africa,10,334,30
2020-03-28T00:00:00Z,28,3,2020,132,4,Mexico,MX,MEX,126190788,America,12,717,1
2020-03-29T00:00:00Z,29,3,2020,131,4,Mexico,MX,MEX,126190788,America,16,848,2
2020-03-30T00:00:00Z,30,3,2020,145,4,Mexico,MX,MEX,126190788,America,20,993,3
2020-03-31T00:00:00Z,31,3,2020,101,8,Mexico,MX,MEX,126190788,America,28,1094,4
2020-04-01T00:00:00Z,1,4,2020,121,1,Mexico,MX,MEX,126190788,America,29,1215,5
2020-04-02T00:00:00Z,2,4,2020,163,8,Mexico,MX,MEX,126190788,America,37,1378,6
2020-04-03T00:00:00Z,3,4,2020,132,13,Mexico,MX,MEX,126190788,America,50,1510,7
2020-04-04T00:00:00Z,4,4,2020,178,10,Mexico,MX,MEX,126190788,America,60,1688,8
2020-04-05T00:00:00Z,5,4,2020,202,19,Mexico,MX,MEX,126190788,America,79,1890,9
2020-04-06T00:00:00Z,6,4,2020,253,15,Mexico,MX,MEX,126190788,America,94,2143,10
2020-04-07T00:00:00Z,7,4,2020,296,31,Mexico,MX,MEX,126190788,America,125,2439,11
2020-04-08T00:00:00Z,8,4,2020,346,16,Mexico,MX,MEX,126190788,America,141,2785,12
2020-04-09T00:00:00Z,9,4,2020,396,33,Mexico,MX,MEX,126190788,America,174,3181,13
2020-04-10T00:00:00Z,10,4,2020,260,20,Mexico,MX,MEX,126190788,America,194,3441,14
2020-04-11T00:00:00Z,11,4,2020,403,39,Mexico,MX,MEX,126190788,America,233,3844,15
2020-04-12T00:00:00Z,12,4,2020,375,40,Mexico,MX,MEX,126190788,America,273,4219,16
2020-04-13T00:00:00Z,13,4,2020,442,23,Mexico,MX,MEX,126190788,America,296,4661,17
2020-04-14T00:00:00Z,14,4,2020,353,36,Mexico,MX,MEX,126190788,America,332,5014,18
2020-04-15T00:00:00Z,15,4,2020,385,74,Mexico,MX,MEX,126190788,America,406,5399,19
2020-04-16T00:00:00Z,16,4,2020,448,43,Mexico,MX,MEX,126190788,America,449,5847,20
2020-04-17T00:00:00Z,17,4,2020,450,37,Mexico,MX,MEX,126190788,America,486,6297,21
2020-04-18T00:00:00Z,18,4,2020,578,60,Mexico,MX,MEX,126190788,America,546,6875,22
2020-04-19T00:00:00Z,19,4,2020,622,104,Mexico,MX,MEX,126190788,America,650,7497,23
2020-04-20T00:00:00Z,20,4,2020,764,36,Mexico,MX,MEX,126190788,America,686,8261,24
2020-04-21T00:00:00Z,21,4,2020,511,26,Mexico,MX,MEX,126190788,America,712,8772,25
2020-04-22T00:00:00Z,22,4,2020,729,145,Mexico,MX,MEX,126190788,America,857,9501,26
2020-04-23T00:00:00Z,23,4,2020,1043,113,Mexico,MX,MEX,126190788,America,970,10544,27
2020-04-24T00:00:00Z,24,4,2020,1089,99,Mexico,MX,MEX,126190788,America,1069,11633,28
2020-04-25T00:00:00Z,25,4,2020,1239,152,Mexico,MX,MEX,126190788,America,1221,12872,29
2020-04-26T00:00:00Z,26,4,2020,970,84,Mexico,MX,MEX,126190788,America,1305,13842,30
2020-04-27T00:00:00Z,27,4,2020,835,46,Mexico,MX,MEX,126190788,America,1351,14677,31
2020-04-28T00:00:00Z,28,4,2020,852,83,Mexico,MX,MEX,126190788,America,1434,15529,32
2020-04-29T00:00:00Z,29,4,2020,1223,135,Mexico,MX,MEX,126190788,America,1569,16752,33
2020-04-30T00:00:00Z,30,4,2020,1047,163,Mexico,MX,MEX,126190788,America,1732,17799,34
2020-05-01T00:00:00Z,1,5,2020,1425,127,Mexico,MX,MEX,126190788,America,1859,19224,35
2020-05-02T00:00:00Z,2,5,2020,1515,113,Mexico,MX,MEX,126190788,America,1972,20739,36
2020-05-03T00:00:00Z,3,5,2020,1349,89,Mexico,MX,MEX,126190788,America,2061,22088,37
2020-05-04T00:00:00Z,4,5,2020,1383,93,Mexico,MX,MEX,126190788,America,2154,23471,38
2020-05-05T00:00:00Z,5,5,2020,1434,117,Mexico,MX,MEX,126190788,America,2271,24905,39
2020-05-06T00:00:00Z,6,5,2020,1120,236,Mexico,MX,MEX,126190788,America,2507,26025,40
2020-05-07T00:00:00Z,7,5,2020,1609,197,Mexico,MX,MEX,126190788,America,2704,27634,41
2020-05-08T00:00:00Z,8,5,2020,1982,257,Mexico,MX,MEX,126190788,America,2961,29616,42
2020-05-09T00:00:00Z,9,5,2020,1906,199,Mexico,MX,MEX,126190788,America,3160,31522,43
2020-05-10T00:00:00Z,10,5,2020,1938,193,Mexico,MX,MEX,126190788,America,3353,33460,44
2020-05-11T00:00:00Z,11,5,2020,1562,112,Mexico,MX,MEX,126190788,America,3465,35022,45
2020-05-12T00:00:00Z,12,5,2020,1305,108,Mexico,MX,MEX,126190788,America,3573,36327,46
2020-05-13T00:00:00Z,13,5,2020,1997,353,Mexico,MX,MEX,126190788,America,3926,38324,47
2020-05-14T00:00:00Z,14,5,2020,1862,294,Mexico,MX,MEX,126190788,America,4220,40186,48
2020-05-15T00:00:00Z,15,5,2020,2409,257,Mexico,MX,MEX,126190788,America,4477,42595,49
2020-05-16T00:00:00Z,16,5,2020,2437,290,Mexico,MX,MEX,126190788,America,4767,45032,50
2020-05-17T00:00:00Z,17,5,2020,2112,278,Mexico,MX,MEX,126190788,America,5045,47144,51
2020-05-18T00:00:00Z,18,5,2020,2075,132,Mexico,MX,MEX,126190788,America,5177,49219,52
2020-05-19T00:00:00Z,19,5,2020,2414,155,Mexico,MX,MEX,126190788,America,5332,51633,53
2020-05-20T00:00:00Z,20,5,2020,2713,334,Mexico,MX,MEX,126190788,America,5666,54346,54
2020-05-21T00:00:00Z,21,5,2020,2248,424,Mexico,MX,MEX,126190788,America,6090,56594,55
2020-05-22T00:00:00Z,22,5,2020,2973,420,Mexico,MX,MEX,126190788,America,6510,59567,56
2020-05-23T00:00:00Z,23,5,2020,2960,479,Mexico,MX,MEX,126190788,America,6989,62527,57
2020-05-24T00:00:00Z,24,5,2020,3329,190,Mexico,MX,MEX,126190788,America,7179,65856,58
2020-05-25T00:00:00Z,25,5,2020,2764,215,Mexico,MX,MEX,126190788,America,7394,68620,59
2020-05-26T00:00:00Z,26,5,2020,2485,239,Mexico,MX,MEX,126190788,America,7633,71105,60
2020-05-27T00:00:00Z,27,5,2020,3455,501,Mexico,MX,MEX,126190788,America,8134,74560,61
2020-04-05T00:00:00Z,5,4,2020,161,4,Moldova,MD,MDA,3545883,Europe,12,752,1
2020-04-06T00:00:00Z,6,4,2020,112,3,Moldova,MD,MDA,3545883,Europe,15,864,2
2020-04-07T00:00:00Z,7,4,2020,101,4,Moldova,MD,MDA,3545883,Europe,19,965,3
2020-04-08T00:00:00Z,8,4,2020,91,3,Moldova,MD,MDA,3545883,Europe,22,1056,4
2020-04-09T00:00:00Z,9,4,2020,118,5,Moldova,MD,MDA,3545883,Europe,27,1174,5
2020-04-10T00:00:00Z,10,4,2020,115,2,Moldova,MD,MDA,3545883,Europe,29,1289,6
2020-04-11T00:00:00Z,11,4,2020,149,0,Moldova,MD,MDA,3545883,Europe,29,1438,7
2020-04-12T00:00:00Z,12,4,2020,122,1,Moldova,MD,MDA,3545883,Europe,30,1560,8
2020-04-13T00:00:00Z,13,4,2020,102,2,Moldova,MD,MDA,3545883,Europe,32,1662,9
2020-04-14T00:00:00Z,14,4,2020,50,4,Moldova,MD,MDA,3545883,Europe,36,1712,10
2020-04-15T00:00:00Z,15,4,2020,222,4,Moldova,MD,MDA,3545883,Europe,40,1934,11
2020-04-16T00:00:00Z,16,4,2020,115,6,Moldova,MD,MDA,3545883,Europe,46,2049,12
2020-04-17T00:00:00Z,17,4,2020,105,8,Moldova,MD,MDA,3545883,Europe,54,2154,13
2020-04-18T00:00:00Z,18,4,2020,110,2,Moldova,MD,MDA,3545883,Europe,56,2264,14
2020-04-19T00:00:00Z,19,4,2020,87,4,Moldova,MD,MDA,3545883,Europe,60,2351,15
2020-04-20T00:00:00Z,20,4,2020,121,7,Moldova,MD,MDA,3545883,Europe,67,2472,16
2020-04-21T00:00:00Z,21,4,2020,76,3,Moldova,MD,MDA,3545883,Europe,70,2548,17
2020-04-22T00:00:00Z,22,4,2020,66,3,Moldova,MD,MDA,3545883,Europe,73,2614,18
2020-04-23T00:00:00Z,23,4,2020,164,3,Moldova,MD,MDA,3545883,Europe,76,2778,19
2020-04-24T00:00:00Z,24,4,2020,148,4,Moldova,MD,MDA,3545883,Europe,80,2926,20
2020-04-25T00:00:00Z,25,4,2020,184,7,Moldova,MD,MDA,3545883,Europe,87,3110,21
2020-04-26T00:00:00Z,26,4,2020,194,7,Moldova,MD,MDA,3545883,Europe,94,3304,22
2020-04-27T00:00:00Z,27,4,2020,104,2,Moldova,MD,MDA,3545883,Europe,96,3408,23
2020-04-28T00:00:00Z,28,4,2020,73,6,Moldova,MD,MDA,3545883,Europe,102,3481,24
2020-04-29T00:00:00Z,29,4,2020,157,5,Moldova,MD,MDA,3545883,Europe,107,3638,25
2020-04-30T00:00:00Z,30,4,2020,133,4,Moldova,MD,MDA,3545883,Europe,111,3771,26
2020-05-01T00:00:00Z,1,5,2020,126,8,Moldova,MD,MDA,3545883,Europe,119,3897,27
2020-05-02T00:00:00Z,2,5,2020,83,3,Moldova,MD,MDA,3545883,Europe,122,3980,28
2020-05-03T00:00:00Z,3,5,2020,72,2,Moldova,MD,MDA,3545883,Europe,124,4052,29
2020-05-04T00:00:00Z,4,5,2020,69,1,Moldova,MD,MDA,3545883,Europe,125,4121,30
2020-05-05T00:00:00Z,5,5,2020,127,7,Moldova,MD,MDA,3545883,Europe,132,4248,31
2020-05-06T00:00:00Z,6,5,2020,115,4,Moldova,MD,MDA,3545883,Europe,136,4363,32
2020-05-07T00:00:00Z,7,5,2020,113,7,Moldova,MD,MDA,3545883,Europe,143,4476,33
2020-05-08T00:00:00Z,8,5,2020,129,2,Moldova,MD,MDA,3545883,Europe,145,4605,34
2020-05-09T00:00:00Z,9,5,2020,123,7,Moldova,MD,MDA,3545883,Europe,152,4728,35
2020-05-10T00:00:00Z,10,5,2020,139,9,Moldova,MD,MDA,3545883,Europe,161,4867,36
2020-05-11T00:00:00Z,11,5,2020,60,8,Moldova,MD,MDA,3545883,Europe,169,4927,37
2020-05-12T00:00:00Z,12,5,2020,68,6,Moldova,MD,MDA,3545883,Europe,175,4995,38
2020-05-13T00:00:00Z,13,5,2020,159,7,Moldova,MD,MDA,3545883,Europe,182,5154,39
2020-05-14T00:00:00Z,14,5,2020,252,3,Moldova,MD,MDA,3545883,Europe,185,5406,40
2020-05-15T00:00:00Z,15,5,2020,147,9,Moldova,MD,MDA,3545883,Europe,194,5553,41
2020-05-16T00:00:00Z,16,5,2020,192,3,Moldova,MD,MDA,3545883,Europe,197,5745,42
2020-05-17T00:00:00Z,17,5,2020,189,10,Moldova,MD,MDA,3545883,Europe,207,5934,43
2020-05-18T00:00:00Z,18,5,2020,126,4,Moldova,MD,MDA,3545883,Europe,211,6060,44
2020-05-19T00:00:00Z,19,5,2020,78,4,Moldova,MD,MDA,3545883,Europe,215,6138,45
2020-05-20T00:00:00Z,20,5,2020,202,6,Moldova,MD,MDA,3545883,Europe,221,6340,46
2020-05-21T00:00:00Z,21,5,2020,213,7,Moldova,MD,MDA,3545883,Europe,228,6553,47
2020-05-22T00:00:00Z,22,5,2020,151,5,Moldova,MD,MDA,3545883,Europe,233,6704,48
2020-05-23T00:00:00Z,23,5,2020,143,4,Moldova,MD,MDA,3545883,Europe,237,6847,49
2020-05-24T00:00:00Z,24,5,2020,147,5,Moldova,MD,MDA,3545883,Europe,242,6994,50
2020-05-25T00:00:00Z,25,5,2020,99,8,Moldova,MD,MDA,3545883,Europe,250,7093,51
2020-05-26T00:00:00Z,26,5,2020,54,11,Moldova,MD,MDA,3545883,Europe,261,7147,52
2020-05-27T00:00:00Z,27,5,2020,158,6,Moldova,MD,MDA,3545883,Europe,267,7305,53
2020-03-27T00:00:00Z,27,3,2020,50,4,Morocco,MA,MAR,36029138,Africa,10,275,1
2020-03-28T00:00:00Z,28,3,2020,70,13,Morocco,MA,MAR,36029138,Africa,23,345,2
2020-03-29T00:00:00Z,29,3,2020,13,0,Morocco,MA,MAR,36029138,Africa,23,358,3
2020-03-30T00:00:00Z,30,3,2020,121,3,Morocco,MA,MAR,36029138,Africa,26,479,4
2020-03-31T00:00:00Z,31,3,2020,77,7,Morocco,MA,MAR,36029138,Africa,33,556,5
2020-04-01T00:00:00Z,1,4,2020,61,3,Morocco,MA,MAR,36029138,Africa,36,617,6
2020-04-02T00:00:00Z,2,4,2020,37,3,Morocco,MA,MAR,36029138,Africa,39,654,7
2020-04-03T00:00:00Z,3,4,2020,54,5,Morocco,MA,MAR,36029138,Africa,44,708,8
2020-04-04T00:00:00Z,4,4,2020,0,0,Morocco,MA,MAR,36029138,Africa,44,708,9
2020-04-05T00:00:00Z,5,4,2020,211,15,Morocco,MA,MAR,36029138,Africa,59,919,10
2020-04-06T00:00:00Z,6,4,2020,102,11,Morocco,MA,MAR,36029138,Africa,70,1021,11
2020-04-07T00:00:00Z,7,4,2020,99,10,Morocco,MA,MAR,36029138,Africa,80,1120,12
2020-04-08T00:00:00Z,8,4,2020,64,10,Morocco,MA,MAR,36029138,Africa,90,1184,13
2020-04-09T00:00:00Z,9,4,2020,91,3,Morocco,MA,MAR,36029138,Africa,93,1275,14
2020-04-10T00:00:00Z,10,4,2020,99,4,Morocco,MA,MAR,36029138,Africa,97,1374,15
2020-04-11T00:00:00Z,11,4,2020,74,10,Morocco,MA,MAR,36029138,Africa,107,1448,16
2020-04-12T00:00:00Z,12,4,2020,97,4,Morocco,MA,MAR,36029138,Africa,111,1545,17
2020-04-13T00:00:00Z,13,4,2020,116,7,Morocco,MA,MAR,36029138,Africa,118,1661,18
2020-04-14T00:00:00Z,14,4,2020,102,8,Morocco,MA,MAR,36029138,Africa,126,1763,19
2020-04-15T00:00:00Z,15,4,2020,125,0,Morocco,MA,MAR,36029138,Africa,126,1888,20
2020-04-16T00:00:00Z,16,4,2020,136,1,Morocco,MA,MAR,36029138,Africa,127,2024,21
2020-04-17T00:00:00Z,17,4,2020,259,3,Morocco,MA,MAR,36029138,Africa,130,2283,22
2020-04-18T00:00:00Z,18,4,2020,281,5,Morocco,MA,MAR,36029138,Africa,135,2564,23
2020-04-19T00:00:00Z,19,4,2020,121,2,Morocco,MA,MAR,36029138,Africa,137,2685,24
2020-04-20T00:00:00Z,20,4,2020,170,4,Morocco,MA,MAR,36029138,Africa,141,2855,25
2020-04-21T00:00:00Z,21,4,2020,191,2,Morocco,MA,MAR,36029138,Africa,143,3046,26
2020-04-22T00:00:00Z,22,4,2020,163,2,Morocco,MA,MAR,36029138,Africa,145,3209,27
2020-04-23T00:00:00Z,23,4,2020,168,4,Morocco,MA,MAR,36029138,Africa,149,3377,28
2020-04-24T00:00:00Z,24,4,2020,191,6,Morocco,MA,MAR,36029138,Africa,155,3568,29
2020-04-25T00:00:00Z,25,4,2020,190,3,Morocco,MA,MAR,36029138,Africa,158,3758,30
2020-04-26T00:00:00Z,26,4,2020,139,1,Morocco,MA,MAR,36029138,Africa,159,3897,31
2020-04-27T00:00:00Z,27,4,2020,168,2,Morocco,MA,MAR,36029138,Africa,161,4065,32
2020-04-28T00:00:00Z,28,4,2020,55,1,Morocco,MA,MAR,36029138,Africa,162,4120,33
2020-04-29T00:00:00Z,29,4,2020,132,3,Morocco,MA,MAR,36029138,Africa,165,4252,34
2020-04-30T00:00:00Z,30,4,2020,69,3,Morocco,MA,MAR,36029138,Africa,168,4321,35
2020-05-01T00:00:00Z,1,5,2020,102,2,Morocco,MA,MAR,36029138,Africa,170,4423,36
2020-05-02T00:00:00Z,2,5,2020,146,1,Morocco,MA,MAR,36029138,Africa,171,4569,37
2020-05-03T00:00:00Z,3,5,2020,160,2,Morocco,MA,MAR,36029138,Africa,173,4729,38
2020-05-04T00:00:00Z,4,5,2020,174,1,Morocco,MA,MAR,36029138,Africa,174,4903,39
2020-05-05T00:00:00Z,5,5,2020,140,5,Morocco,MA,MAR,36029138,Africa,179,5043,40
2020-05-06T00:00:00Z,6,5,2020,176,2,Morocco,MA,MAR,36029138,Africa,181,5219,41
2020-05-07T00:00:00Z,7,5,2020,189,2,Morocco,MA,MAR,36029138,Africa,183,5408,42
2020-05-08T00:00:00Z,8,5,2020,140,0,Morocco,MA,MAR,36029138,Africa,183,5548,43
2020-05-09T00:00:00Z,9,5,2020,163,3,Morocco,MA,MAR,36029138,Africa,186,5711,44
2020-05-10T00:00:00Z,10,5,2020,199,0,Morocco,MA,MAR,36029138,Africa,186,5910,45
2020-05-11T00:00:00Z,11,5,2020,153,2,Morocco,MA,MAR,36029138,Africa,188,6063,46
2020-05-12T00:00:00Z,12,5,2020,218,0,Morocco,MA,MAR,36029138,Africa,188,6281,47
2020-05-13T00:00:00Z,13,5,2020,137,0,Morocco,MA,MAR,36029138,Africa,188,6418,48
2020-05-14T00:00:00Z,14,5,2020,94,0,Morocco,MA,MAR,36029138,Africa,188,6512,49
2020-05-15T00:00:00Z,15,5,2020,95,2,Morocco,MA,MAR,36029138,Africa,190,6607,50
2020-05-16T00:00:00Z,16,5,2020,45,0,Morocco,MA,MAR,36029138,Africa,190,6652,51
2020-05-17T00:00:00Z,17,5,2020,89,2,Morocco,MA,MAR,36029138,Africa,192,6741,52
2020-05-18T00:00:00Z,18,5,2020,129,0,Morocco,MA,MAR,36029138,Africa,192,6870,53
2020-05-19T00:00:00Z,19,5,2020,82,0,Morocco,MA,MAR,36029138,Africa,192,6952,54
2020-05-20T00:00:00Z,20,5,2020,71,1,Morocco,MA,MAR,36029138,Africa,193,7023,55
2020-05-21T00:00:00Z,21,5,2020,110,1,Morocco,MA,MAR,36029138,Africa,194,7133,56
2020-05-22T00:00:00Z,22,5,2020,78,2,Morocco,MA,MAR,36029138,Africa,196,7211,57
2020-05-23T00:00:00Z,23,5,2020,121,1,Morocco,MA,MAR,36029138,Africa,197,7332,58
2020-05-24T00:00:00Z,24,5,2020,74,1,Morocco,MA,MAR,36029138,Africa,198,7406,59
2020-05-25T00:00:00Z,25,5,2020,27,1,Morocco,MA,MAR,36029138,Africa,199,7433,60
2020-05-26T00:00:00Z,26,5,2020,99,1,Morocco,MA,MAR,36029138,Africa,200,7532,61
2020-05-27T00:00:00Z,27,5,2020,45,2,Morocco,MA,MAR,36029138,Africa,202,7577,62
2020-03-15T00:00:00Z,15,3,2020,155,7,Netherlands,NL,NLD,17231017,Europe,12,959,1
2020-03-16T00:00:00Z,16,3,2020,176,8,Netherlands,NL,NLD,17231017,Europe,20,1135,2
2020-03-17T00:00:00Z,17,3,2020,278,4,Netherlands,NL,NLD,17231017,Europe,24,1413,3
2020-03-18T00:00:00Z,18,3,2020,292,19,Netherlands,NL,NLD,17231017,Europe,43,1705,4
2020-03-19T00:00:00Z,19,3,2020,346,15,Netherlands,NL,NLD,17231017,Europe,58,2051,5
2020-03-20T00:00:00Z,20,3,2020,409,18,Netherlands,NL,NLD,17231017,Europe,76,2460,6
2020-03-21T00:00:00Z,21,3,2020,534,30,Netherlands,NL,NLD,17231017,Europe,106,2994,7
2020-03-22T00:00:00Z,22,3,2020,637,30,Netherlands,NL,NLD,17231017,Europe,136,3631,8
2020-03-23T00:00:00Z,23,3,2020,573,43,Netherlands,NL,NLD,17231017,Europe,179,4204,9
2020-03-24T00:00:00Z,24,3,2020,545,34,Netherlands,NL,NLD,17231017,Europe,213,4749,10
2020-03-25T00:00:00Z,25,3,2020,811,63,Netherlands,NL,NLD,17231017,Europe,276,5560,11
2020-03-26T00:00:00Z,26,3,2020,852,80,Netherlands,NL,NLD,17231017,Europe,356,6412,12
2020-03-27T00:00:00Z,27,3,2020,1019,78,Netherlands,NL,NLD,17231017,Europe,434,7431,13
2020-03-28T00:00:00Z,28,3,2020,1172,112,Netherlands,NL,NLD,17231017,Europe,546,8603,14
2020-03-29T00:00:00Z,29,3,2020,1159,93,Netherlands,NL,NLD,17231017,Europe,639,9762,15
2020-03-30T00:00:00Z,30,3,2020,1104,132,Netherlands,NL,NLD,17231017,Europe,771,10866,16
2020-03-31T00:00:00Z,31,3,2020,884,93,Netherlands,NL,NLD,17231017,Europe,864,11750,17
2020-04-01T00:00:00Z,1,4,2020,845,175,Netherlands,NL,NLD,17231017,Europe,1039,12595,18
2020-04-02T00:00:00Z,2,4,2020,1019,134,Netherlands,NL,NLD,17231017,Europe,1173,13614,19
2020-04-03T00:00:00Z,3,4,2020,1083,166,Netherlands,NL,NLD,17231017,Europe,1339,14697,20
2020-04-04T00:00:00Z,4,4,2020,1026,148,Netherlands,NL,NLD,17231017,Europe,1487,15723,21
2020-04-05T00:00:00Z,5,4,2020,904,164,Netherlands,NL,NLD,17231017,Europe,1651,16627,22
2020-04-06T00:00:00Z,6,4,2020,1224,115,Netherlands,NL,NLD,17231017,Europe,1766,17851,23
2020-04-07T00:00:00Z,7,4,2020,952,101,Netherlands,NL,NLD,17231017,Europe,1867,18803,24
2020-04-08T00:00:00Z,8,4,2020,777,234,Netherlands,NL,NLD,17231017,Europe,2101,19580,25
2020-04-09T00:00:00Z,9,4,2020,969,147,Netherlands,NL,NLD,17231017,Europe,2248,20549,26
2020-04-10T00:00:00Z,10,4,2020,1213,148,Netherlands,NL,NLD,17231017,Europe,2396,21762,27
2020-04-11T00:00:00Z,11,4,2020,1335,115,Netherlands,NL,NLD,17231017,Europe,2511,23097,28
2020-04-12T00:00:00Z,12,4,2020,1316,132,Netherlands,NL,NLD,17231017,Europe,2643,24413,29
2020-04-13T00:00:00Z,13,4,2020,1174,94,Netherlands,NL,NLD,17231017,Europe,2737,25587,30
2020-04-14T00:00:00Z,14,4,2020,964,86,Netherlands,NL,NLD,17231017,Europe,2823,26551,31
2020-04-15T00:00:00Z,15,4,2020,868,122,Netherlands,NL,NLD,17231017,Europe,2945,27419,32
2020-04-16T00:00:00Z,16,4,2020,734,189,Netherlands,NL,NLD,17231017,Europe,3134,28153,33
2020-04-17T00:00:00Z,17,4,2020,1061,181,Netherlands,NL,NLD,17231017,Europe,3315,29214,34
2020-04-18T00:00:00Z,18,4,2020,1235,144,Netherlands,NL,NLD,17231017,Europe,3459,30449,35
2020-04-19T00:00:00Z,19,4,2020,1140,142,Netherlands,NL,NLD,17231017,Europe,3601,31589,36
2020-04-20T00:00:00Z,20,4,2020,1066,83,Netherlands,NL,NLD,17231017,Europe,3684,32655,37
2020-04-21T00:00:00Z,21,4,2020,750,67,Netherlands,NL,NLD,17231017,Europe,3751,33405,38
2020-04-22T00:00:00Z,22,4,2020,729,165,Netherlands,NL,NLD,17231017,Europe,3916,34134,39
2020-04-23T00:00:00Z,23,4,2020,708,138,Netherlands,NL,NLD,17231017,Europe,4054,34842,40
2020-04-24T00:00:00Z,24,4,2020,887,123,Netherlands,NL,NLD,17231017,Europe,4177,35729,41
2020-04-25T00:00:00Z,25,4,2020,806,112,Netherlands,NL,NLD,17231017,Europe,4289,36535,42
2020-04-26T00:00:00Z,26,4,2020,655,120,Netherlands,NL,NLD,17231017,Europe,4409,37190,43
2020-04-27T00:00:00Z,27,4,2020,655,66,Netherlands,NL,NLD,17231017,Europe,4475,37845,44
2020-04-28T00:00:00Z,28,4,2020,400,43,Netherlands,NL,NLD,17231017,Europe,4518,38245,45
2020-04-29T00:00:00Z,29,4,2020,171,48,Netherlands,NL,NLD,17231017,Europe,4566,38416,46
2020-04-30T00:00:00Z,30,4,2020,386,145,Netherlands,NL,NLD,17231017,Europe,4711,38802,47
2020-05-01T00:00:00Z,1,5,2020,514,84,Netherlands,NL,NLD,17231017,Europe,4795,39316,48
2020-05-02T00:00:00Z,2,5,2020,475,98,Netherlands,NL,NLD,17231017,Europe,4893,39791,49
2020-05-03T00:00:00Z,3,5,2020,445,94,Netherlands,NL,NLD,17231017,Europe,4987,40236,50
2020-05-04T00:00:00Z,4,5,2020,335,69,Netherlands,NL,NLD,17231017,Europe,5056,40571,51
2020-05-05T00:00:00Z,5,5,2020,199,26,Netherlands,NL,NLD,17231017,Europe,5082,40770,52
2020-05-06T00:00:00Z,6,5,2020,317,86,Netherlands,NL,NLD,17231017,Europe,5168,41087,53
2020-05-07T00:00:00Z,7,5,2020,232,36,Netherlands,NL,NLD,17231017,Europe,5204,41319,54
2020-05-08T00:00:00Z,8,5,2020,455,84,Netherlands,NL,NLD,17231017,Europe,5288,41774,55
2020-05-09T00:00:00Z,9,5,2020,319,71,Netherlands,NL,NLD,17231017,Europe,5359,42093,56
2020-05-10T00:00:00Z,10,5,2020,289,63,Netherlands,NL,NLD,17231017,Europe,5422,42382,57
2020-05-11T00:00:00Z,11,5,2020,245,18,Netherlands,NL,NLD,17231017,Europe,5440,42627,58
2020-05-12T00:00:00Z,12,5,2020,161,16,Netherlands,NL,NLD,17231017,Europe,5456,42788,59
2020-05-13T00:00:00Z,13,5,2020,196,54,Netherlands,NL,NLD,17231017,Europe,5510,42984,60
2020-05-14T00:00:00Z,14,5,2020,227,52,Netherlands,NL,NLD,17231017,Europe,5562,43211,61
2020-05-15T00:00:00Z,15,5,2020,270,28,Netherlands,NL,NLD,17231017,Europe,5590,43481,62
2020-05-16T00:00:00Z,16,5,2020,200,53,Netherlands,NL,NLD,17231017,Europe,5643,43681,63
2020-05-17T00:00:00Z,17,5,2020,189,27,Netherlands,NL,NLD,17231017,Europe,5670,43870,64
2020-05-18T00:00:00Z,18,5,2020,125,10,Netherlands,NL,NLD,17231017,Europe,5680,43995,65
2020-05-19T00:00:00Z,19,5,2020,146,14,Netherlands,NL,NLD,17231017,Europe,5694,44141,66
2020-05-20T00:00:00Z,20,5,2020,108,21,Netherlands,NL,NLD,17231017,Europe,5715,44249,67
2020-05-21T00:00:00Z,21,5,2020,198,33,Netherlands,NL,NLD,17231017,Europe,5748,44447,68
2020-05-22T00:00:00Z,22,5,2020,253,27,Netherlands,NL,NLD,17231017,Europe,5775,44700,69
2020-05-23T00:00:00Z,23,5,2020,188,13,Netherlands,NL,NLD,17231017,Europe,5788,44888,70
2020-05-24T00:00:00Z,24,5,2020,176,23,Netherlands,NL,NLD,17231017,Europe,5811,45064,71
2020-05-25T00:00:00Z,25,5,2020,172,11,Netherlands,NL,NLD,17231017,Europe,5822,45236,72
2020-05-26T00:00:00Z,26,5,2020,209,8,Netherlands,NL,NLD,17231017,Europe,5830,45445,73
2020-05-27T00:00:00Z,27,5,2020,133,26,Netherlands,NL,NLD,17231017,Europe,5856,45578,74
2020-04-17T00:00:00Z,17,4,2020,2,2,New_Zealand,NZ,NZL,4885500,Oceania,11,1086,1
2020-04-18T00:00:00Z,18,4,2020,8,0,New_Zealand,NZ,NZL,4885500,Oceania,11,1094,2
2020-04-19T00:00:00Z,19,4,2020,4,1,New_Zealand,NZ,NZL,4885500,Oceania,12,1098,3
2020-04-20T00:00:00Z,20,4,2020,7,0,New_Zealand,NZ,NZL,4885500,Oceania,12,1105,4
2020-04-21T00:00:00Z,21,4,2020,2,1,New_Zealand,NZ,NZL,4885500,Oceania,13,1107,5
2020-04-22T00:00:00Z,22,4,2020,5,1,New_Zealand,NZ,NZL,4885500,Oceania,14,1112,6
2020-04-23T00:00:00Z,23,4,2020,0,2,New_Zealand,NZ,NZL,4885500,Oceania,16,1112,7
2020-04-24T00:00:00Z,24,4,2020,2,1,New_Zealand,NZ,NZL,4885500,Oceania,17,1114,8
2020-04-25T00:00:00Z,25,4,2020,3,1,New_Zealand,NZ,NZL,4885500,Oceania,18,1117,9
2020-04-26T00:00:00Z,26,4,2020,4,0,New_Zealand,NZ,NZL,4885500,Oceania,18,1121,10
2020-04-27T00:00:00Z,27,4,2020,1,1,New_Zealand,NZ,NZL,4885500,Oceania,19,1122,11
2020-04-28T00:00:00Z,28,4,2020,2,0,New_Zealand,NZ,NZL,4885500,Oceania,19,1124,12
2020-04-29T00:00:00Z,29,4,2020,2,0,New_Zealand,NZ,NZL,4885500,Oceania,19,1126,13
2020-04-30T00:00:00Z,30,4,2020,3,0,New_Zealand,NZ,NZL,4885500,Oceania,19,1129,14
2020-05-01T00:00:00Z,1,5,2020,3,0,New_Zealand,NZ,NZL,4885500,Oceania,19,1132,15
2020-05-02T00:00:00Z,2,5,2020,2,1,New_Zealand,NZ,NZL,4885500,Oceania,20,1134,16
2020-05-03T00:00:00Z,3,5,2020,2,0,New_Zealand,NZ,NZL,4885500,Oceania,20,1136,17
2020-05-04T00:00:00Z,4,5,2020,1,0,New_Zealand,NZ,NZL,4885500,Oceania,20,1137,18
2020-05-05T00:00:00Z,5,5,2020,0,0,New_Zealand,NZ,NZL,4885500,Oceania,20,1137,19
2020-05-06T00:00:00Z,6,5,2020,1,1,New_Zealand,NZ,NZL,4885500,Oceania,21,1138,20
2020-05-07T00:00:00Z,7,5,2020,1,0,New_Zealand,NZ,NZL,4885500,Oceania,21,1139,21
2020-05-08T00:00:00Z,8,5,2020,2,0,New_Zealand,NZ,NZL,4885500,Oceania,21,1141,22
2020-05-09T00:00:00Z,9,5,2020,1,0,New_Zealand,NZ,NZL,4885500,Oceania,21,1142,23
2020-05-10T00:00:00Z,10,5,2020,2,0,New_Zealand,NZ,NZL,4885500,Oceania,21,1144,24
2020-05-11T00:00:00Z,11,5,2020,3,0,New_Zealand,NZ,NZL,4885500,Oceania,21,1147,25
2020-05-12T00:00:00Z,12,5,2020,0,0,New_Zealand,NZ,NZL,4885500,Oceania,21,1147,26
2020-05-13T00:00:00Z,13,5,2020,0,0,New_Zealand,NZ,NZL,4885500,Oceania,21,1147,27
2020-05-14T00:00:00Z,14,5,2020,0,0,New_Zealand,NZ,NZL,4885500,Oceania,21,1147,28
2020-05-15T00:00:00Z,15,5,2020,1,0,New_Zealand,NZ,NZL,4885500,Oceania,21,1148,29
2020-05-16T00:00:00Z,16,5,2020,0,0,New_Zealand,NZ,NZL,4885500,Oceania,21,1148,30
2020-05-17T00:00:00Z,17,5,2020,1,0,New_Zealand,NZ,NZL,4885500,Oceania,21,1149,31
2020-05-18T00:00:00Z,18,5,2020,0,0,New_Zealand,NZ,NZL,4885500,Oceania,21,1149,32
2020-05-19T00:00:00Z,19,5,2020,4,0,New_Zealand,NZ,NZL,4885500,Oceania,21,1153,33
2020-05-20T00:00:00Z,20,5,2020,0,0,New_Zealand,NZ,NZL,4885500,Oceania,21,1153,34
2020-05-21T00:00:00Z,21,5,2020,0,0,New_Zealand,NZ,NZL,4885500,Oceania,21,1153,35
2020-05-22T00:00:00Z,22,5,2020,1,0,New_Zealand,NZ,NZL,4885500,Oceania,21,1154,36
2020-05-23T00:00:00Z,23,5,2020,0,0,New_Zealand,NZ,NZL,4885500,Oceania,21,1154,37
2020-05-24T00:00:00Z,24,5,2020,0,0,New_Zealand,NZ,NZL,4885500,Oceania,21,1154,38
2020-05-25T00:00:00Z,25,5,2020,0,0,New_Zealand,NZ,NZL,4885500,Oceania,21,1154,39
2020-05-26T00:00:00Z,26,5,2020,0,0,New_Zealand,NZ,NZL,4885500,Oceania,21,1154,40
2020-05-27T00:00:00Z,27,5,2020,0,0,New_Zealand,NZ,NZL,4885500,Oceania,21,1154,41
2020-05-23T00:00:00Z,23,5,2020,254,9,Nicaragua,NI,NIC,6465513,America,17,279,1
2020-05-24T00:00:00Z,24,5,2020,0,0,Nicaragua,NI,NIC,6465513,America,17,279,2
2020-05-25T00:00:00Z,25,5,2020,0,0,Nicaragua,NI,NIC,6465513,America,17,279,3
2020-05-26T00:00:00Z,26,5,2020,0,0,Nicaragua,NI,NIC,6465513,America,17,279,4
2020-05-27T00:00:00Z,27,5,2020,480,18,Nicaragua,NI,NIC,6465513,America,35,759,5
2020-04-06T00:00:00Z,6,4,2020,64,5,Niger,NE,NER,22442948,Africa,10,184,1
2020-04-07T00:00:00Z,7,4,2020,69,0,Niger,NE,NER,22442948,Africa,10,253,2
2020-04-08T00:00:00Z,8,4,2020,25,1,Niger,NE,NER,22442948,Africa,11,278,3
2020-04-09T00:00:00Z,9,4,2020,64,0,Niger,NE,NER,22442948,Africa,11,342,4
2020-04-10T00:00:00Z,10,4,2020,68,0,Niger,NE,NER,22442948,Africa,11,410,5
2020-04-11T00:00:00Z,11,4,2020,28,0,Niger,NE,NER,22442948,Africa,11,438,6
2020-04-12T00:00:00Z,12,4,2020,53,0,Niger,NE,NER,22442948,Africa,11,491,7
2020-04-13T00:00:00Z,13,4,2020,38,1,Niger,NE,NER,22442948,Africa,12,529,8
2020-04-14T00:00:00Z,14,4,2020,19,1,Niger,NE,NER,22442948,Africa,13,548,9
2020-04-15T00:00:00Z,15,4,2020,22,1,Niger,NE,NER,22442948,Africa,14,570,10
2020-04-16T00:00:00Z,16,4,2020,14,0,Niger,NE,NER,22442948,Africa,14,584,11
2020-04-17T00:00:00Z,17,4,2020,25,1,Niger,NE,NER,22442948,Africa,15,609,12
2020-04-18T00:00:00Z,18,4,2020,18,3,Niger,NE,NER,22442948,Africa,18,627,13
2020-04-19T00:00:00Z,19,4,2020,12,1,Niger,NE,NER,22442948,Africa,19,639,14
2020-04-20T00:00:00Z,20,4,2020,9,1,Niger,NE,NER,22442948,Africa,20,648,15
2020-04-21T00:00:00Z,21,4,2020,7,0,Niger,NE,NER,22442948,Africa,20,655,16
2020-04-22T00:00:00Z,22,4,2020,0,0,Niger,NE,NER,22442948,Africa,20,655,17
2020-04-23T00:00:00Z,23,4,2020,7,2,Niger,NE,NER,22442948,Africa,22,662,18
2020-04-24T00:00:00Z,24,4,2020,9,2,Niger,NE,NER,22442948,Africa,24,671,19
2020-04-25T00:00:00Z,25,4,2020,10,0,Niger,NE,NER,22442948,Africa,24,681,20
2020-04-26T00:00:00Z,26,4,2020,3,3,Niger,NE,NER,22442948,Africa,27,684,21
2020-04-27T00:00:00Z,27,4,2020,12,2,Niger,NE,NER,22442948,Africa,29,696,22
2020-04-28T00:00:00Z,28,4,2020,5,0,Niger,NE,NER,22442948,Africa,29,701,23
2020-04-29T00:00:00Z,29,4,2020,8,2,Niger,NE,NER,22442948,Africa,31,709,24
2020-04-30T00:00:00Z,30,4,2020,4,1,Niger,NE,NER,22442948,Africa,32,713,25
2020-05-01T00:00:00Z,1,5,2020,6,0,Niger,NE,NER,22442948,Africa,32,719,26
2020-05-02T00:00:00Z,2,5,2020,9,1,Niger,NE,NER,22442948,Africa,33,728,27
2020-05-03T00:00:00Z,3,5,2020,8,2,Niger,NE,NER,22442948,Africa,35,736,28
2020-05-04T00:00:00Z,4,5,2020,14,1,Niger,NE,NER,22442948,Africa,36,750,29
2020-05-05T00:00:00Z,5,5,2020,5,1,Niger,NE,NER,22442948,Africa,37,755,30
2020-05-06T00:00:00Z,6,5,2020,8,1,Niger,NE,NER,22442948,Africa,38,763,31
2020-05-07T00:00:00Z,7,5,2020,7,0,Niger,NE,NER,22442948,Africa,38,770,32
2020-05-08T00:00:00Z,8,5,2020,11,4,Niger,NE,NER,22442948,Africa,42,781,33
2020-05-09T00:00:00Z,9,5,2020,14,2,Niger,NE,NER,22442948,Africa,44,795,34
2020-05-10T00:00:00Z,10,5,2020,20,1,Niger,NE,NER,22442948,Africa,45,815,35
2020-05-11T00:00:00Z,11,5,2020,6,1,Niger,NE,NER,22442948,Africa,46,821,36
2020-05-12T00:00:00Z,12,5,2020,11,0,Niger,NE,NER,22442948,Africa,46,832,37
2020-05-13T00:00:00Z,13,5,2020,22,1,Niger,NE,NER,22442948,Africa,47,854,38
2020-05-14T00:00:00Z,14,5,2020,6,2,Niger,NE,NER,22442948,Africa,49,860,39
2020-05-15T00:00:00Z,15,5,2020,16,1,Niger,NE,NER,22442948,Africa,50,876,40
2020-05-16T00:00:00Z,16,5,2020,9,1,Niger,NE,NER,22442948,Africa,51,885,41
2020-05-17T00:00:00Z,17,5,2020,4,0,Niger,NE,NER,22442948,Africa,51,889,42
2020-05-18T00:00:00Z,18,5,2020,15,3,Niger,NE,NER,22442948,Africa,54,904,43
2020-05-19T00:00:00Z,19,5,2020,5,1,Niger,NE,NER,22442948,Africa,55,909,44
2020-05-20T00:00:00Z,20,5,2020,5,0,Niger,NE,NER,22442948,Africa,55,914,45
2020-05-21T00:00:00Z,21,5,2020,6,3,Niger,NE,NER,22442948,Africa,58,920,46
2020-05-22T00:00:00Z,22,5,2020,4,2,Niger,NE,NER,22442948,Africa,60,924,47
2020-05-23T00:00:00Z,23,5,2020,13,0,Niger,NE,NER,22442948,Africa,60,937,48
2020-05-24T00:00:00Z,24,5,2020,6,1,Niger,NE,NER,22442948,Africa,61,943,49
2020-05-25T00:00:00Z,25,5,2020,2,0,Niger,NE,NER,22442948,Africa,61,945,50
2020-05-26T00:00:00Z,26,5,2020,6,1,Niger,NE,NER,22442948,Africa,62,951,51
2020-05-27T00:00:00Z,27,5,2020,1,1,Niger,NE,NER,22442948,Africa,63,952,52
2020-04-12T00:00:00Z,12,4,2020,13,3,Nigeria,NG,NGA,195874740,Africa,10,318,1
2020-04-13T00:00:00Z,13,4,2020,5,0,Nigeria,NG,NGA,195874740,Africa,10,323,2
2020-04-14T00:00:00Z,14,4,2020,20,0,Nigeria,NG,NGA,195874740,Africa,10,343,3
2020-04-15T00:00:00Z,15,4,2020,30,1,Nigeria,NG,NGA,195874740,Africa,11,373,4
2020-04-16T00:00:00Z,16,4,2020,34,1,Nigeria,NG,NGA,195874740,Africa,12,407,5
2020-04-17T00:00:00Z,17,4,2020,35,1,Nigeria,NG,NGA,195874740,Africa,13,442,6
2020-04-18T00:00:00Z,18,4,2020,51,4,Nigeria,NG,NGA,195874740,Africa,17,493,7
2020-04-19T00:00:00Z,19,4,2020,49,2,Nigeria,NG,NGA,195874740,Africa,19,542,8
2020-04-20T00:00:00Z,20,4,2020,85,2,Nigeria,NG,NGA,195874740,Africa,21,627,9
2020-04-21T00:00:00Z,21,4,2020,38,1,Nigeria,NG,NGA,195874740,Africa,22,665,10
2020-04-22T00:00:00Z,22,4,2020,117,3,Nigeria,NG,NGA,195874740,Africa,25,782,11
2020-04-23T00:00:00Z,23,4,2020,91,3,Nigeria,NG,NGA,195874740,Africa,28,873,12
2020-04-24T00:00:00Z,24,4,2020,108,3,Nigeria,NG,NGA,195874740,Africa,31,981,13
2020-04-25T00:00:00Z,25,4,2020,114,1,Nigeria,NG,NGA,195874740,Africa,32,1095,14
2020-04-26T00:00:00Z,26,4,2020,87,3,Nigeria,NG,NGA,195874740,Africa,35,1182,15
2020-04-27T00:00:00Z,27,4,2020,91,5,Nigeria,NG,NGA,195874740,Africa,40,1273,16
2020-04-28T00:00:00Z,28,4,2020,64,0,Nigeria,NG,NGA,195874740,Africa,40,1337,17
2020-04-29T00:00:00Z,29,4,2020,195,4,Nigeria,NG,NGA,195874740,Africa,44,1532,18
2020-04-30T00:00:00Z,30,4,2020,196,7,Nigeria,NG,NGA,195874740,Africa,51,1728,19
2020-05-01T00:00:00Z,1,5,2020,204,7,Nigeria,NG,NGA,195874740,Africa,58,1932,20
2020-05-02T00:00:00Z,2,5,2020,238,10,Nigeria,NG,NGA,195874740,Africa,68,2170,21
2020-05-03T00:00:00Z,3,5,2020,218,17,Nigeria,NG,NGA,195874740,Africa,85,2388,22
2020-05-04T00:00:00Z,4,5,2020,170,2,Nigeria,NG,NGA,195874740,Africa,87,2558,23
2020-05-05T00:00:00Z,5,5,2020,244,6,Nigeria,NG,NGA,195874740,Africa,93,2802,24
2020-05-06T00:00:00Z,6,5,2020,148,5,Nigeria,NG,NGA,195874740,Africa,98,2950,25
2020-05-07T00:00:00Z,7,5,2020,195,5,Nigeria,NG,NGA,195874740,Africa,103,3145,26
2020-05-08T00:00:00Z,8,5,2020,381,4,Nigeria,NG,NGA,195874740,Africa,107,3526,27
2020-05-09T00:00:00Z,9,5,2020,386,10,Nigeria,NG,NGA,195874740,Africa,117,3912,28
2020-05-10T00:00:00Z,10,5,2020,239,11,Nigeria,NG,NGA,195874740,Africa,128,4151,29
2020-05-11T00:00:00Z,11,5,2020,248,15,Nigeria,NG,NGA,195874740,Africa,143,4399,30
2020-05-12T00:00:00Z,12,5,2020,242,7,Nigeria,NG,NGA,195874740,Africa,150,4641,31
2020-05-13T00:00:00Z,13,5,2020,146,8,Nigeria,NG,NGA,195874740,Africa,158,4787,32
2020-05-14T00:00:00Z,14,5,2020,184,6,Nigeria,NG,NGA,195874740,Africa,164,4971,33
2020-05-15T00:00:00Z,15,5,2020,191,3,Nigeria,NG,NGA,195874740,Africa,167,5162,34
2020-05-16T00:00:00Z,16,5,2020,283,4,Nigeria,NG,NGA,195874740,Africa,171,5445,35
2020-05-17T00:00:00Z,17,5,2020,176,5,Nigeria,NG,NGA,195874740,Africa,176,5621,36
2020-05-18T00:00:00Z,18,5,2020,338,6,Nigeria,NG,NGA,195874740,Africa,182,5959,37
2020-05-19T00:00:00Z,19,5,2020,216,9,Nigeria,NG,NGA,195874740,Africa,191,6175,38
2020-05-20T00:00:00Z,20,5,2020,226,1,Nigeria,NG,NGA,195874740,Africa,192,6401,39
2020-05-21T00:00:00Z,21,5,2020,276,8,Nigeria,NG,NGA,195874740,Africa,200,6677,40
2020-05-22T00:00:00Z,22,5,2020,339,11,Nigeria,NG,NGA,195874740,Africa,211,7016,41
2020-05-23T00:00:00Z,23,5,2020,245,10,Nigeria,NG,NGA,195874740,Africa,221,7261,42
2020-05-24T00:00:00Z,24,5,2020,265,0,Nigeria,NG,NGA,195874740,Africa,221,7526,43
2020-05-25T00:00:00Z,25,5,2020,313,5,Nigeria,NG,NGA,195874740,Africa,226,7839,44
2020-05-26T00:00:00Z,26,5,2020,229,7,Nigeria,NG,NGA,195874740,Africa,233,8068,45
2020-05-27T00:00:00Z,27,5,2020,276,16,Nigeria,NG,NGA,195874740,Africa,249,8344,46
2020-04-02T00:00:00Z,2,4,2020,25,1,North_Macedonia,MK,MKD,2082958,Europe,10,354,1
2020-04-03T00:00:00Z,3,4,2020,0,1,North_Macedonia,MK,MKD,2082958,Europe,11,354,2
2020-04-04T00:00:00Z,4,4,2020,76,1,North_Macedonia,MK,MKD,2082958,Europe,12,430,3
2020-04-05T00:00:00Z,5,4,2020,53,5,North_Macedonia,MK,MKD,2082958,Europe,17,483,4
2020-04-06T00:00:00Z,6,4,2020,0,0,North_Macedonia,MK,MKD,2082958,Europe,17,483,5
2020-04-07T00:00:00Z,7,4,2020,87,4,North_Macedonia,MK,MKD,2082958,Europe,21,570,6
2020-04-08T00:00:00Z,8,4,2020,29,5,North_Macedonia,MK,MKD,2082958,Europe,26,599,7
2020-04-09T00:00:00Z,9,4,2020,18,4,North_Macedonia,MK,MKD,2082958,Europe,30,617,8
2020-04-10T00:00:00Z,10,4,2020,46,2,North_Macedonia,MK,MKD,2082958,Europe,32,663,9
2020-04-11T00:00:00Z,11,4,2020,48,0,North_Macedonia,MK,MKD,2082958,Europe,32,711,10
2020-04-12T00:00:00Z,12,4,2020,49,2,North_Macedonia,MK,MKD,2082958,Europe,34,760,11
2020-04-13T00:00:00Z,13,4,2020,68,0,North_Macedonia,MK,MKD,2082958,Europe,34,828,12
2020-04-14T00:00:00Z,14,4,2020,26,4,North_Macedonia,MK,MKD,2082958,Europe,38,854,13
2020-04-15T00:00:00Z,15,4,2020,54,6,North_Macedonia,MK,MKD,2082958,Europe,44,908,14
2020-04-16T00:00:00Z,16,4,2020,66,1,North_Macedonia,MK,MKD,2082958,Europe,45,974,15
2020-04-17T00:00:00Z,17,4,2020,107,1,North_Macedonia,MK,MKD,2082958,Europe,46,1081,16
2020-04-18T00:00:00Z,18,4,2020,36,3,North_Macedonia,MK,MKD,2082958,Europe,49,1117,17
2020-04-19T00:00:00Z,19,4,2020,53,0,North_Macedonia,MK,MKD,2082958,Europe,49,1170,18
2020-04-20T00:00:00Z,20,4,2020,37,2,North_Macedonia,MK,MKD,2082958,Europe,51,1207,19
2020-04-21T00:00:00Z,21,4,2020,18,3,North_Macedonia,MK,MKD,2082958,Europe,54,1225,20
2020-04-22T00:00:00Z,22,4,2020,6,1,North_Macedonia,MK,MKD,2082958,Europe,55,1231,21
2020-04-23T00:00:00Z,23,4,2020,28,1,North_Macedonia,MK,MKD,2082958,Europe,56,1259,22
2020-04-24T00:00:00Z,24,4,2020,41,0,North_Macedonia,MK,MKD,2082958,Europe,56,1300,23
2020-04-25T00:00:00Z,25,4,2020,26,1,North_Macedonia,MK,MKD,2082958,Europe,57,1326,24
2020-04-26T00:00:00Z,26,4,2020,41,2,North_Macedonia,MK,MKD,2082958,Europe,59,1367,25
2020-04-27T00:00:00Z,27,4,2020,19,2,North_Macedonia,MK,MKD,2082958,Europe,61,1386,26
2020-04-28T00:00:00Z,28,4,2020,13,4,North_Macedonia,MK,MKD,2082958,Europe,65,1399,27
2020-04-29T00:00:00Z,29,4,2020,22,6,North_Macedonia,MK,MKD,2082958,Europe,71,1421,28
2020-04-30T00:00:00Z,30,4,2020,21,2,North_Macedonia,MK,MKD,2082958,Europe,73,1442,29
2020-05-01T00:00:00Z,1,5,2020,23,4,North_Macedonia,MK,MKD,2082958,Europe,77,1465,30
2020-05-02T00:00:00Z,2,5,2020,29,4,North_Macedonia,MK,MKD,2082958,Europe,81,1494,31
2020-05-03T00:00:00Z,3,5,2020,12,1,North_Macedonia,MK,MKD,2082958,Europe,82,1506,32
2020-05-04T00:00:00Z,4,5,2020,5,2,North_Macedonia,MK,MKD,2082958,Europe,84,1511,33
2020-05-05T00:00:00Z,5,5,2020,7,1,North_Macedonia,MK,MKD,2082958,Europe,85,1518,34
2020-05-06T00:00:00Z,6,5,2020,8,1,North_Macedonia,MK,MKD,2082958,Europe,86,1526,35
2020-05-07T00:00:00Z,7,5,2020,13,2,North_Macedonia,MK,MKD,2082958,Europe,88,1539,36
2020-05-08T00:00:00Z,8,5,2020,33,1,North_Macedonia,MK,MKD,2082958,Europe,89,1572,37
2020-05-09T00:00:00Z,9,5,2020,14,1,North_Macedonia,MK,MKD,2082958,Europe,90,1586,38
2020-05-10T00:00:00Z,10,5,2020,36,1,North_Macedonia,MK,MKD,2082958,Europe,91,1622,39
2020-05-11T00:00:00Z,11,5,2020,20,0,North_Macedonia,MK,MKD,2082958,Europe,91,1642,40
2020-05-12T00:00:00Z,12,5,2020,22,0,North_Macedonia,MK,MKD,2082958,Europe,91,1664,41
2020-05-13T00:00:00Z,13,5,2020,10,1,North_Macedonia,MK,MKD,2082958,Europe,92,1674,42
2020-05-14T00:00:00Z,14,5,2020,20,3,North_Macedonia,MK,MKD,2082958,Europe,95,1694,43
2020-05-15T00:00:00Z,15,5,2020,29,0,North_Macedonia,MK,MKD,2082958,Europe,95,1723,44
2020-05-16T00:00:00Z,16,5,2020,17,2,North_Macedonia,MK,MKD,2082958,Europe,97,1740,45
2020-05-17T00:00:00Z,17,5,2020,22,1,North_Macedonia,MK,MKD,2082958,Europe,98,1762,46
2020-05-18T00:00:00Z,18,5,2020,30,3,North_Macedonia,MK,MKD,2082958,Europe,101,1792,47
2020-05-19T00:00:00Z,19,5,2020,25,3,North_Macedonia,MK,MKD,2082958,Europe,104,1817,48
2020-05-20T00:00:00Z,20,5,2020,22,2,North_Macedonia,MK,MKD,2082958,Europe,106,1839,49
2020-05-21T00:00:00Z,21,5,2020,19,4,North_Macedonia,MK,MKD,2082958,Europe,110,1858,50
2020-05-22T00:00:00Z,22,5,2020,40,1,North_Macedonia,MK,MKD,2082958,Europe,111,1898,51
2020-05-23T00:00:00Z,23,5,2020,23,1,North_Macedonia,MK,MKD,2082958,Europe,112,1921,52
2020-05-24T00:00:00Z,24,5,2020,20,1,North_Macedonia,MK,MKD,2082958,Europe,113,1941,53
2020-05-25T00:00:00Z,25,5,2020,37,0,North_Macedonia,MK,MKD,2082958,Europe,113,1978,54
2020-05-26T00:00:00Z,26,5,2020,21,0,North_Macedonia,MK,MKD,2082958,Europe,113,1999,55
2020-05-27T00:00:00Z,27,5,2020,16,3,North_Macedonia,MK,MKD,2082958,Europe,116,2015,56
2020-03-25T00:00:00Z,25,3,2020,195,2,Norway,NO,NOR,5314336,Europe,10,2566,1
2020-03-26T00:00:00Z,26,3,2020,350,2,Norway,NO,NOR,5314336,Europe,12,2916,2
2020-03-27T00:00:00Z,27,3,2020,240,2,Norway,NO,NOR,5314336,Europe,14,3156,3
2020-03-28T00:00:00Z,28,3,2020,425,2,Norway,NO,NOR,5314336,Europe,16,3581,4
2020-03-29T00:00:00Z,29,3,2020,264,4,Norway,NO,NOR,5314336,Europe,20,3845,5
2020-03-30T00:00:00Z,30,3,2020,257,2,Norway,NO,NOR,5314336,Europe,22,4102,6
2020-03-31T00:00:00Z,31,3,2020,124,4,Norway,NO,NOR,5314336,Europe,26,4226,7
2020-04-01T00:00:00Z,1,4,2020,221,2,Norway,NO,NOR,5314336,Europe,28,4447,8
2020-04-02T00:00:00Z,2,4,2020,218,4,Norway,NO,NOR,5314336,Europe,32,4665,9
2020-04-03T00:00:00Z,3,4,2020,270,10,Norway,NO,NOR,5314336,Europe,42,4935,10
2020-04-04T00:00:00Z,4,4,2020,273,2,Norway,NO,NOR,5314336,Europe,44,5208,11
2020-04-05T00:00:00Z,5,4,2020,302,6,Norway,NO,NOR,5314336,Europe,50,5510,12
2020-04-06T00:00:00Z,6,4,2020,130,8,Norway,NO,NOR,5314336,Europe,58,5640,13
2020-04-07T00:00:00Z,7,4,2020,115,1,Norway,NO,NOR,5314336,Europe,59,5755,14
2020-04-08T00:00:00Z,8,4,2020,108,10,Norway,NO,NOR,5314336,Europe,69,5863,15
2020-04-09T00:00:00Z,9,4,2020,147,11,Norway,NO,NOR,5314336,Europe,80,6010,16
2020-04-10T00:00:00Z,10,4,2020,150,8,Norway,NO,NOR,5314336,Europe,88,6160,17
2020-04-11T00:00:00Z,11,4,2020,84,4,Norway,NO,NOR,5314336,Europe,92,6244,18
2020-04-12T00:00:00Z,12,4,2020,76,6,Norway,NO,NOR,5314336,Europe,98,6320,19
2020-04-13T00:00:00Z,13,4,2020,95,5,Norway,NO,NOR,5314336,Europe,103,6415,20
2020-04-14T00:00:00Z,14,4,2020,73,11,Norway,NO,NOR,5314336,Europe,114,6488,21
2020-04-15T00:00:00Z,15,4,2020,78,13,Norway,NO,NOR,5314336,Europe,127,6566,22
2020-04-16T00:00:00Z,16,4,2020,111,3,Norway,NO,NOR,5314336,Europe,130,6677,23
2020-04-17T00:00:00Z,17,4,2020,114,6,Norway,NO,NOR,5314336,Europe,136,6791,24
2020-04-18T00:00:00Z,18,4,2020,0,0,Norway,NO,NOR,5314336,Europe,136,6791,25
2020-04-19T00:00:00Z,19,4,2020,193,12,Norway,NO,NOR,5314336,Europe,148,6984,26
2020-04-20T00:00:00Z,20,4,2020,84,6,Norway,NO,NOR,5314336,Europe,154,7068,27
2020-04-21T00:00:00Z,21,4,2020,45,0,Norway,NO,NOR,5314336,Europe,154,7113,28
2020-04-22T00:00:00Z,22,4,2020,53,9,Norway,NO,NOR,5314336,Europe,163,7166,29
2020-04-23T00:00:00Z,23,4,2020,84,6,Norway,NO,NOR,5314336,Europe,169,7250,30
2020-04-24T00:00:00Z,24,4,2020,95,11,Norway,NO,NOR,5314336,Europe,180,7345,31
2020-04-25T00:00:00Z,25,4,2020,63,11,Norway,NO,NOR,5314336,Europe,191,7408,32
2020-04-26T00:00:00Z,26,4,2020,59,2,Norway,NO,NOR,5314336,Europe,193,7467,33
2020-04-27T00:00:00Z,27,4,2020,38,0,Norway,NO,NOR,5314336,Europe,193,7505,34
2020-04-28T00:00:00Z,28,4,2020,28,0,Norway,NO,NOR,5314336,Europe,193,7533,35
2020-04-29T00:00:00Z,29,4,2020,72,2,Norway,NO,NOR,5314336,Europe,195,7605,36
2020-04-30T00:00:00Z,30,4,2020,62,7,Norway,NO,NOR,5314336,Europe,202,7667,37
2020-05-01T00:00:00Z,1,5,2020,43,2,Norway,NO,NOR,5314336,Europe,204,7710,38
2020-05-02T00:00:00Z,2,5,2020,49,0,Norway,NO,NOR,5314336,Europe,204,7759,39
2020-05-03T00:00:00Z,3,5,2020,0,0,Norway,NO,NOR,5314336,Europe,204,7759,40
2020-05-04T00:00:00Z,4,5,2020,50,4,Norway,NO,NOR,5314336,Europe,208,7809,41
2020-05-05T00:00:00Z,5,5,2020,38,0,Norway,NO,NOR,5314336,Europe,208,7847,42
2020-05-06T00:00:00Z,6,5,2020,56,1,Norway,NO,NOR,5314336,Europe,209,7903,43
2020-05-07T00:00:00Z,7,5,2020,50,0,Norway,NO,NOR,5314336,Europe,209,7953,44
2020-05-08T00:00:00Z,8,5,2020,42,0,Norway,NO,NOR,5314336,Europe,209,7995,45
2020-05-09T00:00:00Z,9,5,2020,39,4,Norway,NO,NOR,5314336,Europe,213,8034,46
2020-05-10T00:00:00Z,10,5,2020,35,0,Norway,NO,NOR,5314336,Europe,213,8069,47
2020-05-11T00:00:00Z,11,5,2020,30,4,Norway,NO,NOR,5314336,Europe,217,8099,48
2020-05-12T00:00:00Z,12,5,2020,7,7,Norway,NO,NOR,5314336,Europe,224,8106,49
2020-05-13T00:00:00Z,13,5,2020,29,4,Norway,NO,NOR,5314336,Europe,228,8135,50
2020-05-14T00:00:00Z,14,5,2020,23,1,Norway,NO,NOR,5314336,Europe,229,8158,51
2020-05-15T00:00:00Z,15,5,2020,17,3,Norway,NO,NOR,5314336,Europe,232,8175,52
2020-05-16T00:00:00Z,16,5,2020,22,0,Norway,NO,NOR,5314336,Europe,232,8197,53
2020-05-17T00:00:00Z,17,5,2020,0,0,Norway,NO,NOR,5314336,Europe,232,8197,54
2020-05-18T00:00:00Z,18,5,2020,0,0,Norway,NO,NOR,5314336,Europe,232,8197,55
2020-05-19T00:00:00Z,19,5,2020,52,1,Norway,NO,NOR,5314336,Europe,233,8249,56
2020-05-20T00:00:00Z,20,5,2020,8,0,Norway,NO,NOR,5314336,Europe,233,8257,57
2020-05-21T00:00:00Z,21,5,2020,11,1,Norway,NO,NOR,5314336,Europe,234,8268,58
2020-05-22T00:00:00Z,22,5,2020,0,0,Norway,NO,NOR,5314336,Europe,234,8268,59
2020-05-23T00:00:00Z,23,5,2020,41,1,Norway,NO,NOR,5314336,Europe,235,8309,60
2020-05-24T00:00:00Z,24,5,2020,0,0,Norway,NO,NOR,5314336,Europe,235,8309,61
2020-05-25T00:00:00Z,25,5,2020,0,0,Norway,NO,NOR,5314336,Europe,235,8309,62
2020-05-26T00:00:00Z,26,5,2020,43,0,Norway,NO,NOR,5314336,Europe,235,8352,63
2020-05-27T00:00:00Z,27,5,2020,12,0,Norway,NO,NOR,5314336,Europe,235,8364,64
2020-04-25T00:00:00Z,25,4,2020,74,1,Oman,OM,OMN,4829483,Asia,10,1790,1
2020-04-26T00:00:00Z,26,4,2020,115,0,Oman,OM,OMN,4829483,Asia,10,1905,2
2020-04-27T00:00:00Z,27,4,2020,93,0,Oman,OM,OMN,4829483,Asia,10,1998,3
2020-04-28T00:00:00Z,28,4,2020,51,0,Oman,OM,OMN,4829483,Asia,10,2049,4
2020-04-29T00:00:00Z,29,4,2020,82,0,Oman,OM,OMN,4829483,Asia,10,2131,5
2020-04-30T00:00:00Z,30,4,2020,143,0,Oman,OM,OMN,4829483,Asia,10,2274,6
2020-05-01T00:00:00Z,1,5,2020,74,1,Oman,OM,OMN,4829483,Asia,11,2348,7
2020-05-02T00:00:00Z,2,5,2020,99,0,Oman,OM,OMN,4829483,Asia,11,2447,8
2020-05-03T00:00:00Z,3,5,2020,36,1,Oman,OM,OMN,4829483,Asia,12,2483,9
2020-05-04T00:00:00Z,4,5,2020,85,0,Oman,OM,OMN,4829483,Asia,12,2568,10
2020-05-05T00:00:00Z,5,5,2020,69,0,Oman,OM,OMN,4829483,Asia,12,2637,11
2020-05-06T00:00:00Z,6,5,2020,98,0,Oman,OM,OMN,4829483,Asia,12,2735,12
2020-05-07T00:00:00Z,7,5,2020,168,1,Oman,OM,OMN,4829483,Asia,13,2903,13
2020-05-08T00:00:00Z,8,5,2020,55,1,Oman,OM,OMN,4829483,Asia,14,2958,14
2020-05-09T00:00:00Z,9,5,2020,154,1,Oman,OM,OMN,4829483,Asia,15,3112,15
2020-05-10T00:00:00Z,10,5,2020,112,2,Oman,OM,OMN,4829483,Asia,17,3224,16
2020-05-11T00:00:00Z,11,5,2020,175,0,Oman,OM,OMN,4829483,Asia,17,3399,17
2020-05-12T00:00:00Z,12,5,2020,175,0,Oman,OM,OMN,4829483,Asia,17,3574,18
2020-05-13T00:00:00Z,13,5,2020,147,0,Oman,OM,OMN,4829483,Asia,17,3721,19
2020-05-14T00:00:00Z,14,5,2020,298,0,Oman,OM,OMN,4829483,Asia,17,4019,20
2020-05-15T00:00:00Z,15,5,2020,322,2,Oman,OM,OMN,4829483,Asia,19,4341,21
2020-05-16T00:00:00Z,16,5,2020,284,0,Oman,OM,OMN,4829483,Asia,19,4625,22
2020-05-17T00:00:00Z,17,5,2020,404,2,Oman,OM,OMN,4829483,Asia,21,5029,23
2020-05-18T00:00:00Z,18,5,2020,157,1,Oman,OM,OMN,4829483,Asia,22,5186,24
2020-05-19T00:00:00Z,19,5,2020,193,4,Oman,OM,OMN,4829483,Asia,26,5379,25
2020-05-20T00:00:00Z,20,5,2020,292,1,Oman,OM,OMN,4829483,Asia,27,5671,26
2020-05-21T00:00:00Z,21,5,2020,372,3,Oman,OM,OMN,4829483,Asia,30,6043,27
2020-05-22T00:00:00Z,22,5,2020,327,1,Oman,OM,OMN,4829483,Asia,31,6370,28
2020-05-23T00:00:00Z,23,5,2020,424,1,Oman,OM,OMN,4829483,Asia,32,6794,29
2020-05-24T00:00:00Z,24,5,2020,463,4,Oman,OM,OMN,4829483,Asia,36,7257,30
2020-05-25T00:00:00Z,25,5,2020,513,1,Oman,OM,OMN,4829483,Asia,37,7770,31
2020-05-26T00:00:00Z,26,5,2020,0,0,Oman,OM,OMN,4829483,Asia,37,7770,32
2020-05-27T00:00:00Z,27,5,2020,348,0,Oman,OM,OMN,4829483,Asia,37,8118,33
2020-03-29T00:00:00Z,29,3,2020,211,2,Pakistan,PK,PAK,212215030,Asia,11,1408,1
2020-03-30T00:00:00Z,30,3,2020,118,2,Pakistan,PK,PAK,212215030,Asia,13,1526,2
2020-03-31T00:00:00Z,31,3,2020,99,5,Pakistan,PK,PAK,212215030,Asia,18,1625,3
2020-04-01T00:00:00Z,1,4,2020,414,8,Pakistan,PK,PAK,212215030,Asia,26,2039,4
2020-04-02T00:00:00Z,2,4,2020,252,5,Pakistan,PK,PAK,212215030,Asia,31,2291,5
2020-04-03T00:00:00Z,3,4,2020,0,0,Pakistan,PK,PAK,212215030,Asia,31,2291,6
2020-04-04T00:00:00Z,4,4,2020,0,0,Pakistan,PK,PAK,212215030,Asia,31,2291,7
2020-04-05T00:00:00Z,5,4,2020,159,4,Pakistan,PK,PAK,212215030,Asia,35,2450,8
2020-04-06T00:00:00Z,6,4,2020,827,15,Pakistan,PK,PAK,212215030,Asia,50,3277,9
2020-04-07T00:00:00Z,7,4,2020,587,4,Pakistan,PK,PAK,212215030,Asia,54,3864,10
2020-04-08T00:00:00Z,8,4,2020,208,4,Pakistan,PK,PAK,212215030,Asia,58,4072,11
2020-04-09T00:00:00Z,9,4,2020,250,5,Pakistan,PK,PAK,212215030,Asia,63,4322,12
2020-04-10T00:00:00Z,10,4,2020,279,3,Pakistan,PK,PAK,212215030,Asia,66,4601,13
2020-04-11T00:00:00Z,11,4,2020,187,5,Pakistan,PK,PAK,212215030,Asia,71,4788,14
2020-04-12T00:00:00Z,12,4,2020,250,15,Pakistan,PK,PAK,212215030,Asia,86,5038,15
2020-04-13T00:00:00Z,13,4,2020,336,7,Pakistan,PK,PAK,212215030,Asia,93,5374,16
2020-04-14T00:00:00Z,14,4,2020,342,3,Pakistan,PK,PAK,212215030,Asia,96,5716,17
2020-04-15T00:00:00Z,15,4,2020,272,11,Pakistan,PK,PAK,212215030,Asia,107,5988,18
2020-04-16T00:00:00Z,16,4,2020,517,17,Pakistan,PK,PAK,212215030,Asia,124,6505,19
2020-04-17T00:00:00Z,17,4,2020,520,11,Pakistan,PK,PAK,212215030,Asia,135,7025,20
2020-04-18T00:00:00Z,18,4,2020,456,8,Pakistan,PK,PAK,212215030,Asia,143,7481,21
2020-04-19T00:00:00Z,19,4,2020,512,16,Pakistan,PK,PAK,212215030,Asia,159,7993,22
2020-04-20T00:00:00Z,20,4,2020,425,17,Pakistan,PK,PAK,212215030,Asia,176,8418,23
2020-04-21T00:00:00Z,21,4,2020,798,16,Pakistan,PK,PAK,212215030,Asia,192,9216,24
2020-04-22T00:00:00Z,22,4,2020,533,17,Pakistan,PK,PAK,212215030,Asia,209,9749,25
2020-04-23T00:00:00Z,23,4,2020,0,0,Pakistan,PK,PAK,212215030,Asia,209,9749,26
2020-04-24T00:00:00Z,24,4,2020,1406,28,Pakistan,PK,PAK,212215030,Asia,237,11155,27
2020-04-25T00:00:00Z,25,4,2020,785,16,Pakistan,PK,PAK,212215030,Asia,253,11940,28
2020-04-26T00:00:00Z,26,4,2020,783,16,Pakistan,PK,PAK,212215030,Asia,269,12723,29
2020-04-27T00:00:00Z,27,4,2020,605,12,Pakistan,PK,PAK,212215030,Asia,281,13328,30
2020-04-28T00:00:00Z,28,4,2020,751,20,Pakistan,PK,PAK,212215030,Asia,301,14079,31
2020-04-29T00:00:00Z,29,4,2020,806,26,Pakistan,PK,PAK,212215030,Asia,327,14885,32
2020-04-30T00:00:00Z,30,4,2020,874,19,Pakistan,PK,PAK,212215030,Asia,346,15759,33
2020-05-01T00:00:00Z,1,5,2020,1058,39,Pakistan,PK,PAK,212215030,Asia,385,16817,34
2020-05-02T00:00:00Z,2,5,2020,1297,32,Pakistan,PK,PAK,212215030,Asia,417,18114,35
2020-05-03T00:00:00Z,3,5,2020,989,23,Pakistan,PK,PAK,212215030,Asia,440,19103,36
2020-05-04T00:00:00Z,4,5,2020,1083,22,Pakistan,PK,PAK,212215030,Asia,462,20186,37
2020-05-05T00:00:00Z,5,5,2020,1315,24,Pakistan,PK,PAK,212215030,Asia,486,21501,38
2020-05-06T00:00:00Z,6,5,2020,1049,40,Pakistan,PK,PAK,212215030,Asia,526,22550,39
2020-05-07T00:00:00Z,7,5,2020,1523,38,Pakistan,PK,PAK,212215030,Asia,564,24073,40
2020-05-08T00:00:00Z,8,5,2020,1764,30,Pakistan,PK,PAK,212215030,Asia,594,25837,41
2020-05-09T00:00:00Z,9,5,2020,1637,24,Pakistan,PK,PAK,212215030,Asia,618,27474,42
2020-05-10T00:00:00Z,10,5,2020,1991,21,Pakistan,PK,PAK,212215030,Asia,639,29465,43
2020-05-11T00:00:00Z,11,5,2020,1476,28,Pakistan,PK,PAK,212215030,Asia,667,30941,44
2020-05-12T00:00:00Z,12,5,2020,1140,39,Pakistan,PK,PAK,212215030,Asia,706,32081,45
2020-05-13T00:00:00Z,13,5,2020,2255,31,Pakistan,PK,PAK,212215030,Asia,737,34336,46
2020-05-14T00:00:00Z,14,5,2020,1452,33,Pakistan,PK,PAK,212215030,Asia,770,35788,47
2020-05-15T00:00:00Z,15,5,2020,1430,33,Pakistan,PK,PAK,212215030,Asia,803,37218,48
2020-05-16T00:00:00Z,16,5,2020,1581,31,Pakistan,PK,PAK,212215030,Asia,834,38799,49
2020-05-17T00:00:00Z,17,5,2020,1352,39,Pakistan,PK,PAK,212215030,Asia,873,40151,50
2020-05-18T00:00:00Z,18,5,2020,1974,30,Pakistan,PK,PAK,212215030,Asia,903,42125,51
2020-05-19T00:00:00Z,19,5,2020,1841,36,Pakistan,PK,PAK,212215030,Asia,939,43966,52
2020-05-20T00:00:00Z,20,5,2020,1932,46,Pakistan,PK,PAK,212215030,Asia,985,45898,53
2020-05-21T00:00:00Z,21,5,2020,2193,32,Pakistan,PK,PAK,212215030,Asia,1017,48091,54
2020-05-22T00:00:00Z,22,5,2020,2603,50,Pakistan,PK,PAK,212215030,Asia,1067,50694,55
2020-05-23T00:00:00Z,23,5,2020,1743,34,Pakistan,PK,PAK,212215030,Asia,1101,52437,56
2020-05-24T00:00:00Z,24,5,2020,2164,32,Pakistan,PK,PAK,212215030,Asia,1133,54601,57
2020-05-25T00:00:00Z,25,5,2020,1748,34,Pakistan,PK,PAK,212215030,Asia,1167,56349,58
2020-05-26T00:00:00Z,26,5,2020,1356,30,Pakistan,PK,PAK,212215030,Asia,1197,57705,59
2020-05-27T00:00:00Z,27,5,2020,1446,28,Pakistan,PK,PAK,212215030,Asia,1225,59151,60
2020-03-28T00:00:00Z,28,3,2020,112,5,Panama,PA,PAN,4176873,America,14,786,1
2020-03-29T00:00:00Z,29,3,2020,115,3,Panama,PA,PAN,4176873,America,17,901,2
2020-03-30T00:00:00Z,30,3,2020,88,7,Panama,PA,PAN,4176873,America,24,989,3
2020-03-31T00:00:00Z,31,3,2020,86,2,Panama,PA,PAN,4176873,America,26,1075,4
2020-04-01T00:00:00Z,1,4,2020,106,4,Panama,PA,PAN,4176873,America,30,1181,5
2020-04-02T00:00:00Z,2,4,2020,136,2,Panama,PA,PAN,4176873,America,32,1317,6
2020-04-03T00:00:00Z,3,4,2020,158,5,Panama,PA,PAN,4176873,America,37,1475,7
2020-04-04T00:00:00Z,4,4,2020,198,4,Panama,PA,PAN,4176873,America,41,1673,8
2020-04-05T00:00:00Z,5,4,2020,128,5,Panama,PA,PAN,4176873,America,46,1801,9
2020-04-06T00:00:00Z,6,4,2020,187,8,Panama,PA,PAN,4176873,America,54,1988,10
2020-04-07T00:00:00Z,7,4,2020,112,1,Panama,PA,PAN,4176873,America,55,2100,11
2020-04-08T00:00:00Z,8,4,2020,149,4,Panama,PA,PAN,4176873,America,59,2249,12
2020-04-09T00:00:00Z,9,4,2020,279,4,Panama,PA,PAN,4176873,America,63,2528,13
2020-04-10T00:00:00Z,10,4,2020,224,3,Panama,PA,PAN,4176873,America,66,2752,14
2020-04-11T00:00:00Z,11,4,2020,222,8,Panama,PA,PAN,4176873,America,74,2974,15
2020-04-12T00:00:00Z,12,4,2020,260,5,Panama,PA,PAN,4176873,America,79,3234,16
2020-04-13T00:00:00Z,13,4,2020,166,8,Panama,PA,PAN,4176873,America,87,3400,17
2020-04-14T00:00:00Z,14,4,2020,72,7,Panama,PA,PAN,4176873,America,94,3472,18
2020-04-15T00:00:00Z,15,4,2020,102,1,Panama,PA,PAN,4176873,America,95,3574,19
2020-04-16T00:00:00Z,16,4,2020,177,8,Panama,PA,PAN,4176873,America,103,3751,20
2020-04-17T00:00:00Z,17,4,2020,265,6,Panama,PA,PAN,4176873,America,109,4016,21
2020-04-18T00:00:00Z,18,4,2020,194,7,Panama,PA,PAN,4176873,America,116,4210,22
2020-04-19T00:00:00Z,19,4,2020,63,4,Panama,PA,PAN,4176873,America,120,4273,23
2020-04-20T00:00:00Z,20,4,2020,194,6,Panama,PA,PAN,4176873,America,126,4467,24
2020-04-21T00:00:00Z,21,4,2020,191,10,Panama,PA,PAN,4176873,America,136,4658,25
2020-04-22T00:00:00Z,22,4,2020,163,5,Panama,PA,PAN,4176873,America,141,4821,26
2020-04-23T00:00:00Z,23,4,2020,171,3,Panama,PA,PAN,4176873,America,144,4992,27
2020-04-24T00:00:00Z,24,4,2020,174,2,Panama,PA,PAN,4176873,America,146,5166,28
2020-04-25T00:00:00Z,25,4,2020,172,8,Panama,PA,PAN,4176873,America,154,5338,29
2020-04-26T00:00:00Z,26,4,2020,200,5,Panama,PA,PAN,4176873,America,159,5538,30
2020-04-27T00:00:00Z,27,4,2020,241,6,Panama,PA,PAN,4176873,America,165,5779,31
2020-04-28T00:00:00Z,28,4,2020,242,2,Panama,PA,PAN,4176873,America,167,6021,32
2020-04-29T00:00:00Z,29,4,2020,179,9,Panama,PA,PAN,4176873,America,176,6200,33
2020-04-30T00:00:00Z,30,4,2020,178,2,Panama,PA,PAN,4176873,America,178,6378,34
2020-05-01T00:00:00Z,1,5,2020,154,10,Panama,PA,PAN,4176873,America,188,6532,35
2020-05-02T00:00:00Z,2,5,2020,188,4,Panama,PA,PAN,4176873,America,192,6720,36
2020-05-03T00:00:00Z,3,5,2020,370,5,Panama,PA,PAN,4176873,America,197,7090,37
2020-05-04T00:00:00Z,4,5,2020,107,3,Panama,PA,PAN,4176873,America,200,7197,38
2020-05-05T00:00:00Z,5,5,2020,190,3,Panama,PA,PAN,4176873,America,203,7387,39
2020-05-06T00:00:00Z,6,5,2020,136,7,Panama,PA,PAN,4176873,America,210,7523,40
2020-05-07T00:00:00Z,7,5,2020,208,8,Panama,PA,PAN,4176873,America,218,7731,41
2020-05-08T00:00:00Z,8,5,2020,137,7,Panama,PA,PAN,4176873,America,225,7868,42
2020-05-09T00:00:00Z,9,5,2020,202,6,Panama,PA,PAN,4176873,America,231,8070,43
2020-05-10T00:00:00Z,10,5,2020,212,6,Panama,PA,PAN,4176873,America,237,8282,44
2020-05-11T00:00:00Z,11,5,2020,166,7,Panama,PA,PAN,4176873,America,244,8448,45
2020-05-12T00:00:00Z,12,5,2020,168,5,Panama,PA,PAN,4176873,America,249,8616,46
2020-05-13T00:00:00Z,13,5,2020,167,3,Panama,PA,PAN,4176873,America,252,8783,47
2020-05-14T00:00:00Z,14,5,2020,161,4,Panama,PA,PAN,4176873,America,256,8944,48
2020-05-15T00:00:00Z,15,5,2020,174,4,Panama,PA,PAN,4176873,America,260,9118,49
2020-05-16T00:00:00Z,16,5,2020,150,6,Panama,PA,PAN,4176873,America,266,9268,50
2020-05-17T00:00:00Z,17,5,2020,181,3,Panama,PA,PAN,4176873,America,269,9449,51
2020-05-18T00:00:00Z,18,5,2020,157,6,Panama,PA,PAN,4176873,America,275,9606,52
2020-05-19T00:00:00Z,19,5,2020,120,4,Panama,PA,PAN,4176873,America,279,9726,53
2020-05-20T00:00:00Z,20,5,2020,141,2,Panama,PA,PAN,4176873,America,281,9867,54
2020-05-21T00:00:00Z,21,5,2020,110,6,Panama,PA,PAN,4176873,America,287,9977,55
2020-05-22T00:00:00Z,22,5,2020,139,4,Panama,PA,PAN,4176873,America,291,10116,56
2020-05-23T00:00:00Z,23,5,2020,151,4,Panama,PA,PAN,4176873,America,295,10267,57
2020-05-24T00:00:00Z,24,5,2020,310,4,Panama,PA,PAN,4176873,America,299,10577,58
2020-05-25T00:00:00Z,25,5,2020,349,7,Panama,PA,PAN,4176873,America,306,10926,59
2020-05-26T00:00:00Z,26,5,2020,257,4,Panama,PA,PAN,4176873,America,310,11183,60
2020-05-27T00:00:00Z,27,5,2020,264,3,Panama,PA,PAN,4176873,America,313,11447,61
2020-05-01T00:00:00Z,1,5,2020,17,1,Paraguay,PY,PRY,6956071,America,10,266,1
2020-05-02T00:00:00Z,2,5,2020,67,0,Paraguay,PY,PRY,6956071,America,10,333,2
2020-05-03T00:00:00Z,3,5,2020,37,0,Paraguay,PY,PRY,6956071,America,10,370,3
2020-05-04T00:00:00Z,4,5,2020,26,0,Paraguay,PY,PRY,6956071,America,10,396,4
2020-05-05T00:00:00Z,5,5,2020,19,0,Paraguay,PY,PRY,6956071,America,10,415,5
2020-05-06T00:00:00Z,6,5,2020,16,0,Paraguay,PY,PRY,6956071,America,10,431,6
2020-05-07T00:00:00Z,7,5,2020,9,0,Paraguay,PY,PRY,6956071,America,10,440,7
2020-05-08T00:00:00Z,8,5,2020,22,0,Paraguay,PY,PRY,6956071,America,10,462,8
2020-05-09T00:00:00Z,9,5,2020,101,0,Paraguay,PY,PRY,6956071,America,10,563,9
2020-05-10T00:00:00Z,10,5,2020,126,0,Paraguay,PY,PRY,6956071,America,10,689,10
2020-05-11T00:00:00Z,11,5,2020,24,0,Paraguay,PY,PRY,6956071,America,10,713,11
2020-05-12T00:00:00Z,12,5,2020,11,0,Paraguay,PY,PRY,6956071,America,10,724,12
2020-05-13T00:00:00Z,13,5,2020,13,0,Paraguay,PY,PRY,6956071,America,10,737,13
2020-05-14T00:00:00Z,14,5,2020,3,1,Paraguay,PY,PRY,6956071,America,11,740,14
2020-05-15T00:00:00Z,15,5,2020,14,0,Paraguay,PY,PRY,6956071,America,11,754,15
2020-05-16T00:00:00Z,16,5,2020,5,0,Paraguay,PY,PRY,6956071,America,11,759,16
2020-05-17T00:00:00Z,17,5,2020,19,0,Paraguay,PY,PRY,6956071,America,11,778,17
2020-05-18T00:00:00Z,18,5,2020,8,0,Paraguay,PY,PRY,6956071,America,11,786,18
2020-05-19T00:00:00Z,19,5,2020,2,0,Paraguay,PY,PRY,6956071,America,11,788,19
2020-05-20T00:00:00Z,20,5,2020,41,0,Paraguay,PY,PRY,6956071,America,11,829,20
2020-05-21T00:00:00Z,21,5,2020,4,0,Paraguay,PY,PRY,6956071,America,11,833,21
2020-05-22T00:00:00Z,22,5,2020,3,0,Paraguay,PY,PRY,6956071,America,11,836,22
2020-05-23T00:00:00Z,23,5,2020,2,0,Paraguay,PY,PRY,6956071,America,11,838,23
2020-05-24T00:00:00Z,24,5,2020,12,0,Paraguay,PY,PRY,6956071,America,11,850,24
2020-05-25T00:00:00Z,25,5,2020,12,0,Paraguay,PY,PRY,6956071,America,11,862,25
2020-05-26T00:00:00Z,26,5,2020,3,0,Paraguay,PY,PRY,6956071,America,11,865,26
2020-05-27T00:00:00Z,27,5,2020,12,0,Paraguay,PY,PRY,6956071,America,11,877,27
2020-03-28T00:00:00Z,28,3,2020,55,2,Peru,PE,PER,31989256,America,11,635,1
2020-03-29T00:00:00Z,29,3,2020,36,5,Peru,PE,PER,31989256,America,16,671,2
2020-03-30T00:00:00Z,30,3,2020,181,2,Peru,PE,PER,31989256,America,18,852,3
2020-03-31T00:00:00Z,31,3,2020,98,6,Peru,PE,PER,31989256,America,24,950,4
2020-04-01T00:00:00Z,1,4,2020,115,6,Peru,PE,PER,31989256,America,30,1065,5
2020-04-02T00:00:00Z,2,4,2020,258,17,Peru,PE,PER,31989256,America,47,1323,6
2020-04-03T00:00:00Z,3,4,2020,91,8,Peru,PE,PER,31989256,America,55,1414,7
2020-04-04T00:00:00Z,4,4,2020,181,6,Peru,PE,PER,31989256,America,61,1595,8
2020-04-05T00:00:00Z,5,4,2020,151,12,Peru,PE,PER,31989256,America,73,1746,9
2020-04-06T00:00:00Z,6,4,2020,535,10,Peru,PE,PER,31989256,America,83,2281,10
2020-04-07T00:00:00Z,7,4,2020,280,9,Peru,PE,PER,31989256,America,92,2561,11
2020-04-08T00:00:00Z,8,4,2020,393,15,Peru,PE,PER,31989256,America,107,2954,12
2020-04-09T00:00:00Z,9,4,2020,1388,14,Peru,PE,PER,31989256,America,121,4342,13
2020-04-10T00:00:00Z,10,4,2020,914,17,Peru,PE,PER,31989256,America,138,5256,14
2020-04-11T00:00:00Z,11,4,2020,641,31,Peru,PE,PER,31989256,America,169,5897,15
2020-04-12T00:00:00Z,12,4,2020,951,12,Peru,PE,PER,31989256,America,181,6848,16
2020-04-13T00:00:00Z,13,4,2020,671,12,Peru,PE,PER,31989256,America,193,7519,17
2020-04-14T00:00:00Z,14,4,2020,0,0,Peru,PE,PER,31989256,America,193,7519,18
2020-04-15T00:00:00Z,15,4,2020,2784,37,Peru,PE,PER,31989256,America,230,10303,19
2020-04-16T00:00:00Z,16,4,2020,1172,24,Peru,PE,PER,31989256,America,254,11475,20
2020-04-17T00:00:00Z,17,4,2020,1016,20,Peru,PE,PER,31989256,America,274,12491,21
2020-04-18T00:00:00Z,18,4,2020,998,26,Peru,PE,PER,31989256,America,300,13489,22
2020-04-19T00:00:00Z,19,4,2020,931,48,Peru,PE,PER,31989256,America,348,14420,23
2020-04-20T00:00:00Z,20,4,2020,1208,52,Peru,PE,PER,31989256,America,400,15628,24
2020-04-21T00:00:00Z,21,4,2020,697,45,Peru,PE,PER,31989256,America,445,16325,25
2020-04-22T00:00:00Z,22,4,2020,1512,39,Peru,PE,PER,31989256,America,484,17837,26
2020-04-23T00:00:00Z,23,4,2020,1413,46,Peru,PE,PER,31989256,America,530,19250,27
2020-04-24T00:00:00Z,24,4,2020,1664,42,Peru,PE,PER,31989256,America,572,20914,28
2020-04-25T00:00:00Z,25,4,2020,734,62,Peru,PE,PER,31989256,America,634,21648,29
2020-04-26T00:00:00Z,26,4,2020,3683,66,Peru,PE,PER,31989256,America,700,25331,30
2020-04-27T00:00:00Z,27,4,2020,2186,28,Peru,PE,PER,31989256,America,728,27517,31
2020-04-28T00:00:00Z,28,4,2020,1182,54,Peru,PE,PER,31989256,America,782,28699,32
2020-04-29T00:00:00Z,29,4,2020,2491,72,Peru,PE,PER,31989256,America,854,31190,33
2020-04-30T00:00:00Z,30,4,2020,2741,89,Peru,PE,PER,31989256,America,943,33931,34
2020-05-01T00:00:00Z,1,5,2020,3045,108,Peru,PE,PER,31989256,America,1051,36976,35
2020-05-02T00:00:00Z,2,5,2020,3483,73,Peru,PE,PER,31989256,America,1124,40459,36
2020-05-03T00:00:00Z,3,5,2020,2075,76,Peru,PE,PER,31989256,America,1200,42534,37
2020-05-04T00:00:00Z,4,5,2020,3394,86,Peru,PE,PER,31989256,America,1286,45928,38
2020-05-05T00:00:00Z,5,5,2020,1444,58,Peru,PE,PER,31989256,America,1344,47372,39
2020-05-06T00:00:00Z,6,5,2020,3817,100,Peru,PE,PER,31989256,America,1444,51189,40
2020-05-07T00:00:00Z,7,5,2020,3628,89,Peru,PE,PER,31989256,America,1533,54817,41
2020-05-08T00:00:00Z,8,5,2020,3709,94,Peru,PE,PER,31989256,America,1627,58526,42
2020-05-09T00:00:00Z,9,5,2020,3321,87,Peru,PE,PER,31989256,America,1714,61847,43
2020-05-10T00:00:00Z,10,5,2020,3168,100,Peru,PE,PER,31989256,America,1814,65015,44
2020-05-11T00:00:00Z,11,5,2020,2292,75,Peru,PE,PER,31989256,America,1889,67307,45
2020-05-12T00:00:00Z,12,5,2020,1515,72,Peru,PE,PER,31989256,America,1961,68822,46
2020-05-13T00:00:00Z,13,5,2020,3237,96,Peru,PE,PER,31989256,America,2057,72059,47
2020-05-14T00:00:00Z,14,5,2020,4247,112,Peru,PE,PER,31989256,America,2169,76306,48
2020-05-15T00:00:00Z,15,5,2020,4298,98,Peru,PE,PER,31989256,America,2267,80604,49
2020-05-16T00:00:00Z,16,5,2020,3891,126,Peru,PE,PER,31989256,America,2393,84495,50
2020-05-17T00:00:00Z,17,5,2020,4046,130,Peru,PE,PER,31989256,America,2523,88541,51
2020-05-18T00:00:00Z,18,5,2020,3732,125,Peru,PE,PER,31989256,America,2648,92273,52
2020-05-19T00:00:00Z,19,5,2020,2660,141,Peru,PE,PER,31989256,America,2789,94933,53
2020-05-20T00:00:00Z,20,5,2020,4550,125,Peru,PE,PER,31989256,America,2914,99483,54
2020-05-21T00:00:00Z,21,5,2020,4537,110,Peru,PE,PER,31989256,America,3024,104020,55
2020-05-22T00:00:00Z,22,5,2020,4749,124,Peru,PE,PER,31989256,America,3148,108769,56
2020-05-23T00:00:00Z,23,5,2020,2929,96,Peru,PE,PER,31989256,America,3244,111698,57
2020-05-24T00:00:00Z,24,5,2020,4056,129,Peru,PE,PER,31989256,America,3373,115754,58
2020-05-25T00:00:00Z,25,5,2020,4205,83,Peru,PE,PER,31989256,America,3456,119959,59
2020-05-26T00:00:00Z,26,5,2020,4020,173,Peru,PE,PER,31989256,America,3629,123979,60
2020-05-27T00:00:00Z,27,5,2020,5772,159,Peru,PE,PER,31989256,America,3788,129751,61
2020-03-16T00:00:00Z,16,3,2020,29,6,Philippines,PH,PHL,106651922,Asia,12,140,1
2020-03-17T00:00:00Z,17,3,2020,2,0,Philippines,PH,PHL,106651922,Asia,12,142,2
2020-03-18T00:00:00Z,18,3,2020,45,2,Philippines,PH,PHL,106651922,Asia,14,187,3
2020-03-19T00:00:00Z,19,3,2020,15,3,Philippines,PH,PHL,106651922,Asia,17,202,4
2020-03-20T00:00:00Z,20,3,2020,28,1,Philippines,PH,PHL,106651922,Asia,18,230,5
2020-03-21T00:00:00Z,21,3,2020,0,0,Philippines,PH,PHL,106651922,Asia,18,230,6
2020-03-22T00:00:00Z,22,3,2020,150,7,Philippines,PH,PHL,106651922,Asia,25,380,7
2020-03-23T00:00:00Z,23,3,2020,0,0,Philippines,PH,PHL,106651922,Asia,25,380,8
2020-03-24T00:00:00Z,24,3,2020,82,8,Philippines,PH,PHL,106651922,Asia,33,462,9
2020-03-25T00:00:00Z,25,3,2020,90,2,Philippines,PH,PHL,106651922,Asia,35,552,10
2020-03-26T00:00:00Z,26,3,2020,84,3,Philippines,PH,PHL,106651922,Asia,38,636,11
2020-03-27T00:00:00Z,27,3,2020,71,7,Philippines,PH,PHL,106651922,Asia,45,707,12
2020-03-28T00:00:00Z,28,3,2020,96,9,Philippines,PH,PHL,106651922,Asia,54,803,13
2020-03-29T00:00:00Z,29,3,2020,272,14,Philippines,PH,PHL,106651922,Asia,68,1075,14
2020-03-30T00:00:00Z,30,3,2020,343,3,Philippines,PH,PHL,106651922,Asia,71,1418,15
2020-03-31T00:00:00Z,31,3,2020,666,17,Philippines,PH,PHL,106651922,Asia,88,2084,16
2020-04-01T00:00:00Z,1,4,2020,0,0,Philippines,PH,PHL,106651922,Asia,88,2084,17
2020-04-02T00:00:00Z,2,4,2020,227,8,Philippines,PH,PHL,106651922,Asia,96,2311,18
2020-04-03T00:00:00Z,3,4,2020,322,11,Philippines,PH,PHL,106651922,Asia,107,2633,19
2020-04-04T00:00:00Z,4,4,2020,385,29,Philippines,PH,PHL,106651922,Asia,136,3018,20
2020-04-05T00:00:00Z,5,4,2020,76,8,Philippines,PH,PHL,106651922,Asia,144,3094,21
2020-04-06T00:00:00Z,6,4,2020,152,8,Philippines,PH,PHL,106651922,Asia,152,3246,22
2020-04-07T00:00:00Z,7,4,2020,414,11,Philippines,PH,PHL,106651922,Asia,163,3660,23
2020-04-08T00:00:00Z,8,4,2020,104,14,Philippines,PH,PHL,106651922,Asia,177,3764,24
2020-04-09T00:00:00Z,9,4,2020,106,5,Philippines,PH,PHL,106651922,Asia,182,3870,25
2020-04-10T00:00:00Z,10,4,2020,206,21,Philippines,PH,PHL,106651922,Asia,203,4076,26
2020-04-11T00:00:00Z,11,4,2020,0,0,Philippines,PH,PHL,106651922,Asia,203,4076,27
2020-04-12T00:00:00Z,12,4,2020,352,44,Philippines,PH,PHL,106651922,Asia,247,4428,28
2020-04-13T00:00:00Z,13,4,2020,220,50,Philippines,PH,PHL,106651922,Asia,297,4648,29
2020-04-14T00:00:00Z,14,4,2020,284,18,Philippines,PH,PHL,106651922,Asia,315,4932,30
2020-04-15T00:00:00Z,15,4,2020,291,20,Philippines,PH,PHL,106651922,Asia,335,5223,31
2020-04-16T00:00:00Z,16,4,2020,230,14,Philippines,PH,PHL,106651922,Asia,349,5453,32
2020-04-17T00:00:00Z,17,4,2020,207,13,Philippines,PH,PHL,106651922,Asia,362,5660,33
2020-04-18T00:00:00Z,18,4,2020,218,25,Philippines,PH,PHL,106651922,Asia,387,5878,34
2020-04-19T00:00:00Z,19,4,2020,209,10,Philippines,PH,PHL,106651922,Asia,397,6087,35
2020-04-20T00:00:00Z,20,4,2020,172,12,Philippines,PH,PHL,106651922,Asia,409,6259,36
2020-04-21T00:00:00Z,21,4,2020,200,19,Philippines,PH,PHL,106651922,Asia,428,6459,37
2020-04-22T00:00:00Z,22,4,2020,140,9,Philippines,PH,PHL,106651922,Asia,437,6599,38
2020-04-23T00:00:00Z,23,4,2020,111,9,Philippines,PH,PHL,106651922,Asia,446,6710,39
2020-04-24T00:00:00Z,24,4,2020,271,16,Philippines,PH,PHL,106651922,Asia,462,6981,40
2020-04-25T00:00:00Z,25,4,2020,211,15,Philippines,PH,PHL,106651922,Asia,477,7192,41
2020-04-26T00:00:00Z,26,4,2020,102,17,Philippines,PH,PHL,106651922,Asia,494,7294,42
2020-04-27T00:00:00Z,27,4,2020,285,7,Philippines,PH,PHL,106651922,Asia,501,7579,43
2020-04-28T00:00:00Z,28,4,2020,198,10,Philippines,PH,PHL,106651922,Asia,511,7777,44
2020-04-29T00:00:00Z,29,4,2020,181,19,Philippines,PH,PHL,106651922,Asia,530,7958,45
2020-04-30T00:00:00Z,30,4,2020,254,28,Philippines,PH,PHL,106651922,Asia,558,8212,46
2020-05-01T00:00:00Z,1,5,2020,276,10,Philippines,PH,PHL,106651922,Asia,568,8488,47
2020-05-02T00:00:00Z,2,5,2020,284,11,Philippines,PH,PHL,106651922,Asia,579,8772,48
2020-05-03T00:00:00Z,3,5,2020,156,24,Philippines,PH,PHL,106651922,Asia,603,8928,49
2020-05-04T00:00:00Z,4,5,2020,295,4,Philippines,PH,PHL,106651922,Asia,607,9223,50
2020-05-05T00:00:00Z,5,5,2020,262,16,Philippines,PH,PHL,106651922,Asia,623,9485,51
2020-05-06T00:00:00Z,6,5,2020,199,14,Philippines,PH,PHL,106651922,Asia,637,9684,52
2020-05-07T00:00:00Z,7,5,2020,320,21,Philippines,PH,PHL,106651922,Asia,658,10004,53
2020-05-08T00:00:00Z,8,5,2020,339,27,Philippines,PH,PHL,106651922,Asia,685,10343,54
2020-05-09T00:00:00Z,9,5,2020,120,11,Philippines,PH,PHL,106651922,Asia,696,10463,55
2020-05-10T00:00:00Z,10,5,2020,147,8,Philippines,PH,PHL,106651922,Asia,704,10610,56
2020-05-11T00:00:00Z,11,5,2020,184,15,Philippines,PH,PHL,106651922,Asia,719,10794,57
2020-05-12T00:00:00Z,12,5,2020,292,7,Philippines,PH,PHL,106651922,Asia,726,11086,58
2020-05-13T00:00:00Z,13,5,2020,264,25,Philippines,PH,PHL,106651922,Asia,751,11350,59
2020-05-14T00:00:00Z,14,5,2020,268,21,Philippines,PH,PHL,106651922,Asia,772,11618,60
2020-05-15T00:00:00Z,15,5,2020,258,18,Philippines,PH,PHL,106651922,Asia,790,11876,61
2020-05-16T00:00:00Z,16,5,2020,215,16,Philippines,PH,PHL,106651922,Asia,806,12091,62
2020-05-17T00:00:00Z,17,5,2020,214,11,Philippines,PH,PHL,106651922,Asia,817,12305,63
2020-05-18T00:00:00Z,18,5,2020,208,7,Philippines,PH,PHL,106651922,Asia,824,12513,64
2020-05-19T00:00:00Z,19,5,2020,205,7,Philippines,PH,PHL,106651922,Asia,831,12718,65
2020-05-20T00:00:00Z,20,5,2020,224,6,Philippines,PH,PHL,106651922,Asia,837,12942,66
2020-05-21T00:00:00Z,21,5,2020,279,5,Philippines,PH,PHL,106651922,Asia,842,13221,67
2020-05-22T00:00:00Z,22,5,2020,213,4,Philippines,PH,PHL,106651922,Asia,846,13434,68
2020-05-23T00:00:00Z,23,5,2020,163,11,Philippines,PH,PHL,106651922,Asia,857,13597,69
2020-05-24T00:00:00Z,24,5,2020,180,6,Philippines,PH,PHL,106651922,Asia,863,13777,70
2020-05-25T00:00:00Z,25,5,2020,258,5,Philippines,PH,PHL,106651922,Asia,868,14035,71
2020-05-26T00:00:00Z,26,5,2020,284,5,Philippines,PH,PHL,106651922,Asia,873,14319,72
2020-05-27T00:00:00Z,27,5,2020,350,13,Philippines,PH,PHL,106651922,Asia,886,14669,73
2020-03-25T00:00:00Z,25,3,2020,152,2,Poland,PL,POL,37978548,Europe,10,901,1
2020-03-26T00:00:00Z,26,3,2020,150,4,Poland,PL,POL,37978548,Europe,14,1051,2
2020-03-27T00:00:00Z,27,3,2020,170,2,Poland,PL,POL,37978548,Europe,16,1221,3
2020-03-28T00:00:00Z,28,3,2020,168,0,Poland,PL,POL,37978548,Europe,16,1389,4
2020-03-29T00:00:00Z,29,3,2020,249,2,Poland,PL,POL,37978548,Europe,18,1638,5
2020-03-30T00:00:00Z,30,3,2020,224,4,Poland,PL,POL,37978548,Europe,22,1862,6
2020-03-31T00:00:00Z,31,3,2020,193,9,Poland,PL,POL,37978548,Europe,31,2055,7
2020-04-01T00:00:00Z,1,4,2020,256,2,Poland,PL,POL,37978548,Europe,33,2311,8
2020-04-02T00:00:00Z,2,4,2020,243,10,Poland,PL,POL,37978548,Europe,43,2554,9
2020-04-03T00:00:00Z,3,4,2020,392,14,Poland,PL,POL,37978548,Europe,57,2946,10
2020-04-04T00:00:00Z,4,4,2020,437,14,Poland,PL,POL,37978548,Europe,71,3383,11
2020-04-05T00:00:00Z,5,4,2020,244,8,Poland,PL,POL,37978548,Europe,79,3627,12
2020-04-06T00:00:00Z,6,4,2020,475,15,Poland,PL,POL,37978548,Europe,94,4102,13
2020-04-07T00:00:00Z,7,4,2020,311,13,Poland,PL,POL,37978548,Europe,107,4413,14
2020-04-08T00:00:00Z,8,4,2020,435,22,Poland,PL,POL,37978548,Europe,129,4848,15
2020-04-09T00:00:00Z,9,4,2020,357,30,Poland,PL,POL,37978548,Europe,159,5205,16
2020-04-10T00:00:00Z,10,4,2020,370,15,Poland,PL,POL,37978548,Europe,174,5575,17
2020-04-11T00:00:00Z,11,4,2020,380,7,Poland,PL,POL,37978548,Europe,181,5955,18
2020-04-12T00:00:00Z,12,4,2020,401,27,Poland,PL,POL,37978548,Europe,208,6356,19
2020-04-13T00:00:00Z,13,4,2020,318,24,Poland,PL,POL,37978548,Europe,232,6674,20
2020-04-14T00:00:00Z,14,4,2020,260,13,Poland,PL,POL,37978548,Europe,245,6934,21
2020-04-15T00:00:00Z,15,4,2020,268,18,Poland,PL,POL,37978548,Europe,263,7202,22
2020-04-16T00:00:00Z,16,4,2020,380,23,Poland,PL,POL,37978548,Europe,286,7582,23
2020-04-17T00:00:00Z,17,4,2020,336,28,Poland,PL,POL,37978548,Europe,314,7918,24
2020-04-18T00:00:00Z,18,4,2020,461,18,Poland,PL,POL,37978548,Europe,332,8379,25
2020-04-19T00:00:00Z,19,4,2020,363,15,Poland,PL,POL,37978548,Europe,347,8742,26
2020-04-20T00:00:00Z,20,4,2020,545,13,Poland,PL,POL,37978548,Europe,360,9287,27
2020-04-21T00:00:00Z,21,4,2020,306,20,Poland,PL,POL,37978548,Europe,380,9593,28
2020-04-22T00:00:00Z,22,4,2020,263,21,Poland,PL,POL,37978548,Europe,401,9856,29
2020-04-23T00:00:00Z,23,4,2020,313,25,Poland,PL,POL,37978548,Europe,426,10169,30
2020-04-24T00:00:00Z,24,4,2020,342,28,Poland,PL,POL,37978548,Europe,454,10511,31
2020-04-25T00:00:00Z,25,4,2020,381,40,Poland,PL,POL,37978548,Europe,494,10892,32
2020-04-26T00:00:00Z,26,4,2020,381,30,Poland,PL,POL,37978548,Europe,524,11273,33
2020-04-27T00:00:00Z,27,4,2020,344,11,Poland,PL,POL,37978548,Europe,535,11617,34
2020-04-28T00:00:00Z,28,4,2020,285,27,Poland,PL,POL,37978548,Europe,562,11902,35
2020-04-29T00:00:00Z,29,4,2020,316,34,Poland,PL,POL,37978548,Europe,596,12218,36
2020-04-30T00:00:00Z,30,4,2020,422,28,Poland,PL,POL,37978548,Europe,624,12640,37
2020-05-01T00:00:00Z,1,5,2020,237,20,Poland,PL,POL,37978548,Europe,644,12877,38
2020-05-02T00:00:00Z,2,5,2020,228,7,Poland,PL,POL,37978548,Europe,651,13105,39
2020-05-03T00:00:00Z,3,5,2020,270,13,Poland,PL,POL,37978548,Europe,664,13375,40
2020-05-04T00:00:00Z,4,5,2020,318,14,Poland,PL,POL,37978548,Europe,678,13693,41
2020-05-05T00:00:00Z,5,5,2020,313,20,Poland,PL,POL,37978548,Europe,698,14006,42
2020-05-06T00:00:00Z,6,5,2020,425,18,Poland,PL,POL,37978548,Europe,716,14431,43
2020-05-07T00:00:00Z,7,5,2020,309,17,Poland,PL,POL,37978548,Europe,733,14740,44
2020-05-08T00:00:00Z,8,5,2020,307,22,Poland,PL,POL,37978548,Europe,755,15047,45
2020-05-09T00:00:00Z,9,5,2020,319,21,Poland,PL,POL,37978548,Europe,776,15366,46
2020-05-10T00:00:00Z,10,5,2020,285,9,Poland,PL,POL,37978548,Europe,785,15651,47
2020-05-11T00:00:00Z,11,5,2020,345,15,Poland,PL,POL,37978548,Europe,800,15996,48
2020-05-12T00:00:00Z,12,5,2020,330,11,Poland,PL,POL,37978548,Europe,811,16326,49
2020-05-13T00:00:00Z,13,5,2020,595,28,Poland,PL,POL,37978548,Europe,839,16921,50
2020-05-14T00:00:00Z,14,5,2020,283,22,Poland,PL,POL,37978548,Europe,861,17204,51
2020-05-15T00:00:00Z,15,5,2020,411,22,Poland,PL,POL,37978548,Europe,883,17615,52
2020-05-16T00:00:00Z,16,5,2020,401,24,Poland,PL,POL,37978548,Europe,907,18016,53
2020-05-17T00:00:00Z,17,5,2020,241,8,Poland,PL,POL,37978548,Europe,915,18257,54
2020-05-18T00:00:00Z,18,5,2020,272,10,Poland,PL,POL,37978548,Europe,925,18529,55
2020-05-19T00:00:00Z,19,5,2020,356,11,Poland,PL,POL,37978548,Europe,936,18885,56
2020-05-20T00:00:00Z,20,5,2020,383,12,Poland,PL,POL,37978548,Europe,948,19268,57
2020-05-21T00:00:00Z,21,5,2020,471,14,Poland,PL,POL,37978548,Europe,962,19739,58
2020-05-22T00:00:00Z,22,5,2020,404,10,Poland,PL,POL,37978548,Europe,972,20143,59
2020-05-23T00:00:00Z,23,5,2020,476,10,Poland,PL,POL,37978548,Europe,982,20619,60
2020-05-24T00:00:00Z,24,5,2020,312,11,Poland,PL,POL,37978548,Europe,993,20931,61
2020-05-25T00:00:00Z,25,5,2020,395,3,Poland,PL,POL,37978548,Europe,996,21326,62
2020-05-26T00:00:00Z,26,5,2020,305,11,Poland,PL,POL,37978548,Europe,1007,21631,63
2020-05-27T00:00:00Z,27,5,2020,443,17,Poland,PL,POL,37978548,Europe,1024,22074,64
2020-03-22T00:00:00Z,22,3,2020,260,6,Portugal,PT,PRT,10281762,Europe,12,1280,1
2020-03-23T00:00:00Z,23,3,2020,320,2,Portugal,PT,PRT,10281762,Europe,14,1600,2
2020-03-24T00:00:00Z,24,3,2020,460,9,Portugal,PT,PRT,10281762,Europe,23,2060,3
2020-03-25T00:00:00Z,25,3,2020,302,10,Portugal,PT,PRT,10281762,Europe,33,2362,4
2020-03-26T00:00:00Z,26,3,2020,633,10,Portugal,PT,PRT,10281762,Europe,43,2995,5
2020-03-27T00:00:00Z,27,3,2020,549,17,Portugal,PT,PRT,10281762,Europe,60,3544,6
2020-03-28T00:00:00Z,28,3,2020,724,16,Portugal,PT,PRT,10281762,Europe,76,4268,7
2020-03-29T00:00:00Z,29,3,2020,902,24,Portugal,PT,PRT,10281762,Europe,100,5170,8
2020-03-30T00:00:00Z,30,3,2020,792,19,Portugal,PT,PRT,10281762,Europe,119,5962,9
2020-03-31T00:00:00Z,31,3,2020,446,21,Portugal,PT,PRT,10281762,Europe,140,6408,10
2020-04-01T00:00:00Z,1,4,2020,1035,20,Portugal,PT,PRT,10281762,Europe,160,7443,11
2020-04-02T00:00:00Z,2,4,2020,808,27,Portugal,PT,PRT,10281762,Europe,187,8251,12
2020-04-03T00:00:00Z,3,4,2020,783,22,Portugal,PT,PRT,10281762,Europe,209,9034,13
2020-04-04T00:00:00Z,4,4,2020,852,37,Portugal,PT,PRT,10281762,Europe,246,9886,14
2020-04-05T00:00:00Z,5,4,2020,638,20,Portugal,PT,PRT,10281762,Europe,266,10524,15
2020-04-06T00:00:00Z,6,4,2020,754,29,Portugal,PT,PRT,10281762,Europe,295,11278,16
2020-04-07T00:00:00Z,7,4,2020,452,16,Portugal,PT,PRT,10281762,Europe,311,11730,17
2020-04-08T00:00:00Z,8,4,2020,712,34,Portugal,PT,PRT,10281762,Europe,345,12442,18
2020-04-09T00:00:00Z,9,4,2020,699,35,Portugal,PT,PRT,10281762,Europe,380,13141,19
2020-04-10T00:00:00Z,10,4,2020,815,29,Portugal,PT,PRT,10281762,Europe,409,13956,20
2020-04-11T00:00:00Z,11,4,2020,1516,26,Portugal,PT,PRT,10281762,Europe,435,15472,21
2020-04-12T00:00:00Z,12,4,2020,515,35,Portugal,PT,PRT,10281762,Europe,470,15987,22
2020-04-13T00:00:00Z,13,4,2020,598,34,Portugal,PT,PRT,10281762,Europe,504,16585,23
2020-04-14T00:00:00Z,14,4,2020,349,31,Portugal,PT,PRT,10281762,Europe,535,16934,24
2020-04-15T00:00:00Z,15,4,2020,514,32,Portugal,PT,PRT,10281762,Europe,567,17448,25
2020-04-16T00:00:00Z,16,4,2020,643,32,Portugal,PT,PRT,10281762,Europe,599,18091,26
2020-04-17T00:00:00Z,17,4,2020,750,30,Portugal,PT,PRT,10281762,Europe,629,18841,27
2020-04-18T00:00:00Z,18,4,2020,181,28,Portugal,PT,PRT,10281762,Europe,657,19022,28
2020-04-19T00:00:00Z,19,4,2020,663,30,Portugal,PT,PRT,10281762,Europe,687,19685,29
2020-04-20T00:00:00Z,20,4,2020,521,27,Portugal,PT,PRT,10281762,Europe,714,20206,30
2020-04-21T00:00:00Z,21,4,2020,657,21,Portugal,PT,PRT,10281762,Europe,735,20863,31
2020-04-22T00:00:00Z,22,4,2020,516,27,Portugal,PT,PRT,10281762,Europe,762,21379,32
2020-04-23T00:00:00Z,23,4,2020,603,23,Portugal,PT,PRT,10281762,Europe,785,21982,33
2020-04-24T00:00:00Z,24,4,2020,371,35,Portugal,PT,PRT,10281762,Europe,820,22353,34
2020-04-25T00:00:00Z,25,4,2020,918,60,Portugal,PT,PRT,10281762,Europe,880,23271,35
2020-04-26T00:00:00Z,26,4,2020,412,23,Portugal,PT,PRT,10281762,Europe,903,23683,36
2020-04-27T00:00:00Z,27,4,2020,163,25,Portugal,PT,PRT,10281762,Europe,928,23846,37
2020-04-28T00:00:00Z,28,4,2020,298,20,Portugal,PT,PRT,10281762,Europe,948,24144,38
2020-04-29T00:00:00Z,29,4,2020,180,25,Portugal,PT,PRT,10281762,Europe,973,24324,39
2020-04-30T00:00:00Z,30,4,2020,368,16,Portugal,PT,PRT,10281762,Europe,989,24692,40
2020-05-01T00:00:00Z,1,5,2020,295,18,Portugal,PT,PRT,10281762,Europe,1007,24987,41
2020-05-02T00:00:00Z,2,5,2020,364,0,Portugal,PT,PRT,10281762,Europe,1007,25351,42
2020-05-03T00:00:00Z,3,5,2020,-161,16,Portugal,PT,PRT,10281762,Europe,1023,25190,43
2020-05-04T00:00:00Z,4,5,2020,334,40,Portugal,PT,PRT,10281762,Europe,1063,25524,44
2020-05-05T00:00:00Z,5,5,2020,0,0,Portugal,PT,PRT,10281762,Europe,1063,25524,45
2020-05-06T00:00:00Z,6,5,2020,178,11,Portugal,PT,PRT,10281762,Europe,1074,25702,46
2020-05-07T00:00:00Z,7,5,2020,480,15,Portugal,PT,PRT,10281762,Europe,1089,26182,47
2020-05-08T00:00:00Z,8,5,2020,533,16,Portugal,PT,PRT,10281762,Europe,1105,26715,48
2020-05-09T00:00:00Z,9,5,2020,553,9,Portugal,PT,PRT,10281762,Europe,1114,27268,49
2020-05-10T00:00:00Z,10,5,2020,138,12,Portugal,PT,PRT,10281762,Europe,1126,27406,50
2020-05-11T00:00:00Z,11,5,2020,175,9,Portugal,PT,PRT,10281762,Europe,1135,27581,51
2020-05-12T00:00:00Z,12,5,2020,98,9,Portugal,PT,PRT,10281762,Europe,1144,27679,52
2020-05-13T00:00:00Z,13,5,2020,234,19,Portugal,PT,PRT,10281762,Europe,1163,27913,53
2020-05-14T00:00:00Z,14,5,2020,219,12,Portugal,PT,PRT,10281762,Europe,1175,28132,54
2020-05-15T00:00:00Z,15,5,2020,187,9,Portugal,PT,PRT,10281762,Europe,1184,28319,55
2020-05-16T00:00:00Z,16,5,2020,264,6,Portugal,PT,PRT,10281762,Europe,1190,28583,56
2020-05-17T00:00:00Z,17,5,2020,227,13,Portugal,PT,PRT,10281762,Europe,1203,28810,57
2020-05-18T00:00:00Z,18,5,2020,226,15,Portugal,PT,PRT,10281762,Europe,1218,29036,58
2020-05-19T00:00:00Z,19,5,2020,173,13,Portugal,PT,PRT,10281762,Europe,1231,29209,59
2020-05-20T00:00:00Z,20,5,2020,223,16,Portugal,PT,PRT,10281762,Europe,1247,29432,60
2020-05-21T00:00:00Z,21,5,2020,228,16,Portugal,PT,PRT,10281762,Europe,1263,29660,61
2020-05-22T00:00:00Z,22,5,2020,252,14,Portugal,PT,PRT,10281762,Europe,1277,29912,62
2020-05-23T00:00:00Z,23,5,2020,288,12,Portugal,PT,PRT,10281762,Europe,1289,30200,63
2020-05-24T00:00:00Z,24,5,2020,271,13,Portugal,PT,PRT,10281762,Europe,1302,30471,64
2020-05-25T00:00:00Z,25,5,2020,152,14,Portugal,PT,PRT,10281762,Europe,1316,30623,65
2020-05-26T00:00:00Z,26,5,2020,165,14,Portugal,PT,PRT,10281762,Europe,1330,30788,66
2020-05-27T00:00:00Z,27,5,2020,219,12,Portugal,PT,PRT,10281762,Europe,1342,31007,67
2020-04-02T00:00:00Z,2,4,2020,47,3,Puerto_Rico,PR,PRI,3195153,America,11,286,1
2020-04-03T00:00:00Z,3,4,2020,30,1,Puerto_Rico,PR,PRI,3195153,America,12,316,2
2020-04-04T00:00:00Z,4,4,2020,62,3,Puerto_Rico,PR,PRI,3195153,America,15,378,3
2020-04-05T00:00:00Z,5,4,2020,74,3,Puerto_Rico,PR,PRI,3195153,America,18,452,4
2020-04-06T00:00:00Z,6,4,2020,23,2,Puerto_Rico,PR,PRI,3195153,America,20,475,5
2020-04-07T00:00:00Z,7,4,2020,38,1,Puerto_Rico,PR,PRI,3195153,America,21,513,6
2020-04-08T00:00:00Z,8,4,2020,60,2,Puerto_Rico,PR,PRI,3195153,America,23,573,7
2020-04-09T00:00:00Z,9,4,2020,47,1,Puerto_Rico,PR,PRI,3195153,America,24,620,8
2020-04-10T00:00:00Z,10,4,2020,63,9,Puerto_Rico,PR,PRI,3195153,America,33,683,9
2020-04-11T00:00:00Z,11,4,2020,42,6,Puerto_Rico,PR,PRI,3195153,America,39,725,10
2020-04-12T00:00:00Z,12,4,2020,63,3,Puerto_Rico,PR,PRI,3195153,America,42,788,11
2020-04-13T00:00:00Z,13,4,2020,109,2,Puerto_Rico,PR,PRI,3195153,America,44,897,12
2020-04-14T00:00:00Z,14,4,2020,6,1,Puerto_Rico,PR,PRI,3195153,America,45,903,13
2020-04-15T00:00:00Z,15,4,2020,20,0,Puerto_Rico,PR,PRI,3195153,America,45,923,14
2020-04-16T00:00:00Z,16,4,2020,51,6,Puerto_Rico,PR,PRI,3195153,America,51,974,15
2020-04-17T00:00:00Z,17,4,2020,69,5,Puerto_Rico,PR,PRI,3195153,America,56,1043,16
2020-04-18T00:00:00Z,18,4,2020,25,2,Puerto_Rico,PR,PRI,3195153,America,58,1068,17
2020-04-19T00:00:00Z,19,4,2020,50,2,Puerto_Rico,PR,PRI,3195153,America,60,1118,18
2020-04-20T00:00:00Z,20,4,2020,95,2,Puerto_Rico,PR,PRI,3195153,America,62,1213,19
2020-04-21T00:00:00Z,21,4,2020,39,1,Puerto_Rico,PR,PRI,3195153,America,63,1252,20
2020-04-22T00:00:00Z,22,4,2020,0,0,Puerto_Rico,PR,PRI,3195153,America,63,1252,21
2020-04-23T00:00:00Z,23,4,2020,0,1,Puerto_Rico,PR,PRI,3195153,America,64,1252,22
2020-04-24T00:00:00Z,24,4,2020,0,5,Puerto_Rico,PR,PRI,3195153,America,69,1252,23
2020-04-25T00:00:00Z,25,4,2020,24,8,Puerto_Rico,PR,PRI,3195153,America,77,1276,24
2020-04-26T00:00:00Z,26,4,2020,31,6,Puerto_Rico,PR,PRI,3195153,America,83,1307,25
2020-04-27T00:00:00Z,27,4,2020,64,1,Puerto_Rico,PR,PRI,3195153,America,84,1371,26
2020-04-28T00:00:00Z,28,4,2020,18,0,Puerto_Rico,PR,PRI,3195153,America,84,1389,27
2020-04-29T00:00:00Z,29,4,2020,11,2,Puerto_Rico,PR,PRI,3195153,America,86,1400,28
2020-04-30T00:00:00Z,30,4,2020,33,0,Puerto_Rico,PR,PRI,3195153,America,86,1433,29
2020-05-01T00:00:00Z,1,5,2020,106,6,Puerto_Rico,PR,PRI,3195153,America,92,1539,30
2020-05-02T00:00:00Z,2,5,2020,36,2,Puerto_Rico,PR,PRI,3195153,America,94,1575,31
2020-05-03T00:00:00Z,3,5,2020,182,1,Puerto_Rico,PR,PRI,3195153,America,95,1757,32
2020-05-04T00:00:00Z,4,5,2020,51,2,Puerto_Rico,PR,PRI,3195153,America,97,1808,33
2020-05-05T00:00:00Z,5,5,2020,35,0,Puerto_Rico,PR,PRI,3195153,America,97,1843,34
2020-05-06T00:00:00Z,6,5,2020,81,2,Puerto_Rico,PR,PRI,3195153,America,99,1924,35
2020-05-07T00:00:00Z,7,5,2020,44,0,Puerto_Rico,PR,PRI,3195153,America,99,1968,36
2020-05-08T00:00:00Z,8,5,2020,63,3,Puerto_Rico,PR,PRI,3195153,America,102,2031,37
2020-05-09T00:00:00Z,9,5,2020,125,5,Puerto_Rico,PR,PRI,3195153,America,107,2156,38
2020-05-10T00:00:00Z,10,5,2020,17,1,Puerto_Rico,PR,PRI,3195153,America,108,2173,39
2020-05-11T00:00:00Z,11,5,2020,25,3,Puerto_Rico,PR,PRI,3195153,America,111,2198,40
2020-05-12T00:00:00Z,12,5,2020,58,2,Puerto_Rico,PR,PRI,3195153,America,113,2256,41
2020-05-13T00:00:00Z,13,5,2020,43,1,Puerto_Rico,PR,PRI,3195153,America,114,2299,42
2020-05-14T00:00:00Z,14,5,2020,30,1,Puerto_Rico,PR,PRI,3195153,America,115,2329,43
2020-05-15T00:00:00Z,15,5,2020,98,2,Puerto_Rico,PR,PRI,3195153,America,117,2427,44
2020-05-16T00:00:00Z,16,5,2020,115,5,Puerto_Rico,PR,PRI,3195153,America,122,2542,45
2020-05-17T00:00:00Z,17,5,2020,47,0,Puerto_Rico,PR,PRI,3195153,America,122,2589,46
2020-05-18T00:00:00Z,18,5,2020,57,1,Puerto_Rico,PR,PRI,3195153,America,123,2646,47
2020-05-19T00:00:00Z,19,5,2020,64,1,Puerto_Rico,PR,PRI,3195153,America,124,2710,48
2020-05-20T00:00:00Z,20,5,2020,95,0,Puerto_Rico,PR,PRI,3195153,America,124,2805,49
2020-05-21T00:00:00Z,21,5,2020,61,1,Puerto_Rico,PR,PRI,3195153,America,125,2866,50
2020-05-22T00:00:00Z,22,5,2020,47,1,Puerto_Rico,PR,PRI,3195153,America,126,2913,51
2020-05-23T00:00:00Z,23,5,2020,117,0,Puerto_Rico,PR,PRI,3195153,America,126,3030,52
2020-05-24T00:00:00Z,24,5,2020,70,1,Puerto_Rico,PR,PRI,3195153,America,127,3100,53
2020-05-25T00:00:00Z,25,5,2020,89,0,Puerto_Rico,PR,PRI,3195153,America,127,3189,54
2020-05-26T00:00:00Z,26,5,2020,71,2,Puerto_Rico,PR,PRI,3195153,America,129,3260,55
2020-05-27T00:00:00Z,27,5,2020,64,0,Puerto_Rico,PR,PRI,3195153,America,129,3324,56
2020-04-23T00:00:00Z,23,4,2020,608,1,Qatar,QA,QAT,2781677,Asia,10,7141,1
2020-04-24T00:00:00Z,24,4,2020,623,0,Qatar,QA,QAT,2781677,Asia,10,7764,2
2020-04-25T00:00:00Z,25,4,2020,761,0,Qatar,QA,QAT,2781677,Asia,10,8525,3
2020-04-26T00:00:00Z,26,4,2020,833,0,Qatar,QA,QAT,2781677,Asia,10,9358,4
2020-04-27T00:00:00Z,27,4,2020,929,0,Qatar,QA,QAT,2781677,Asia,10,10287,5
2020-04-28T00:00:00Z,28,4,2020,957,0,Qatar,QA,QAT,2781677,Asia,10,11244,6
2020-04-29T00:00:00Z,29,4,2020,677,0,Qatar,QA,QAT,2781677,Asia,10,11921,7
2020-04-30T00:00:00Z,30,4,2020,643,0,Qatar,QA,QAT,2781677,Asia,10,12564,8
2020-05-01T00:00:00Z,1,5,2020,845,0,Qatar,QA,QAT,2781677,Asia,10,13409,9
2020-05-02T00:00:00Z,2,5,2020,687,2,Qatar,QA,QAT,2781677,Asia,12,14096,10
2020-05-03T00:00:00Z,3,5,2020,776,0,Qatar,QA,QAT,2781677,Asia,12,14872,11
2020-05-04T00:00:00Z,4,5,2020,679,0,Qatar,QA,QAT,2781677,Asia,12,15551,12
2020-05-05T00:00:00Z,5,5,2020,640,0,Qatar,QA,QAT,2781677,Asia,12,16191,13
2020-05-06T00:00:00Z,6,5,2020,951,0,Qatar,QA,QAT,2781677,Asia,12,17142,14
2020-05-07T00:00:00Z,7,5,2020,830,0,Qatar,QA,QAT,2781677,Asia,12,17972,15
2020-05-08T00:00:00Z,8,5,2020,918,0,Qatar,QA,QAT,2781677,Asia,12,18890,16
2020-05-09T00:00:00Z,9,5,2020,1311,0,Qatar,QA,QAT,2781677,Asia,12,20201,17
2020-05-10T00:00:00Z,10,5,2020,1130,1,Qatar,QA,QAT,2781677,Asia,13,21331,18
2020-05-11T00:00:00Z,11,5,2020,1189,1,Qatar,QA,QAT,2781677,Asia,14,22520,19
2020-05-12T00:00:00Z,12,5,2020,1103,0,Qatar,QA,QAT,2781677,Asia,14,23623,20
2020-05-13T00:00:00Z,13,5,2020,1526,0,Qatar,QA,QAT,2781677,Asia,14,25149,21
2020-05-14T00:00:00Z,14,5,2020,1390,0,Qatar,QA,QAT,2781677,Asia,14,26539,22
2020-05-15T00:00:00Z,15,5,2020,1733,0,Qatar,QA,QAT,2781677,Asia,14,28272,23
2020-05-16T00:00:00Z,16,5,2020,1153,0,Qatar,QA,QAT,2781677,Asia,14,29425,24
2020-05-17T00:00:00Z,17,5,2020,1547,1,Qatar,QA,QAT,2781677,Asia,15,30972,25
2020-05-18T00:00:00Z,18,5,2020,1632,0,Qatar,QA,QAT,2781677,Asia,15,32604,26
2020-05-19T00:00:00Z,19,5,2020,1365,0,Qatar,QA,QAT,2781677,Asia,15,33969,27
2020-05-20T00:00:00Z,20,5,2020,1637,0,Qatar,QA,QAT,2781677,Asia,15,35606,28
2020-05-21T00:00:00Z,21,5,2020,1491,1,Qatar,QA,QAT,2781677,Asia,16,37097,29
2020-05-22T00:00:00Z,22,5,2020,1554,1,Qatar,QA,QAT,2781677,Asia,17,38651,30
2020-05-23T00:00:00Z,23,5,2020,1830,2,Qatar,QA,QAT,2781677,Asia,19,40481,31
2020-05-24T00:00:00Z,24,5,2020,1732,2,Qatar,QA,QAT,2781677,Asia,21,42213,32
2020-05-25T00:00:00Z,25,5,2020,1501,2,Qatar,QA,QAT,2781677,Asia,23,43714,33
2020-05-26T00:00:00Z,26,5,2020,1751,3,Qatar,QA,QAT,2781677,Asia,26,45465,34
2020-05-27T00:00:00Z,27,5,2020,1742,2,Qatar,QA,QAT,2781677,Asia,28,47207,35
2020-03-25T00:00:00Z,25,3,2020,186,4,Romania,RO,ROU,19473936,Europe,11,762,1
2020-03-26T00:00:00Z,26,3,2020,144,2,Romania,RO,ROU,19473936,Europe,13,906,2
2020-03-27T00:00:00Z,27,3,2020,123,4,Romania,RO,ROU,19473936,Europe,17,1029,3
2020-03-28T00:00:00Z,28,3,2020,263,7,Romania,RO,ROU,19473936,Europe,24,1292,4
2020-03-29T00:00:00Z,29,3,2020,160,5,Romania,RO,ROU,19473936,Europe,29,1452,5
2020-03-30T00:00:00Z,30,3,2020,308,11,Romania,RO,ROU,19473936,Europe,40,1760,6
2020-03-31T00:00:00Z,31,3,2020,192,4,Romania,RO,ROU,19473936,Europe,44,1952,7
2020-04-01T00:00:00Z,1,4,2020,293,25,Romania,RO,ROU,19473936,Europe,69,2245,8
2020-04-02T00:00:00Z,2,4,2020,215,16,Romania,RO,ROU,19473936,Europe,85,2460,9
2020-04-03T00:00:00Z,3,4,2020,278,9,Romania,RO,ROU,19473936,Europe,94,2738,10
2020-04-04T00:00:00Z,4,4,2020,445,39,Romania,RO,ROU,19473936,Europe,133,3183,11
2020-04-05T00:00:00Z,5,4,2020,430,8,Romania,RO,ROU,19473936,Europe,141,3613,12
2020-04-06T00:00:00Z,6,4,2020,251,7,Romania,RO,ROU,19473936,Europe,148,3864,13
2020-04-07T00:00:00Z,7,4,2020,193,9,Romania,RO,ROU,19473936,Europe,157,4057,14
2020-04-08T00:00:00Z,8,4,2020,360,25,Romania,RO,ROU,19473936,Europe,182,4417,15
2020-04-09T00:00:00Z,9,4,2020,344,27,Romania,RO,ROU,19473936,Europe,209,4761,16
2020-04-10T00:00:00Z,10,4,2020,441,20,Romania,RO,ROU,19473936,Europe,229,5202,17
2020-04-11T00:00:00Z,11,4,2020,265,28,Romania,RO,ROU,19473936,Europe,257,5467,18
2020-04-12T00:00:00Z,12,4,2020,523,25,Romania,RO,ROU,19473936,Europe,282,5990,19
2020-04-13T00:00:00Z,13,4,2020,310,24,Romania,RO,ROU,19473936,Europe,306,6300,20
2020-04-14T00:00:00Z,14,4,2020,333,12,Romania,RO,ROU,19473936,Europe,318,6633,21
2020-04-15T00:00:00Z,15,4,2020,246,26,Romania,RO,ROU,19473936,Europe,344,6879,22
2020-04-16T00:00:00Z,16,4,2020,337,28,Romania,RO,ROU,19473936,Europe,372,7216,23
2020-04-17T00:00:00Z,17,4,2020,491,15,Romania,RO,ROU,19473936,Europe,387,7707,24
2020-04-18T00:00:00Z,18,4,2020,360,13,Romania,RO,ROU,19473936,Europe,400,8067,25
2020-04-19T00:00:00Z,19,4,2020,351,17,Romania,RO,ROU,19473936,Europe,417,8418,26
2020-04-20T00:00:00Z,20,4,2020,328,17,Romania,RO,ROU,19473936,Europe,434,8746,27
2020-04-21T00:00:00Z,21,4,2020,190,17,Romania,RO,ROU,19473936,Europe,451,8936,28
2020-04-22T00:00:00Z,22,4,2020,306,32,Romania,RO,ROU,19473936,Europe,483,9242,29
2020-04-23T00:00:00Z,23,4,2020,468,25,Romania,RO,ROU,19473936,Europe,508,9710,30
2020-04-24T00:00:00Z,24,4,2020,386,19,Romania,RO,ROU,19473936,Europe,527,10096,31
2020-04-25T00:00:00Z,25,4,2020,321,25,Romania,RO,ROU,19473936,Europe,552,10417,32
2020-04-26T00:00:00Z,26,4,2020,218,23,Romania,RO,ROU,19473936,Europe,575,10635,33
2020-04-27T00:00:00Z,27,4,2020,401,33,Romania,RO,ROU,19473936,Europe,608,11036,34
2020-04-28T00:00:00Z,28,4,2020,303,23,Romania,RO,ROU,19473936,Europe,631,11339,35
2020-04-29T00:00:00Z,29,4,2020,277,19,Romania,RO,ROU,19473936,Europe,650,11616,36
2020-04-30T00:00:00Z,30,4,2020,362,25,Romania,RO,ROU,19473936,Europe,675,11978,37
2020-05-01T00:00:00Z,1,5,2020,262,42,Romania,RO,ROU,19473936,Europe,717,12240,38
2020-05-02T00:00:00Z,2,5,2020,327,27,Romania,RO,ROU,19473936,Europe,744,12567,39
2020-05-03T00:00:00Z,3,5,2020,165,27,Romania,RO,ROU,19473936,Europe,771,12732,40
2020-05-04T00:00:00Z,4,5,2020,431,9,Romania,RO,ROU,19473936,Europe,780,13163,41
2020-05-05T00:00:00Z,5,5,2020,349,23,Romania,RO,ROU,19473936,Europe,803,13512,42
2020-05-06T00:00:00Z,6,5,2020,325,24,Romania,RO,ROU,19473936,Europe,827,13837,43
2020-05-07T00:00:00Z,7,5,2020,270,31,Romania,RO,ROU,19473936,Europe,858,14107,44
2020-05-08T00:00:00Z,8,5,2020,392,18,Romania,RO,ROU,19473936,Europe,876,14499,45
2020-05-09T00:00:00Z,9,5,2020,312,22,Romania,RO,ROU,19473936,Europe,898,14811,46
2020-05-10T00:00:00Z,10,5,2020,320,28,Romania,RO,ROU,19473936,Europe,926,15131,47
2020-05-11T00:00:00Z,11,5,2020,231,26,Romania,RO,ROU,19473936,Europe,952,15362,48
2020-05-12T00:00:00Z,12,5,2020,226,20,Romania,RO,ROU,19473936,Europe,972,15588,49
2020-05-13T00:00:00Z,13,5,2020,190,30,Romania,RO,ROU,19473936,Europe,1002,15778,50
2020-05-14T00:00:00Z,14,5,2020,224,14,Romania,RO,ROU,19473936,Europe,1016,16002,51
2020-05-15T00:00:00Z,15,5,2020,245,30,Romania,RO,ROU,19473936,Europe,1046,16247,52
2020-05-16T00:00:00Z,16,5,2020,190,10,Romania,RO,ROU,19473936,Europe,1056,16437,53
2020-05-17T00:00:00Z,17,5,2020,267,25,Romania,RO,ROU,19473936,Europe,1081,16704,54
2020-05-18T00:00:00Z,18,5,2020,167,16,Romania,RO,ROU,19473936,Europe,1097,16871,55
2020-05-19T00:00:00Z,19,5,2020,165,10,Romania,RO,ROU,19473936,Europe,1107,17036,56
2020-05-20T00:00:00Z,20,5,2020,155,19,Romania,RO,ROU,19473936,Europe,1126,17191,57
2020-05-21T00:00:00Z,21,5,2020,196,15,Romania,RO,ROU,19473936,Europe,1141,17387,58
2020-05-22T00:00:00Z,22,5,2020,198,10,Romania,RO,ROU,19473936,Europe,1151,17585,59
2020-05-23T00:00:00Z,23,5,2020,127,8,Romania,RO,ROU,19473936,Europe,1159,17712,60
2020-05-24T00:00:00Z,24,5,2020,145,11,Romania,RO,ROU,19473936,Europe,1170,17857,61
2020-05-25T00:00:00Z,25,5,2020,213,9,Romania,RO,ROU,19473936,Europe,1179,18070,62
2020-05-26T00:00:00Z,26,5,2020,213,18,Romania,RO,ROU,19473936,Europe,1197,18283,63
2020-05-27T00:00:00Z,27,5,2020,146,13,Romania,RO,ROU,19473936,Europe,1210,18429,64
2020-03-31T00:00:00Z,31,3,2020,302,2,Russia,RU,RUS,144478050,Europe,10,1836,1
2020-04-01T00:00:00Z,1,4,2020,501,7,Russia,RU,RUS,144478050,Europe,17,2337,2
2020-04-02T00:00:00Z,2,4,2020,440,7,Russia,RU,RUS,144478050,Europe,24,2777,3
2020-04-03T00:00:00Z,3,4,2020,771,6,Russia,RU,RUS,144478050,Europe,30,3548,4
2020-04-04T00:00:00Z,4,4,2020,601,4,Russia,RU,RUS,144478050,Europe,34,4149,5
2020-04-05T00:00:00Z,5,4,2020,582,9,Russia,RU,RUS,144478050,Europe,43,4731,6
2020-04-06T00:00:00Z,6,4,2020,658,2,Russia,RU,RUS,144478050,Europe,45,5389,7
2020-04-07T00:00:00Z,7,4,2020,954,2,Russia,RU,RUS,144478050,Europe,47,6343,8
2020-04-08T00:00:00Z,8,4,2020,1154,11,Russia,RU,RUS,144478050,Europe,58,7497,9
2020-04-09T00:00:00Z,9,4,2020,1175,5,Russia,RU,RUS,144478050,Europe,63,8672,10
2020-04-10T00:00:00Z,10,4,2020,1459,13,Russia,RU,RUS,144478050,Europe,76,10131,11
2020-04-11T00:00:00Z,11,4,2020,1786,18,Russia,RU,RUS,144478050,Europe,94,11917,12
2020-04-12T00:00:00Z,12,4,2020,1667,12,Russia,RU,RUS,144478050,Europe,106,13584,13
2020-04-13T00:00:00Z,13,4,2020,2186,24,Russia,RU,RUS,144478050,Europe,130,15770,14
2020-04-14T00:00:00Z,14,4,2020,2558,18,Russia,RU,RUS,144478050,Europe,148,18328,15
2020-04-15T00:00:00Z,15,4,2020,2774,22,Russia,RU,RUS,144478050,Europe,170,21102,16
2020-04-16T00:00:00Z,16,4,2020,3388,28,Russia,RU,RUS,144478050,Europe,198,24490,17
2020-04-17T00:00:00Z,17,4,2020,3448,34,Russia,RU,RUS,144478050,Europe,232,27938,18
2020-04-18T00:00:00Z,18,4,2020,4070,41,Russia,RU,RUS,144478050,Europe,273,32008,19
2020-04-19T00:00:00Z,19,4,2020,4785,40,Russia,RU,RUS,144478050,Europe,313,36793,20
2020-04-20T00:00:00Z,20,4,2020,6060,48,Russia,RU,RUS,144478050,Europe,361,42853,21
2020-04-21T00:00:00Z,21,4,2020,4268,44,Russia,RU,RUS,144478050,Europe,405,47121,22
2020-04-22T00:00:00Z,22,4,2020,5642,51,Russia,RU,RUS,144478050,Europe,456,52763,23
2020-04-23T00:00:00Z,23,4,2020,5236,57,Russia,RU,RUS,144478050,Europe,513,57999,24
2020-04-24T00:00:00Z,24,4,2020,4774,42,Russia,RU,RUS,144478050,Europe,555,62773,25
2020-04-25T00:00:00Z,25,4,2020,5849,60,Russia,RU,RUS,144478050,Europe,615,68622,26
2020-04-26T00:00:00Z,26,4,2020,5966,66,Russia,RU,RUS,144478050,Europe,681,74588,27
2020-04-27T00:00:00Z,27,4,2020,6361,66,Russia,RU,RUS,144478050,Europe,747,80949,28
2020-04-28T00:00:00Z,28,4,2020,6198,48,Russia,RU,RUS,144478050,Europe,795,87147,29
2020-04-29T00:00:00Z,29,4,2020,6411,72,Russia,RU,RUS,144478050,Europe,867,93558,30
2020-04-30T00:00:00Z,30,4,2020,5841,105,Russia,RU,RUS,144478050,Europe,972,99399,31
2020-05-01T00:00:00Z,1,5,2020,7099,101,Russia,RU,RUS,144478050,Europe,1073,106498,32
2020-05-02T00:00:00Z,2,5,2020,7933,96,Russia,RU,RUS,144478050,Europe,1169,114431,33
2020-05-03T00:00:00Z,3,5,2020,9623,53,Russia,RU,RUS,144478050,Europe,1222,124054,34
2020-05-04T00:00:00Z,4,5,2020,10633,58,Russia,RU,RUS,144478050,Europe,1280,134687,35
2020-05-05T00:00:00Z,5,5,2020,10581,76,Russia,RU,RUS,144478050,Europe,1356,145268,36
2020-05-06T00:00:00Z,6,5,2020,10102,95,Russia,RU,RUS,144478050,Europe,1451,155370,37
2020-05-07T00:00:00Z,7,5,2020,10559,86,Russia,RU,RUS,144478050,Europe,1537,165929,38
2020-05-08T00:00:00Z,8,5,2020,11231,88,Russia,RU,RUS,144478050,Europe,1625,177160,39
2020-05-09T00:00:00Z,9,5,2020,10699,98,Russia,RU,RUS,144478050,Europe,1723,187859,40
2020-05-10T00:00:00Z,10,5,2020,10817,104,Russia,RU,RUS,144478050,Europe,1827,198676,41
2020-05-11T00:00:00Z,11,5,2020,11012,88,Russia,RU,RUS,144478050,Europe,1915,209688,42
2020-05-12T00:00:00Z,12,5,2020,11656,94,Russia,RU,RUS,144478050,Europe,2009,221344,43
2020-05-13T00:00:00Z,13,5,2020,10899,107,Russia,RU,RUS,144478050,Europe,2116,232243,44
2020-05-14T00:00:00Z,14,5,2020,10028,96,Russia,RU,RUS,144478050,Europe,2212,242271,45
2020-05-15T00:00:00Z,15,5,2020,9974,93,Russia,RU,RUS,144478050,Europe,2305,252245,46
2020-05-16T00:00:00Z,16,5,2020,10598,113,Russia,RU,RUS,144478050,Europe,2418,262843,47
2020-05-17T00:00:00Z,17,5,2020,9200,119,Russia,RU,RUS,144478050,Europe,2537,272043,48
2020-05-18T00:00:00Z,18,5,2020,9709,94,Russia,RU,RUS,144478050,Europe,2631,281752,49
2020-05-19T00:00:00Z,19,5,2020,8926,91,Russia,RU,RUS,144478050,Europe,2722,290678,50
2020-05-20T00:00:00Z,20,5,2020,9263,115,Russia,RU,RUS,144478050,Europe,2837,299941,51
2020-05-21T00:00:00Z,21,5,2020,8764,135,Russia,RU,RUS,144478050,Europe,2972,308705,52
2020-05-22T00:00:00Z,22,5,2020,8849,127,Russia,RU,RUS,144478050,Europe,3099,317554,53
2020-05-23T00:00:00Z,23,5,2020,8894,150,Russia,RU,RUS,144478050,Europe,3249,326448,54
2020-05-24T00:00:00Z,24,5,2020,9434,139,Russia,RU,RUS,144478050,Europe,3388,335882,55
2020-05-25T00:00:00Z,25,5,2020,8599,153,Russia,RU,RUS,144478050,Europe,3541,344481,56
2020-05-26T00:00:00Z,26,5,2020,8946,92,Russia,RU,RUS,144478050,Europe,3633,353427,57
2020-05-27T00:00:00Z,27,5,2020,8915,174,Russia,RU,RUS,144478050,Europe,3807,362342,58
2020-03-18T00:00:00Z,18,3,2020,2,2,San_Marino,SM,SMR,33785,Europe,11,104,1
2020-03-19T00:00:00Z,19,3,2020,5,3,San_Marino,SM,SMR,33785,Europe,14,109,2
2020-03-20T00:00:00Z,20,3,2020,17,0,San_Marino,SM,SMR,33785,Europe,14,126,3
2020-03-21T00:00:00Z,21,3,2020,25,0,San_Marino,SM,SMR,33785,Europe,14,151,4
2020-03-22T00:00:00Z,22,3,2020,0,6,San_Marino,SM,SMR,33785,Europe,20,151,5
2020-03-23T00:00:00Z,23,3,2020,0,0,San_Marino,SM,SMR,33785,Europe,20,151,6
2020-03-24T00:00:00Z,24,3,2020,36,0,San_Marino,SM,SMR,33785,Europe,20,187,7
2020-03-25T00:00:00Z,25,3,2020,0,1,San_Marino,SM,SMR,33785,Europe,21,187,8
2020-03-26T00:00:00Z,26,3,2020,21,0,San_Marino,SM,SMR,33785,Europe,21,208,9
2020-03-27T00:00:00Z,27,3,2020,10,0,San_Marino,SM,SMR,33785,Europe,21,218,10
2020-03-28T00:00:00Z,28,3,2020,5,0,San_Marino,SM,SMR,33785,Europe,21,223,11
2020-03-29T00:00:00Z,29,3,2020,1,1,San_Marino,SM,SMR,33785,Europe,22,224,12
2020-03-30T00:00:00Z,30,3,2020,5,2,San_Marino,SM,SMR,33785,Europe,24,229,13
2020-03-31T00:00:00Z,31,3,2020,0,1,San_Marino,SM,SMR,33785,Europe,25,229,14
2020-04-01T00:00:00Z,1,4,2020,1,1,San_Marino,SM,SMR,33785,Europe,26,230,15
2020-04-02T00:00:00Z,2,4,2020,6,0,San_Marino,SM,SMR,33785,Europe,26,236,16
2020-04-03T00:00:00Z,3,4,2020,9,4,San_Marino,SM,SMR,33785,Europe,30,245,17
2020-04-04T00:00:00Z,4,4,2020,6,2,San_Marino,SM,SMR,33785,Europe,32,251,18
2020-04-05T00:00:00Z,5,4,2020,8,0,San_Marino,SM,SMR,33785,Europe,32,259,19
2020-04-06T00:00:00Z,6,4,2020,7,0,San_Marino,SM,SMR,33785,Europe,32,266,20
2020-04-07T00:00:00Z,7,4,2020,11,0,San_Marino,SM,SMR,33785,Europe,32,277,21
2020-04-08T00:00:00Z,8,4,2020,2,2,San_Marino,SM,SMR,33785,Europe,34,279,22
2020-04-09T00:00:00Z,9,4,2020,29,0,San_Marino,SM,SMR,33785,Europe,34,308,23
2020-04-10T00:00:00Z,10,4,2020,25,0,San_Marino,SM,SMR,33785,Europe,34,333,24
2020-04-11T00:00:00Z,11,4,2020,11,0,San_Marino,SM,SMR,33785,Europe,34,344,25
2020-04-12T00:00:00Z,12,4,2020,12,1,San_Marino,SM,SMR,33785,Europe,35,356,26
2020-04-13T00:00:00Z,13,4,2020,0,0,San_Marino,SM,SMR,33785,Europe,35,356,27
2020-04-14T00:00:00Z,14,4,2020,0,1,San_Marino,SM,SMR,33785,Europe,36,356,28
2020-04-15T00:00:00Z,15,4,2020,16,0,San_Marino,SM,SMR,33785,Europe,36,372,29
2020-04-16T00:00:00Z,16,4,2020,20,0,San_Marino,SM,SMR,33785,Europe,36,392,30
2020-04-17T00:00:00Z,17,4,2020,34,2,San_Marino,SM,SMR,33785,Europe,38,426,31
2020-04-18T00:00:00Z,18,4,2020,9,1,San_Marino,SM,SMR,33785,Europe,39,435,32
2020-04-19T00:00:00Z,19,4,2020,20,0,San_Marino,SM,SMR,33785,Europe,39,455,33
2020-04-20T00:00:00Z,20,4,2020,6,0,San_Marino,SM,SMR,33785,Europe,39,461,34
2020-04-21T00:00:00Z,21,4,2020,1,0,San_Marino,SM,SMR,33785,Europe,39,462,35
2020-04-22T00:00:00Z,22,4,2020,14,1,San_Marino,SM,SMR,33785,Europe,40,476,36
2020-04-23T00:00:00Z,23,4,2020,12,0,San_Marino,SM,SMR,33785,Europe,40,488,37
2020-04-24T00:00:00Z,24,4,2020,13,0,San_Marino,SM,SMR,33785,Europe,40,501,38
2020-04-25T00:00:00Z,25,4,2020,12,0,San_Marino,SM,SMR,33785,Europe,40,513,39
2020-04-26T00:00:00Z,26,4,2020,0,0,San_Marino,SM,SMR,33785,Europe,40,513,40
2020-04-27T00:00:00Z,27,4,2020,25,1,San_Marino,SM,SMR,33785,Europe,41,538,41
2020-04-28T00:00:00Z,28,4,2020,0,0,San_Marino,SM,SMR,33785,Europe,41,538,42
2020-04-29T00:00:00Z,29,4,2020,15,0,San_Marino,SM,SMR,33785,Europe,41,553,43
2020-04-30T00:00:00Z,30,4,2020,10,0,San_Marino,SM,SMR,33785,Europe,41,563,44
2020-05-01T00:00:00Z,1,5,2020,6,0,San_Marino,SM,SMR,33785,Europe,41,569,45
2020-05-02T00:00:00Z,2,5,2020,11,0,San_Marino,SM,SMR,33785,Europe,41,580,46
2020-05-03T00:00:00Z,3,5,2020,0,0,San_Marino,SM,SMR,33785,Europe,41,580,47
2020-05-04T00:00:00Z,4,5,2020,2,0,San_Marino,SM,SMR,33785,Europe,41,582,48
2020-05-05T00:00:00Z,5,5,2020,0,0,San_Marino,SM,SMR,33785,Europe,41,582,49
2020-05-06T00:00:00Z,6,5,2020,7,0,San_Marino,SM,SMR,33785,Europe,41,589,50
2020-05-07T00:00:00Z,7,5,2020,19,0,San_Marino,SM,SMR,33785,Europe,41,608,51
2020-05-08T00:00:00Z,8,5,2020,14,0,San_Marino,SM,SMR,33785,Europe,41,622,52
2020-05-09T00:00:00Z,9,5,2020,1,0,San_Marino,SM,SMR,33785,Europe,41,623,53
2020-05-10T00:00:00Z,10,5,2020,14,0,San_Marino,SM,SMR,33785,Europe,41,637,54
2020-05-11T00:00:00Z,11,5,2020,-9,0,San_Marino,SM,SMR,33785,Europe,41,628,55
2020-05-12T00:00:00Z,12,5,2020,0,0,San_Marino,SM,SMR,33785,Europe,41,628,56
2020-05-13T00:00:00Z,13,5,2020,10,0,San_Marino,SM,SMR,33785,Europe,41,638,57
2020-05-14T00:00:00Z,14,5,2020,5,0,San_Marino,SM,SMR,33785,Europe,41,643,58
2020-05-15T00:00:00Z,15,5,2020,5,0,San_Marino,SM,SMR,33785,Europe,41,648,59
2020-05-16T00:00:00Z,16,5,2020,4,0,San_Marino,SM,SMR,33785,Europe,41,652,60
2020-05-17T00:00:00Z,17,5,2020,1,0,San_Marino,SM,SMR,33785,Europe,41,653,61
2020-05-18T00:00:00Z,18,5,2020,1,0,San_Marino,SM,SMR,33785,Europe,41,654,62
2020-05-19T00:00:00Z,19,5,2020,0,0,San_Marino,SM,SMR,33785,Europe,41,654,63
2020-05-20T00:00:00Z,20,5,2020,1,0,San_Marino,SM,SMR,33785,Europe,41,655,64
2020-05-21T00:00:00Z,21,5,2020,1,0,San_Marino,SM,SMR,33785,Europe,41,656,65
2020-05-22T00:00:00Z,22,5,2020,2,0,San_Marino,SM,SMR,33785,Europe,41,658,66
2020-05-23T00:00:00Z,23,5,2020,3,0,San_Marino,SM,SMR,33785,Europe,41,661,67
2020-05-24T00:00:00Z,24,5,2020,4,1,San_Marino,SM,SMR,33785,Europe,42,665,68
2020-05-25T00:00:00Z,25,5,2020,0,0,San_Marino,SM,SMR,33785,Europe,42,665,69
2020-05-26T00:00:00Z,26,5,2020,1,0,San_Marino,SM,SMR,33785,Europe,42,666,70
2020-05-27T00:00:00Z,27,5,2020,0,0,San_Marino,SM,SMR,33785,Europe,42,666,71
2020-05-26T00:00:00Z,26,5,2020,0,2,Sao_Tome_and_Principe,ST,STP,211028,Africa,11,299,1
2020-05-27T00:00:00Z,27,5,2020,142,1,Sao_Tome_and_Principe,ST,STP,211028,Africa,12,441,2
2020-04-01T00:00:00Z,1,4,2020,110,2,Saudi_Arabia,SA,SAU,33699947,Asia,10,1563,1
2020-04-02T00:00:00Z,2,4,2020,157,6,Saudi_Arabia,SA,SAU,33699947,Asia,16,1720,2
2020-04-03T00:00:00Z,3,4,2020,165,5,Saudi_Arabia,SA,SAU,33699947,Asia,21,1885,3
2020-04-04T00:00:00Z,4,4,2020,0,0,Saudi_Arabia,SA,SAU,33699947,Asia,21,1885,4
2020-04-05T00:00:00Z,5,4,2020,294,8,Saudi_Arabia,SA,SAU,33699947,Asia,29,2179,5
2020-04-06T00:00:00Z,6,4,2020,206,5,Saudi_Arabia,SA,SAU,33699947,Asia,34,2385,6
2020-04-07T00:00:00Z,7,4,2020,138,4,Saudi_Arabia,SA,SAU,33699947,Asia,38,2523,7
2020-04-08T00:00:00Z,8,4,2020,272,3,Saudi_Arabia,SA,SAU,33699947,Asia,41,2795,8
2020-04-09T00:00:00Z,9,4,2020,137,0,Saudi_Arabia,SA,SAU,33699947,Asia,41,2932,9
2020-04-10T00:00:00Z,10,4,2020,355,3,Saudi_Arabia,SA,SAU,33699947,Asia,44,3287,10
2020-04-11T00:00:00Z,11,4,2020,364,3,Saudi_Arabia,SA,SAU,33699947,Asia,47,3651,11
2020-04-12T00:00:00Z,12,4,2020,382,5,Saudi_Arabia,SA,SAU,33699947,Asia,52,4033,12
2020-04-13T00:00:00Z,13,4,2020,429,7,Saudi_Arabia,SA,SAU,33699947,Asia,59,4462,13
2020-04-14T00:00:00Z,14,4,2020,472,6,Saudi_Arabia,SA,SAU,33699947,Asia,65,4934,14
2020-04-15T00:00:00Z,15,4,2020,435,8,Saudi_Arabia,SA,SAU,33699947,Asia,73,5369,15
2020-04-16T00:00:00Z,16,4,2020,493,6,Saudi_Arabia,SA,SAU,33699947,Asia,79,5862,16
2020-04-17T00:00:00Z,17,4,2020,518,4,Saudi_Arabia,SA,SAU,33699947,Asia,83,6380,17
2020-04-18T00:00:00Z,18,4,2020,762,4,Saudi_Arabia,SA,SAU,33699947,Asia,87,7142,18
2020-04-19T00:00:00Z,19,4,2020,1132,5,Saudi_Arabia,SA,SAU,33699947,Asia,92,8274,19
2020-04-20T00:00:00Z,20,4,2020,1088,5,Saudi_Arabia,SA,SAU,33699947,Asia,97,9362,20
2020-04-21T00:00:00Z,21,4,2020,1122,6,Saudi_Arabia,SA,SAU,33699947,Asia,103,10484,21
2020-04-22T00:00:00Z,22,4,2020,1147,6,Saudi_Arabia,SA,SAU,33699947,Asia,109,11631,22
2020-04-23T00:00:00Z,23,4,2020,1141,5,Saudi_Arabia,SA,SAU,33699947,Asia,114,12772,23
2020-04-24T00:00:00Z,24,4,2020,1158,7,Saudi_Arabia,SA,SAU,33699947,Asia,121,13930,24
2020-04-25T00:00:00Z,25,4,2020,1172,6,Saudi_Arabia,SA,SAU,33699947,Asia,127,15102,25
2020-04-26T00:00:00Z,26,4,2020,1197,9,Saudi_Arabia,SA,SAU,33699947,Asia,136,16299,26
2020-04-27T00:00:00Z,27,4,2020,1223,3,Saudi_Arabia,SA,SAU,33699947,Asia,139,17522,27
2020-04-28T00:00:00Z,28,4,2020,1289,5,Saudi_Arabia,SA,SAU,33699947,Asia,144,18811,28
2020-04-29T00:00:00Z,29,4,2020,1266,8,Saudi_Arabia,SA,SAU,33699947,Asia,152,20077,29
2020-04-30T00:00:00Z,30,4,2020,1325,5,Saudi_Arabia,SA,SAU,33699947,Asia,157,21402,30
2020-05-01T00:00:00Z,1,5,2020,1351,5,Saudi_Arabia,SA,SAU,33699947,Asia,162,22753,31
2020-05-02T00:00:00Z,2,5,2020,1344,7,Saudi_Arabia,SA,SAU,33699947,Asia,169,24097,32
2020-05-03T00:00:00Z,3,5,2020,1362,7,Saudi_Arabia,SA,SAU,33699947,Asia,176,25459,33
2020-05-04T00:00:00Z,4,5,2020,1552,8,Saudi_Arabia,SA,SAU,33699947,Asia,184,27011,34
2020-05-05T00:00:00Z,5,5,2020,1645,7,Saudi_Arabia,SA,SAU,33699947,Asia,191,28656,35
2020-05-06T00:00:00Z,6,5,2020,1595,9,Saudi_Arabia,SA,SAU,33699947,Asia,200,30251,36
2020-05-07T00:00:00Z,7,5,2020,1687,9,Saudi_Arabia,SA,SAU,33699947,Asia,209,31938,37
2020-05-08T00:00:00Z,8,5,2020,1793,10,Saudi_Arabia,SA,SAU,33699947,Asia,219,33731,38
2020-05-09T00:00:00Z,9,5,2020,1701,10,Saudi_Arabia,SA,SAU,33699947,Asia,229,35432,39
2020-05-10T00:00:00Z,10,5,2020,1704,10,Saudi_Arabia,SA,SAU,33699947,Asia,239,37136,40
2020-05-11T00:00:00Z,11,5,2020,1912,7,Saudi_Arabia,SA,SAU,33699947,Asia,246,39048,41
2020-05-12T00:00:00Z,12,5,2020,1966,9,Saudi_Arabia,SA,SAU,33699947,Asia,255,41014,42
2020-05-13T00:00:00Z,13,5,2020,1911,9,Saudi_Arabia,SA,SAU,33699947,Asia,264,42925,43
2020-05-14T00:00:00Z,14,5,2020,1905,9,Saudi_Arabia,SA,SAU,33699947,Asia,273,44830,44
2020-05-15T00:00:00Z,15,5,2020,2039,10,Saudi_Arabia,SA,SAU,33699947,Asia,283,46869,45
2020-05-16T00:00:00Z,16,5,2020,2307,9,Saudi_Arabia,SA,SAU,33699947,Asia,292,49176,46
2020-05-17T00:00:00Z,17,5,2020,2840,10,Saudi_Arabia,SA,SAU,33699947,Asia,302,52016,47
2020-05-18T00:00:00Z,18,5,2020,2736,10,Saudi_Arabia,SA,SAU,33699947,Asia,312,54752,48
2020-05-19T00:00:00Z,19,5,2020,2593,8,Saudi_Arabia,SA,SAU,33699947,Asia,320,57345,49
2020-05-20T00:00:00Z,20,5,2020,2509,9,Saudi_Arabia,SA,SAU,33699947,Asia,329,59854,50
2020-05-21T00:00:00Z,21,5,2020,2691,10,Saudi_Arabia,SA,SAU,33699947,Asia,339,62545,51
2020-05-22T00:00:00Z,22,5,2020,2532,12,Saudi_Arabia,SA,SAU,33699947,Asia,351,65077,52
2020-05-23T00:00:00Z,23,5,2020,2642,13,Saudi_Arabia,SA,SAU,33699947,Asia,364,67719,53
2020-05-24T00:00:00Z,24,5,2020,2442,15,Saudi_Arabia,SA,SAU,33699947,Asia,379,70161,54
2020-05-25T00:00:00Z,25,5,2020,2399,11,Saudi_Arabia,SA,SAU,33699947,Asia,390,72560,55
2020-05-26T00:00:00Z,26,5,2020,2235,9,Saudi_Arabia,SA,SAU,33699947,Asia,399,74795,56
2020-05-27T00:00:00Z,27,5,2020,1931,12,Saudi_Arabia,SA,SAU,33699947,Asia,411,76726,57
2020-05-05T00:00:00Z,5,5,2020,89,1,Senegal,SN,SEN,15854360,Africa,10,1271,1
2020-05-06T00:00:00Z,6,5,2020,58,1,Senegal,SN,SEN,15854360,Africa,11,1329,2
2020-05-07T00:00:00Z,7,5,2020,104,1,Senegal,SN,SEN,15854360,Africa,12,1433,3
2020-05-08T00:00:00Z,8,5,2020,59,1,Senegal,SN,SEN,15854360,Africa,13,1492,4
2020-05-09T00:00:00Z,9,5,2020,59,1,Senegal,SN,SEN,15854360,Africa,14,1551,5
2020-05-10T00:00:00Z,10,5,2020,83,3,Senegal,SN,SEN,15854360,Africa,17,1634,6
2020-05-11T00:00:00Z,11,5,2020,75,2,Senegal,SN,SEN,15854360,Africa,19,1709,7
2020-05-12T00:00:00Z,12,5,2020,177,0,Senegal,SN,SEN,15854360,Africa,19,1886,8
2020-05-13T00:00:00Z,13,5,2020,109,0,Senegal,SN,SEN,15854360,Africa,19,1995,9
2020-05-14T00:00:00Z,14,5,2020,110,3,Senegal,SN,SEN,15854360,Africa,22,2105,10
2020-05-15T00:00:00Z,15,5,2020,84,1,Senegal,SN,SEN,15854360,Africa,23,2189,11
2020-05-16T00:00:00Z,16,5,2020,121,2,Senegal,SN,SEN,15854360,Africa,25,2310,12
2020-05-17T00:00:00Z,17,5,2020,119,0,Senegal,SN,SEN,15854360,Africa,25,2429,13
2020-05-18T00:00:00Z,18,5,2020,51,1,Senegal,SN,SEN,15854360,Africa,26,2480,14
2020-05-19T00:00:00Z,19,5,2020,64,0,Senegal,SN,SEN,15854360,Africa,26,2544,15
2020-05-20T00:00:00Z,20,5,2020,73,4,Senegal,SN,SEN,15854360,Africa,30,2617,16
2020-05-21T00:00:00Z,21,5,2020,97,0,Senegal,SN,SEN,15854360,Africa,30,2714,17
2020-05-22T00:00:00Z,22,5,2020,98,3,Senegal,SN,SEN,15854360,Africa,33,2812,18
2020-05-23T00:00:00Z,23,5,2020,97,0,Senegal,SN,SEN,15854360,Africa,33,2909,19
2020-05-24T00:00:00Z,24,5,2020,67,2,Senegal,SN,SEN,15854360,Africa,35,2976,20
2020-05-25T00:00:00Z,25,5,2020,71,0,Senegal,SN,SEN,15854360,Africa,35,3047,21
2020-05-26T00:00:00Z,26,5,2020,83,1,Senegal,SN,SEN,15854360,Africa,36,3130,22
2020-05-27T00:00:00Z,27,5,2020,31,1,Senegal,SN,SEN,15854360,Africa,37,3161,23
2020-03-29T00:00:00Z,29,3,2020,202,4,Serbia,RS,SRB,6982084,Europe,10,659,1
2020-03-30T00:00:00Z,30,3,2020,82,3,Serbia,RS,SRB,6982084,Europe,13,741,2
2020-03-31T00:00:00Z,31,3,2020,0,0,Serbia,RS,SRB,6982084,Europe,13,741,3
2020-04-01T00:00:00Z,1,4,2020,159,10,Serbia,RS,SRB,6982084,Europe,23,900,4
2020-04-02T00:00:00Z,2,4,2020,160,0,Serbia,RS,SRB,6982084,Europe,23,1060,5
2020-04-03T00:00:00Z,3,4,2020,111,8,Serbia,RS,SRB,6982084,Europe,31,1171,6
2020-04-04T00:00:00Z,4,4,2020,305,8,Serbia,RS,SRB,6982084,Europe,39,1476,7
2020-04-05T00:00:00Z,5,4,2020,148,5,Serbia,RS,SRB,6982084,Europe,44,1624,8
2020-04-06T00:00:00Z,6,4,2020,284,7,Serbia,RS,SRB,6982084,Europe,51,1908,9
2020-04-07T00:00:00Z,7,4,2020,292,7,Serbia,RS,SRB,6982084,Europe,58,2200,10
2020-04-08T00:00:00Z,8,4,2020,247,3,Serbia,RS,SRB,6982084,Europe,61,2447,11
2020-04-09T00:00:00Z,9,4,2020,219,4,Serbia,RS,SRB,6982084,Europe,65,2666,12
2020-04-10T00:00:00Z,10,4,2020,201,1,Serbia,RS,SRB,6982084,Europe,66,2867,13
2020-04-11T00:00:00Z,11,4,2020,238,5,Serbia,RS,SRB,6982084,Europe,71,3105,14
2020-04-12T00:00:00Z,12,4,2020,275,3,Serbia,RS,SRB,6982084,Europe,74,3380,15
2020-04-13T00:00:00Z,13,4,2020,250,6,Serbia,RS,SRB,6982084,Europe,80,3630,16
2020-04-14T00:00:00Z,14,4,2020,424,5,Serbia,RS,SRB,6982084,Europe,85,4054,17
2020-04-15T00:00:00Z,15,4,2020,411,9,Serbia,RS,SRB,6982084,Europe,94,4465,18
2020-04-16T00:00:00Z,16,4,2020,408,5,Serbia,RS,SRB,6982084,Europe,99,4873,19
2020-04-17T00:00:00Z,17,4,2020,445,4,Serbia,RS,SRB,6982084,Europe,103,5318,20
2020-04-18T00:00:00Z,18,4,2020,372,7,Serbia,RS,SRB,6982084,Europe,110,5690,21
2020-04-19T00:00:00Z,19,4,2020,304,7,Serbia,RS,SRB,6982084,Europe,117,5994,22
2020-04-20T00:00:00Z,20,4,2020,324,5,Serbia,RS,SRB,6982084,Europe,122,6318,23
2020-04-21T00:00:00Z,21,4,2020,312,3,Serbia,RS,SRB,6982084,Europe,125,6630,24
2020-04-22T00:00:00Z,22,4,2020,260,0,Serbia,RS,SRB,6982084,Europe,125,6890,25
2020-04-23T00:00:00Z,23,4,2020,224,9,Serbia,RS,SRB,6982084,Europe,134,7114,26
2020-04-24T00:00:00Z,24,4,2020,162,5,Serbia,RS,SRB,6982084,Europe,139,7276,27
2020-04-25T00:00:00Z,25,4,2020,207,5,Serbia,RS,SRB,6982084,Europe,144,7483,28
2020-04-26T00:00:00Z,26,4,2020,296,7,Serbia,RS,SRB,6982084,Europe,151,7779,29
2020-04-27T00:00:00Z,27,4,2020,263,5,Serbia,RS,SRB,6982084,Europe,156,8042,30
2020-04-28T00:00:00Z,28,4,2020,233,6,Serbia,RS,SRB,6982084,Europe,162,8275,31
2020-04-29T00:00:00Z,29,4,2020,222,6,Serbia,RS,SRB,6982084,Europe,168,8497,32
2020-04-30T00:00:00Z,30,4,2020,227,5,Serbia,RS,SRB,6982084,Europe,173,8724,33
2020-05-01T00:00:00Z,1,5,2020,285,6,Serbia,RS,SRB,6982084,Europe,179,9009,34
2020-05-02T00:00:00Z,2,5,2020,196,6,Serbia,RS,SRB,6982084,Europe,185,9205,35
2020-05-03T00:00:00Z,3,5,2020,157,4,Serbia,RS,SRB,6982084,Europe,189,9362,36
2020-05-04T00:00:00Z,4,5,2020,102,4,Serbia,RS,SRB,6982084,Europe,193,9464,37
2020-05-05T00:00:00Z,5,5,2020,93,4,Serbia,RS,SRB,6982084,Europe,197,9557,38
2020-05-06T00:00:00Z,6,5,2020,120,3,Serbia,RS,SRB,6982084,Europe,200,9677,39
2020-05-07T00:00:00Z,7,5,2020,114,3,Serbia,RS,SRB,6982084,Europe,203,9791,40
2020-05-08T00:00:00Z,8,5,2020,57,3,Serbia,RS,SRB,6982084,Europe,206,9848,41
2020-05-09T00:00:00Z,9,5,2020,95,3,Serbia,RS,SRB,6982084,Europe,209,9943,42
2020-05-10T00:00:00Z,10,5,2020,89,4,Serbia,RS,SRB,6982084,Europe,213,10032,43
2020-05-11T00:00:00Z,11,5,2020,82,2,Serbia,RS,SRB,6982084,Europe,215,10114,44
2020-05-12T00:00:00Z,12,5,2020,62,3,Serbia,RS,SRB,6982084,Europe,218,10176,45
2020-05-13T00:00:00Z,13,5,2020,67,2,Serbia,RS,SRB,6982084,Europe,220,10243,46
2020-05-14T00:00:00Z,14,5,2020,52,2,Serbia,RS,SRB,6982084,Europe,222,10295,47
2020-05-15T00:00:00Z,15,5,2020,79,2,Serbia,RS,SRB,6982084,Europe,224,10374,48
2020-05-16T00:00:00Z,16,5,2020,64,1,Serbia,RS,SRB,6982084,Europe,225,10438,49
2020-05-17T00:00:00Z,17,5,2020,58,3,Serbia,RS,SRB,6982084,Europe,228,10496,50
2020-05-18T00:00:00Z,18,5,2020,114,2,Serbia,RS,SRB,6982084,Europe,230,10610,51
2020-05-19T00:00:00Z,19,5,2020,89,1,Serbia,RS,SRB,6982084,Europe,231,10699,52
2020-05-20T00:00:00Z,20,5,2020,34,3,Serbia,RS,SRB,6982084,Europe,234,10733,53
2020-05-21T00:00:00Z,21,5,2020,100,1,Serbia,RS,SRB,6982084,Europe,235,10833,54
2020-05-22T00:00:00Z,22,5,2020,86,2,Serbia,RS,SRB,6982084,Europe,237,10919,55
2020-05-23T00:00:00Z,23,5,2020,105,0,Serbia,RS,SRB,6982084,Europe,237,11024,56
2020-05-24T00:00:00Z,24,5,2020,68,1,Serbia,RS,SRB,6982084,Europe,238,11092,57
2020-05-25T00:00:00Z,25,5,2020,67,0,Serbia,RS,SRB,6982084,Europe,238,11159,58
2020-05-26T00:00:00Z,26,5,2020,34,1,Serbia,RS,SRB,6982084,Europe,239,11193,59
2020-05-27T00:00:00Z,27,5,2020,34,0,Serbia,RS,SRB,6982084,Europe,239,11227,60
2020-05-06T00:00:00Z,6,5,2020,21,2,Sierra_Leone,SL,SLE,7650154,Africa,11,199,1
2020-05-07T00:00:00Z,7,5,2020,26,3,Sierra_Leone,SL,SLE,7650154,Africa,14,225,2
2020-05-08T00:00:00Z,8,5,2020,6,2,Sierra_Leone,SL,SLE,7650154,Africa,16,231,3
2020-05-09T00:00:00Z,9,5,2020,26,1,Sierra_Leone,SL,SLE,7650154,Africa,17,257,4
2020-05-10T00:00:00Z,10,5,2020,34,1,Sierra_Leone,SL,SLE,7650154,Africa,18,291,5
2020-05-11T00:00:00Z,11,5,2020,16,0,Sierra_Leone,SL,SLE,7650154,Africa,18,307,6
2020-05-12T00:00:00Z,12,5,2020,31,1,Sierra_Leone,SL,SLE,7650154,Africa,19,338,7
2020-05-13T00:00:00Z,13,5,2020,0,1,Sierra_Leone,SL,SLE,7650154,Africa,20,338,8
2020-05-14T00:00:00Z,14,5,2020,49,1,Sierra_Leone,SL,SLE,7650154,Africa,21,387,9
2020-05-15T00:00:00Z,15,5,2020,21,5,Sierra_Leone,SL,SLE,7650154,Africa,26,408,10
2020-05-16T00:00:00Z,16,5,2020,39,1,Sierra_Leone,SL,SLE,7650154,Africa,27,447,11
2020-05-17T00:00:00Z,17,5,2020,15,2,Sierra_Leone,SL,SLE,7650154,Africa,29,462,12
2020-05-18T00:00:00Z,18,5,2020,43,3,Sierra_Leone,SL,SLE,7650154,Africa,32,505,13
2020-05-19T00:00:00Z,19,5,2020,14,1,Sierra_Leone,SL,SLE,7650154,Africa,33,519,14
2020-05-20T00:00:00Z,20,5,2020,15,0,Sierra_Leone,SL,SLE,7650154,Africa,33,534,15
2020-05-21T00:00:00Z,21,5,2020,36,1,Sierra_Leone,SL,SLE,7650154,Africa,34,570,16
2020-05-22T00:00:00Z,22,5,2020,15,1,Sierra_Leone,SL,SLE,7650154,Africa,35,585,17
2020-05-23T00:00:00Z,23,5,2020,21,3,Sierra_Leone,SL,SLE,7650154,Africa,38,606,18
2020-05-24T00:00:00Z,24,5,2020,15,1,Sierra_Leone,SL,SLE,7650154,Africa,39,621,19
2020-05-25T00:00:00Z,25,5,2020,86,1,Sierra_Leone,SL,SLE,7650154,Africa,40,707,20
2020-05-26T00:00:00Z,26,5,2020,28,2,Sierra_Leone,SL,SLE,7650154,Africa,42,735,21
2020-05-27T00:00:00Z,27,5,2020,19,2,Sierra_Leone,SL,SLE,7650154,Africa,44,754,22
2020-04-15T00:00:00Z,15,4,2020,334,1,Singapore,SG,SGP,5638676,Asia,10,3252,1
2020-04-16T00:00:00Z,16,4,2020,447,0,Singapore,SG,SGP,5638676,Asia,10,3699,2
2020-04-17T00:00:00Z,17,4,2020,728,0,Singapore,SG,SGP,5638676,Asia,10,4427,3
2020-04-18T00:00:00Z,18,4,2020,623,1,Singapore,SG,SGP,5638676,Asia,11,5050,4
2020-04-19T00:00:00Z,19,4,2020,942,0,Singapore,SG,SGP,5638676,Asia,11,5992,5
2020-04-20T00:00:00Z,20,4,2020,596,0,Singapore,SG,SGP,5638676,Asia,11,6588,6
2020-04-21T00:00:00Z,21,4,2020,1426,0,Singapore,SG,SGP,5638676,Asia,11,8014,7
2020-04-22T00:00:00Z,22,4,2020,1111,0,Singapore,SG,SGP,5638676,Asia,11,9125,8
2020-04-23T00:00:00Z,23,4,2020,1016,1,Singapore,SG,SGP,5638676,Asia,12,10141,9
2020-04-24T00:00:00Z,24,4,2020,1037,0,Singapore,SG,SGP,5638676,Asia,12,11178,10
2020-04-25T00:00:00Z,25,4,2020,897,0,Singapore,SG,SGP,5638676,Asia,12,12075,11
2020-04-26T00:00:00Z,26,4,2020,618,0,Singapore,SG,SGP,5638676,Asia,12,12693,12
2020-04-27T00:00:00Z,27,4,2020,931,0,Singapore,SG,SGP,5638676,Asia,12,13624,13
2020-04-28T00:00:00Z,28,4,2020,799,2,Singapore,SG,SGP,5638676,Asia,14,14423,14
2020-04-29T00:00:00Z,29,4,2020,528,0,Singapore,SG,SGP,5638676,Asia,14,14951,15
2020-04-30T00:00:00Z,30,4,2020,690,0,Singapore,SG,SGP,5638676,Asia,14,15641,16
2020-05-01T00:00:00Z,1,5,2020,528,1,Singapore,SG,SGP,5638676,Asia,15,16169,17
2020-05-02T00:00:00Z,2,5,2020,932,1,Singapore,SG,SGP,5638676,Asia,16,17101,18
2020-05-03T00:00:00Z,3,5,2020,447,1,Singapore,SG,SGP,5638676,Asia,17,17548,19
2020-05-04T00:00:00Z,4,5,2020,657,1,Singapore,SG,SGP,5638676,Asia,18,18205,20
2020-05-05T00:00:00Z,5,5,2020,573,0,Singapore,SG,SGP,5638676,Asia,18,18778,21
2020-05-06T00:00:00Z,6,5,2020,632,0,Singapore,SG,SGP,5638676,Asia,18,19410,22
2020-05-07T00:00:00Z,7,5,2020,788,2,Singapore,SG,SGP,5638676,Asia,20,20198,23
2020-05-08T00:00:00Z,8,5,2020,741,0,Singapore,SG,SGP,5638676,Asia,20,20939,24
2020-05-09T00:00:00Z,9,5,2020,768,0,Singapore,SG,SGP,5638676,Asia,20,21707,25
2020-05-10T00:00:00Z,10,5,2020,753,0,Singapore,SG,SGP,5638676,Asia,20,22460,26
2020-05-11T00:00:00Z,11,5,2020,876,0,Singapore,SG,SGP,5638676,Asia,20,23336,27
2020-05-12T00:00:00Z,12,5,2020,451,1,Singapore,SG,SGP,5638676,Asia,21,23787,28
2020-05-13T00:00:00Z,13,5,2020,884,0,Singapore,SG,SGP,5638676,Asia,21,24671,29
2020-05-14T00:00:00Z,14,5,2020,675,0,Singapore,SG,SGP,5638676,Asia,21,25346,30
2020-05-15T00:00:00Z,15,5,2020,752,0,Singapore,SG,SGP,5638676,Asia,21,26098,31
2020-05-16T00:00:00Z,16,5,2020,793,0,Singapore,SG,SGP,5638676,Asia,21,26891,32
2020-05-17T00:00:00Z,17,5,2020,465,1,Singapore,SG,SGP,5638676,Asia,22,27356,33
2020-05-18T00:00:00Z,18,5,2020,682,0,Singapore,SG,SGP,5638676,Asia,22,28038,34
2020-05-19T00:00:00Z,19,5,2020,305,0,Singapore,SG,SGP,5638676,Asia,22,28343,35
2020-05-20T00:00:00Z,20,5,2020,451,0,Singapore,SG,SGP,5638676,Asia,22,28794,36
2020-05-21T00:00:00Z,21,5,2020,570,0,Singapore,SG,SGP,5638676,Asia,22,29364,37
2020-05-22T00:00:00Z,22,5,2020,448,1,Singapore,SG,SGP,5638676,Asia,23,29812,38
2020-05-23T00:00:00Z,23,5,2020,614,0,Singapore,SG,SGP,5638676,Asia,23,30426,39
2020-05-24T00:00:00Z,24,5,2020,642,0,Singapore,SG,SGP,5638676,Asia,23,31068,40
2020-05-25T00:00:00Z,25,5,2020,548,0,Singapore,SG,SGP,5638676,Asia,23,31616,41
2020-05-26T00:00:00Z,26,5,2020,344,0,Singapore,SG,SGP,5638676,Asia,23,31960,42
2020-05-27T00:00:00Z,27,5,2020,383,0,Singapore,SG,SGP,5638676,Asia,23,32343,43
2020-04-20T00:00:00Z,20,4,2020,3,1,Sint_Maarten,SX,SXM,41486,America,10,67,1
2020-04-21T00:00:00Z,21,4,2020,1,0,Sint_Maarten,SX,SXM,41486,America,10,68,2
2020-04-22T00:00:00Z,22,4,2020,0,0,Sint_Maarten,SX,SXM,41486,America,10,68,3
2020-04-23T00:00:00Z,23,4,2020,5,2,Sint_Maarten,SX,SXM,41486,America,12,73,4
2020-04-24T00:00:00Z,24,4,2020,0,0,Sint_Maarten,SX,SXM,41486,America,12,73,5
2020-04-25T00:00:00Z,25,4,2020,0,0,Sint_Maarten,SX,SXM,41486,America,12,73,6
2020-04-26T00:00:00Z,26,4,2020,0,0,Sint_Maarten,SX,SXM,41486,America,12,73,7
2020-04-27T00:00:00Z,27,4,2020,1,1,Sint_Maarten,SX,SXM,41486,America,13,74,8
2020-04-28T00:00:00Z,28,4,2020,1,0,Sint_Maarten,SX,SXM,41486,America,13,75,9
2020-04-29T00:00:00Z,29,4,2020,0,0,Sint_Maarten,SX,SXM,41486,America,13,75,10
2020-04-30T00:00:00Z,30,4,2020,1,0,Sint_Maarten,SX,SXM,41486,America,13,76,11
2020-05-01T00:00:00Z,1,5,2020,0,0,Sint_Maarten,SX,SXM,41486,America,13,76,12
2020-05-02T00:00:00Z,2,5,2020,0,0,Sint_Maarten,SX,SXM,41486,America,13,76,13
2020-05-03T00:00:00Z,3,5,2020,0,0,Sint_Maarten,SX,SXM,41486,America,13,76,14
2020-05-04T00:00:00Z,4,5,2020,0,0,Sint_Maarten,SX,SXM,41486,America,13,76,15
2020-05-05T00:00:00Z,5,5,2020,0,0,Sint_Maarten,SX,SXM,41486,America,13,76,16
2020-05-06T00:00:00Z,6,5,2020,0,1,Sint_Maarten,SX,SXM,41486,America,14,76,17
2020-05-07T00:00:00Z,7,5,2020,0,0,Sint_Maarten,SX,SXM,41486,America,14,76,18
2020-05-08T00:00:00Z,8,5,2020,0,0,Sint_Maarten,SX,SXM,41486,America,14,76,19
2020-05-09T00:00:00Z,9,5,2020,0,1,Sint_Maarten,SX,SXM,41486,America,15,76,20
2020-05-10T00:00:00Z,10,5,2020,0,0,Sint_Maarten,SX,SXM,41486,America,15,76,21
2020-05-11T00:00:00Z,11,5,2020,0,0,Sint_Maarten,SX,SXM,41486,America,15,76,22
2020-05-12T00:00:00Z,12,5,2020,0,0,Sint_Maarten,SX,SXM,41486,America,15,76,23
2020-05-13T00:00:00Z,13,5,2020,1,0,Sint_Maarten,SX,SXM,41486,America,15,77,24
2020-05-14T00:00:00Z,14,5,2020,0,0,Sint_Maarten,SX,SXM,41486,America,15,77,25
2020-05-15T00:00:00Z,15,5,2020,0,0,Sint_Maarten,SX,SXM,41486,America,15,77,26
2020-05-16T00:00:00Z,16,5,2020,0,0,Sint_Maarten,SX,SXM,41486,America,15,77,27
2020-05-17T00:00:00Z,17,5,2020,0,0,Sint_Maarten,SX,SXM,41486,America,15,77,28
2020-05-18T00:00:00Z,18,5,2020,0,0,Sint_Maarten,SX,SXM,41486,America,15,77,29
2020-05-19T00:00:00Z,19,5,2020,0,0,Sint_Maarten,SX,SXM,41486,America,15,77,30
2020-05-20T00:00:00Z,20,5,2020,0,0,Sint_Maarten,SX,SXM,41486,America,15,77,31
2020-05-21T00:00:00Z,21,5,2020,0,0,Sint_Maarten,SX,SXM,41486,America,15,77,32
2020-05-22T00:00:00Z,22,5,2020,0,0,Sint_Maarten,SX,SXM,41486,America,15,77,33
2020-05-23T00:00:00Z,23,5,2020,0,0,Sint_Maarten,SX,SXM,41486,America,15,77,34
2020-05-24T00:00:00Z,24,5,2020,0,0,Sint_Maarten,SX,SXM,41486,America,15,77,35
2020-05-25T00:00:00Z,25,5,2020,0,0,Sint_Maarten,SX,SXM,41486,America,15,77,36
2020-05-26T00:00:00Z,26,5,2020,0,0,Sint_Maarten,SX,SXM,41486,America,15,77,37
2020-05-27T00:00:00Z,27,5,2020,0,0,Sint_Maarten,SX,SXM,41486,America,15,77,38
2020-04-19T00:00:00Z,19,4,2020,40,2,Slovakia,SK,SVK,5447011,Europe,11,1089,1
2020-04-20T00:00:00Z,20,4,2020,72,1,Slovakia,SK,SVK,5447011,Europe,12,1161,2
2020-04-21T00:00:00Z,21,4,2020,12,1,Slovakia,SK,SVK,5447011,Europe,13,1173,3
2020-04-22T00:00:00Z,22,4,2020,26,1,Slovakia,SK,SVK,5447011,Europe,14,1199,4
2020-04-23T00:00:00Z,23,4,2020,45,0,Slovakia,SK,SVK,5447011,Europe,14,1244,5
2020-04-24T00:00:00Z,24,4,2020,81,1,Slovakia,SK,SVK,5447011,Europe,15,1325,6
2020-04-25T00:00:00Z,25,4,2020,35,2,Slovakia,SK,SVK,5447011,Europe,17,1360,7
2020-04-26T00:00:00Z,26,4,2020,13,0,Slovakia,SK,SVK,5447011,Europe,17,1373,8
2020-04-27T00:00:00Z,27,4,2020,6,1,Slovakia,SK,SVK,5447011,Europe,18,1379,9
2020-04-28T00:00:00Z,28,4,2020,2,0,Slovakia,SK,SVK,5447011,Europe,18,1381,10
2020-04-29T00:00:00Z,29,4,2020,3,2,Slovakia,SK,SVK,5447011,Europe,20,1384,11
2020-04-30T00:00:00Z,30,4,2020,7,2,Slovakia,SK,SVK,5447011,Europe,22,1391,12
2020-05-01T00:00:00Z,1,5,2020,5,1,Slovakia,SK,SVK,5447011,Europe,23,1396,13
2020-05-02T00:00:00Z,2,5,2020,7,0,Slovakia,SK,SVK,5447011,Europe,23,1403,14
2020-05-03T00:00:00Z,3,5,2020,4,1,Slovakia,SK,SVK,5447011,Europe,24,1407,15
2020-05-04T00:00:00Z,4,5,2020,1,0,Slovakia,SK,SVK,5447011,Europe,24,1408,16
2020-05-05T00:00:00Z,5,5,2020,5,1,Slovakia,SK,SVK,5447011,Europe,25,1413,17
2020-05-06T00:00:00Z,6,5,2020,8,0,Slovakia,SK,SVK,5447011,Europe,25,1421,18
2020-05-07T00:00:00Z,7,5,2020,8,0,Slovakia,SK,SVK,5447011,Europe,25,1429,19
2020-05-08T00:00:00Z,8,5,2020,16,1,Slovakia,SK,SVK,5447011,Europe,26,1445,20
2020-05-09T00:00:00Z,9,5,2020,10,0,Slovakia,SK,SVK,5447011,Europe,26,1455,21
2020-05-10T00:00:00Z,10,5,2020,0,0,Slovakia,SK,SVK,5447011,Europe,26,1455,22
2020-05-11T00:00:00Z,11,5,2020,2,0,Slovakia,SK,SVK,5447011,Europe,26,1457,23
2020-05-12T00:00:00Z,12,5,2020,0,0,Slovakia,SK,SVK,5447011,Europe,26,1457,24
2020-05-13T00:00:00Z,13,5,2020,8,1,Slovakia,SK,SVK,5447011,Europe,27,1465,25
2020-05-14T00:00:00Z,14,5,2020,4,0,Slovakia,SK,SVK,5447011,Europe,27,1469,26
2020-05-15T00:00:00Z,15,5,2020,8,0,Slovakia,SK,SVK,5447011,Europe,27,1477,27
2020-05-16T00:00:00Z,16,5,2020,3,0,Slovakia,SK,SVK,5447011,Europe,27,1480,28
2020-05-17T00:00:00Z,17,5,2020,13,1,Slovakia,SK,SVK,5447011,Europe,28,1493,29
2020-05-18T00:00:00Z,18,5,2020,1,0,Slovakia,SK,SVK,5447011,Europe,28,1494,30
2020-05-19T00:00:00Z,19,5,2020,1,0,Slovakia,SK,SVK,5447011,Europe,28,1495,31
2020-05-20T00:00:00Z,20,5,2020,0,0,Slovakia,SK,SVK,5447011,Europe,28,1495,32
2020-05-21T00:00:00Z,21,5,2020,1,0,Slovakia,SK,SVK,5447011,Europe,28,1496,33
2020-05-22T00:00:00Z,22,5,2020,6,0,Slovakia,SK,SVK,5447011,Europe,28,1502,34
2020-05-23T00:00:00Z,23,5,2020,1,0,Slovakia,SK,SVK,5447011,Europe,28,1503,35
2020-05-24T00:00:00Z,24,5,2020,1,0,Slovakia,SK,SVK,5447011,Europe,28,1504,36
2020-05-25T00:00:00Z,25,5,2020,5,0,Slovakia,SK,SVK,5447011,Europe,28,1509,37
2020-05-26T00:00:00Z,26,5,2020,2,0,Slovakia,SK,SVK,5447011,Europe,28,1511,38
2020-05-27T00:00:00Z,27,5,2020,2,0,Slovakia,SK,SVK,5447011,Europe,28,1513,39
2020-03-30T00:00:00Z,30,3,2020,39,2,Slovenia,SI,SVN,2067372,Europe,11,730,1
2020-03-31T00:00:00Z,31,3,2020,33,0,Slovenia,SI,SVN,2067372,Europe,11,763,2
2020-04-01T00:00:00Z,1,4,2020,51,2,Slovenia,SI,SVN,2067372,Europe,13,814,3
2020-04-02T00:00:00Z,2,4,2020,27,2,Slovenia,SI,SVN,2067372,Europe,15,841,4
2020-04-03T00:00:00Z,3,4,2020,56,1,Slovenia,SI,SVN,2067372,Europe,16,897,5
2020-04-04T00:00:00Z,4,4,2020,37,4,Slovenia,SI,SVN,2067372,Europe,20,934,6
2020-04-05T00:00:00Z,5,4,2020,43,2,Slovenia,SI,SVN,2067372,Europe,22,977,7
2020-04-06T00:00:00Z,6,4,2020,20,6,Slovenia,SI,SVN,2067372,Europe,28,997,8
2020-04-07T00:00:00Z,7,4,2020,24,2,Slovenia,SI,SVN,2067372,Europe,30,1021,9
2020-04-08T00:00:00Z,8,4,2020,34,6,Slovenia,SI,SVN,2067372,Europe,36,1055,10
2020-04-09T00:00:00Z,9,4,2020,36,4,Slovenia,SI,SVN,2067372,Europe,40,1091,11
2020-04-10T00:00:00Z,10,4,2020,33,3,Slovenia,SI,SVN,2067372,Europe,43,1124,12
2020-04-11T00:00:00Z,11,4,2020,36,2,Slovenia,SI,SVN,2067372,Europe,45,1160,13
2020-04-12T00:00:00Z,12,4,2020,28,5,Slovenia,SI,SVN,2067372,Europe,50,1188,14
2020-04-13T00:00:00Z,13,4,2020,17,3,Slovenia,SI,SVN,2067372,Europe,53,1205,15
2020-04-14T00:00:00Z,14,4,2020,7,2,Slovenia,SI,SVN,2067372,Europe,55,1212,16
2020-04-15T00:00:00Z,15,4,2020,8,1,Slovenia,SI,SVN,2067372,Europe,56,1220,17
2020-04-16T00:00:00Z,16,4,2020,28,5,Slovenia,SI,SVN,2067372,Europe,61,1248,18
2020-04-17T00:00:00Z,17,4,2020,20,0,Slovenia,SI,SVN,2067372,Europe,61,1268,19
2020-04-18T00:00:00Z,18,4,2020,36,5,Slovenia,SI,SVN,2067372,Europe,66,1304,20
2020-04-19T00:00:00Z,19,4,2020,13,4,Slovenia,SI,SVN,2067372,Europe,70,1317,21
2020-04-20T00:00:00Z,20,4,2020,13,4,Slovenia,SI,SVN,2067372,Europe,74,1330,22
2020-04-21T00:00:00Z,21,4,2020,5,0,Slovenia,SI,SVN,2067372,Europe,74,1335,23
2020-04-22T00:00:00Z,22,4,2020,5,3,Slovenia,SI,SVN,2067372,Europe,77,1340,24
2020-04-23T00:00:00Z,23,4,2020,13,2,Slovenia,SI,SVN,2067372,Europe,79,1353,25
2020-04-24T00:00:00Z,24,4,2020,13,0,Slovenia,SI,SVN,2067372,Europe,79,1366,26
2020-04-25T00:00:00Z,25,4,2020,7,1,Slovenia,SI,SVN,2067372,Europe,80,1373,27
2020-04-26T00:00:00Z,26,4,2020,15,1,Slovenia,SI,SVN,2067372,Europe,81,1388,28
2020-04-27T00:00:00Z,27,4,2020,19,1,Slovenia,SI,SVN,2067372,Europe,82,1407,29
2020-04-28T00:00:00Z,28,4,2020,0,1,Slovenia,SI,SVN,2067372,Europe,83,1407,30
2020-04-29T00:00:00Z,29,4,2020,1,3,Slovenia,SI,SVN,2067372,Europe,86,1408,31
2020-04-30T00:00:00Z,30,4,2020,10,3,Slovenia,SI,SVN,2067372,Europe,89,1418,32
2020-05-01T00:00:00Z,1,5,2020,11,2,Slovenia,SI,SVN,2067372,Europe,91,1429,33
2020-05-02T00:00:00Z,2,5,2020,5,2,Slovenia,SI,SVN,2067372,Europe,93,1434,34
2020-05-03T00:00:00Z,3,5,2020,5,1,Slovenia,SI,SVN,2067372,Europe,94,1439,35
2020-05-04T00:00:00Z,4,5,2020,0,2,Slovenia,SI,SVN,2067372,Europe,96,1439,36
2020-05-05T00:00:00Z,5,5,2020,6,1,Slovenia,SI,SVN,2067372,Europe,97,1445,37
2020-05-06T00:00:00Z,6,5,2020,3,1,Slovenia,SI,SVN,2067372,Europe,98,1448,38
2020-05-07T00:00:00Z,7,5,2020,1,1,Slovenia,SI,SVN,2067372,Europe,99,1449,39
2020-05-08T00:00:00Z,8,5,2020,1,0,Slovenia,SI,SVN,2067372,Europe,99,1450,40
2020-05-09T00:00:00Z,9,5,2020,4,1,Slovenia,SI,SVN,2067372,Europe,100,1454,41
2020-05-10T00:00:00Z,10,5,2020,3,1,Slovenia,SI,SVN,2067372,Europe,101,1457,42
2020-05-11T00:00:00Z,11,5,2020,3,1,Slovenia,SI,SVN,2067372,Europe,102,1460,43
2020-05-12T00:00:00Z,12,5,2020,1,0,Slovenia,SI,SVN,2067372,Europe,102,1461,44
2020-05-13T00:00:00Z,13,5,2020,2,0,Slovenia,SI,SVN,2067372,Europe,102,1463,45
2020-05-14T00:00:00Z,14,5,2020,1,1,Slovenia,SI,SVN,2067372,Europe,103,1464,46
2020-05-15T00:00:00Z,15,5,2020,1,0,Slovenia,SI,SVN,2067372,Europe,103,1465,47
2020-05-16T00:00:00Z,16,5,2020,0,0,Slovenia,SI,SVN,2067372,Europe,103,1465,48
2020-05-17T00:00:00Z,17,5,2020,1,0,Slovenia,SI,SVN,2067372,Europe,103,1466,49
2020-05-18T00:00:00Z,18,5,2020,0,1,Slovenia,SI,SVN,2067372,Europe,104,1466,50
2020-05-19T00:00:00Z,19,5,2020,1,0,Slovenia,SI,SVN,2067372,Europe,104,1467,51
2020-05-20T00:00:00Z,20,5,2020,1,0,Slovenia,SI,SVN,2067372,Europe,104,1468,52
2020-05-21T00:00:00Z,21,5,2020,0,2,Slovenia,SI,SVN,2067372,Europe,106,1468,53
2020-05-22T00:00:00Z,22,5,2020,0,0,Slovenia,SI,SVN,2067372,Europe,106,1468,54
2020-05-23T00:00:00Z,23,5,2020,0,0,Slovenia,SI,SVN,2067372,Europe,106,1468,55
2020-05-24T00:00:00Z,24,5,2020,0,0,Slovenia,SI,SVN,2067372,Europe,106,1468,56
2020-05-25T00:00:00Z,25,5,2020,1,0,Slovenia,SI,SVN,2067372,Europe,106,1469,57
2020-05-26T00:00:00Z,26,5,2020,0,0,Slovenia,SI,SVN,2067372,Europe,106,1469,58
2020-05-27T00:00:00Z,27,5,2020,0,0,Slovenia,SI,SVN,2067372,Europe,106,1469,59
2020-04-23T00:00:00Z,23,4,2020,0,6,Somalia,SO,SOM,15008154,Africa,14,286,1
2020-04-24T00:00:00Z,24,4,2020,42,0,Somalia,SO,SOM,15008154,Africa,14,328,2
2020-04-25T00:00:00Z,25,4,2020,0,2,Somalia,SO,SOM,15008154,Africa,16,328,3
2020-04-26T00:00:00Z,26,4,2020,62,2,Somalia,SO,SOM,15008154,Africa,18,390,4
2020-04-27T00:00:00Z,27,4,2020,46,5,Somalia,SO,SOM,15008154,Africa,23,436,5
2020-04-28T00:00:00Z,28,4,2020,44,3,Somalia,SO,SOM,15008154,Africa,26,480,6
2020-04-29T00:00:00Z,29,4,2020,48,2,Somalia,SO,SOM,15008154,Africa,28,528,7
2020-04-30T00:00:00Z,30,4,2020,54,0,Somalia,SO,SOM,15008154,Africa,28,582,8
2020-05-01T00:00:00Z,1,5,2020,19,0,Somalia,SO,SOM,15008154,Africa,28,601,9
2020-05-02T00:00:00Z,2,5,2020,0,0,Somalia,SO,SOM,15008154,Africa,28,601,10
2020-05-03T00:00:00Z,3,5,2020,70,3,Somalia,SO,SOM,15008154,Africa,31,671,11
2020-05-04T00:00:00Z,4,5,2020,51,1,Somalia,SO,SOM,15008154,Africa,32,722,12
2020-05-05T00:00:00Z,5,5,2020,34,3,Somalia,SO,SOM,15008154,Africa,35,756,13
2020-05-06T00:00:00Z,6,5,2020,79,3,Somalia,SO,SOM,15008154,Africa,38,835,14
2020-05-07T00:00:00Z,7,5,2020,38,1,Somalia,SO,SOM,15008154,Africa,39,873,15
2020-05-08T00:00:00Z,8,5,2020,55,5,Somalia,SO,SOM,15008154,Africa,44,928,16
2020-05-09T00:00:00Z,9,5,2020,0,0,Somalia,SO,SOM,15008154,Africa,44,928,17
2020-05-10T00:00:00Z,10,5,2020,69,4,Somalia,SO,SOM,15008154,Africa,48,997,18
2020-05-11T00:00:00Z,11,5,2020,57,3,Somalia,SO,SOM,15008154,Africa,51,1054,19
2020-05-12T00:00:00Z,12,5,2020,35,1,Somalia,SO,SOM,15008154,Africa,52,1089,20
2020-05-13T00:00:00Z,13,5,2020,81,0,Somalia,SO,SOM,15008154,Africa,52,1170,21
2020-05-14T00:00:00Z,14,5,2020,49,0,Somalia,SO,SOM,15008154,Africa,52,1219,22
2020-05-15T00:00:00Z,15,5,2020,65,1,Somalia,SO,SOM,15008154,Africa,53,1284,23
2020-05-16T00:00:00Z,16,5,2020,0,0,Somalia,SO,SOM,15008154,Africa,53,1284,24
2020-05-17T00:00:00Z,17,5,2020,73,2,Somalia,SO,SOM,15008154,Africa,55,1357,25
2020-05-18T00:00:00Z,18,5,2020,64,1,Somalia,SO,SOM,15008154,Africa,56,1421,26
2020-05-19T00:00:00Z,19,5,2020,34,1,Somalia,SO,SOM,15008154,Africa,57,1455,27
2020-05-20T00:00:00Z,20,5,2020,47,2,Somalia,SO,SOM,15008154,Africa,59,1502,28
2020-05-21T00:00:00Z,21,5,2020,71,2,Somalia,SO,SOM,15008154,Africa,61,1573,29
2020-05-22T00:00:00Z,22,5,2020,21,0,Somalia,SO,SOM,15008154,Africa,61,1594,30
2020-05-23T00:00:00Z,23,5,2020,0,0,Somalia,SO,SOM,15008154,Africa,61,1594,31
2020-05-24T00:00:00Z,24,5,2020,0,0,Somalia,SO,SOM,15008154,Africa,61,1594,32
2020-05-25T00:00:00Z,25,5,2020,0,0,Somalia,SO,SOM,15008154,Africa,61,1594,33
2020-05-26T00:00:00Z,26,5,2020,95,5,Somalia,SO,SOM,15008154,Africa,66,1689,34
2020-05-27T00:00:00Z,27,5,2020,22,1,Somalia,SO,SOM,15008154,Africa,67,1711,35
2020-04-06T00:00:00Z,6,4,2020,70,2,South_Africa,ZA,ZAF,57779622,Africa,11,1655,1
2020-04-07T00:00:00Z,7,4,2020,31,1,South_Africa,ZA,ZAF,57779622,Africa,12,1686,2
2020-04-08T00:00:00Z,8,4,2020,63,1,South_Africa,ZA,ZAF,57779622,Africa,13,1749,3
2020-04-09T00:00:00Z,9,4,2020,96,5,South_Africa,ZA,ZAF,57779622,Africa,18,1845,4
2020-04-10T00:00:00Z,10,4,2020,89,0,South_Africa,ZA,ZAF,57779622,Africa,18,1934,5
2020-04-11T00:00:00Z,11,4,2020,69,6,South_Africa,ZA,ZAF,57779622,Africa,24,2003,6
2020-04-12T00:00:00Z,12,4,2020,25,1,South_Africa,ZA,ZAF,57779622,Africa,25,2028,7
2020-04-13T00:00:00Z,13,4,2020,145,0,South_Africa,ZA,ZAF,57779622,Africa,25,2173,8
2020-04-14T00:00:00Z,14,4,2020,99,2,South_Africa,ZA,ZAF,57779622,Africa,27,2272,9
2020-04-15T00:00:00Z,15,4,2020,143,0,South_Africa,ZA,ZAF,57779622,Africa,27,2415,10
2020-04-16T00:00:00Z,16,4,2020,91,7,South_Africa,ZA,ZAF,57779622,Africa,34,2506,11
2020-04-17T00:00:00Z,17,4,2020,99,14,South_Africa,ZA,ZAF,57779622,Africa,48,2605,12
2020-04-18T00:00:00Z,18,4,2020,178,2,South_Africa,ZA,ZAF,57779622,Africa,50,2783,13
2020-04-19T00:00:00Z,19,4,2020,251,2,South_Africa,ZA,ZAF,57779622,Africa,52,3034,14
2020-04-20T00:00:00Z,20,4,2020,124,2,South_Africa,ZA,ZAF,57779622,Africa,54,3158,15
2020-04-21T00:00:00Z,21,4,2020,142,4,South_Africa,ZA,ZAF,57779622,Africa,58,3300,16
2020-04-22T00:00:00Z,22,4,2020,165,0,South_Africa,ZA,ZAF,57779622,Africa,58,3465,17
2020-04-23T00:00:00Z,23,4,2020,170,7,South_Africa,ZA,ZAF,57779622,Africa,65,3635,18
2020-04-24T00:00:00Z,24,4,2020,318,10,South_Africa,ZA,ZAF,57779622,Africa,75,3953,19
2020-04-25T00:00:00Z,25,4,2020,267,4,South_Africa,ZA,ZAF,57779622,Africa,79,4220,20
2020-04-26T00:00:00Z,26,4,2020,141,7,South_Africa,ZA,ZAF,57779622,Africa,86,4361,21
2020-04-27T00:00:00Z,27,4,2020,185,1,South_Africa,ZA,ZAF,57779622,Africa,87,4546,22
2020-04-28T00:00:00Z,28,4,2020,247,3,South_Africa,ZA,ZAF,57779622,Africa,90,4793,23
2020-04-29T00:00:00Z,29,4,2020,203,3,South_Africa,ZA,ZAF,57779622,Africa,93,4996,24
2020-04-30T00:00:00Z,30,4,2020,354,10,South_Africa,ZA,ZAF,57779622,Africa,103,5350,25
2020-05-01T00:00:00Z,1,5,2020,297,0,South_Africa,ZA,ZAF,57779622,Africa,103,5647,26
2020-05-02T00:00:00Z,2,5,2020,304,13,South_Africa,ZA,ZAF,57779622,Africa,116,5951,27
2020-05-03T00:00:00Z,3,5,2020,385,7,South_Africa,ZA,ZAF,57779622,Africa,123,6336,28
2020-05-04T00:00:00Z,4,5,2020,447,8,South_Africa,ZA,ZAF,57779622,Africa,131,6783,29
2020-05-05T00:00:00Z,5,5,2020,437,7,South_Africa,ZA,ZAF,57779622,Africa,138,7220,30
2020-05-06T00:00:00Z,6,5,2020,352,10,South_Africa,ZA,ZAF,57779622,Africa,148,7572,31
2020-05-07T00:00:00Z,7,5,2020,236,5,South_Africa,ZA,ZAF,57779622,Africa,153,7808,32
2020-05-08T00:00:00Z,8,5,2020,424,8,South_Africa,ZA,ZAF,57779622,Africa,161,8232,33
2020-05-09T00:00:00Z,9,5,2020,663,17,South_Africa,ZA,ZAF,57779622,Africa,178,8895,34
2020-05-10T00:00:00Z,10,5,2020,525,8,South_Africa,ZA,ZAF,57779622,Africa,186,9420,35
2020-05-11T00:00:00Z,11,5,2020,595,8,South_Africa,ZA,ZAF,57779622,Africa,194,10015,36
2020-05-12T00:00:00Z,12,5,2020,637,12,South_Africa,ZA,ZAF,57779622,Africa,206,10652,37
2020-05-13T00:00:00Z,13,5,2020,698,0,South_Africa,ZA,ZAF,57779622,Africa,206,11350,38
2020-05-14T00:00:00Z,14,5,2020,724,13,South_Africa,ZA,ZAF,57779622,Africa,219,12074,39
2020-05-15T00:00:00Z,15,5,2020,665,19,South_Africa,ZA,ZAF,57779622,Africa,238,12739,40
2020-05-16T00:00:00Z,16,5,2020,785,9,South_Africa,ZA,ZAF,57779622,Africa,247,13524,41
2020-05-17T00:00:00Z,17,5,2020,831,14,South_Africa,ZA,ZAF,57779622,Africa,261,14355,42
2020-05-18T00:00:00Z,18,5,2020,1160,3,South_Africa,ZA,ZAF,57779622,Africa,264,15515,43
2020-05-19T00:00:00Z,19,5,2020,918,22,South_Africa,ZA,ZAF,57779622,Africa,286,16433,44
2020-05-20T00:00:00Z,20,5,2020,767,26,South_Africa,ZA,ZAF,57779622,Africa,312,17200,45
2020-05-21T00:00:00Z,21,5,2020,803,27,South_Africa,ZA,ZAF,57779622,Africa,339,18003,46
2020-05-22T00:00:00Z,22,5,2020,1134,30,South_Africa,ZA,ZAF,57779622,Africa,369,19137,47
2020-05-23T00:00:00Z,23,5,2020,988,28,South_Africa,ZA,ZAF,57779622,Africa,397,20125,48
2020-05-24T00:00:00Z,24,5,2020,1218,10,South_Africa,ZA,ZAF,57779622,Africa,407,21343,49
2020-05-25T00:00:00Z,25,5,2020,1240,22,South_Africa,ZA,ZAF,57779622,Africa,429,22583,50
2020-05-26T00:00:00Z,26,5,2020,1032,52,South_Africa,ZA,ZAF,57779622,Africa,481,23615,51
2020-05-27T00:00:00Z,27,5,2020,649,43,South_Africa,ZA,ZAF,57779622,Africa,524,24264,52
2020-02-26T00:00:00Z,26,2,2020,254,3,South_Korea,KR,KOR,51635256,Asia,11,1146,1
2020-02-27T00:00:00Z,27,2,2020,449,1,South_Korea,KR,KOR,51635256,Asia,12,1595,2
2020-02-28T00:00:00Z,28,2,2020,427,1,South_Korea,KR,KOR,51635256,Asia,13,2022,3
2020-02-29T00:00:00Z,29,2,2020,909,3,South_Korea,KR,KOR,51635256,Asia,16,2931,4
2020-03-01T00:00:00Z,1,3,2020,595,1,South_Korea,KR,KOR,51635256,Asia,17,3526,5
2020-03-02T00:00:00Z,2,3,2020,686,5,South_Korea,KR,KOR,51635256,Asia,22,4212,6
2020-03-03T00:00:00Z,3,3,2020,600,6,South_Korea,KR,KOR,51635256,Asia,28,4812,7
2020-03-04T00:00:00Z,4,3,2020,516,4,South_Korea,KR,KOR,51635256,Asia,32,5328,8
2020-03-05T00:00:00Z,5,3,2020,438,3,South_Korea,KR,KOR,51635256,Asia,35,5766,9
2020-03-06T00:00:00Z,6,3,2020,518,7,South_Korea,KR,KOR,51635256,Asia,42,6284,10
2020-03-07T00:00:00Z,7,3,2020,483,2,South_Korea,KR,KOR,51635256,Asia,44,6767,11
2020-03-08T00:00:00Z,8,3,2020,367,6,South_Korea,KR,KOR,51635256,Asia,50,7134,12
2020-03-09T00:00:00Z,9,3,2020,248,1,South_Korea,KR,KOR,51635256,Asia,51,7382,13
2020-03-10T00:00:00Z,10,3,2020,131,3,South_Korea,KR,KOR,51635256,Asia,54,7513,14
2020-03-11T00:00:00Z,11,3,2020,242,6,South_Korea,KR,KOR,51635256,Asia,60,7755,15
2020-03-12T00:00:00Z,12,3,2020,114,6,South_Korea,KR,KOR,51635256,Asia,66,7869,16
2020-03-13T00:00:00Z,13,3,2020,110,1,South_Korea,KR,KOR,51635256,Asia,67,7979,17
2020-03-14T00:00:00Z,14,3,2020,107,5,South_Korea,KR,KOR,51635256,Asia,72,8086,18
2020-03-15T00:00:00Z,15,3,2020,76,3,South_Korea,KR,KOR,51635256,Asia,75,8162,19
2020-03-16T00:00:00Z,16,3,2020,74,0,South_Korea,KR,KOR,51635256,Asia,75,8236,20
2020-03-17T00:00:00Z,17,3,2020,84,6,South_Korea,KR,KOR,51635256,Asia,81,8320,21
2020-03-18T00:00:00Z,18,3,2020,93,5,South_Korea,KR,KOR,51635256,Asia,86,8413,22
2020-03-19T00:00:00Z,19,3,2020,152,5,South_Korea,KR,KOR,51635256,Asia,91,8565,23
2020-03-20T00:00:00Z,20,3,2020,87,9,South_Korea,KR,KOR,51635256,Asia,100,8652,24
2020-03-21T00:00:00Z,21,3,2020,147,3,South_Korea,KR,KOR,51635256,Asia,103,8799,25
2020-03-22T00:00:00Z,22,3,2020,98,1,South_Korea,KR,KOR,51635256,Asia,104,8897,26
2020-03-23T00:00:00Z,23,3,2020,64,9,South_Korea,KR,KOR,51635256,Asia,113,8961,27
2020-03-24T00:00:00Z,24,3,2020,76,7,South_Korea,KR,KOR,51635256,Asia,120,9037,28
2020-03-25T00:00:00Z,25,3,2020,100,6,South_Korea,KR,KOR,51635256,Asia,126,9137,29
2020-03-26T00:00:00Z,26,3,2020,104,5,South_Korea,KR,KOR,51635256,Asia,131,9241,30
2020-03-27T00:00:00Z,27,3,2020,91,8,South_Korea,KR,KOR,51635256,Asia,139,9332,31
2020-03-28T00:00:00Z,28,3,2020,146,5,South_Korea,KR,KOR,51635256,Asia,144,9478,32
2020-03-29T00:00:00Z,29,3,2020,105,8,South_Korea,KR,KOR,51635256,Asia,152,9583,33
2020-03-30T00:00:00Z,30,3,2020,78,6,South_Korea,KR,KOR,51635256,Asia,158,9661,34
2020-03-31T00:00:00Z,31,3,2020,125,5,South_Korea,KR,KOR,51635256,Asia,163,9786,35
2020-04-01T00:00:00Z,1,4,2020,0,0,South_Korea,KR,KOR,51635256,Asia,163,9786,36
2020-04-02T00:00:00Z,2,4,2020,190,6,South_Korea,KR,KOR,51635256,Asia,169,9976,37
2020-04-03T00:00:00Z,3,4,2020,86,5,South_Korea,KR,KOR,51635256,Asia,174,10062,38
2020-04-04T00:00:00Z,4,4,2020,94,3,South_Korea,KR,KOR,51635256,Asia,177,10156,39
2020-04-05T00:00:00Z,5,4,2020,81,6,South_Korea,KR,KOR,51635256,Asia,183,10237,40
2020-04-06T00:00:00Z,6,4,2020,47,3,South_Korea,KR,KOR,51635256,Asia,186,10284,41
2020-04-07T00:00:00Z,7,4,2020,47,6,South_Korea,KR,KOR,51635256,Asia,192,10331,42
2020-04-08T00:00:00Z,8,4,2020,53,8,South_Korea,KR,KOR,51635256,Asia,200,10384,43
2020-04-09T00:00:00Z,9,4,2020,39,4,South_Korea,KR,KOR,51635256,Asia,204,10423,44
2020-04-10T00:00:00Z,10,4,2020,27,4,South_Korea,KR,KOR,51635256,Asia,208,10450,45
2020-04-11T00:00:00Z,11,4,2020,0,0,South_Korea,KR,KOR,51635256,Asia,208,10450,46
2020-04-12T00:00:00Z,12,4,2020,62,6,South_Korea,KR,KOR,51635256,Asia,214,10512,47
2020-04-13T00:00:00Z,13,4,2020,25,3,South_Korea,KR,KOR,51635256,Asia,217,10537,48
2020-04-14T00:00:00Z,14,4,2020,27,5,South_Korea,KR,KOR,51635256,Asia,222,10564,49
2020-04-15T00:00:00Z,15,4,2020,27,3,South_Korea,KR,KOR,51635256,Asia,225,10591,50
2020-04-16T00:00:00Z,16,4,2020,22,4,South_Korea,KR,KOR,51635256,Asia,229,10613,51
2020-04-17T00:00:00Z,17,4,2020,22,1,South_Korea,KR,KOR,51635256,Asia,230,10635,52
2020-04-18T00:00:00Z,18,4,2020,18,2,South_Korea,KR,KOR,51635256,Asia,232,10653,53
2020-04-19T00:00:00Z,19,4,2020,8,2,South_Korea,KR,KOR,51635256,Asia,234,10661,54
2020-04-20T00:00:00Z,20,4,2020,13,2,South_Korea,KR,KOR,51635256,Asia,236,10674,55
2020-04-21T00:00:00Z,21,4,2020,9,1,South_Korea,KR,KOR,51635256,Asia,237,10683,56
2020-04-22T00:00:00Z,22,4,2020,11,1,South_Korea,KR,KOR,51635256,Asia,238,10694,57
2020-04-23T00:00:00Z,23,4,2020,8,2,South_Korea,KR,KOR,51635256,Asia,240,10702,58
2020-04-24T00:00:00Z,24,4,2020,6,0,South_Korea,KR,KOR,51635256,Asia,240,10708,59
2020-04-25T00:00:00Z,25,4,2020,10,0,South_Korea,KR,KOR,51635256,Asia,240,10718,60
2020-04-26T00:00:00Z,26,4,2020,10,2,South_Korea,KR,KOR,51635256,Asia,242,10728,61
2020-04-27T00:00:00Z,27,4,2020,10,1,South_Korea,KR,KOR,51635256,Asia,243,10738,62
2020-04-28T00:00:00Z,28,4,2020,14,1,South_Korea,KR,KOR,51635256,Asia,244,10752,63
2020-04-29T00:00:00Z,29,4,2020,9,2,South_Korea,KR,KOR,51635256,Asia,246,10761,64
2020-04-30T00:00:00Z,30,4,2020,4,1,South_Korea,KR,KOR,51635256,Asia,247,10765,65
2020-05-01T00:00:00Z,1,5,2020,9,1,South_Korea,KR,KOR,51635256,Asia,248,10774,66
2020-05-02T00:00:00Z,2,5,2020,6,2,South_Korea,KR,KOR,51635256,Asia,250,10780,67
2020-05-03T00:00:00Z,3,5,2020,13,0,South_Korea,KR,KOR,51635256,Asia,250,10793,68
2020-05-04T00:00:00Z,4,5,2020,8,2,South_Korea,KR,KOR,51635256,Asia,252,10801,69
2020-05-05T00:00:00Z,5,5,2020,3,2,South_Korea,KR,KOR,51635256,Asia,254,10804,70
2020-05-06T00:00:00Z,6,5,2020,2,1,South_Korea,KR,KOR,51635256,Asia,255,10806,71
2020-05-07T00:00:00Z,7,5,2020,4,1,South_Korea,KR,KOR,51635256,Asia,256,10810,72
2020-05-08T00:00:00Z,8,5,2020,12,0,South_Korea,KR,KOR,51635256,Asia,256,10822,73
2020-05-09T00:00:00Z,9,5,2020,18,0,South_Korea,KR,KOR,51635256,Asia,256,10840,74
2020-05-10T00:00:00Z,10,5,2020,34,0,South_Korea,KR,KOR,51635256,Asia,256,10874,75
2020-05-11T00:00:00Z,11,5,2020,35,0,South_Korea,KR,KOR,51635256,Asia,256,10909,76
2020-05-12T00:00:00Z,12,5,2020,27,2,South_Korea,KR,KOR,51635256,Asia,258,10936,77
2020-05-13T00:00:00Z,13,5,2020,26,1,South_Korea,KR,KOR,51635256,Asia,259,10962,78
2020-05-14T00:00:00Z,14,5,2020,29,1,South_Korea,KR,KOR,51635256,Asia,260,10991,79
2020-05-15T00:00:00Z,15,5,2020,27,0,South_Korea,KR,KOR,51635256,Asia,260,11018,80
2020-05-16T00:00:00Z,16,5,2020,19,2,South_Korea,KR,KOR,51635256,Asia,262,11037,81
2020-05-17T00:00:00Z,17,5,2020,13,0,South_Korea,KR,KOR,51635256,Asia,262,11050,82
2020-05-18T00:00:00Z,18,5,2020,15,1,South_Korea,KR,KOR,51635256,Asia,263,11065,83
2020-05-19T00:00:00Z,19,5,2020,13,0,South_Korea,KR,KOR,51635256,Asia,263,11078,84
2020-05-20T00:00:00Z,20,5,2020,32,0,South_Korea,KR,KOR,51635256,Asia,263,11110,85
2020-05-21T00:00:00Z,21,5,2020,12,1,South_Korea,KR,KOR,51635256,Asia,264,11122,86
2020-05-22T00:00:00Z,22,5,2020,20,0,South_Korea,KR,KOR,51635256,Asia,264,11142,87
2020-05-23T00:00:00Z,23,5,2020,23,2,South_Korea,KR,KOR,51635256,Asia,266,11165,88
2020-05-24T00:00:00Z,24,5,2020,25,0,South_Korea,KR,KOR,51635256,Asia,266,11190,89
2020-05-25T00:00:00Z,25,5,2020,16,1,South_Korea,KR,KOR,51635256,Asia,267,11206,90
2020-05-26T00:00:00Z,26,5,2020,19,2,South_Korea,KR,KOR,51635256,Asia,269,11225,91
2020-05-27T00:00:00Z,27,5,2020,40,0,South_Korea,KR,KOR,51635256,Asia,269,11265,92
2020-03-10T00:00:00Z,10,3,2020,772,23,Spain,ES,ESP,46723749,Europe,28,2299,1
2020-03-11T00:00:00Z,11,3,2020,975,7,Spain,ES,ESP,46723749,Europe,35,3274,2
2020-03-12T00:00:00Z,12,3,2020,1153,12,Spain,ES,ESP,46723749,Europe,47,4427,3
2020-03-13T00:00:00Z,13,3,2020,1531,37,Spain,ES,ESP,46723749,Europe,84,5958,4
2020-03-14T00:00:00Z,14,3,2020,1683,37,Spain,ES,ESP,46723749,Europe,121,7641,5
2020-03-15T00:00:00Z,15,3,2020,2144,15,Spain,ES,ESP,46723749,Europe,136,9785,6
2020-03-16T00:00:00Z,16,3,2020,1706,152,Spain,ES,ESP,46723749,Europe,288,11491,7
2020-03-17T00:00:00Z,17,3,2020,2503,21,Spain,ES,ESP,46723749,Europe,309,13994,8
2020-03-18T00:00:00Z,18,3,2020,3694,182,Spain,ES,ESP,46723749,Europe,491,17688,9
2020-03-19T00:00:00Z,19,3,2020,4047,107,Spain,ES,ESP,46723749,Europe,598,21735,10
2020-03-20T00:00:00Z,20,3,2020,4569,169,Spain,ES,ESP,46723749,Europe,767,26304,11
2020-03-21T00:00:00Z,21,3,2020,5446,235,Spain,ES,ESP,46723749,Europe,1002,31750,12
2020-03-22T00:00:00Z,22,3,2020,4866,324,Spain,ES,ESP,46723749,Europe,1326,36616,13
2020-03-23T00:00:00Z,23,3,2020,4646,394,Spain,ES,ESP,46723749,Europe,1720,41262,14
2020-03-24T00:00:00Z,24,3,2020,7691,462,Spain,ES,ESP,46723749,Europe,2182,48953,15
2020-03-25T00:00:00Z,25,3,2020,8553,514,Spain,ES,ESP,46723749,Europe,2696,57506,16
2020-03-26T00:00:00Z,26,3,2020,8954,738,Spain,ES,ESP,46723749,Europe,3434,66460,17
2020-03-27T00:00:00Z,27,3,2020,9181,655,Spain,ES,ESP,46723749,Europe,4089,75641,18
2020-03-28T00:00:00Z,28,3,2020,8244,769,Spain,ES,ESP,46723749,Europe,4858,83885,19
2020-03-29T00:00:00Z,29,3,2020,6424,832,Spain,ES,ESP,46723749,Europe,5690,90309,20
2020-03-30T00:00:00Z,30,3,2020,5813,838,Spain,ES,ESP,46723749,Europe,6528,96122,21
2020-03-31T00:00:00Z,31,3,2020,8145,812,Spain,ES,ESP,46723749,Europe,7340,104267,22
2020-04-01T00:00:00Z,1,4,2020,7413,849,Spain,ES,ESP,46723749,Europe,8189,111680,23
2020-04-02T00:00:00Z,2,4,2020,7583,864,Spain,ES,ESP,46723749,Europe,9053,119263,24
2020-04-03T00:00:00Z,3,4,2020,7272,950,Spain,ES,ESP,46723749,Europe,10003,126535,25
2020-04-04T00:00:00Z,4,4,2020,6663,932,Spain,ES,ESP,46723749,Europe,10935,133198,26
2020-04-05T00:00:00Z,5,4,2020,5533,809,Spain,ES,ESP,46723749,Europe,11744,138731,27
2020-04-06T00:00:00Z,6,4,2020,3667,674,Spain,ES,ESP,46723749,Europe,12418,142398,28
2020-04-07T00:00:00Z,7,4,2020,5209,637,Spain,ES,ESP,46723749,Europe,13055,147607,29
2020-04-08T00:00:00Z,8,4,2020,5583,743,Spain,ES,ESP,46723749,Europe,13798,153190,30
2020-04-09T00:00:00Z,9,4,2020,5745,757,Spain,ES,ESP,46723749,Europe,14555,158935,31
2020-04-10T00:00:00Z,10,4,2020,4537,683,Spain,ES,ESP,46723749,Europe,15238,163472,32
2020-04-11T00:00:00Z,11,4,2020,4550,605,Spain,ES,ESP,46723749,Europe,15843,168022,33
2020-04-12T00:00:00Z,12,4,2020,3899,510,Spain,ES,ESP,46723749,Europe,16353,171921,34
2020-04-13T00:00:00Z,13,4,2020,3030,619,Spain,ES,ESP,46723749,Europe,16972,174951,35
2020-04-14T00:00:00Z,14,4,2020,3116,517,Spain,ES,ESP,46723749,Europe,17489,178067,36
2020-04-15T00:00:00Z,15,4,2020,4424,787,Spain,ES,ESP,46723749,Europe,18276,182491,37
2020-04-16T00:00:00Z,16,4,2020,3820,617,Spain,ES,ESP,46723749,Europe,18893,186311,38
2020-04-17T00:00:00Z,17,4,2020,3818,585,Spain,ES,ESP,46723749,Europe,19478,190129,39
2020-04-18T00:00:00Z,18,4,2020,3836,565,Spain,ES,ESP,46723749,Europe,20043,193965,40
2020-04-19T00:00:00Z,19,4,2020,-713,410,Spain,ES,ESP,46723749,Europe,20453,193252,41
2020-04-20T00:00:00Z,20,4,2020,2218,399,Spain,ES,ESP,46723749,Europe,20852,195470,42
2020-04-21T00:00:00Z,21,4,2020,2951,430,Spain,ES,ESP,46723749,Europe,21282,198421,43
2020-04-22T00:00:00Z,22,4,2020,2312,435,Spain,ES,ESP,46723749,Europe,21717,200733,44
2020-04-23T00:00:00Z,23,4,2020,2916,440,Spain,ES,ESP,46723749,Europe,22157,203649,45
2020-04-24T00:00:00Z,24,4,2020,2114,367,Spain,ES,ESP,46723749,Europe,22524,205763,46
2020-04-25T00:00:00Z,25,4,2020,2506,378,Spain,ES,ESP,46723749,Europe,22902,208269,47
2020-04-26T00:00:00Z,26,4,2020,1641,288,Spain,ES,ESP,46723749,Europe,23190,209910,48
2020-04-27T00:00:00Z,27,4,2020,1660,0,Spain,ES,ESP,46723749,Europe,23190,211570,49
2020-04-28T00:00:00Z,28,4,2020,1525,632,Spain,ES,ESP,46723749,Europe,23822,213095,50
2020-04-29T00:00:00Z,29,4,2020,847,453,Spain,ES,ESP,46723749,Europe,24275,213942,51
2020-04-30T00:00:00Z,30,4,2020,1241,268,Spain,ES,ESP,46723749,Europe,24543,215183,52
2020-05-01T00:00:00Z,1,5,2020,1387,281,Spain,ES,ESP,46723749,Europe,24824,216570,53
2020-05-02T00:00:00Z,2,5,2020,1234,276,Spain,ES,ESP,46723749,Europe,25100,217804,54
2020-05-03T00:00:00Z,3,5,2020,935,164,Spain,ES,ESP,46723749,Europe,25264,218739,55
2020-05-04T00:00:00Z,4,5,2020,466,164,Spain,ES,ESP,46723749,Europe,25428,219205,56
2020-05-05T00:00:00Z,5,5,2020,1039,185,Spain,ES,ESP,46723749,Europe,25613,220244,57
2020-05-06T00:00:00Z,6,5,2020,880,244,Spain,ES,ESP,46723749,Europe,25857,221124,58
2020-05-07T00:00:00Z,7,5,2020,921,213,Spain,ES,ESP,46723749,Europe,26070,222045,59
2020-05-08T00:00:00Z,8,5,2020,1173,181,Spain,ES,ESP,46723749,Europe,26251,223218,60
2020-05-09T00:00:00Z,9,5,2020,743,227,Spain,ES,ESP,46723749,Europe,26478,223961,61
2020-05-10T00:00:00Z,10,5,2020,3416,143,Spain,ES,ESP,46723749,Europe,26621,227377,62
2020-05-11T00:00:00Z,11,5,2020,393,123,Spain,ES,ESP,46723749,Europe,26744,227770,63
2020-05-12T00:00:00Z,12,5,2020,482,176,Spain,ES,ESP,46723749,Europe,26920,228252,64
2020-05-13T00:00:00Z,13,5,2020,439,184,Spain,ES,ESP,46723749,Europe,27104,228691,65
2020-05-14T00:00:00Z,14,5,2020,849,217,Spain,ES,ESP,46723749,Europe,27321,229540,66
2020-05-15T00:00:00Z,15,5,2020,643,138,Spain,ES,ESP,46723749,Europe,27459,230183,67
2020-05-16T00:00:00Z,16,5,2020,515,104,Spain,ES,ESP,46723749,Europe,27563,230698,68
2020-05-17T00:00:00Z,17,5,2020,652,87,Spain,ES,ESP,46723749,Europe,27650,231350,69
2020-05-18T00:00:00Z,18,5,2020,256,59,Spain,ES,ESP,46723749,Europe,27709,231606,70
2020-05-19T00:00:00Z,19,5,2020,431,69,Spain,ES,ESP,46723749,Europe,27778,232037,71
2020-05-20T00:00:00Z,20,5,2020,518,110,Spain,ES,ESP,46723749,Europe,27888,232555,72
2020-05-21T00:00:00Z,21,5,2020,482,52,Spain,ES,ESP,46723749,Europe,27940,233037,73
2020-05-22T00:00:00Z,22,5,2020,1787,688,Spain,ES,ESP,46723749,Europe,28628,234824,74
2020-05-23T00:00:00Z,23,5,2020,466,50,Spain,ES,ESP,46723749,Europe,28678,235290,75
2020-05-24T00:00:00Z,24,5,2020,482,74,Spain,ES,ESP,46723749,Europe,28752,235772,76
2020-05-25T00:00:00Z,25,5,2020,-372,-1918,Spain,ES,ESP,46723749,Europe,26834,235400,77
2020-05-26T00:00:00Z,26,5,2020,859,283,Spain,ES,ESP,46723749,Europe,27117,236259,78
2020-05-26T00:00:00Z,26,5,2020,41,1,Sri_Lanka,LK,LKA,21670000,Asia,10,1182,1
2020-05-27T00:00:00Z,27,5,2020,137,0,Sri_Lanka,LK,LKA,21670000,Asia,10,1319,2
2020-04-19T00:00:00Z,19,4,2020,34,5,Sudan,SD,SDN,41801533,Africa,10,66,1
2020-04-20T00:00:00Z,20,4,2020,0,0,Sudan,SD,SDN,41801533,Africa,10,66,2
2020-04-21T00:00:00Z,21,4,2020,26,2,Sudan,SD,SDN,41801533,Africa,12,92,3
2020-04-22T00:00:00Z,22,4,2020,15,0,Sudan,SD,SDN,41801533,Africa,12,107,4
2020-04-23T00:00:00Z,23,4,2020,33,1,Sudan,SD,SDN,41801533,Africa,13,140,5
2020-04-24T00:00:00Z,24,4,2020,22,0,Sudan,SD,SDN,41801533,Africa,13,162,6
2020-04-25T00:00:00Z,25,4,2020,12,3,Sudan,SD,SDN,41801533,Africa,16,174,7
2020-04-26T00:00:00Z,26,4,2020,39,1,Sudan,SD,SDN,41801533,Africa,17,213,8
2020-04-27T00:00:00Z,27,4,2020,24,4,Sudan,SD,SDN,41801533,Africa,21,237,9
2020-04-28T00:00:00Z,28,4,2020,38,1,Sudan,SD,SDN,41801533,Africa,22,275,10
2020-04-29T00:00:00Z,29,4,2020,43,3,Sudan,SD,SDN,41801533,Africa,25,318,11
2020-04-30T00:00:00Z,30,4,2020,57,3,Sudan,SD,SDN,41801533,Africa,28,375,12
2020-05-01T00:00:00Z,1,5,2020,67,3,Sudan,SD,SDN,41801533,Africa,31,442,13
2020-05-02T00:00:00Z,2,5,2020,0,0,Sudan,SD,SDN,41801533,Africa,31,442,14
2020-05-03T00:00:00Z,3,5,2020,150,10,Sudan,SD,SDN,41801533,Africa,41,592,15
2020-05-04T00:00:00Z,4,5,2020,86,0,Sudan,SD,SDN,41801533,Africa,41,678,16
2020-05-05T00:00:00Z,5,5,2020,0,0,Sudan,SD,SDN,41801533,Africa,41,678,17
2020-05-06T00:00:00Z,6,5,2020,100,4,Sudan,SD,SDN,41801533,Africa,45,778,18
2020-05-07T00:00:00Z,7,5,2020,74,4,Sudan,SD,SDN,41801533,Africa,49,852,19
2020-05-08T00:00:00Z,8,5,2020,78,3,Sudan,SD,SDN,41801533,Africa,52,930,20
2020-05-09T00:00:00Z,9,5,2020,181,7,Sudan,SD,SDN,41801533,Africa,59,1111,21
2020-05-10T00:00:00Z,10,5,2020,53,5,Sudan,SD,SDN,41801533,Africa,64,1164,22
2020-05-11T00:00:00Z,11,5,2020,199,6,Sudan,SD,SDN,41801533,Africa,70,1363,23
2020-05-12T00:00:00Z,12,5,2020,163,4,Sudan,SD,SDN,41801533,Africa,74,1526,24
2020-05-13T00:00:00Z,13,5,2020,135,6,Sudan,SD,SDN,41801533,Africa,80,1661,25
2020-05-14T00:00:00Z,14,5,2020,157,10,Sudan,SD,SDN,41801533,Africa,90,1818,26
2020-05-15T00:00:00Z,15,5,2020,146,1,Sudan,SD,SDN,41801533,Africa,91,1964,27
2020-05-16T00:00:00Z,16,5,2020,0,0,Sudan,SD,SDN,41801533,Africa,91,1964,28
2020-05-17T00:00:00Z,17,5,2020,0,0,Sudan,SD,SDN,41801533,Africa,91,1964,29
2020-05-18T00:00:00Z,18,5,2020,325,6,Sudan,SD,SDN,41801533,Africa,97,2289,30
2020-05-19T00:00:00Z,19,5,2020,302,8,Sudan,SD,SDN,41801533,Africa,105,2591,31
2020-05-20T00:00:00Z,20,5,2020,0,0,Sudan,SD,SDN,41801533,Africa,105,2591,32
2020-05-21T00:00:00Z,21,5,2020,137,6,Sudan,SD,SDN,41801533,Africa,111,2728,33
2020-05-22T00:00:00Z,22,5,2020,410,10,Sudan,SD,SDN,41801533,Africa,121,3138,34
2020-05-23T00:00:00Z,23,5,2020,240,16,Sudan,SD,SDN,41801533,Africa,137,3378,35
2020-05-24T00:00:00Z,24,5,2020,250,9,Sudan,SD,SDN,41801533,Africa,146,3628,36
2020-05-25T00:00:00Z,25,5,2020,6,0,Sudan,SD,SDN,41801533,Africa,146,3634,37
2020-05-26T00:00:00Z,26,5,2020,192,19,Sudan,SD,SDN,41801533,Africa,165,3826,38
2020-05-27T00:00:00Z,27,5,2020,150,5,Sudan,SD,SDN,41801533,Africa,170,3976,39
2020-03-19T00:00:00Z,19,3,2020,134,2,Sweden,SE,SWE,10183175,Europe,10,1301,1
2020-03-20T00:00:00Z,20,3,2020,122,0,Sweden,SE,SWE,10183175,Europe,10,1423,2
2020-03-21T00:00:00Z,21,3,2020,200,6,Sweden,SE,SWE,10183175,Europe,16,1623,3
2020-03-22T00:00:00Z,22,3,2020,123,4,Sweden,SE,SWE,10183175,Europe,20,1746,4
2020-03-23T00:00:00Z,23,3,2020,160,1,Sweden,SE,SWE,10183175,Europe,21,1906,5
2020-03-24T00:00:00Z,24,3,2020,110,4,Sweden,SE,SWE,10183175,Europe,25,2016,6
2020-03-25T00:00:00Z,25,3,2020,256,11,Sweden,SE,SWE,10183175,Europe,36,2272,7
2020-03-26T00:00:00Z,26,3,2020,238,6,Sweden,SE,SWE,10183175,Europe,42,2510,8
2020-03-27T00:00:00Z,27,3,2020,296,24,Sweden,SE,SWE,10183175,Europe,66,2806,9
2020-03-28T00:00:00Z,28,3,2020,240,26,Sweden,SE,SWE,10183175,Europe,92,3046,10
2020-03-29T00:00:00Z,29,3,2020,401,10,Sweden,SE,SWE,10183175,Europe,102,3447,11
2020-03-30T00:00:00Z,30,3,2020,253,8,Sweden,SE,SWE,10183175,Europe,110,3700,12
2020-03-31T00:00:00Z,31,3,2020,328,36,Sweden,SE,SWE,10183175,Europe,146,4028,13
2020-04-01T00:00:00Z,1,4,2020,407,34,Sweden,SE,SWE,10183175,Europe,180,4435,14
2020-04-02T00:00:00Z,2,4,2020,512,59,Sweden,SE,SWE,10183175,Europe,239,4947,15
2020-04-03T00:00:00Z,3,4,2020,519,43,Sweden,SE,SWE,10183175,Europe,282,5466,16
2020-04-04T00:00:00Z,4,4,2020,612,51,Sweden,SE,SWE,10183175,Europe,333,6078,17
2020-04-05T00:00:00Z,5,4,2020,365,40,Sweden,SE,SWE,10183175,Europe,373,6443,18
2020-04-06T00:00:00Z,6,4,2020,387,28,Sweden,SE,SWE,10183175,Europe,401,6830,19
2020-04-07T00:00:00Z,7,4,2020,376,76,Sweden,SE,SWE,10183175,Europe,477,7206,20
2020-04-08T00:00:00Z,8,4,2020,487,114,Sweden,SE,SWE,10183175,Europe,591,7693,21
2020-04-09T00:00:00Z,9,4,2020,726,96,Sweden,SE,SWE,10183175,Europe,687,8419,22
2020-04-10T00:00:00Z,10,4,2020,722,106,Sweden,SE,SWE,10183175,Europe,793,9141,23
2020-04-11T00:00:00Z,11,4,2020,544,77,Sweden,SE,SWE,10183175,Europe,870,9685,24
2020-04-12T00:00:00Z,12,4,2020,466,17,Sweden,SE,SWE,10183175,Europe,887,10151,25
2020-04-13T00:00:00Z,13,4,2020,332,12,Sweden,SE,SWE,10183175,Europe,899,10483,26
2020-04-14T00:00:00Z,14,4,2020,465,20,Sweden,SE,SWE,10183175,Europe,919,10948,27
2020-04-15T00:00:00Z,15,4,2020,497,114,Sweden,SE,SWE,10183175,Europe,1033,11445,28
2020-04-16T00:00:00Z,16,4,2020,482,170,Sweden,SE,SWE,10183175,Europe,1203,11927,29
2020-04-17T00:00:00Z,17,4,2020,613,130,Sweden,SE,SWE,10183175,Europe,1333,12540,30
2020-04-18T00:00:00Z,18,4,2020,676,67,Sweden,SE,SWE,10183175,Europe,1400,13216,31
2020-04-19T00:00:00Z,19,4,2020,606,111,Sweden,SE,SWE,10183175,Europe,1511,13822,32
2020-04-20T00:00:00Z,20,4,2020,563,29,Sweden,SE,SWE,10183175,Europe,1540,14385,33
2020-04-21T00:00:00Z,21,4,2020,392,40,Sweden,SE,SWE,10183175,Europe,1580,14777,34
2020-04-22T00:00:00Z,22,4,2020,545,185,Sweden,SE,SWE,10183175,Europe,1765,15322,35
2020-04-23T00:00:00Z,23,4,2020,682,172,Sweden,SE,SWE,10183175,Europe,1937,16004,36
2020-04-24T00:00:00Z,24,4,2020,751,84,Sweden,SE,SWE,10183175,Europe,2021,16755,37
2020-04-25T00:00:00Z,25,4,2020,812,131,Sweden,SE,SWE,10183175,Europe,2152,17567,38
2020-04-26T00:00:00Z,26,4,2020,610,40,Sweden,SE,SWE,10183175,Europe,2192,18177,39
2020-04-27T00:00:00Z,27,4,2020,463,2,Sweden,SE,SWE,10183175,Europe,2194,18640,40
2020-04-28T00:00:00Z,28,4,2020,286,80,Sweden,SE,SWE,10183175,Europe,2274,18926,41
2020-04-29T00:00:00Z,29,4,2020,695,81,Sweden,SE,SWE,10183175,Europe,2355,19621,42
2020-04-30T00:00:00Z,30,4,2020,681,107,Sweden,SE,SWE,10183175,Europe,2462,20302,43
2020-05-01T00:00:00Z,1,5,2020,790,124,Sweden,SE,SWE,10183175,Europe,2586,21092,44
2020-05-02T00:00:00Z,2,5,2020,428,67,Sweden,SE,SWE,10183175,Europe,2653,21520,45
2020-05-03T00:00:00Z,3,5,2020,562,16,Sweden,SE,SWE,10183175,Europe,2669,22082,46
2020-05-04T00:00:00Z,4,5,2020,235,10,Sweden,SE,SWE,10183175,Europe,2679,22317,47
2020-05-05T00:00:00Z,5,5,2020,404,90,Sweden,SE,SWE,10183175,Europe,2769,22721,48
2020-05-06T00:00:00Z,6,5,2020,495,85,Sweden,SE,SWE,10183175,Europe,2854,23216,49
2020-05-07T00:00:00Z,7,5,2020,702,87,Sweden,SE,SWE,10183175,Europe,2941,23918,50
2020-05-08T00:00:00Z,8,5,2020,705,99,Sweden,SE,SWE,10183175,Europe,3040,24623,51
2020-05-09T00:00:00Z,9,5,2020,642,135,Sweden,SE,SWE,10183175,Europe,3175,25265,52
2020-05-10T00:00:00Z,10,5,2020,656,45,Sweden,SE,SWE,10183175,Europe,3220,25921,53
2020-05-11T00:00:00Z,11,5,2020,401,5,Sweden,SE,SWE,10183175,Europe,3225,26322,54
2020-05-12T00:00:00Z,12,5,2020,348,31,Sweden,SE,SWE,10183175,Europe,3256,26670,55
2020-05-13T00:00:00Z,13,5,2020,602,57,Sweden,SE,SWE,10183175,Europe,3313,27272,56
2020-05-14T00:00:00Z,14,5,2020,637,147,Sweden,SE,SWE,10183175,Europe,3460,27909,57
2020-05-15T00:00:00Z,15,5,2020,673,69,Sweden,SE,SWE,10183175,Europe,3529,28582,58
2020-05-16T00:00:00Z,16,5,2020,625,117,Sweden,SE,SWE,10183175,Europe,3646,29207,59
2020-05-17T00:00:00Z,17,5,2020,470,28,Sweden,SE,SWE,10183175,Europe,3674,29677,60
2020-05-18T00:00:00Z,18,5,2020,466,5,Sweden,SE,SWE,10183175,Europe,3679,30143,61
2020-05-19T00:00:00Z,19,5,2020,234,19,Sweden,SE,SWE,10183175,Europe,3698,30377,62
2020-05-20T00:00:00Z,20,5,2020,422,45,Sweden,SE,SWE,10183175,Europe,3743,30799,63
2020-05-21T00:00:00Z,21,5,2020,724,88,Sweden,SE,SWE,10183175,Europe,3831,31523,64
2020-05-22T00:00:00Z,22,5,2020,649,40,Sweden,SE,SWE,10183175,Europe,3871,32172,65
2020-05-23T00:00:00Z,23,5,2020,637,54,Sweden,SE,SWE,10183175,Europe,3925,32809,66
2020-05-24T00:00:00Z,24,5,2020,379,67,Sweden,SE,SWE,10183175,Europe,3992,33188,67
2020-05-25T00:00:00Z,25,5,2020,271,6,Sweden,SE,SWE,10183175,Europe,3998,33459,68
2020-05-26T00:00:00Z,26,5,2020,384,31,Sweden,SE,SWE,10183175,Europe,4029,33843,69
2020-05-27T00:00:00Z,27,5,2020,597,96,Sweden,SE,SWE,10183175,Europe,4125,34440,70
2020-03-15T00:00:00Z,15,3,2020,238,4,Switzerland,CH,CHE,8516543,Europe,11,1359,1
2020-03-16T00:00:00Z,16,3,2020,841,2,Switzerland,CH,CHE,8516543,Europe,13,2200,2
2020-03-17T00:00:00Z,17,3,2020,0,1,Switzerland,CH,CHE,8516543,Europe,14,2200,3
2020-03-18T00:00:00Z,18,3,2020,450,5,Switzerland,CH,CHE,8516543,Europe,19,2650,4
2020-03-19T00:00:00Z,19,3,2020,360,2,Switzerland,CH,CHE,8516543,Europe,21,3010,5
2020-03-20T00:00:00Z,20,3,2020,878,12,Switzerland,CH,CHE,8516543,Europe,33,3888,6
2020-03-21T00:00:00Z,21,3,2020,952,10,Switzerland,CH,CHE,8516543,Europe,43,4840,7
2020-03-22T00:00:00Z,22,3,2020,1237,13,Switzerland,CH,CHE,8516543,Europe,56,6077,8
2020-03-23T00:00:00Z,23,3,2020,894,4,Switzerland,CH,CHE,8516543,Europe,60,6971,9
2020-03-24T00:00:00Z,24,3,2020,1044,6,Switzerland,CH,CHE,8516543,Europe,66,8015,10
2020-03-25T00:00:00Z,25,3,2020,774,20,Switzerland,CH,CHE,8516543,Europe,86,8789,11
2020-03-26T00:00:00Z,26,3,2020,925,17,Switzerland,CH,CHE,8516543,Europe,103,9714,12
2020-03-27T00:00:00Z,27,3,2020,1000,58,Switzerland,CH,CHE,8516543,Europe,161,10714,13
2020-03-28T00:00:00Z,28,3,2020,1390,36,Switzerland,CH,CHE,8516543,Europe,197,12104,14
2020-03-29T00:00:00Z,29,3,2020,1048,38,Switzerland,CH,CHE,8516543,Europe,235,13152,15
2020-03-30T00:00:00Z,30,3,2020,1122,22,Switzerland,CH,CHE,8516543,Europe,257,14274,16
2020-03-31T00:00:00Z,31,3,2020,1138,38,Switzerland,CH,CHE,8516543,Europe,295,15412,17
2020-04-01T00:00:00Z,1,4,2020,696,78,Switzerland,CH,CHE,8516543,Europe,373,16108,18
2020-04-02T00:00:00Z,2,4,2020,962,5,Switzerland,CH,CHE,8516543,Europe,378,17070,19
2020-04-03T00:00:00Z,3,4,2020,1124,54,Switzerland,CH,CHE,8516543,Europe,432,18194,20
2020-04-04T00:00:00Z,4,4,2020,1033,52,Switzerland,CH,CHE,8516543,Europe,484,19227,21
2020-04-05T00:00:00Z,5,4,2020,974,56,Switzerland,CH,CHE,8516543,Europe,540,20201,22
2020-04-06T00:00:00Z,6,4,2020,821,19,Switzerland,CH,CHE,8516543,Europe,559,21022,23
2020-04-07T00:00:00Z,7,4,2020,552,25,Switzerland,CH,CHE,8516543,Europe,584,21574,24
2020-04-08T00:00:00Z,8,4,2020,590,57,Switzerland,CH,CHE,8516543,Europe,641,22164,25
2020-04-09T00:00:00Z,9,4,2020,546,64,Switzerland,CH,CHE,8516543,Europe,705,22710,26
2020-04-10T00:00:00Z,10,4,2020,785,51,Switzerland,CH,CHE,8516543,Europe,756,23495,27
2020-04-11T00:00:00Z,11,4,2020,733,49,Switzerland,CH,CHE,8516543,Europe,805,24228,28
2020-04-12T00:00:00Z,12,4,2020,592,26,Switzerland,CH,CHE,8516543,Europe,831,24820,29
2020-04-13T00:00:00Z,13,4,2020,400,27,Switzerland,CH,CHE,8516543,Europe,858,25220,30
2020-04-14T00:00:00Z,14,4,2020,279,0,Switzerland,CH,CHE,8516543,Europe,858,25499,31
2020-04-15T00:00:00Z,15,4,2020,254,42,Switzerland,CH,CHE,8516543,Europe,900,25753,32
2020-04-16T00:00:00Z,16,4,2020,583,73,Switzerland,CH,CHE,8516543,Europe,973,26336,33
2020-04-17T00:00:00Z,17,4,2020,315,43,Switzerland,CH,CHE,8516543,Europe,1016,26651,34
2020-04-18T00:00:00Z,18,4,2020,346,42,Switzerland,CH,CHE,8516543,Europe,1058,26997,35
2020-04-19T00:00:00Z,19,4,2020,325,52,Switzerland,CH,CHE,8516543,Europe,1110,27322,36
2020-04-20T00:00:00Z,20,4,2020,336,24,Switzerland,CH,CHE,8516543,Europe,1134,27658,37
2020-04-21T00:00:00Z,21,4,2020,168,7,Switzerland,CH,CHE,8516543,Europe,1141,27826,38
2020-04-22T00:00:00Z,22,4,2020,155,45,Switzerland,CH,CHE,8516543,Europe,1186,27981,39
2020-04-23T00:00:00Z,23,4,2020,205,30,Switzerland,CH,CHE,8516543,Europe,1216,28186,40
2020-04-24T00:00:00Z,24,4,2020,228,51,Switzerland,CH,CHE,8516543,Europe,1267,28414,41
2020-04-25T00:00:00Z,25,4,2020,181,41,Switzerland,CH,CHE,8516543,Europe,1308,28595,42
2020-04-26T00:00:00Z,26,4,2020,216,20,Switzerland,CH,CHE,8516543,Europe,1328,28811,43
2020-04-27T00:00:00Z,27,4,2020,167,8,Switzerland,CH,CHE,8516543,Europe,1336,28978,44
2020-04-28T00:00:00Z,28,4,2020,103,16,Switzerland,CH,CHE,8516543,Europe,1352,29081,45
2020-04-29T00:00:00Z,29,4,2020,100,27,Switzerland,CH,CHE,8516543,Europe,1379,29181,46
2020-04-30T00:00:00Z,30,4,2020,143,28,Switzerland,CH,CHE,8516543,Europe,1407,29324,47
2020-05-01T00:00:00Z,1,5,2020,179,15,Switzerland,CH,CHE,8516543,Europe,1422,29503,48
2020-05-02T00:00:00Z,2,5,2020,119,12,Switzerland,CH,CHE,8516543,Europe,1434,29622,49
2020-05-03T00:00:00Z,3,5,2020,112,32,Switzerland,CH,CHE,8516543,Europe,1466,29734,50
2020-05-04T00:00:00Z,4,5,2020,88,6,Switzerland,CH,CHE,8516543,Europe,1472,29822,51
2020-05-05T00:00:00Z,5,5,2020,76,4,Switzerland,CH,CHE,8516543,Europe,1476,29898,52
2020-05-06T00:00:00Z,6,5,2020,28,6,Switzerland,CH,CHE,8516543,Europe,1482,29926,53
2020-05-07T00:00:00Z,7,5,2020,51,22,Switzerland,CH,CHE,8516543,Europe,1504,29977,54
2020-05-08T00:00:00Z,8,5,2020,66,13,Switzerland,CH,CHE,8516543,Europe,1517,30043,55
2020-05-09T00:00:00Z,9,5,2020,81,8,Switzerland,CH,CHE,8516543,Europe,1525,30124,56
2020-05-10T00:00:00Z,10,5,2020,44,6,Switzerland,CH,CHE,8516543,Europe,1531,30168,57
2020-05-11T00:00:00Z,11,5,2020,54,6,Switzerland,CH,CHE,8516543,Europe,1537,30222,58
2020-05-12T00:00:00Z,12,5,2020,39,5,Switzerland,CH,CHE,8516543,Europe,1542,30261,59
2020-05-13T00:00:00Z,13,5,2020,36,18,Switzerland,CH,CHE,8516543,Europe,1560,30297,60
2020-05-14T00:00:00Z,14,5,2020,33,3,Switzerland,CH,CHE,8516543,Europe,1563,30330,61
2020-05-15T00:00:00Z,15,5,2020,50,25,Switzerland,CH,CHE,8516543,Europe,1588,30380,62
2020-05-16T00:00:00Z,16,5,2020,51,6,Switzerland,CH,CHE,8516543,Europe,1594,30431,63
2020-05-17T00:00:00Z,17,5,2020,58,7,Switzerland,CH,CHE,8516543,Europe,1601,30489,64
2020-05-18T00:00:00Z,18,5,2020,15,1,Switzerland,CH,CHE,8516543,Europe,1602,30504,65
2020-05-19T00:00:00Z,19,5,2020,10,0,Switzerland,CH,CHE,8516543,Europe,1602,30514,66
2020-05-20T00:00:00Z,20,5,2020,21,11,Switzerland,CH,CHE,8516543,Europe,1613,30535,67
2020-05-21T00:00:00Z,21,5,2020,40,16,Switzerland,CH,CHE,8516543,Europe,1629,30575,68
2020-05-22T00:00:00Z,22,5,2020,36,8,Switzerland,CH,CHE,8516543,Europe,1637,30611,69
2020-05-23T00:00:00Z,23,5,2020,13,0,Switzerland,CH,CHE,8516543,Europe,1637,30624,70
2020-05-24T00:00:00Z,24,5,2020,18,4,Switzerland,CH,CHE,8516543,Europe,1641,30642,71
2020-05-25T00:00:00Z,25,5,2020,11,0,Switzerland,CH,CHE,8516543,Europe,1641,30653,72
2020-05-26T00:00:00Z,26,5,2020,10,0,Switzerland,CH,CHE,8516543,Europe,1641,30663,73
2020-05-27T00:00:00Z,27,5,2020,15,6,Switzerland,CH,CHE,8516543,Europe,1647,30678,74
2020-05-08T00:00:00Z,8,5,2020,82,4,Tajikistan,TJ,TJK,9100837,Asia,12,461,1
2020-05-09T00:00:00Z,9,5,2020,61,0,Tajikistan,TJ,TJK,9100837,Asia,12,522,2
2020-05-10T00:00:00Z,10,5,2020,90,8,Tajikistan,TJ,TJK,9100837,Asia,20,612,3
2020-05-11T00:00:00Z,11,5,2020,0,0,Tajikistan,TJ,TJK,9100837,Asia,20,612,4
2020-05-12T00:00:00Z,12,5,2020,49,1,Tajikistan,TJ,TJK,9100837,Asia,21,661,5
2020-05-13T00:00:00Z,13,5,2020,68,2,Tajikistan,TJ,TJK,9100837,Asia,23,729,6
2020-05-14T00:00:00Z,14,5,2020,72,0,Tajikistan,TJ,TJK,9100837,Asia,23,801,7
2020-05-15T00:00:00Z,15,5,2020,106,6,Tajikistan,TJ,TJK,9100837,Asia,29,907,8
2020-05-16T00:00:00Z,16,5,2020,211,4,Tajikistan,TJ,TJK,9100837,Asia,33,1118,9
2020-05-17T00:00:00Z,17,5,2020,204,3,Tajikistan,TJ,TJK,9100837,Asia,36,1322,10
2020-05-18T00:00:00Z,18,5,2020,202,3,Tajikistan,TJ,TJK,9100837,Asia,39,1524,11
2020-05-19T00:00:00Z,19,5,2020,205,2,Tajikistan,TJ,TJK,9100837,Asia,41,1729,12
2020-05-20T00:00:00Z,20,5,2020,0,0,Tajikistan,TJ,TJK,9100837,Asia,41,1729,13
2020-05-21T00:00:00Z,21,5,2020,207,3,Tajikistan,TJ,TJK,9100837,Asia,44,1936,14
2020-05-22T00:00:00Z,22,5,2020,204,0,Tajikistan,TJ,TJK,9100837,Asia,44,2140,15
2020-05-23T00:00:00Z,23,5,2020,210,0,Tajikistan,TJ,TJK,9100837,Asia,44,2350,16
2020-05-24T00:00:00Z,24,5,2020,201,0,Tajikistan,TJ,TJK,9100837,Asia,44,2551,17
2020-05-25T00:00:00Z,25,5,2020,187,0,Tajikistan,TJ,TJK,9100837,Asia,44,2738,18
2020-05-26T00:00:00Z,26,5,2020,362,2,Tajikistan,TJ,TJK,9100837,Asia,46,3100,19
2020-05-27T00:00:00Z,27,5,2020,0,0,Tajikistan,TJ,TJK,9100837,Asia,46,3100,20
2020-03-31T00:00:00Z,31,3,2020,263,3,Thailand,TH,THA,69428524,Asia,10,1651,1
2020-04-01T00:00:00Z,1,4,2020,0,0,Thailand,TH,THA,69428524,Asia,10,1651,2
2020-04-02T00:00:00Z,2,4,2020,120,2,Thailand,TH,THA,69428524,Asia,12,1771,3
2020-04-03T00:00:00Z,3,4,2020,104,3,Thailand,TH,THA,69428524,Asia,15,1875,4
2020-04-04T00:00:00Z,4,4,2020,103,4,Thailand,TH,THA,69428524,Asia,19,1978,5
2020-04-05T00:00:00Z,5,4,2020,191,4,Thailand,TH,THA,69428524,Asia,23,2169,6
2020-04-06T00:00:00Z,6,4,2020,51,3,Thailand,TH,THA,69428524,Asia,26,2220,7
2020-04-07T00:00:00Z,7,4,2020,38,0,Thailand,TH,THA,69428524,Asia,26,2258,8
2020-04-08T00:00:00Z,8,4,2020,111,4,Thailand,TH,THA,69428524,Asia,30,2369,9
2020-04-09T00:00:00Z,9,4,2020,54,2,Thailand,TH,THA,69428524,Asia,32,2423,10
2020-04-10T00:00:00Z,10,4,2020,50,1,Thailand,TH,THA,69428524,Asia,33,2473,11
2020-04-11T00:00:00Z,11,4,2020,45,2,Thailand,TH,THA,69428524,Asia,35,2518,12
2020-04-12T00:00:00Z,12,4,2020,33,3,Thailand,TH,THA,69428524,Asia,38,2551,13
2020-04-13T00:00:00Z,13,4,2020,28,2,Thailand,TH,THA,69428524,Asia,40,2579,14
2020-04-14T00:00:00Z,14,4,2020,34,1,Thailand,TH,THA,69428524,Asia,41,2613,15
2020-04-15T00:00:00Z,15,4,2020,30,2,Thailand,TH,THA,69428524,Asia,43,2643,16
2020-04-16T00:00:00Z,16,4,2020,29,3,Thailand,TH,THA,69428524,Asia,46,2672,17
2020-04-17T00:00:00Z,17,4,2020,28,1,Thailand,TH,THA,69428524,Asia,47,2700,18
2020-04-18T00:00:00Z,18,4,2020,0,0,Thailand,TH,THA,69428524,Asia,47,2700,19
2020-04-19T00:00:00Z,19,4,2020,33,0,Thailand,TH,THA,69428524,Asia,47,2733,20
2020-04-20T00:00:00Z,20,4,2020,32,0,Thailand,TH,THA,69428524,Asia,47,2765,21
2020-04-21T00:00:00Z,21,4,2020,27,0,Thailand,TH,THA,69428524,Asia,47,2792,22
2020-04-22T00:00:00Z,22,4,2020,19,1,Thailand,TH,THA,69428524,Asia,48,2811,23
2020-04-23T00:00:00Z,23,4,2020,28,2,Thailand,TH,THA,69428524,Asia,50,2839,24
2020-04-24T00:00:00Z,24,4,2020,0,0,Thailand,TH,THA,69428524,Asia,50,2839,25
2020-04-25T00:00:00Z,25,4,2020,15,0,Thailand,TH,THA,69428524,Asia,50,2854,26
2020-04-26T00:00:00Z,26,4,2020,68,1,Thailand,TH,THA,69428524,Asia,51,2922,27
2020-04-27T00:00:00Z,27,4,2020,0,0,Thailand,TH,THA,69428524,Asia,51,2922,28
2020-04-28T00:00:00Z,28,4,2020,16,3,Thailand,TH,THA,69428524,Asia,54,2938,29
2020-04-29T00:00:00Z,29,4,2020,0,0,Thailand,TH,THA,69428524,Asia,54,2938,30
2020-04-30T00:00:00Z,30,4,2020,16,0,Thailand,TH,THA,69428524,Asia,54,2954,31
2020-05-01T00:00:00Z,1,5,2020,6,0,Thailand,TH,THA,69428524,Asia,54,2960,32
2020-05-02T00:00:00Z,2,5,2020,0,0,Thailand,TH,THA,69428524,Asia,54,2960,33
2020-05-03T00:00:00Z,3,5,2020,6,0,Thailand,TH,THA,69428524,Asia,54,2966,34
2020-05-04T00:00:00Z,4,5,2020,3,0,Thailand,TH,THA,69428524,Asia,54,2969,35
2020-05-05T00:00:00Z,5,5,2020,18,0,Thailand,TH,THA,69428524,Asia,54,2987,36
2020-05-06T00:00:00Z,6,5,2020,1,0,Thailand,TH,THA,69428524,Asia,54,2988,37
2020-05-07T00:00:00Z,7,5,2020,1,1,Thailand,TH,THA,69428524,Asia,55,2989,38
2020-05-08T00:00:00Z,8,5,2020,3,0,Thailand,TH,THA,69428524,Asia,55,2992,39
2020-05-09T00:00:00Z,9,5,2020,8,0,Thailand,TH,THA,69428524,Asia,55,3000,40
2020-05-10T00:00:00Z,10,5,2020,4,1,Thailand,TH,THA,69428524,Asia,56,3004,41
2020-05-11T00:00:00Z,11,5,2020,11,0,Thailand,TH,THA,69428524,Asia,56,3015,42
2020-05-12T00:00:00Z,12,5,2020,0,0,Thailand,TH,THA,69428524,Asia,56,3015,43
2020-05-13T00:00:00Z,13,5,2020,2,0,Thailand,TH,THA,69428524,Asia,56,3017,44
2020-05-14T00:00:00Z,14,5,2020,0,0,Thailand,TH,THA,69428524,Asia,56,3017,45
2020-05-15T00:00:00Z,15,5,2020,1,0,Thailand,TH,THA,69428524,Asia,56,3018,46
2020-05-16T00:00:00Z,16,5,2020,7,0,Thailand,TH,THA,69428524,Asia,56,3025,47
2020-05-17T00:00:00Z,17,5,2020,3,0,Thailand,TH,THA,69428524,Asia,56,3028,48
2020-05-18T00:00:00Z,18,5,2020,0,0,Thailand,TH,THA,69428524,Asia,56,3028,49
2020-05-19T00:00:00Z,19,5,2020,3,0,Thailand,TH,THA,69428524,Asia,56,3031,50
2020-05-20T00:00:00Z,20,5,2020,3,0,Thailand,TH,THA,69428524,Asia,56,3034,51
2020-05-21T00:00:00Z,21,5,2020,0,0,Thailand,TH,THA,69428524,Asia,56,3034,52
2020-05-22T00:00:00Z,22,5,2020,3,0,Thailand,TH,THA,69428524,Asia,56,3037,53
2020-05-23T00:00:00Z,23,5,2020,3,0,Thailand,TH,THA,69428524,Asia,56,3040,54
2020-05-24T00:00:00Z,24,5,2020,0,0,Thailand,TH,THA,69428524,Asia,56,3040,55
2020-05-25T00:00:00Z,25,5,2020,2,1,Thailand,TH,THA,69428524,Asia,57,3042,56
2020-05-26T00:00:00Z,26,5,2020,0,0,Thailand,TH,THA,69428524,Asia,57,3042,57
2020-05-27T00:00:00Z,27,5,2020,3,0,Thailand,TH,THA,69428524,Asia,57,3045,58
2020-05-09T00:00:00Z,9,5,2020,10,1,Togo,TG,TGO,7889094,Africa,10,145,1
2020-05-10T00:00:00Z,10,5,2020,8,0,Togo,TG,TGO,7889094,Africa,10,153,2
2020-05-11T00:00:00Z,11,5,2020,21,1,Togo,TG,TGO,7889094,Africa,11,174,3
2020-05-12T00:00:00Z,12,5,2020,7,0,Togo,TG,TGO,7889094,Africa,11,181,4
2020-05-13T00:00:00Z,13,5,2020,18,0,Togo,TG,TGO,7889094,Africa,11,199,5
2020-05-14T00:00:00Z,14,5,2020,20,0,Togo,TG,TGO,7889094,Africa,11,219,6
2020-05-15T00:00:00Z,15,5,2020,19,0,Togo,TG,TGO,7889094,Africa,11,238,7
2020-05-16T00:00:00Z,16,5,2020,25,0,Togo,TG,TGO,7889094,Africa,11,263,8
2020-05-17T00:00:00Z,17,5,2020,35,0,Togo,TG,TGO,7889094,Africa,11,298,9
2020-05-18T00:00:00Z,18,5,2020,3,0,Togo,TG,TGO,7889094,Africa,11,301,10
2020-05-19T00:00:00Z,19,5,2020,29,1,Togo,TG,TGO,7889094,Africa,12,330,11
2020-05-20T00:00:00Z,20,5,2020,8,0,Togo,TG,TGO,7889094,Africa,12,338,12
2020-05-21T00:00:00Z,21,5,2020,2,0,Togo,TG,TGO,7889094,Africa,12,340,13
2020-05-22T00:00:00Z,22,5,2020,14,0,Togo,TG,TGO,7889094,Africa,12,354,14
2020-05-23T00:00:00Z,23,5,2020,9,0,Togo,TG,TGO,7889094,Africa,12,363,15
2020-05-24T00:00:00Z,24,5,2020,10,0,Togo,TG,TGO,7889094,Africa,12,373,16
2020-05-25T00:00:00Z,25,5,2020,8,0,Togo,TG,TGO,7889094,Africa,12,381,17
2020-05-26T00:00:00Z,26,5,2020,5,1,Togo,TG,TGO,7889094,Africa,13,386,18
2020-05-27T00:00:00Z,27,5,2020,5,0,Togo,TG,TGO,7889094,Africa,13,391,19
2020-04-02T00:00:00Z,2,4,2020,32,1,Tunisia,TN,TUN,11565204,Africa,10,394,1
2020-04-03T00:00:00Z,3,4,2020,61,3,Tunisia,TN,TUN,11565204,Africa,13,455,2
2020-04-04T00:00:00Z,4,4,2020,0,0,Tunisia,TN,TUN,11565204,Africa,13,455,3
2020-04-05T00:00:00Z,5,4,2020,40,5,Tunisia,TN,TUN,11565204,Africa,18,495,4
2020-04-06T00:00:00Z,6,4,2020,58,1,Tunisia,TN,TUN,11565204,Africa,19,553,5
2020-04-07T00:00:00Z,7,4,2020,21,3,Tunisia,TN,TUN,11565204,Africa,22,574,6
2020-04-08T00:00:00Z,8,4,2020,22,0,Tunisia,TN,TUN,11565204,Africa,22,596,7
2020-04-09T00:00:00Z,9,4,2020,27,1,Tunisia,TN,TUN,11565204,Africa,23,623,8
2020-04-10T00:00:00Z,10,4,2020,20,2,Tunisia,TN,TUN,11565204,Africa,25,643,9
2020-04-11T00:00:00Z,11,4,2020,28,0,Tunisia,TN,TUN,11565204,Africa,25,671,10
2020-04-12T00:00:00Z,12,4,2020,14,3,Tunisia,TN,TUN,11565204,Africa,28,685,11
2020-04-13T00:00:00Z,13,4,2020,22,3,Tunisia,TN,TUN,11565204,Africa,31,707,12
2020-04-14T00:00:00Z,14,4,2020,19,3,Tunisia,TN,TUN,11565204,Africa,34,726,13
2020-04-15T00:00:00Z,15,4,2020,21,0,Tunisia,TN,TUN,11565204,Africa,34,747,14
2020-04-16T00:00:00Z,16,4,2020,33,1,Tunisia,TN,TUN,11565204,Africa,35,780,15
2020-04-17T00:00:00Z,17,4,2020,42,2,Tunisia,TN,TUN,11565204,Africa,37,822,16
2020-04-18T00:00:00Z,18,4,2020,42,0,Tunisia,TN,TUN,11565204,Africa,37,864,17
2020-04-19T00:00:00Z,19,4,2020,2,0,Tunisia,TN,TUN,11565204,Africa,37,866,18
2020-04-20T00:00:00Z,20,4,2020,13,1,Tunisia,TN,TUN,11565204,Africa,38,879,19
2020-04-21T00:00:00Z,21,4,2020,5,0,Tunisia,TN,TUN,11565204,Africa,38,884,20
2020-04-22T00:00:00Z,22,4,2020,17,0,Tunisia,TN,TUN,11565204,Africa,38,901,21
2020-04-23T00:00:00Z,23,4,2020,0,0,Tunisia,TN,TUN,11565204,Africa,38,901,22
2020-04-24T00:00:00Z,24,4,2020,17,0,Tunisia,TN,TUN,11565204,Africa,38,918,23
2020-04-25T00:00:00Z,25,4,2020,4,0,Tunisia,TN,TUN,11565204,Africa,38,922,24
2020-04-26T00:00:00Z,26,4,2020,17,0,Tunisia,TN,TUN,11565204,Africa,38,939,25
2020-04-27T00:00:00Z,27,4,2020,10,0,Tunisia,TN,TUN,11565204,Africa,38,949,26
2020-04-28T00:00:00Z,28,4,2020,18,1,Tunisia,TN,TUN,11565204,Africa,39,967,27
2020-04-29T00:00:00Z,29,4,2020,8,1,Tunisia,TN,TUN,11565204,Africa,40,975,28
2020-04-30T00:00:00Z,30,4,2020,5,0,Tunisia,TN,TUN,11565204,Africa,40,980,29
2020-05-01T00:00:00Z,1,5,2020,14,0,Tunisia,TN,TUN,11565204,Africa,40,994,30
2020-05-02T00:00:00Z,2,5,2020,4,1,Tunisia,TN,TUN,11565204,Africa,41,998,31
2020-05-03T00:00:00Z,3,5,2020,11,1,Tunisia,TN,TUN,11565204,Africa,42,1009,32
2020-05-04T00:00:00Z,4,5,2020,4,0,Tunisia,TN,TUN,11565204,Africa,42,1013,33
2020-05-05T00:00:00Z,5,5,2020,5,1,Tunisia,TN,TUN,11565204,Africa,43,1018,34
2020-05-06T00:00:00Z,6,5,2020,4,0,Tunisia,TN,TUN,11565204,Africa,43,1022,35
2020-05-07T00:00:00Z,7,5,2020,3,0,Tunisia,TN,TUN,11565204,Africa,43,1025,36
2020-05-08T00:00:00Z,8,5,2020,1,1,Tunisia,TN,TUN,11565204,Africa,44,1026,37
2020-05-09T00:00:00Z,9,5,2020,4,1,Tunisia,TN,TUN,11565204,Africa,45,1030,38
2020-05-10T00:00:00Z,10,5,2020,2,0,Tunisia,TN,TUN,11565204,Africa,45,1032,39
2020-05-11T00:00:00Z,11,5,2020,0,0,Tunisia,TN,TUN,11565204,Africa,45,1032,40
2020-05-12T00:00:00Z,12,5,2020,0,0,Tunisia,TN,TUN,11565204,Africa,45,1032,41
2020-05-13T00:00:00Z,13,5,2020,0,0,Tunisia,TN,TUN,11565204,Africa,45,1032,42
2020-05-14T00:00:00Z,14,5,2020,0,0,Tunisia,TN,TUN,11565204,Africa,45,1032,43
2020-05-15T00:00:00Z,15,5,2020,0,0,Tunisia,TN,TUN,11565204,Africa,45,1032,44
2020-05-16T00:00:00Z,16,5,2020,3,0,Tunisia,TN,TUN,11565204,Africa,45,1035,45
2020-05-17T00:00:00Z,17,5,2020,0,0,Tunisia,TN,TUN,11565204,Africa,45,1035,46
2020-05-18T00:00:00Z,18,5,2020,2,0,Tunisia,TN,TUN,11565204,Africa,45,1037,47
2020-05-19T00:00:00Z,19,5,2020,6,1,Tunisia,TN,TUN,11565204,Africa,46,1043,48
2020-05-20T00:00:00Z,20,5,2020,1,1,Tunisia,TN,TUN,11565204,Africa,47,1044,49
2020-05-21T00:00:00Z,21,5,2020,1,0,Tunisia,TN,TUN,11565204,Africa,47,1045,50
2020-05-22T00:00:00Z,22,5,2020,1,0,Tunisia,TN,TUN,11565204,Africa,47,1046,51
2020-05-23T00:00:00Z,23,5,2020,2,0,Tunisia,TN,TUN,11565204,Africa,47,1048,52
2020-05-24T00:00:00Z,24,5,2020,0,1,Tunisia,TN,TUN,11565204,Africa,48,1048,53
2020-05-25T00:00:00Z,25,5,2020,3,0,Tunisia,TN,TUN,11565204,Africa,48,1051,54
2020-05-26T00:00:00Z,26,5,2020,0,0,Tunisia,TN,TUN,11565204,Africa,48,1051,55
2020-05-27T00:00:00Z,27,5,2020,0,0,Tunisia,TN,TUN,11565204,Africa,48,1051,56
2020-03-22T00:00:00Z,22,3,2020,277,12,Turkey,TR,TUR,82319724,Asia,21,947,1
2020-03-23T00:00:00Z,23,3,2020,289,9,Turkey,TR,TUR,82319724,Asia,30,1236,2
2020-03-24T00:00:00Z,24,3,2020,293,7,Turkey,TR,TUR,82319724,Asia,37,1529,3
2020-03-25T00:00:00Z,25,3,2020,343,7,Turkey,TR,TUR,82319724,Asia,44,1872,4
2020-03-26T00:00:00Z,26,3,2020,561,15,Turkey,TR,TUR,82319724,Asia,59,2433,5
2020-03-27T00:00:00Z,27,3,2020,1196,16,Turkey,TR,TUR,82319724,Asia,75,3629,6
2020-03-28T00:00:00Z,28,3,2020,2069,17,Turkey,TR,TUR,82319724,Asia,92,5698,7
2020-03-29T00:00:00Z,29,3,2020,1704,16,Turkey,TR,TUR,82319724,Asia,108,7402,8
2020-03-30T00:00:00Z,30,3,2020,1815,23,Turkey,TR,TUR,82319724,Asia,131,9217,9
2020-03-31T00:00:00Z,31,3,2020,1610,37,Turkey,TR,TUR,82319724,Asia,168,10827,10
2020-04-01T00:00:00Z,1,4,2020,2704,46,Turkey,TR,TUR,82319724,Asia,214,13531,11
2020-04-02T00:00:00Z,2,4,2020,2148,63,Turkey,TR,TUR,82319724,Asia,277,15679,12
2020-04-03T00:00:00Z,3,4,2020,2456,79,Turkey,TR,TUR,82319724,Asia,356,18135,13
2020-04-04T00:00:00Z,4,4,2020,2786,69,Turkey,TR,TUR,82319724,Asia,425,20921,14
2020-04-05T00:00:00Z,5,4,2020,3013,76,Turkey,TR,TUR,82319724,Asia,501,23934,15
2020-04-06T00:00:00Z,6,4,2020,3135,73,Turkey,TR,TUR,82319724,Asia,574,27069,16
2020-04-07T00:00:00Z,7,4,2020,3148,75,Turkey,TR,TUR,82319724,Asia,649,30217,17
2020-04-08T00:00:00Z,8,4,2020,3892,76,Turkey,TR,TUR,82319724,Asia,725,34109,18
2020-04-09T00:00:00Z,9,4,2020,4117,87,Turkey,TR,TUR,82319724,Asia,812,38226,19
2020-04-10T00:00:00Z,10,4,2020,4056,96,Turkey,TR,TUR,82319724,Asia,908,42282,20
2020-04-11T00:00:00Z,11,4,2020,4747,98,Turkey,TR,TUR,82319724,Asia,1006,47029,21
2020-04-12T00:00:00Z,12,4,2020,5138,95,Turkey,TR,TUR,82319724,Asia,1101,52167,22
2020-04-13T00:00:00Z,13,4,2020,4789,97,Turkey,TR,TUR,82319724,Asia,1198,56956,23
2020-04-14T00:00:00Z,14,4,2020,4093,98,Turkey,TR,TUR,82319724,Asia,1296,61049,24
2020-04-15T00:00:00Z,15,4,2020,4062,107,Turkey,TR,TUR,82319724,Asia,1403,65111,25
2020-04-16T00:00:00Z,16,4,2020,4281,115,Turkey,TR,TUR,82319724,Asia,1518,69392,26
2020-04-17T00:00:00Z,17,4,2020,4801,125,Turkey,TR,TUR,82319724,Asia,1643,74193,27
2020-04-18T00:00:00Z,18,4,2020,4353,126,Turkey,TR,TUR,82319724,Asia,1769,78546,28
2020-04-19T00:00:00Z,19,4,2020,3783,121,Turkey,TR,TUR,82319724,Asia,1890,82329,29
2020-04-20T00:00:00Z,20,4,2020,3977,127,Turkey,TR,TUR,82319724,Asia,2017,86306,30
2020-04-21T00:00:00Z,21,4,2020,4674,123,Turkey,TR,TUR,82319724,Asia,2140,90980,31
2020-04-22T00:00:00Z,22,4,2020,4611,119,Turkey,TR,TUR,82319724,Asia,2259,95591,32
2020-04-23T00:00:00Z,23,4,2020,3083,117,Turkey,TR,TUR,82319724,Asia,2376,98674,33
2020-04-24T00:00:00Z,24,4,2020,3116,115,Turkey,TR,TUR,82319724,Asia,2491,101790,34
2020-04-25T00:00:00Z,25,4,2020,3122,109,Turkey,TR,TUR,82319724,Asia,2600,104912,35
2020-04-26T00:00:00Z,26,4,2020,2861,106,Turkey,TR,TUR,82319724,Asia,2706,107773,36
2020-04-27T00:00:00Z,27,4,2020,2357,99,Turkey,TR,TUR,82319724,Asia,2805,110130,37
2020-04-28T00:00:00Z,28,4,2020,2131,95,Turkey,TR,TUR,82319724,Asia,2900,112261,38
2020-04-29T00:00:00Z,29,4,2020,2392,92,Turkey,TR,TUR,82319724,Asia,2992,114653,39
2020-04-30T00:00:00Z,30,4,2020,2936,89,Turkey,TR,TUR,82319724,Asia,3081,117589,40
2020-05-01T00:00:00Z,1,5,2020,2615,93,Turkey,TR,TUR,82319724,Asia,3174,120204,41
2020-05-02T00:00:00Z,2,5,2020,2188,84,Turkey,TR,TUR,82319724,Asia,3258,122392,42
2020-05-03T00:00:00Z,3,5,2020,1983,78,Turkey,TR,TUR,82319724,Asia,3336,124375,43
2020-05-04T00:00:00Z,4,5,2020,1670,61,Turkey,TR,TUR,82319724,Asia,3397,126045,44
2020-05-05T00:00:00Z,5,5,2020,1614,64,Turkey,TR,TUR,82319724,Asia,3461,127659,45
2020-05-06T00:00:00Z,6,5,2020,1832,59,Turkey,TR,TUR,82319724,Asia,3520,129491,46
2020-05-07T00:00:00Z,7,5,2020,2253,64,Turkey,TR,TUR,82319724,Asia,3584,131744,47
2020-05-08T00:00:00Z,8,5,2020,1977,57,Turkey,TR,TUR,82319724,Asia,3641,133721,48
2020-05-09T00:00:00Z,9,5,2020,1848,48,Turkey,TR,TUR,82319724,Asia,3689,135569,49
2020-05-10T00:00:00Z,10,5,2020,1546,50,Turkey,TR,TUR,82319724,Asia,3739,137115,50
2020-05-11T00:00:00Z,11,5,2020,1542,47,Turkey,TR,TUR,82319724,Asia,3786,138657,51
2020-05-12T00:00:00Z,12,5,2020,1114,55,Turkey,TR,TUR,82319724,Asia,3841,139771,52
2020-05-13T00:00:00Z,13,5,2020,1704,53,Turkey,TR,TUR,82319724,Asia,3894,141475,53
2020-05-14T00:00:00Z,14,5,2020,1639,58,Turkey,TR,TUR,82319724,Asia,3952,143114,54
2020-05-15T00:00:00Z,15,5,2020,1635,55,Turkey,TR,TUR,82319724,Asia,4007,144749,55
2020-05-16T00:00:00Z,16,5,2020,1708,48,Turkey,TR,TUR,82319724,Asia,4055,146457,56
2020-05-17T00:00:00Z,17,5,2020,1610,41,Turkey,TR,TUR,82319724,Asia,4096,148067,57
2020-05-18T00:00:00Z,18,5,2020,1368,44,Turkey,TR,TUR,82319724,Asia,4140,149435,58
2020-05-19T00:00:00Z,19,5,2020,1158,31,Turkey,TR,TUR,82319724,Asia,4171,150593,59
2020-05-20T00:00:00Z,20,5,2020,1022,28,Turkey,TR,TUR,82319724,Asia,4199,151615,60
2020-05-21T00:00:00Z,21,5,2020,972,23,Turkey,TR,TUR,82319724,Asia,4222,152587,61
2020-05-22T00:00:00Z,22,5,2020,961,27,Turkey,TR,TUR,82319724,Asia,4249,153548,62
2020-05-23T00:00:00Z,23,5,2020,952,27,Turkey,TR,TUR,82319724,Asia,4276,154500,63
2020-05-24T00:00:00Z,24,5,2020,1186,32,Turkey,TR,TUR,82319724,Asia,4308,155686,64
2020-05-25T00:00:00Z,25,5,2020,1141,32,Turkey,TR,TUR,82319724,Asia,4340,156827,65
2020-05-26T00:00:00Z,26,5,2020,987,29,Turkey,TR,TUR,82319724,Asia,4369,157814,66
2020-05-27T00:00:00Z,27,5,2020,948,28,Turkey,TR,TUR,82319724,Asia,4397,158762,67
2020-03-31T00:00:00Z,31,3,2020,62,2,Ukraine,UA,UKR,44622516,Europe,11,480,1
2020-04-01T00:00:00Z,1,4,2020,69,2,Ukraine,UA,UKR,44622516,Europe,13,549,2
2020-04-02T00:00:00Z,2,4,2020,245,7,Ukraine,UA,UKR,44622516,Europe,20,794,3
2020-04-03T00:00:00Z,3,4,2020,10,0,Ukraine,UA,UKR,44622516,Europe,20,804,4
2020-04-04T00:00:00Z,4,4,2020,183,3,Ukraine,UA,UKR,44622516,Europe,23,987,5
2020-04-05T00:00:00Z,5,4,2020,109,5,Ukraine,UA,UKR,44622516,Europe,28,1096,6
2020-04-06T00:00:00Z,6,4,2020,155,4,Ukraine,UA,UKR,44622516,Europe,32,1251,7
2020-04-07T00:00:00Z,7,4,2020,68,6,Ukraine,UA,UKR,44622516,Europe,38,1319,8
2020-04-08T00:00:00Z,8,4,2020,143,7,Ukraine,UA,UKR,44622516,Europe,45,1462,9
2020-04-09T00:00:00Z,9,4,2020,206,7,Ukraine,UA,UKR,44622516,Europe,52,1668,10
2020-04-10T00:00:00Z,10,4,2020,224,5,Ukraine,UA,UKR,44622516,Europe,57,1892,11
2020-04-11T00:00:00Z,11,4,2020,311,12,Ukraine,UA,UKR,44622516,Europe,69,2203,12
2020-04-12T00:00:00Z,12,4,2020,308,4,Ukraine,UA,UKR,44622516,Europe,73,2511,13
2020-04-13T00:00:00Z,13,4,2020,266,10,Ukraine,UA,UKR,44622516,Europe,83,2777,14
2020-04-14T00:00:00Z,14,4,2020,325,10,Ukraine,UA,UKR,44622516,Europe,93,3102,15
2020-04-15T00:00:00Z,15,4,2020,270,5,Ukraine,UA,UKR,44622516,Europe,98,3372,16
2020-04-16T00:00:00Z,16,4,2020,789,18,Ukraine,UA,UKR,44622516,Europe,116,4161,17
2020-04-17T00:00:00Z,17,4,2020,301,9,Ukraine,UA,UKR,44622516,Europe,125,4462,18
2020-04-18T00:00:00Z,18,4,2020,644,8,Ukraine,UA,UKR,44622516,Europe,133,5106,19
2020-04-19T00:00:00Z,19,4,2020,343,8,Ukraine,UA,UKR,44622516,Europe,141,5449,20
2020-04-20T00:00:00Z,20,4,2020,261,10,Ukraine,UA,UKR,44622516,Europe,151,5710,21
2020-04-21T00:00:00Z,21,4,2020,415,10,Ukraine,UA,UKR,44622516,Europe,161,6125,22
2020-04-22T00:00:00Z,22,4,2020,467,13,Ukraine,UA,UKR,44622516,Europe,174,6592,23
2020-04-23T00:00:00Z,23,4,2020,578,13,Ukraine,UA,UKR,44622516,Europe,187,7170,24
2020-04-24T00:00:00Z,24,4,2020,477,6,Ukraine,UA,UKR,44622516,Europe,193,7647,25
2020-04-25T00:00:00Z,25,4,2020,478,8,Ukraine,UA,UKR,44622516,Europe,201,8125,26
2020-04-26T00:00:00Z,26,4,2020,492,8,Ukraine,UA,UKR,44622516,Europe,209,8617,27
2020-04-27T00:00:00Z,27,4,2020,392,11,Ukraine,UA,UKR,44622516,Europe,220,9009,28
2020-04-28T00:00:00Z,28,4,2020,0,0,Ukraine,UA,UKR,44622516,Europe,220,9009,29
2020-04-29T00:00:00Z,29,4,2020,401,19,Ukraine,UA,UKR,44622516,Europe,239,9410,30
2020-04-30T00:00:00Z,30,4,2020,456,11,Ukraine,UA,UKR,44622516,Europe,250,9866,31
2020-05-01T00:00:00Z,1,5,2020,540,0,Ukraine,UA,UKR,44622516,Europe,250,10406,32
2020-05-02T00:00:00Z,2,5,2020,455,29,Ukraine,UA,UKR,44622516,Europe,279,10861,33
2020-05-03T00:00:00Z,3,5,2020,550,0,Ukraine,UA,UKR,44622516,Europe,279,11411,34
2020-05-04T00:00:00Z,4,5,2020,502,9,Ukraine,UA,UKR,44622516,Europe,288,11913,35
2020-05-05T00:00:00Z,5,5,2020,418,15,Ukraine,UA,UKR,44622516,Europe,303,12331,36
2020-05-06T00:00:00Z,6,5,2020,366,13,Ukraine,UA,UKR,44622516,Europe,316,12697,37
2020-05-07T00:00:00Z,7,5,2020,487,11,Ukraine,UA,UKR,44622516,Europe,327,13184,38
2020-05-08T00:00:00Z,8,5,2020,507,13,Ukraine,UA,UKR,44622516,Europe,340,13691,39
2020-05-09T00:00:00Z,9,5,2020,504,21,Ukraine,UA,UKR,44622516,Europe,361,14195,40
2020-05-10T00:00:00Z,10,5,2020,515,15,Ukraine,UA,UKR,44622516,Europe,376,14710,41
2020-05-11T00:00:00Z,11,5,2020,522,15,Ukraine,UA,UKR,44622516,Europe,391,15232,42
2020-05-12T00:00:00Z,12,5,2020,416,17,Ukraine,UA,UKR,44622516,Europe,408,15648,43
2020-05-13T00:00:00Z,13,5,2020,375,17,Ukraine,UA,UKR,44622516,Europe,425,16023,44
2020-05-14T00:00:00Z,14,5,2020,402,14,Ukraine,UA,UKR,44622516,Europe,439,16425,45
2020-05-15T00:00:00Z,15,5,2020,422,17,Ukraine,UA,UKR,44622516,Europe,456,16847,46
2020-05-16T00:00:00Z,16,5,2020,483,27,Ukraine,UA,UKR,44622516,Europe,483,17330,47
2020-05-17T00:00:00Z,17,5,2020,528,14,Ukraine,UA,UKR,44622516,Europe,497,17858,48
2020-05-18T00:00:00Z,18,5,2020,433,17,Ukraine,UA,UKR,44622516,Europe,514,18291,49
2020-05-19T00:00:00Z,19,5,2020,325,21,Ukraine,UA,UKR,44622516,Europe,535,18616,50
2020-05-20T00:00:00Z,20,5,2020,260,13,Ukraine,UA,UKR,44622516,Europe,548,18876,51
2020-05-21T00:00:00Z,21,5,2020,354,16,Ukraine,UA,UKR,44622516,Europe,564,19230,52
2020-05-22T00:00:00Z,22,5,2020,476,15,Ukraine,UA,UKR,44622516,Europe,579,19706,53
2020-05-23T00:00:00Z,23,5,2020,442,9,Ukraine,UA,UKR,44622516,Europe,588,20148,54
2020-05-24T00:00:00Z,24,5,2020,432,17,Ukraine,UA,UKR,44622516,Europe,605,20580,55
2020-05-25T00:00:00Z,25,5,2020,406,12,Ukraine,UA,UKR,44622516,Europe,617,20986,56
2020-05-26T00:00:00Z,26,5,2020,259,6,Ukraine,UA,UKR,44622516,Europe,623,21245,57
2020-05-27T00:00:00Z,27,5,2020,339,21,Ukraine,UA,UKR,44622516,Europe,644,21584,58
2020-04-05T00:00:00Z,5,4,2020,481,2,United_Arab_Emirates,AE,ARE,9630959,Asia,10,1505,1
2020-04-06T00:00:00Z,6,4,2020,294,0,United_Arab_Emirates,AE,ARE,9630959,Asia,10,1799,2
2020-04-07T00:00:00Z,7,4,2020,277,1,United_Arab_Emirates,AE,ARE,9630959,Asia,11,2076,3
2020-04-08T00:00:00Z,8,4,2020,283,1,United_Arab_Emirates,AE,ARE,9630959,Asia,12,2359,4
2020-04-09T00:00:00Z,9,4,2020,300,0,United_Arab_Emirates,AE,ARE,9630959,Asia,12,2659,5
2020-04-10T00:00:00Z,10,4,2020,331,2,United_Arab_Emirates,AE,ARE,9630959,Asia,14,2990,6
2020-04-11T00:00:00Z,11,4,2020,370,2,United_Arab_Emirates,AE,ARE,9630959,Asia,16,3360,7
2020-04-12T00:00:00Z,12,4,2020,376,4,United_Arab_Emirates,AE,ARE,9630959,Asia,20,3736,8
2020-04-13T00:00:00Z,13,4,2020,387,2,United_Arab_Emirates,AE,ARE,9630959,Asia,22,4123,9
2020-04-14T00:00:00Z,14,4,2020,398,3,United_Arab_Emirates,AE,ARE,9630959,Asia,25,4521,10
2020-04-15T00:00:00Z,15,4,2020,412,3,United_Arab_Emirates,AE,ARE,9630959,Asia,28,4933,11
2020-04-16T00:00:00Z,16,4,2020,432,5,United_Arab_Emirates,AE,ARE,9630959,Asia,33,5365,12
2020-04-17T00:00:00Z,17,4,2020,460,0,United_Arab_Emirates,AE,ARE,9630959,Asia,33,5825,13
2020-04-18T00:00:00Z,18,4,2020,0,2,United_Arab_Emirates,AE,ARE,9630959,Asia,35,5825,14
2020-04-19T00:00:00Z,19,4,2020,477,2,United_Arab_Emirates,AE,ARE,9630959,Asia,37,6302,15
2020-04-20T00:00:00Z,20,4,2020,479,4,United_Arab_Emirates,AE,ARE,9630959,Asia,41,6781,16
2020-04-21T00:00:00Z,21,4,2020,484,2,United_Arab_Emirates,AE,ARE,9630959,Asia,43,7265,17
2020-04-22T00:00:00Z,22,4,2020,490,3,United_Arab_Emirates,AE,ARE,9630959,Asia,46,7755,18
2020-04-23T00:00:00Z,23,4,2020,483,6,United_Arab_Emirates,AE,ARE,9630959,Asia,52,8238,19
2020-04-24T00:00:00Z,24,4,2020,518,4,United_Arab_Emirates,AE,ARE,9630959,Asia,56,8756,20
2020-04-25T00:00:00Z,25,4,2020,525,8,United_Arab_Emirates,AE,ARE,9630959,Asia,64,9281,21
2020-04-26T00:00:00Z,26,4,2020,532,0,United_Arab_Emirates,AE,ARE,9630959,Asia,64,9813,22
2020-04-27T00:00:00Z,27,4,2020,536,12,United_Arab_Emirates,AE,ARE,9630959,Asia,76,10349,23
2020-04-28T00:00:00Z,28,4,2020,490,6,United_Arab_Emirates,AE,ARE,9630959,Asia,82,10839,24
2020-04-29T00:00:00Z,29,4,2020,541,7,United_Arab_Emirates,AE,ARE,9630959,Asia,89,11380,25
2020-04-30T00:00:00Z,30,4,2020,549,9,United_Arab_Emirates,AE,ARE,9630959,Asia,98,11929,26
2020-05-01T00:00:00Z,1,5,2020,552,7,United_Arab_Emirates,AE,ARE,9630959,Asia,105,12481,27
2020-05-02T00:00:00Z,2,5,2020,557,6,United_Arab_Emirates,AE,ARE,9630959,Asia,111,13038,28
2020-05-03T00:00:00Z,3,5,2020,561,8,United_Arab_Emirates,AE,ARE,9630959,Asia,119,13599,29
2020-05-04T00:00:00Z,4,5,2020,564,7,United_Arab_Emirates,AE,ARE,9630959,Asia,126,14163,30
2020-05-05T00:00:00Z,5,5,2020,567,11,United_Arab_Emirates,AE,ARE,9630959,Asia,137,14730,31
2020-05-06T00:00:00Z,6,5,2020,462,9,United_Arab_Emirates,AE,ARE,9630959,Asia,146,15192,32
2020-05-07T00:00:00Z,7,5,2020,546,11,United_Arab_Emirates,AE,ARE,9630959,Asia,157,15738,33
2020-05-08T00:00:00Z,8,5,2020,502,8,United_Arab_Emirates,AE,ARE,9630959,Asia,165,16240,34
2020-05-09T00:00:00Z,9,5,2020,553,9,United_Arab_Emirates,AE,ARE,9630959,Asia,174,16793,35
2020-05-10T00:00:00Z,10,5,2020,624,11,United_Arab_Emirates,AE,ARE,9630959,Asia,185,17417,36
2020-05-11T00:00:00Z,11,5,2020,781,13,United_Arab_Emirates,AE,ARE,9630959,Asia,198,18198,37
2020-05-12T00:00:00Z,12,5,2020,680,3,United_Arab_Emirates,AE,ARE,9630959,Asia,201,18878,38
2020-05-13T00:00:00Z,13,5,2020,783,2,United_Arab_Emirates,AE,ARE,9630959,Asia,203,19661,39
2020-05-14T00:00:00Z,14,5,2020,725,3,United_Arab_Emirates,AE,ARE,9630959,Asia,206,20386,40
2020-05-15T00:00:00Z,15,5,2020,698,2,United_Arab_Emirates,AE,ARE,9630959,Asia,208,21084,41
2020-05-16T00:00:00Z,16,5,2020,747,2,United_Arab_Emirates,AE,ARE,9630959,Asia,210,21831,42
2020-05-17T00:00:00Z,17,5,2020,796,4,United_Arab_Emirates,AE,ARE,9630959,Asia,214,22627,43
2020-05-18T00:00:00Z,18,5,2020,731,6,United_Arab_Emirates,AE,ARE,9630959,Asia,220,23358,44
2020-05-19T00:00:00Z,19,5,2020,832,4,United_Arab_Emirates,AE,ARE,9630959,Asia,224,24190,45
2020-05-20T00:00:00Z,20,5,2020,873,3,United_Arab_Emirates,AE,ARE,9630959,Asia,227,25063,46
2020-05-21T00:00:00Z,21,5,2020,941,6,United_Arab_Emirates,AE,ARE,9630959,Asia,233,26004,47
2020-05-22T00:00:00Z,22,5,2020,894,4,United_Arab_Emirates,AE,ARE,9630959,Asia,237,26898,48
2020-05-23T00:00:00Z,23,5,2020,994,4,United_Arab_Emirates,AE,ARE,9630959,Asia,241,27892,49
2020-05-24T00:00:00Z,24,5,2020,812,3,United_Arab_Emirates,AE,ARE,9630959,Asia,244,28704,50
2020-05-25T00:00:00Z,25,5,2020,781,1,United_Arab_Emirates,AE,ARE,9630959,Asia,245,29485,51
2020-05-26T00:00:00Z,26,5,2020,822,3,United_Arab_Emirates,AE,ARE,9630959,Asia,248,30307,52
2020-05-27T00:00:00Z,27,5,2020,779,5,United_Arab_Emirates,AE,ARE,9630959,Asia,253,31086,53
2020-03-14T00:00:00Z,14,3,2020,117,1,United_Kingdom,UK,GBR,66488991,Europe,10,707,1
2020-03-15T00:00:00Z,15,3,2020,433,18,United_Kingdom,UK,GBR,66488991,Europe,28,1140,2
2020-03-16T00:00:00Z,16,3,2020,251,15,United_Kingdom,UK,GBR,66488991,Europe,43,1391,3
2020-03-17T00:00:00Z,17,3,2020,152,22,United_Kingdom,UK,GBR,66488991,Europe,65,1543,4
2020-03-18T00:00:00Z,18,3,2020,407,16,United_Kingdom,UK,GBR,66488991,Europe,81,1950,5
2020-03-19T00:00:00Z,19,3,2020,680,34,United_Kingdom,UK,GBR,66488991,Europe,115,2630,6
2020-03-20T00:00:00Z,20,3,2020,647,43,United_Kingdom,UK,GBR,66488991,Europe,158,3277,7
2020-03-21T00:00:00Z,21,3,2020,706,36,United_Kingdom,UK,GBR,66488991,Europe,194,3983,8
2020-03-22T00:00:00Z,22,3,2020,1035,56,United_Kingdom,UK,GBR,66488991,Europe,250,5018,9
2020-03-23T00:00:00Z,23,3,2020,665,35,United_Kingdom,UK,GBR,66488991,Europe,285,5683,10
2020-03-24T00:00:00Z,24,3,2020,967,74,United_Kingdom,UK,GBR,66488991,Europe,359,6650,11
2020-03-25T00:00:00Z,25,3,2020,1427,149,United_Kingdom,UK,GBR,66488991,Europe,508,8077,12
2020-03-26T00:00:00Z,26,3,2020,1452,186,United_Kingdom,UK,GBR,66488991,Europe,694,9529,13
2020-03-27T00:00:00Z,27,3,2020,2129,183,United_Kingdom,UK,GBR,66488991,Europe,877,11658,14
2020-03-28T00:00:00Z,28,3,2020,2885,284,United_Kingdom,UK,GBR,66488991,Europe,1161,14543,15
2020-03-29T00:00:00Z,29,3,2020,2546,294,United_Kingdom,UK,GBR,66488991,Europe,1455,17089,16
2020-03-30T00:00:00Z,30,3,2020,2433,214,United_Kingdom,UK,GBR,66488991,Europe,1669,19522,17
2020-03-31T00:00:00Z,31,3,2020,2619,374,United_Kingdom,UK,GBR,66488991,Europe,2043,22141,18
2020-04-01T00:00:00Z,1,4,2020,3009,382,United_Kingdom,UK,GBR,66488991,Europe,2425,25150,19
2020-04-02T00:00:00Z,2,4,2020,4324,670,United_Kingdom,UK,GBR,66488991,Europe,3095,29474,20
2020-04-03T00:00:00Z,3,4,2020,4244,652,United_Kingdom,UK,GBR,66488991,Europe,3747,33718,21
2020-04-04T00:00:00Z,4,4,2020,4450,714,United_Kingdom,UK,GBR,66488991,Europe,4461,38168,22
2020-04-05T00:00:00Z,5,4,2020,3735,760,United_Kingdom,UK,GBR,66488991,Europe,5221,41903,23
2020-04-06T00:00:00Z,6,4,2020,5903,644,United_Kingdom,UK,GBR,66488991,Europe,5865,47806,24
2020-04-07T00:00:00Z,7,4,2020,3802,568,United_Kingdom,UK,GBR,66488991,Europe,6433,51608,25
2020-04-08T00:00:00Z,8,4,2020,3634,1038,United_Kingdom,UK,GBR,66488991,Europe,7471,55242,26
2020-04-09T00:00:00Z,9,4,2020,5491,1034,United_Kingdom,UK,GBR,66488991,Europe,8505,60733,27
2020-04-10T00:00:00Z,10,4,2020,4344,1103,United_Kingdom,UK,GBR,66488991,Europe,9608,65077,28
2020-04-11T00:00:00Z,11,4,2020,5195,1152,United_Kingdom,UK,GBR,66488991,Europe,10760,70272,29
2020-04-12T00:00:00Z,12,4,2020,8719,839,United_Kingdom,UK,GBR,66488991,Europe,11599,78991,30
2020-04-13T00:00:00Z,13,4,2020,5288,686,United_Kingdom,UK,GBR,66488991,Europe,12285,84279,31
2020-04-14T00:00:00Z,14,4,2020,4342,744,United_Kingdom,UK,GBR,66488991,Europe,13029,88621,32
2020-04-15T00:00:00Z,15,4,2020,5252,1044,United_Kingdom,UK,GBR,66488991,Europe,14073,93873,33
2020-04-16T00:00:00Z,16,4,2020,4603,842,United_Kingdom,UK,GBR,66488991,Europe,14915,98476,34
2020-04-17T00:00:00Z,17,4,2020,4617,1029,United_Kingdom,UK,GBR,66488991,Europe,15944,103093,35
2020-04-18T00:00:00Z,18,4,2020,5599,935,United_Kingdom,UK,GBR,66488991,Europe,16879,108692,36
2020-04-19T00:00:00Z,19,4,2020,5525,1115,United_Kingdom,UK,GBR,66488991,Europe,17994,114217,37
2020-04-20T00:00:00Z,20,4,2020,5850,498,United_Kingdom,UK,GBR,66488991,Europe,18492,120067,38
2020-04-21T00:00:00Z,21,4,2020,4676,559,United_Kingdom,UK,GBR,66488991,Europe,19051,124743,39
2020-04-22T00:00:00Z,22,4,2020,4301,1172,United_Kingdom,UK,GBR,66488991,Europe,20223,129044,40
2020-04-23T00:00:00Z,23,4,2020,4451,837,United_Kingdom,UK,GBR,66488991,Europe,21060,133495,41
2020-04-24T00:00:00Z,24,4,2020,4583,727,United_Kingdom,UK,GBR,66488991,Europe,21787,138078,42
2020-04-25T00:00:00Z,25,4,2020,5386,1005,United_Kingdom,UK,GBR,66488991,Europe,22792,143464,43
2020-04-26T00:00:00Z,26,4,2020,4913,843,United_Kingdom,UK,GBR,66488991,Europe,23635,148377,44
2020-04-27T00:00:00Z,27,4,2020,4463,420,United_Kingdom,UK,GBR,66488991,Europe,24055,152840,45
2020-04-28T00:00:00Z,28,4,2020,4309,338,United_Kingdom,UK,GBR,66488991,Europe,24393,157149,46
2020-04-29T00:00:00Z,29,4,2020,3996,909,United_Kingdom,UK,GBR,66488991,Europe,25302,161145,47
2020-04-30T00:00:00Z,30,4,2020,4076,795,United_Kingdom,UK,GBR,66488991,Europe,26097,165221,48
2020-05-01T00:00:00Z,1,5,2020,6032,674,United_Kingdom,UK,GBR,66488991,Europe,26771,171253,49
2020-05-02T00:00:00Z,2,5,2020,6201,739,United_Kingdom,UK,GBR,66488991,Europe,27510,177454,50
2020-05-03T00:00:00Z,3,5,2020,4806,621,United_Kingdom,UK,GBR,66488991,Europe,28131,182260,51
2020-05-04T00:00:00Z,4,5,2020,4339,315,United_Kingdom,UK,GBR,66488991,Europe,28446,186599,52
2020-05-05T00:00:00Z,5,5,2020,3985,288,United_Kingdom,UK,GBR,66488991,Europe,28734,190584,53
2020-05-06T00:00:00Z,6,5,2020,4406,693,United_Kingdom,UK,GBR,66488991,Europe,29427,194990,54
2020-05-07T00:00:00Z,7,5,2020,6211,649,United_Kingdom,UK,GBR,66488991,Europe,30076,201201,55
2020-05-08T00:00:00Z,8,5,2020,5514,539,United_Kingdom,UK,GBR,66488991,Europe,30615,206715,56
2020-05-09T00:00:00Z,9,5,2020,4649,626,United_Kingdom,UK,GBR,66488991,Europe,31241,211364,57
2020-05-10T00:00:00Z,10,5,2020,3896,346,United_Kingdom,UK,GBR,66488991,Europe,31587,215260,58
2020-05-11T00:00:00Z,11,5,2020,3923,268,United_Kingdom,UK,GBR,66488991,Europe,31855,219183,59
2020-05-12T00:00:00Z,12,5,2020,3877,210,United_Kingdom,UK,GBR,66488991,Europe,32065,223060,60
2020-05-13T00:00:00Z,13,5,2020,3403,627,United_Kingdom,UK,GBR,66488991,Europe,32692,226463,61
2020-05-14T00:00:00Z,14,5,2020,3242,494,United_Kingdom,UK,GBR,66488991,Europe,33186,229705,62
2020-05-15T00:00:00Z,15,5,2020,3446,428,United_Kingdom,UK,GBR,66488991,Europe,33614,233151,63
2020-05-16T00:00:00Z,16,5,2020,3560,384,United_Kingdom,UK,GBR,66488991,Europe,33998,236711,64
2020-05-17T00:00:00Z,17,5,2020,3450,468,United_Kingdom,UK,GBR,66488991,Europe,34466,240161,65
2020-05-18T00:00:00Z,18,5,2020,3534,170,United_Kingdom,UK,GBR,66488991,Europe,34636,243695,66
2020-05-19T00:00:00Z,19,5,2020,2711,160,United_Kingdom,UK,GBR,66488991,Europe,34796,246406,67
2020-05-20T00:00:00Z,20,5,2020,2412,545,United_Kingdom,UK,GBR,66488991,Europe,35341,248818,68
2020-05-21T00:00:00Z,21,5,2020,-525,363,United_Kingdom,UK,GBR,66488991,Europe,35704,248293,69
2020-05-22T00:00:00Z,22,5,2020,2615,338,United_Kingdom,UK,GBR,66488991,Europe,36042,250908,70
2020-05-23T00:00:00Z,23,5,2020,3287,351,United_Kingdom,UK,GBR,66488991,Europe,36393,254195,71
2020-05-24T00:00:00Z,24,5,2020,2959,282,United_Kingdom,UK,GBR,66488991,Europe,36675,257154,72
2020-05-25T00:00:00Z,25,5,2020,2405,118,United_Kingdom,UK,GBR,66488991,Europe,36793,259559,73
2020-05-26T00:00:00Z,26,5,2020,1625,121,United_Kingdom,UK,GBR,66488991,Europe,36914,261184,74
2020-05-27T00:00:00Z,27,5,2020,4043,134,United_Kingdom,UK,GBR,66488991,Europe,37048,265227,75
2020-04-23T00:00:00Z,23,4,2020,31,2,United_Republic_of_Tanzania,TZ,TZA,56318348,Africa,10,285,1
2020-04-24T00:00:00Z,24,4,2020,0,0,United_Republic_of_Tanzania,TZ,TZA,56318348,Africa,10,285,2
2020-04-25T00:00:00Z,25,4,2020,15,0,United_Republic_of_Tanzania,TZ,TZA,56318348,Africa,10,300,3
2020-04-26T00:00:00Z,26,4,2020,0,0,United_Republic_of_Tanzania,TZ,TZA,56318348,Africa,10,300,4
2020-04-27T00:00:00Z,27,4,2020,0,0,United_Republic_of_Tanzania,TZ,TZA,56318348,Africa,10,300,5
2020-04-28T00:00:00Z,28,4,2020,0,0,United_Republic_of_Tanzania,TZ,TZA,56318348,Africa,10,300,6
2020-04-29T00:00:00Z,29,4,2020,6,0,United_Republic_of_Tanzania,TZ,TZA,56318348,Africa,10,306,7
2020-04-30T00:00:00Z,30,4,2020,174,6,United_Republic_of_Tanzania,TZ,TZA,56318348,Africa,16,480,8
2020-05-01T00:00:00Z,1,5,2020,0,0,United_Republic_of_Tanzania,TZ,TZA,56318348,Africa,16,480,9
2020-05-02T00:00:00Z,2,5,2020,0,0,United_Republic_of_Tanzania,TZ,TZA,56318348,Africa,16,480,10
2020-05-03T00:00:00Z,3,5,2020,0,0,United_Republic_of_Tanzania,TZ,TZA,56318348,Africa,16,480,11
2020-05-04T00:00:00Z,4,5,2020,0,0,United_Republic_of_Tanzania,TZ,TZA,56318348,Africa,16,480,12
2020-05-05T00:00:00Z,5,5,2020,0,2,United_Republic_of_Tanzania,TZ,TZA,56318348,Africa,18,480,13
2020-05-06T00:00:00Z,6,5,2020,0,0,United_Republic_of_Tanzania,TZ,TZA,56318348,Africa,18,480,14
2020-05-07T00:00:00Z,7,5,2020,0,0,United_Republic_of_Tanzania,TZ,TZA,56318348,Africa,18,480,15
2020-05-08T00:00:00Z,8,5,2020,29,3,United_Republic_of_Tanzania,TZ,TZA,56318348,Africa,21,509,16
2020-05-09T00:00:00Z,9,5,2020,0,0,United_Republic_of_Tanzania,TZ,TZA,56318348,Africa,21,509,17
2020-05-10T00:00:00Z,10,5,2020,0,0,United_Republic_of_Tanzania,TZ,TZA,56318348,Africa,21,509,18
2020-05-11T00:00:00Z,11,5,2020,0,0,United_Republic_of_Tanzania,TZ,TZA,56318348,Africa,21,509,19
2020-05-12T00:00:00Z,12,5,2020,0,0,United_Republic_of_Tanzania,TZ,TZA,56318348,Africa,21,509,20
2020-05-13T00:00:00Z,13,5,2020,0,0,United_Republic_of_Tanzania,TZ,TZA,56318348,Africa,21,509,21
2020-05-14T00:00:00Z,14,5,2020,0,0,United_Republic_of_Tanzania,TZ,TZA,56318348,Africa,21,509,22
2020-05-15T00:00:00Z,15,5,2020,0,0,United_Republic_of_Tanzania,TZ,TZA,56318348,Africa,21,509,23
2020-05-16T00:00:00Z,16,5,2020,0,0,United_Republic_of_Tanzania,TZ,TZA,56318348,Africa,21,509,24
2020-05-17T00:00:00Z,17,5,2020,0,0,United_Republic_of_Tanzania,TZ,TZA,56318348,Africa,21,509,25
2020-05-18T00:00:00Z,18,5,2020,0,0,United_Republic_of_Tanzania,TZ,TZA,56318348,Africa,21,509,26
2020-05-19T00:00:00Z,19,5,2020,0,0,United_Republic_of_Tanzania,TZ,TZA,56318348,Africa,21,509,27
2020-05-20T00:00:00Z,20,5,2020,0,0,United_Republic_of_Tanzania,TZ,TZA,56318348,Africa,21,509,28
2020-05-21T00:00:00Z,21,5,2020,0,0,United_Republic_of_Tanzania,TZ,TZA,56318348,Africa,21,509,29
2020-05-22T00:00:00Z,22,5,2020,0,0,United_Republic_of_Tanzania,TZ,TZA,56318348,Africa,21,509,30
2020-05-23T00:00:00Z,23,5,2020,0,0,United_Republic_of_Tanzania,TZ,TZA,56318348,Africa,21,509,31
2020-05-24T00:00:00Z,24,5,2020,0,0,United_Republic_of_Tanzania,TZ,TZA,56318348,Africa,21,509,32
2020-05-25T00:00:00Z,25,5,2020,0,0,United_Republic_of_Tanzania,TZ,TZA,56318348,Africa,21,509,33
2020-05-26T00:00:00Z,26,5,2020,0,0,United_Republic_of_Tanzania,TZ,TZA,56318348,Africa,21,509,34
2020-05-27T00:00:00Z,27,5,2020,0,0,United_Republic_of_Tanzania,TZ,TZA,56318348,Africa,21,509,35
2020-03-05T00:00:00Z,5,3,2020,34,2,United_States_of_America,US,USA,327167434,America,11,159,1
2020-03-06T00:00:00Z,6,3,2020,74,1,United_States_of_America,US,USA,327167434,America,12,233,2
2020-03-07T00:00:00Z,7,3,2020,105,2,United_States_of_America,US,USA,327167434,America,14,338,3
2020-03-08T00:00:00Z,8,3,2020,95,3,United_States_of_America,US,USA,327167434,America,17,433,4
2020-03-09T00:00:00Z,9,3,2020,121,4,United_States_of_America,US,USA,327167434,America,21,554,5
2020-03-10T00:00:00Z,10,3,2020,200,5,United_States_of_America,US,USA,327167434,America,26,754,6
2020-03-11T00:00:00Z,11,3,2020,271,2,United_States_of_America,US,USA,327167434,America,28,1025,7
2020-03-12T00:00:00Z,12,3,2020,287,2,United_States_of_America,US,USA,327167434,America,30,1312,8
2020-03-13T00:00:00Z,13,3,2020,351,10,United_States_of_America,US,USA,327167434,America,40,1663,9
2020-03-14T00:00:00Z,14,3,2020,511,7,United_States_of_America,US,USA,327167434,America,47,2174,10
2020-03-15T00:00:00Z,15,3,2020,777,10,United_States_of_America,US,USA,327167434,America,57,2951,11
2020-03-16T00:00:00Z,16,3,2020,823,12,United_States_of_America,US,USA,327167434,America,69,3774,12
2020-03-17T00:00:00Z,17,3,2020,887,16,United_States_of_America,US,USA,327167434,America,85,4661,13
2020-03-18T00:00:00Z,18,3,2020,1766,23,United_States_of_America,US,USA,327167434,America,108,6427,14
2020-03-19T00:00:00Z,19,3,2020,2988,42,United_States_of_America,US,USA,327167434,America,150,9415,15
2020-03-20T00:00:00Z,20,3,2020,4835,0,United_States_of_America,US,USA,327167434,America,150,14250,16
2020-03-21T00:00:00Z,21,3,2020,5374,110,United_States_of_America,US,USA,327167434,America,260,19624,17
2020-03-22T00:00:00Z,22,3,2020,7123,80,United_States_of_America,US,USA,327167434,America,340,26747,18
2020-03-23T00:00:00Z,23,3,2020,8459,131,United_States_of_America,US,USA,327167434,America,471,35206,19
2020-03-24T00:00:00Z,24,3,2020,11236,119,United_States_of_America,US,USA,327167434,America,590,46442,20
2020-03-25T00:00:00Z,25,3,2020,8789,211,United_States_of_America,US,USA,327167434,America,801,55231,21
2020-03-26T00:00:00Z,26,3,2020,13963,249,United_States_of_America,US,USA,327167434,America,1050,69194,22
2020-03-27T00:00:00Z,27,3,2020,16797,246,United_States_of_America,US,USA,327167434,America,1296,85991,23
2020-03-28T00:00:00Z,28,3,2020,18695,411,United_States_of_America,US,USA,327167434,America,1707,104686,24
2020-03-29T00:00:00Z,29,3,2020,19979,484,United_States_of_America,US,USA,327167434,America,2191,124665,25
2020-03-30T00:00:00Z,30,3,2020,18360,318,United_States_of_America,US,USA,327167434,America,2509,143025,26
2020-03-31T00:00:00Z,31,3,2020,21595,661,United_States_of_America,US,USA,327167434,America,3170,164620,27
2020-04-01T00:00:00Z,1,4,2020,24998,909,United_States_of_America,US,USA,327167434,America,4079,189618,28
2020-04-02T00:00:00Z,2,4,2020,27103,1059,United_States_of_America,US,USA,327167434,America,5138,216721,29
2020-04-03T00:00:00Z,3,4,2020,28819,915,United_States_of_America,US,USA,327167434,America,6053,245540,30
2020-04-04T00:00:00Z,4,4,2020,32425,1104,United_States_of_America,US,USA,327167434,America,7157,277965,31
2020-04-05T00:00:00Z,5,4,2020,34272,1344,United_States_of_America,US,USA,327167434,America,8501,312237,32
2020-04-06T00:00:00Z,6,4,2020,25398,1146,United_States_of_America,US,USA,327167434,America,9647,337635,33
2020-04-07T00:00:00Z,7,4,2020,30561,1342,United_States_of_America,US,USA,327167434,America,10989,368196,34
2020-04-08T00:00:00Z,8,4,2020,30613,1906,United_States_of_America,US,USA,327167434,America,12895,398809,35
2020-04-09T00:00:00Z,9,4,2020,33323,1922,United_States_of_America,US,USA,327167434,America,14817,432132,36
2020-04-10T00:00:00Z,10,4,2020,33901,1873,United_States_of_America,US,USA,327167434,America,16690,466033,37
2020-04-11T00:00:00Z,11,4,2020,35527,2087,United_States_of_America,US,USA,327167434,America,18777,501560,38
2020-04-12T00:00:00Z,12,4,2020,28391,1831,United_States_of_America,US,USA,327167434,America,20608,529951,39
2020-04-13T00:00:00Z,13,4,2020,27620,1500,United_States_of_America,US,USA,327167434,America,22108,557571,40
2020-04-14T00:00:00Z,14,4,2020,25023,1541,United_States_of_America,US,USA,327167434,America,23649,582594,41
2020-04-15T00:00:00Z,15,4,2020,26922,2408,United_States_of_America,US,USA,327167434,America,26057,609516,42
2020-04-16T00:00:00Z,16,4,2020,30148,4928,United_States_of_America,US,USA,327167434,America,30985,639664,43
2020-04-17T00:00:00Z,17,4,2020,31667,2299,United_States_of_America,US,USA,327167434,America,33284,671331,44
2020-04-18T00:00:00Z,18,4,2020,30833,3770,United_States_of_America,US,USA,327167434,America,37054,702164,45
2020-04-19T00:00:00Z,19,4,2020,32922,1856,United_States_of_America,US,USA,327167434,America,38910,735086,46
2020-04-20T00:00:00Z,20,4,2020,24601,1772,United_States_of_America,US,USA,327167434,America,40682,759687,47
2020-04-21T00:00:00Z,21,4,2020,28065,1857,United_States_of_America,US,USA,327167434,America,42539,787752,48
2020-04-22T00:00:00Z,22,4,2020,37289,2524,United_States_of_America,US,USA,327167434,America,45063,825041,49
2020-04-23T00:00:00Z,23,4,2020,17588,1721,United_States_of_America,US,USA,327167434,America,46784,842629,50
2020-04-24T00:00:00Z,24,4,2020,26543,3179,United_States_of_America,US,USA,327167434,America,49963,869172,51
2020-04-25T00:00:00Z,25,4,2020,21352,1054,United_States_of_America,US,USA,327167434,America,51017,890524,52
2020-04-26T00:00:00Z,26,4,2020,48529,2172,United_States_of_America,US,USA,327167434,America,53189,939053,53
2020-04-27T00:00:00Z,27,4,2020,26857,1687,United_States_of_America,US,USA,327167434,America,54876,965910,54
2020-04-28T00:00:00Z,28,4,2020,22541,1369,United_States_of_America,US,USA,327167434,America,56245,988451,55
2020-04-29T00:00:00Z,29,4,2020,24132,2110,United_States_of_America,US,USA,327167434,America,58355,1012583,56
2020-04-30T00:00:00Z,30,4,2020,27326,2611,United_States_of_America,US,USA,327167434,America,60966,1039909,57
2020-05-01T00:00:00Z,1,5,2020,29917,2040,United_States_of_America,US,USA,327167434,America,63006,1069826,58
2020-05-02T00:00:00Z,2,5,2020,33955,2062,United_States_of_America,US,USA,327167434,America,65068,1103781,59
2020-05-03T00:00:00Z,3,5,2020,29288,1317,United_States_of_America,US,USA,327167434,America,66385,1133069,60
2020-05-04T00:00:00Z,4,5,2020,24972,1297,United_States_of_America,US,USA,327167434,America,67682,1158041,61
2020-05-05T00:00:00Z,5,5,2020,22593,1252,United_States_of_America,US,USA,327167434,America,68934,1180634,62
2020-05-06T00:00:00Z,6,5,2020,23841,2144,United_States_of_America,US,USA,327167434,America,71078,1204475,63
2020-05-07T00:00:00Z,7,5,2020,24128,2353,United_States_of_America,US,USA,327167434,America,73431,1228603,64
2020-05-08T00:00:00Z,8,5,2020,28369,2239,United_States_of_America,US,USA,327167434,America,75670,1256972,65
2020-05-09T00:00:00Z,9,5,2020,26957,1510,United_States_of_America,US,USA,327167434,America,77180,1283929,66
2020-05-10T00:00:00Z,10,5,2020,25612,1614,United_States_of_America,US,USA,327167434,America,78794,1309541,67
2020-05-11T00:00:00Z,11,5,2020,20258,734,United_States_of_America,US,USA,327167434,America,79528,1329799,68
2020-05-12T00:00:00Z,12,5,2020,18117,1156,United_States_of_America,US,USA,327167434,America,80684,1347916,69
2020-05-13T00:00:00Z,13,5,2020,22048,1703,United_States_of_America,US,USA,327167434,America,82387,1369964,70
2020-05-14T00:00:00Z,14,5,2020,20782,1746,United_States_of_America,US,USA,327167434,America,84133,1390746,71
2020-05-15T00:00:00Z,15,5,2020,27143,1773,United_States_of_America,US,USA,327167434,America,85906,1417889,72
2020-05-16T00:00:00Z,16,5,2020,25508,1662,United_States_of_America,US,USA,327167434,America,87568,1443397,73
2020-05-17T00:00:00Z,17,5,2020,24487,1186,United_States_of_America,US,USA,327167434,America,88754,1467884,74
2020-05-18T00:00:00Z,18,5,2020,18873,808,United_States_of_America,US,USA,327167434,America,89562,1486757,75
2020-05-19T00:00:00Z,19,5,2020,21841,791,United_States_of_America,US,USA,327167434,America,90353,1508598,76
2020-05-20T00:00:00Z,20,5,2020,19970,1568,United_States_of_America,US,USA,327167434,America,91921,1528568,77
2020-05-21T00:00:00Z,21,5,2020,23285,1518,United_States_of_America,US,USA,327167434,America,93439,1551853,78
2020-05-22T00:00:00Z,22,5,2020,25434,1263,United_States_of_America,US,USA,327167434,America,94702,1577287,79
2020-05-23T00:00:00Z,23,5,2020,24147,1305,United_States_of_America,US,USA,327167434,America,96007,1601434,80
2020-05-24T00:00:00Z,24,5,2020,21236,1080,United_States_of_America,US,USA,327167434,America,97087,1622670,81
2020-05-25T00:00:00Z,25,5,2020,20568,633,United_States_of_America,US,USA,327167434,America,97720,1643238,82
2020-05-26T00:00:00Z,26,5,2020,19064,500,United_States_of_America,US,USA,327167434,America,98220,1662302,83
2020-05-27T00:00:00Z,27,5,2020,18910,696,United_States_of_America,US,USA,327167434,America,98916,1681212,84
2020-04-20T00:00:00Z,20,4,2020,11,1,Uruguay,UY,URY,3449299,America,10,528,1
2020-04-21T00:00:00Z,21,4,2020,7,0,Uruguay,UY,URY,3449299,America,10,535,2
2020-04-22T00:00:00Z,22,4,2020,8,2,Uruguay,UY,URY,3449299,America,12,543,3
2020-04-23T00:00:00Z,23,4,2020,6,0,Uruguay,UY,URY,3449299,America,12,549,4
2020-04-24T00:00:00Z,24,4,2020,8,0,Uruguay,UY,URY,3449299,America,12,557,5
2020-04-25T00:00:00Z,25,4,2020,6,0,Uruguay,UY,URY,3449299,America,12,563,6
2020-04-26T00:00:00Z,26,4,2020,33,2,Uruguay,UY,URY,3449299,America,14,596,7
2020-04-27T00:00:00Z,27,4,2020,10,1,Uruguay,UY,URY,3449299,America,15,606,8
2020-04-28T00:00:00Z,28,4,2020,14,0,Uruguay,UY,URY,3449299,America,15,620,9
2020-04-29T00:00:00Z,29,4,2020,5,0,Uruguay,UY,URY,3449299,America,15,625,10
2020-04-30T00:00:00Z,30,4,2020,5,0,Uruguay,UY,URY,3449299,America,15,630,11
2020-05-01T00:00:00Z,1,5,2020,13,2,Uruguay,UY,URY,3449299,America,17,643,12
2020-05-02T00:00:00Z,2,5,2020,5,0,Uruguay,UY,URY,3449299,America,17,648,13
2020-05-03T00:00:00Z,3,5,2020,4,0,Uruguay,UY,URY,3449299,America,17,652,14
2020-05-04T00:00:00Z,4,5,2020,3,0,Uruguay,UY,URY,3449299,America,17,655,15
2020-05-05T00:00:00Z,5,5,2020,2,0,Uruguay,UY,URY,3449299,America,17,657,16
2020-05-06T00:00:00Z,6,5,2020,13,0,Uruguay,UY,URY,3449299,America,17,670,17
2020-05-07T00:00:00Z,7,5,2020,3,0,Uruguay,UY,URY,3449299,America,17,673,18
2020-05-08T00:00:00Z,8,5,2020,11,0,Uruguay,UY,URY,3449299,America,17,684,19
2020-05-09T00:00:00Z,9,5,2020,10,1,Uruguay,UY,URY,3449299,America,18,694,20
2020-05-10T00:00:00Z,10,5,2020,8,0,Uruguay,UY,URY,3449299,America,18,702,21
2020-05-11T00:00:00Z,11,5,2020,5,1,Uruguay,UY,URY,3449299,America,19,707,22
2020-05-12T00:00:00Z,12,5,2020,4,0,Uruguay,UY,URY,3449299,America,19,711,23
2020-05-13T00:00:00Z,13,5,2020,6,0,Uruguay,UY,URY,3449299,America,19,717,24
2020-05-14T00:00:00Z,14,5,2020,2,0,Uruguay,UY,URY,3449299,America,19,719,25
2020-05-15T00:00:00Z,15,5,2020,5,0,Uruguay,UY,URY,3449299,America,19,724,26
2020-05-16T00:00:00Z,16,5,2020,8,0,Uruguay,UY,URY,3449299,America,19,732,27
2020-05-17T00:00:00Z,17,5,2020,1,0,Uruguay,UY,URY,3449299,America,19,733,28
2020-05-18T00:00:00Z,18,5,2020,1,1,Uruguay,UY,URY,3449299,America,20,734,29
2020-05-19T00:00:00Z,19,5,2020,3,0,Uruguay,UY,URY,3449299,America,20,737,30
2020-05-20T00:00:00Z,20,5,2020,1,0,Uruguay,UY,URY,3449299,America,20,738,31
2020-05-21T00:00:00Z,21,5,2020,8,0,Uruguay,UY,URY,3449299,America,20,746,32
2020-05-22T00:00:00Z,22,5,2020,3,0,Uruguay,UY,URY,3449299,America,20,749,33
2020-05-23T00:00:00Z,23,5,2020,4,0,Uruguay,UY,URY,3449299,America,20,753,34
2020-05-24T00:00:00Z,24,5,2020,11,2,Uruguay,UY,URY,3449299,America,22,764,35
2020-05-25T00:00:00Z,25,5,2020,5,0,Uruguay,UY,URY,3449299,America,22,769,36
2020-05-26T00:00:00Z,26,5,2020,18,0,Uruguay,UY,URY,3449299,America,22,787,37
2020-05-27T00:00:00Z,27,5,2020,2,0,Uruguay,UY,URY,3449299,America,22,789,38
2020-05-04T00:00:00Z,4,5,2020,22,1,Uzbekistan,UZ,UZB,32955400,Asia,10,2149,1
2020-05-05T00:00:00Z,5,5,2020,40,0,Uzbekistan,UZ,UZB,32955400,Asia,10,2189,2
2020-05-06T00:00:00Z,6,5,2020,18,0,Uzbekistan,UZ,UZB,32955400,Asia,10,2207,3
2020-05-07T00:00:00Z,7,5,2020,26,0,Uzbekistan,UZ,UZB,32955400,Asia,10,2233,4
2020-05-08T00:00:00Z,8,5,2020,65,0,Uzbekistan,UZ,UZB,32955400,Asia,10,2298,5
2020-05-09T00:00:00Z,9,5,2020,38,0,Uzbekistan,UZ,UZB,32955400,Asia,10,2336,6
2020-05-10T00:00:00Z,10,5,2020,51,0,Uzbekistan,UZ,UZB,32955400,Asia,10,2387,7
2020-05-11T00:00:00Z,11,5,2020,31,0,Uzbekistan,UZ,UZB,32955400,Asia,10,2418,8
2020-05-12T00:00:00Z,12,5,2020,91,0,Uzbekistan,UZ,UZB,32955400,Asia,10,2509,9
2020-05-13T00:00:00Z,13,5,2020,38,0,Uzbekistan,UZ,UZB,32955400,Asia,10,2547,10
2020-05-14T00:00:00Z,14,5,2020,65,1,Uzbekistan,UZ,UZB,32955400,Asia,11,2612,11
2020-05-15T00:00:00Z,15,5,2020,33,0,Uzbekistan,UZ,UZB,32955400,Asia,11,2645,12
2020-05-16T00:00:00Z,16,5,2020,46,0,Uzbekistan,UZ,UZB,32955400,Asia,11,2691,13
2020-05-17T00:00:00Z,17,5,2020,50,0,Uzbekistan,UZ,UZB,32955400,Asia,11,2741,14
2020-05-18T00:00:00Z,18,5,2020,12,1,Uzbekistan,UZ,UZB,32955400,Asia,12,2753,15
2020-05-19T00:00:00Z,19,5,2020,49,1,Uzbekistan,UZ,UZB,32955400,Asia,13,2802,16
2020-05-20T00:00:00Z,20,5,2020,78,0,Uzbekistan,UZ,UZB,32955400,Asia,13,2880,17
2020-05-21T00:00:00Z,21,5,2020,70,0,Uzbekistan,UZ,UZB,32955400,Asia,13,2950,18
2020-05-22T00:00:00Z,22,5,2020,56,0,Uzbekistan,UZ,UZB,32955400,Asia,13,3006,19
2020-05-23T00:00:00Z,23,5,2020,72,0,Uzbekistan,UZ,UZB,32955400,Asia,13,3078,20
2020-05-24T00:00:00Z,24,5,2020,54,0,Uzbekistan,UZ,UZB,32955400,Asia,13,3132,21
2020-05-25T00:00:00Z,25,5,2020,32,0,Uzbekistan,UZ,UZB,32955400,Asia,13,3164,22
2020-05-26T00:00:00Z,26,5,2020,97,0,Uzbekistan,UZ,UZB,32955400,Asia,13,3261,23
2020-05-27T00:00:00Z,27,5,2020,72,1,Uzbekistan,UZ,UZB,32955400,Asia,14,3333,24
2020-04-22T00:00:00Z,22,4,2020,29,1,Venezuela,VE,VEN,28870195,America,10,285,1
2020-04-23T00:00:00Z,23,4,2020,3,0,Venezuela,VE,VEN,28870195,America,10,288,2
2020-04-24T00:00:00Z,24,4,2020,10,0,Venezuela,VE,VEN,28870195,America,10,298,3
2020-04-25T00:00:00Z,25,4,2020,20,0,Venezuela,VE,VEN,28870195,America,10,318,4
2020-04-26T00:00:00Z,26,4,2020,5,0,Venezuela,VE,VEN,28870195,America,10,323,5
2020-04-27T00:00:00Z,27,4,2020,2,0,Venezuela,VE,VEN,28870195,America,10,325,6
2020-04-28T00:00:00Z,28,4,2020,4,0,Venezuela,VE,VEN,28870195,America,10,329,7
2020-04-29T00:00:00Z,29,4,2020,0,0,Venezuela,VE,VEN,28870195,America,10,329,8
2020-04-30T00:00:00Z,30,4,2020,2,0,Venezuela,VE,VEN,28870195,America,10,331,9
2020-05-01T00:00:00Z,1,5,2020,2,0,Venezuela,VE,VEN,28870195,America,10,333,10
2020-05-02T00:00:00Z,2,5,2020,2,0,Venezuela,VE,VEN,28870195,America,10,335,11
2020-05-03T00:00:00Z,3,5,2020,10,0,Venezuela,VE,VEN,28870195,America,10,345,12
2020-05-04T00:00:00Z,4,5,2020,12,0,Venezuela,VE,VEN,28870195,America,10,357,13
2020-05-05T00:00:00Z,5,5,2020,4,0,Venezuela,VE,VEN,28870195,America,10,361,14
2020-05-06T00:00:00Z,6,5,2020,6,0,Venezuela,VE,VEN,28870195,America,10,367,15
2020-05-07T00:00:00Z,7,5,2020,12,0,Venezuela,VE,VEN,28870195,America,10,379,16
2020-05-08T00:00:00Z,8,5,2020,2,0,Venezuela,VE,VEN,28870195,America,10,381,17
2020-05-09T00:00:00Z,9,5,2020,7,0,Venezuela,VE,VEN,28870195,America,10,388,18
2020-05-10T00:00:00Z,10,5,2020,14,0,Venezuela,VE,VEN,28870195,America,10,402,19
2020-05-11T00:00:00Z,11,5,2020,12,0,Venezuela,VE,VEN,28870195,America,10,414,20
2020-05-12T00:00:00Z,12,5,2020,8,0,Venezuela,VE,VEN,28870195,America,10,422,21
2020-05-13T00:00:00Z,13,5,2020,1,0,Venezuela,VE,VEN,28870195,America,10,423,22
2020-05-14T00:00:00Z,14,5,2020,17,0,Venezuela,VE,VEN,28870195,America,10,440,23
2020-05-15T00:00:00Z,15,5,2020,15,0,Venezuela,VE,VEN,28870195,America,10,455,24
2020-05-16T00:00:00Z,16,5,2020,4,0,Venezuela,VE,VEN,28870195,America,10,459,25
2020-05-17T00:00:00Z,17,5,2020,45,0,Venezuela,VE,VEN,28870195,America,10,504,26
2020-05-18T00:00:00Z,18,5,2020,37,0,Venezuela,VE,VEN,28870195,America,10,541,27
2020-05-19T00:00:00Z,19,5,2020,77,0,Venezuela,VE,VEN,28870195,America,10,618,28
2020-05-20T00:00:00Z,20,5,2020,131,0,Venezuela,VE,VEN,28870195,America,10,749,29
2020-05-21T00:00:00Z,21,5,2020,75,0,Venezuela,VE,VEN,28870195,America,10,824,30
2020-05-22T00:00:00Z,22,5,2020,58,0,Venezuela,VE,VEN,28870195,America,10,882,31
2020-05-23T00:00:00Z,23,5,2020,62,0,Venezuela,VE,VEN,28870195,America,10,944,32
2020-05-24T00:00:00Z,24,5,2020,0,0,Venezuela,VE,VEN,28870195,America,10,944,33
2020-05-25T00:00:00Z,25,5,2020,177,0,Venezuela,VE,VEN,28870195,America,10,1121,34
2020-05-26T00:00:00Z,26,5,2020,56,0,Venezuela,VE,VEN,28870195,America,10,1177,35
2020-05-27T00:00:00Z,27,5,2020,34,1,Venezuela,VE,VEN,28870195,America,11,1211,36
2020-05-13T00:00:00Z,13,5,2020,11,2,Yemen,YE,YEM,28498687,Asia,11,67,1
2020-05-14T00:00:00Z,14,5,2020,3,1,Yemen,YE,YEM,28498687,Asia,12,70,2
2020-05-15T00:00:00Z,15,5,2020,17,1,Yemen,YE,YEM,28498687,Asia,13,87,3
2020-05-16T00:00:00Z,16,5,2020,19,2,Yemen,YE,YEM,28498687,Asia,15,106,4
2020-05-17T00:00:00Z,17,5,2020,18,4,Yemen,YE,YEM,28498687,Asia,19,124,5
2020-05-18T00:00:00Z,18,5,2020,4,1,Yemen,YE,YEM,28498687,Asia,20,128,6
2020-05-19T00:00:00Z,19,5,2020,2,0,Yemen,YE,YEM,28498687,Asia,20,130,7
2020-05-20T00:00:00Z,20,5,2020,37,8,Yemen,YE,YEM,28498687,Asia,28,167,8
2020-05-21T00:00:00Z,21,5,2020,13,1,Yemen,YE,YEM,28498687,Asia,29,180,9
2020-05-22T00:00:00Z,22,5,2020,13,4,Yemen,YE,YEM,28498687,Asia,33,193,10
2020-05-23T00:00:00Z,23,5,2020,12,0,Yemen,YE,YEM,28498687,Asia,33,205,11
2020-05-24T00:00:00Z,24,5,2020,7,6,Yemen,YE,YEM,28498687,Asia,39,212,12
2020-05-25T00:00:00Z,25,5,2020,10,3,Yemen,YE,YEM,28498687,Asia,42,222,13
2020-05-26T00:00:00Z,26,5,2020,15,3,Yemen,YE,YEM,28498687,Asia,45,237,14
2020-05-27T00:00:00Z,27,5,2020,12,4,Yemen,YE,YEM,28498687,Asia,49,249,15
