DateRep,day,month,year,Cases,Deaths,Country,geoId,countryterritoryCode,popData2018,continentExp,Total Deaths,Total Cases,Days since first death
2020-03-24T00:00:00Z,24,3,2020,6,1,Afghanistan,AF,AFG,37172386,Asia,1,40,1
2020-03-25T00:00:00Z,25,3,2020,2,0,Afghanistan,AF,AFG,37172386,Asia,1,42,2
2020-03-26T00:00:00Z,26,3,2020,33,0,Afghanistan,AF,AFG,37172386,Asia,1,75,3
2020-03-27T00:00:00Z,27,3,2020,0,0,Afghanistan,AF,AFG,37172386,Asia,1,75,4
2020-03-28T00:00:00Z,28,3,2020,16,1,Afghanistan,AF,AFG,37172386,Asia,2,91,5
2020-03-29T00:00:00Z,29,3,2020,15,1,Afghanistan,AF,AFG,37172386,Asia,3,106,6
2020-03-30T00:00:00Z,30,3,2020,8,1,Afghanistan,AF,AFG,37172386,Asia,4,114,7
2020-03-31T00:00:00Z,31,3,2020,27,0,Afghanistan,AF,AFG,37172386,Asia,4,141,8
2020-04-01T00:00:00Z,1,4,2020,25,0,Afghanistan,AF,AFG,37172386,Asia,4,166,9
2020-04-02T00:00:00Z,2,4,2020,26,0,Afghanistan,AF,AFG,37172386,Asia,4,192,10
2020-04-03T00:00:00Z,3,4,2020,43,0,Afghanistan,AF,AFG,37172386,Asia,4,235,11
2020-04-04T00:00:00Z,4,4,2020,0,0,Afghanistan,AF,AFG,37172386,Asia,4,235,12
2020-04-05T00:00:00Z,5,4,2020,35,1,Afghanistan,AF,AFG,37172386,Asia,5,270,13
2020-04-06T00:00:00Z,6,4,2020,29,2,Afghanistan,AF,AFG,37172386,Asia,7,299,14
2020-04-07T00:00:00Z,7,4,2020,38,0,Afghanistan,AF,AFG,37172386,Asia,7,337,15
2020-04-08T00:00:00Z,8,4,2020,30,4,Afghanistan,AF,AFG,37172386,Asia,11,367,16
2020-04-09T00:00:00Z,9,4,2020,56,3,Afghanistan,AF,AFG,37172386,Asia,14,423,17
2020-04-10T00:00:00Z,10,4,2020,61,1,Afghanistan,AF,AFG,37172386,Asia,15,484,18
2020-04-11T00:00:00Z,11,4,2020,37,0,Afghanistan,AF,AFG,37172386,Asia,15,521,19
2020-04-12T00:00:00Z,12,4,2020,34,3,Afghanistan,AF,AFG,37172386,Asia,18,555,20
2020-04-13T00:00:00Z,13,4,2020,52,0,Afghanistan,AF,AFG,37172386,Asia,18,607,21
2020-04-14T00:00:00Z,14,4,2020,58,3,Afghanistan,AF,AFG,37172386,Asia,21,665,22
2020-04-15T00:00:00Z,15,4,2020,49,2,Afghanistan,AF,AFG,37172386,Asia,23,714,23
2020-04-16T00:00:00Z,16,4,2020,70,2,Afghanistan,AF,AFG,37172386,Asia,25,784,24
2020-04-17T00:00:00Z,17,4,2020,10,4,Afghanistan,AF,AFG,37172386,Asia,29,794,25
2020-04-18T00:00:00Z,18,4,2020,51,1,Afghanistan,AF,AFG,37172386,Asia,30,845,26
2020-04-19T00:00:00Z,19,4,2020,63,0,Afghanistan,AF,AFG,37172386,Asia,30,908,27
2020-04-20T00:00:00Z,20,4,2020,88,3,Afghanistan,AF,AFG,37172386,Asia,33,996,28
2020-04-21T00:00:00Z,21,4,2020,35,2,Afghanistan,AF,AFG,37172386,Asia,35,1031,29
2020-04-22T00:00:00Z,22,4,2020,61,1,Afghanistan,AF,AFG,37172386,Asia,36,1092,30
2020-04-23T00:00:00Z,23,4,2020,84,4,Afghanistan,AF,AFG,37172386,Asia,40,1176,31
2020-04-24T00:00:00Z,24,4,2020,105,2,Afghanistan,AF,AFG,37172386,Asia,42,1281,32
2020-04-25T00:00:00Z,25,4,2020,70,1,Afghanistan,AF,AFG,37172386,Asia,43,1351,33
2020-04-26T00:00:00Z,26,4,2020,112,4,Afghanistan,AF,AFG,37172386,Asia,47,1463,34
2020-04-27T00:00:00Z,27,4,2020,68,10,Afghanistan,AF,AFG,37172386,Asia,57,1531,35
2020-04-28T00:00:00Z,28,4,2020,172,0,Afghanistan,AF,AFG,37172386,Asia,57,1703,36
2020-04-29T00:00:00Z,29,4,2020,124,3,Afghanistan,AF,AFG,37172386,Asia,60,1827,37
2020-04-30T00:00:00Z,30,4,2020,122,0,Afghanistan,AF,AFG,37172386,Asia,60,1949,38
2020-05-01T00:00:00Z,1,5,2020,222,4,Afghanistan,AF,AFG,37172386,Asia,64,2171,39
2020-05-02T00:00:00Z,2,5,2020,164,4,Afghanistan,AF,AFG,37172386,Asia,68,2335,40
2020-05-03T00:00:00Z,3,5,2020,134,4,Afghanistan,AF,AFG,37172386,Asia,72,2469,41
2020-05-04T00:00:00Z,4,5,2020,235,13,Afghanistan,AF,AFG,37172386,Asia,85,2704,42
2020-05-05T00:00:00Z,5,5,2020,190,5,Afghanistan,AF,AFG,37172386,Asia,90,2894,43
2020-05-06T00:00:00Z,6,5,2020,330,5,Afghanistan,AF,AFG,37172386,Asia,95,3224,44
2020-05-07T00:00:00Z,7,5,2020,168,9,Afghanistan,AF,AFG,37172386,Asia,104,3392,45
2020-05-08T00:00:00Z,8,5,2020,171,2,Afghanistan,AF,AFG,37172386,Asia,106,3563,46
2020-05-09T00:00:00Z,9,5,2020,215,3,Afghanistan,AF,AFG,37172386,Asia,109,3778,47
2020-05-10T00:00:00Z,10,5,2020,255,6,Afghanistan,AF,AFG,37172386,Asia,115,4033,48
2020-05-11T00:00:00Z,11,5,2020,369,5,Afghanistan,AF,AFG,37172386,Asia,120,4402,49
2020-05-12T00:00:00Z,12,5,2020,285,2,Afghanistan,AF,AFG,37172386,Asia,122,4687,50
2020-05-13T00:00:00Z,13,5,2020,280,5,Afghanistan,AF,AFG,37172386,Asia,127,4967,51
2020-05-14T00:00:00Z,14,5,2020,259,3,Afghanistan,AF,AFG,37172386,Asia,130,5226,52
2020-05-15T00:00:00Z,15,5,2020,113,6,Afghanistan,AF,AFG,37172386,Asia,136,5339,53
2020-05-16T00:00:00Z,16,5,2020,1063,32,Afghanistan,AF,AFG,37172386,Asia,168,6402,54
2020-05-17T00:00:00Z,17,5,2020,0,0,Afghanistan,AF,AFG,37172386,Asia,168,6402,55
2020-05-18T00:00:00Z,18,5,2020,262,1,Afghanistan,AF,AFG,37172386,Asia,169,6664,56
2020-05-19T00:00:00Z,19,5,2020,408,4,Afghanistan,AF,AFG,37172386,Asia,173,7072,57
2020-05-20T00:00:00Z,20,5,2020,581,5,Afghanistan,AF,AFG,37172386,Asia,178,7653,58
2020-05-21T00:00:00Z,21,5,2020,492,9,Afghanistan,AF,AFG,37172386,Asia,187,8145,59
2020-05-22T00:00:00Z,22,5,2020,531,6,Afghanistan,AF,AFG,37172386,Asia,193,8676,60
2020-05-23T00:00:00Z,23,5,2020,540,12,Afghanistan,AF,AFG,37172386,Asia,205,9216,61
2020-05-24T00:00:00Z,24,5,2020,782,11,Afghanistan,AF,AFG,37172386,Asia,216,9998,62
2020-05-25T00:00:00Z,25,5,2020,584,2,Afghanistan,AF,AFG,37172386,Asia,218,10582,63
2020-05-26T00:00:00Z,26,5,2020,591,1,Afghanistan,AF,AFG,37172386,Asia,219,11173,64
2020-05-27T00:00:00Z,27,5,2020,658,1,Afghanistan,AF,AFG,37172386,Asia,220,11831,65
2020-03-12T00:00:00Z,12,3,2020,1,1,Albania,AL,ALB,2866376,Europe,1,11,1
2020-03-13T00:00:00Z,13,3,2020,12,0,Albania,AL,ALB,2866376,Europe,1,23,2
2020-03-14T00:00:00Z,14,3,2020,10,0,Albania,AL,ALB,2866376,Europe,1,33,3
2020-03-15T00:00:00Z,15,3,2020,5,0,Albania,AL,ALB,2866376,Europe,1,38,4
2020-03-16T00:00:00Z,16,3,2020,4,0,Albania,AL,ALB,2866376,Europe,1,42,5
2020-03-17T00:00:00Z,17,3,2020,9,0,Albania,AL,ALB,2866376,Europe,1,51,6
2020-03-18T00:00:00Z,18,3,2020,4,0,Albania,AL,ALB,2866376,Europe,1,55,7
2020-03-19T00:00:00Z,19,3,2020,4,1,Albania,AL,ALB,2866376,Europe,2,59,8
2020-03-20T00:00:00Z,20,3,2020,11,0,Albania,AL,ALB,2866376,Europe,2,70,9
2020-03-21T00:00:00Z,21,3,2020,0,0,Albania,AL,ALB,2866376,Europe,2,70,10
2020-03-22T00:00:00Z,22,3,2020,6,0,Albania,AL,ALB,2866376,Europe,2,76,11
2020-03-23T00:00:00Z,23,3,2020,13,0,Albania,AL,ALB,2866376,Europe,2,89,12
2020-03-24T00:00:00Z,24,3,2020,11,2,Albania,AL,ALB,2866376,Europe,4,100,13
2020-03-25T00:00:00Z,25,3,2020,23,1,Albania,AL,ALB,2866376,Europe,5,123,14
2020-03-26T00:00:00Z,26,3,2020,23,0,Albania,AL,ALB,2866376,Europe,5,146,15
2020-03-27T00:00:00Z,27,3,2020,28,1,Albania,AL,ALB,2866376,Europe,6,174,16
2020-03-28T00:00:00Z,28,3,2020,12,3,Albania,AL,ALB,2866376,Europe,9,186,17
2020-03-29T00:00:00Z,29,3,2020,11,1,Albania,AL,ALB,2866376,Europe,10,197,18
2020-03-30T00:00:00Z,30,3,2020,15,0,Albania,AL,ALB,2866376,Europe,10,212,19
2020-03-31T00:00:00Z,31,3,2020,11,2,Albania,AL,ALB,2866376,Europe,12,223,20
2020-04-01T00:00:00Z,1,4,2020,20,3,Albania,AL,ALB,2866376,Europe,15,243,21
2020-04-02T00:00:00Z,2,4,2020,16,0,Albania,AL,ALB,2866376,Europe,15,259,22
2020-04-03T00:00:00Z,3,4,2020,18,1,Albania,AL,ALB,2866376,Europe,16,277,23
2020-04-04T00:00:00Z,4,4,2020,27,1,Albania,AL,ALB,2866376,Europe,17,304,24
2020-04-05T00:00:00Z,5,4,2020,29,2,Albania,AL,ALB,2866376,Europe,19,333,25
2020-04-06T00:00:00Z,6,4,2020,28,2,Albania,AL,ALB,2866376,Europe,21,361,26
2020-04-07T00:00:00Z,7,4,2020,16,1,Albania,AL,ALB,2866376,Europe,22,377,27
2020-04-08T00:00:00Z,8,4,2020,6,0,Albania,AL,ALB,2866376,Europe,22,383,28
2020-04-09T00:00:00Z,9,4,2020,17,0,Albania,AL,ALB,2866376,Europe,22,400,29
2020-04-10T00:00:00Z,10,4,2020,9,1,Albania,AL,ALB,2866376,Europe,23,409,30
2020-04-11T00:00:00Z,11,4,2020,7,0,Albania,AL,ALB,2866376,Europe,23,416,31
2020-04-12T00:00:00Z,12,4,2020,17,0,Albania,AL,ALB,2866376,Europe,23,433,32
2020-04-13T00:00:00Z,13,4,2020,13,0,Albania,AL,ALB,2866376,Europe,23,446,33
2020-04-14T00:00:00Z,14,4,2020,21,0,Albania,AL,ALB,2866376,Europe,23,467,34
2020-04-15T00:00:00Z,15,4,2020,8,1,Albania,AL,ALB,2866376,Europe,24,475,35
2020-04-16T00:00:00Z,16,4,2020,19,1,Albania,AL,ALB,2866376,Europe,25,494,36
2020-04-17T00:00:00Z,17,4,2020,24,1,Albania,AL,ALB,2866376,Europe,26,518,37
2020-04-18T00:00:00Z,18,4,2020,21,0,Albania,AL,ALB,2866376,Europe,26,539,38
2020-04-19T00:00:00Z,19,4,2020,9,0,Albania,AL,ALB,2866376,Europe,26,548,39
2020-04-20T00:00:00Z,20,4,2020,14,0,Albania,AL,ALB,2866376,Europe,26,562,40
2020-04-21T00:00:00Z,21,4,2020,22,0,Albania,AL,ALB,2866376,Europe,26,584,41
2020-04-22T00:00:00Z,22,4,2020,25,0,Albania,AL,ALB,2866376,Europe,26,609,42
2020-04-23T00:00:00Z,23,4,2020,25,1,Albania,AL,ALB,2866376,Europe,27,634,43
2020-04-24T00:00:00Z,24,4,2020,29,0,Albania,AL,ALB,2866376,Europe,27,663,44
2020-04-25T00:00:00Z,25,4,2020,15,0,Albania,AL,ALB,2866376,Europe,27,678,45
2020-04-26T00:00:00Z,26,4,2020,34,0,Albania,AL,ALB,2866376,Europe,27,712,46
2020-04-27T00:00:00Z,27,4,2020,14,1,Albania,AL,ALB,2866376,Europe,28,726,47
2020-04-28T00:00:00Z,28,4,2020,10,0,Albania,AL,ALB,2866376,Europe,28,736,48
2020-04-29T00:00:00Z,29,4,2020,14,2,Albania,AL,ALB,2866376,Europe,30,750,49
2020-04-30T00:00:00Z,30,4,2020,16,1,Albania,AL,ALB,2866376,Europe,31,766,50
2020-05-01T00:00:00Z,1,5,2020,7,0,Albania,AL,ALB,2866376,Europe,31,773,51
2020-05-02T00:00:00Z,2,5,2020,9,0,Albania,AL,ALB,2866376,Europe,31,782,52
2020-05-03T00:00:00Z,3,5,2020,7,0,Albania,AL,ALB,2866376,Europe,31,789,53
2020-05-04T00:00:00Z,4,5,2020,6,0,Albania,AL,ALB,2866376,Europe,31,795,54
2020-05-05T00:00:00Z,5,5,2020,8,0,Albania,AL,ALB,2866376,Europe,31,803,55
2020-05-06T00:00:00Z,6,5,2020,17,0,Albania,AL,ALB,2866376,Europe,31,820,56
2020-05-07T00:00:00Z,7,5,2020,12,0,Albania,AL,ALB,2866376,Europe,31,832,57
2020-05-08T00:00:00Z,8,5,2020,10,0,Albania,AL,ALB,2866376,Europe,31,842,58
2020-05-09T00:00:00Z,9,5,2020,8,0,Albania,AL,ALB,2866376,Europe,31,850,59
2020-05-10T00:00:00Z,10,5,2020,6,0,Albania,AL,ALB,2866376,Europe,31,856,60
2020-05-11T00:00:00Z,11,5,2020,12,0,Albania,AL,ALB,2866376,Europe,31,868,61
2020-05-12T00:00:00Z,12,5,2020,4,0,Albania,AL,ALB,2866376,Europe,31,872,62
2020-05-13T00:00:00Z,13,5,2020,4,0,Albania,AL,ALB,2866376,Europe,31,876,63
2020-05-14T00:00:00Z,14,5,2020,4,0,Albania,AL,ALB,2866376,Europe,31,880,64
2020-05-15T00:00:00Z,15,5,2020,18,0,Albania,AL,ALB,2866376,Europe,31,898,65
2020-05-16T00:00:00Z,16,5,2020,18,0,Albania,AL,ALB,2866376,Europe,31,916,66
2020-05-17T00:00:00Z,17,5,2020,17,0,Albania,AL,ALB,2866376,Europe,31,933,67
2020-05-18T00:00:00Z,18,5,2020,13,0,Albania,AL,ALB,2866376,Europe,31,946,68
2020-05-19T00:00:00Z,19,5,2020,2,0,Albania,AL,ALB,2866376,Europe,31,948,69
2020-05-20T00:00:00Z,20,5,2020,1,0,Albania,AL,ALB,2866376,Europe,31,949,70
2020-05-21T00:00:00Z,21,5,2020,15,0,Albania,AL,ALB,2866376,Europe,31,964,71
2020-05-22T00:00:00Z,22,5,2020,5,0,Albania,AL,ALB,2866376,Europe,31,969,72
2020-05-23T00:00:00Z,23,5,2020,12,0,Albania,AL,ALB,2866376,Europe,31,981,73
2020-05-24T00:00:00Z,24,5,2020,8,0,Albania,AL,ALB,2866376,Europe,31,989,74
2020-05-25T00:00:00Z,25,5,2020,9,1,Albania,AL,ALB,2866376,Europe,32,998,75
2020-05-26T00:00:00Z,26,5,2020,6,0,Albania,AL,ALB,2866376,Europe,32,1004,76
2020-05-27T00:00:00Z,27,5,2020,25,1,Albania,AL,ALB,2866376,Europe,33,1029,77
2020-03-13T00:00:00Z,13,3,2020,5,1,Algeria,DZ,DZA,42228429,Africa,1,25,1
2020-03-14T00:00:00Z,14,3,2020,1,1,Algeria,DZ,DZA,42228429,Africa,2,26,2
2020-03-15T00:00:00Z,15,3,2020,11,0,Algeria,DZ,DZA,42228429,Africa,2,37,3
2020-03-16T00:00:00Z,16,3,2020,11,2,Algeria,DZ,DZA,42228429,Africa,4,48,4
2020-03-17T00:00:00Z,17,3,2020,10,0,Algeria,DZ,DZA,42228429,Africa,4,58,5
2020-03-18T00:00:00Z,18,3,2020,2,1,Algeria,DZ,DZA,42228429,Africa,5,60,6
2020-03-19T00:00:00Z,19,3,2020,12,1,Algeria,DZ,DZA,42228429,Africa,6,72,7
2020-03-20T00:00:00Z,20,3,2020,18,1,Algeria,DZ,DZA,42228429,Africa,7,90,8
2020-03-21T00:00:00Z,21,3,2020,12,3,Algeria,DZ,DZA,42228429,Africa,10,102,9
2020-03-22T00:00:00Z,22,3,2020,37,5,Algeria,DZ,DZA,42228429,Africa,15,139,10
2020-03-23T00:00:00Z,23,3,2020,62,2,Algeria,DZ,DZA,42228429,Africa,17,201,11
2020-03-24T00:00:00Z,24,3,2020,29,0,Algeria,DZ,DZA,42228429,Africa,17,230,12
2020-03-25T00:00:00Z,25,3,2020,34,2,Algeria,DZ,DZA,42228429,Africa,19,264,13
2020-03-26T00:00:00Z,26,3,2020,38,2,Algeria,DZ,DZA,42228429,Africa,21,302,14
2020-03-27T00:00:00Z,27,3,2020,65,4,Algeria,DZ,DZA,42228429,Africa,25,367,15
2020-03-28T00:00:00Z,28,3,2020,42,1,Algeria,DZ,DZA,42228429,Africa,26,409,16
2020-03-29T00:00:00Z,29,3,2020,45,3,Algeria,DZ,DZA,42228429,Africa,29,454,17
2020-03-30T00:00:00Z,30,3,2020,57,2,Algeria,DZ,DZA,42228429,Africa,31,511,18
2020-03-31T00:00:00Z,31,3,2020,73,4,Algeria,DZ,DZA,42228429,Africa,35,584,19
2020-04-01T00:00:00Z,1,4,2020,132,9,Algeria,DZ,DZA,42228429,Africa,44,716,20
2020-04-02T00:00:00Z,2,4,2020,131,14,Algeria,DZ,DZA,42228429,Africa,58,847,21
2020-04-03T00:00:00Z,3,4,2020,139,5,Algeria,DZ,DZA,42228429,Africa,63,986,22
2020-04-04T00:00:00Z,4,4,2020,185,42,Algeria,DZ,DZA,42228429,Africa,105,1171,23
2020-04-05T00:00:00Z,5,4,2020,80,25,Algeria,DZ,DZA,42228429,Africa,130,1251,24
2020-04-06T00:00:00Z,6,4,2020,69,22,Algeria,DZ,DZA,42228429,Africa,152,1320,25
2020-04-07T00:00:00Z,7,4,2020,103,21,Algeria,DZ,DZA,42228429,Africa,173,1423,26
2020-04-08T00:00:00Z,8,4,2020,45,20,Algeria,DZ,DZA,42228429,Africa,193,1468,27
2020-04-09T00:00:00Z,9,4,2020,104,12,Algeria,DZ,DZA,42228429,Africa,205,1572,28
2020-04-10T00:00:00Z,10,4,2020,94,30,Algeria,DZ,DZA,42228429,Africa,235,1666,29
2020-04-11T00:00:00Z,11,4,2020,95,21,Algeria,DZ,DZA,42228429,Africa,256,1761,30
2020-04-12T00:00:00Z,12,4,2020,64,19,Algeria,DZ,DZA,42228429,Africa,275,1825,31
2020-04-13T00:00:00Z,13,4,2020,89,18,Algeria,DZ,DZA,42228429,Africa,293,1914,32
2020-04-14T00:00:00Z,14,4,2020,69,20,Algeria,DZ,DZA,42228429,Africa,313,1983,33
2020-04-15T00:00:00Z,15,4,2020,87,12,Algeria,DZ,DZA,42228429,Africa,325,2070,34
2020-04-16T00:00:00Z,16,4,2020,90,11,Algeria,DZ,DZA,42228429,Africa,336,2160,35
2020-04-17T00:00:00Z,17,4,2020,108,12,Algeria,DZ,DZA,42228429,Africa,348,2268,36
2020-04-18T00:00:00Z,18,4,2020,150,16,Algeria,DZ,DZA,42228429,Africa,364,2418,37
2020-04-19T00:00:00Z,19,4,2020,117,3,Algeria,DZ,DZA,42228429,Africa,367,2535,38
2020-04-20T00:00:00Z,20,4,2020,94,8,Algeria,DZ,DZA,42228429,Africa,375,2629,39
2020-04-21T00:00:00Z,21,4,2020,89,9,Algeria,DZ,DZA,42228429,Africa,384,2718,40
2020-04-22T00:00:00Z,22,4,2020,93,8,Algeria,DZ,DZA,42228429,Africa,392,2811,41
2020-04-23T00:00:00Z,23,4,2020,99,10,Algeria,DZ,DZA,42228429,Africa,402,2910,42
2020-04-24T00:00:00Z,24,4,2020,97,5,Algeria,DZ,DZA,42228429,Africa,407,3007,43
2020-04-25T00:00:00Z,25,4,2020,120,8,Algeria,DZ,DZA,42228429,Africa,415,3127,44
2020-04-26T00:00:00Z,26,4,2020,129,4,Algeria,DZ,DZA,42228429,Africa,419,3256,45
2020-04-27T00:00:00Z,27,4,2020,126,6,Algeria,DZ,DZA,42228429,Africa,425,3382,46
2020-04-28T00:00:00Z,28,4,2020,135,7,Algeria,DZ,DZA,42228429,Africa,432,3517,47
2020-04-29T00:00:00Z,29,4,2020,132,5,Algeria,DZ,DZA,42228429,Africa,437,3649,48
2020-04-30T00:00:00Z,30,4,2020,199,7,Algeria,DZ,DZA,42228429,Africa,444,3848,49
2020-05-01T00:00:00Z,1,5,2020,158,6,Algeria,DZ,DZA,42228429,Africa,450,4006,50
2020-05-02T00:00:00Z,2,5,2020,148,3,Algeria,DZ,DZA,42228429,Africa,453,4154,51
2020-05-03T00:00:00Z,3,5,2020,141,6,Algeria,DZ,DZA,42228429,Africa,459,4295,52
2020-05-04T00:00:00Z,4,5,2020,179,4,Algeria,DZ,DZA,42228429,Africa,463,4474,53
2020-05-05T00:00:00Z,5,5,2020,174,2,Algeria,DZ,DZA,42228429,Africa,465,4648,54
2020-05-06T00:00:00Z,6,5,2020,190,5,Algeria,DZ,DZA,42228429,Africa,470,4838,55
2020-05-07T00:00:00Z,7,5,2020,159,6,Algeria,DZ,DZA,42228429,Africa,476,4997,56
2020-05-08T00:00:00Z,8,5,2020,185,7,Algeria,DZ,DZA,42228429,Africa,483,5182,57
2020-05-09T00:00:00Z,9,5,2020,187,5,Algeria,DZ,DZA,42228429,Africa,488,5369,58
2020-05-10T00:00:00Z,10,5,2020,189,6,Algeria,DZ,DZA,42228429,Africa,494,5558,59
2020-05-11T00:00:00Z,11,5,2020,165,8,Algeria,DZ,DZA,42228429,Africa,502,5723,60
2020-05-12T00:00:00Z,12,5,2020,168,5,Algeria,DZ,DZA,42228429,Africa,507,5891,61
2020-05-13T00:00:00Z,13,5,2020,176,8,Algeria,DZ,DZA,42228429,Africa,515,6067,62
2020-05-14T00:00:00Z,14,5,2020,186,7,Algeria,DZ,DZA,42228429,Africa,522,6253,63
2020-05-15T00:00:00Z,15,5,2020,189,7,Algeria,DZ,DZA,42228429,Africa,529,6442,64
2020-05-16T00:00:00Z,16,5,2020,187,7,Algeria,DZ,DZA,42228429,Africa,536,6629,65
2020-05-17T00:00:00Z,17,5,2020,192,6,Algeria,DZ,DZA,42228429,Africa,542,6821,66
2020-05-18T00:00:00Z,18,5,2020,198,6,Algeria,DZ,DZA,42228429,Africa,548,7019,67
2020-05-19T00:00:00Z,19,5,2020,182,7,Algeria,DZ,DZA,42228429,Africa,555,7201,68
2020-05-20T00:00:00Z,20,5,2020,176,6,Algeria,DZ,DZA,42228429,Africa,561,7377,69
2020-05-21T00:00:00Z,21,5,2020,165,7,Algeria,DZ,DZA,42228429,Africa,568,7542,70
2020-05-22T00:00:00Z,22,5,2020,186,7,Algeria,DZ,DZA,42228429,Africa,575,7728,71
2020-05-23T00:00:00Z,23,5,2020,190,7,Algeria,DZ,DZA,42228429,Africa,582,7918,72
2020-05-24T00:00:00Z,24,5,2020,195,10,Algeria,DZ,DZA,42228429,Africa,592,8113,73
2020-05-25T00:00:00Z,25,5,2020,193,8,Algeria,DZ,DZA,42228429,Africa,600,8306,74
2020-05-26T00:00:00Z,26,5,2020,197,9,Algeria,DZ,DZA,42228429,Africa,609,8503,75
2020-05-27T00:00:00Z,27,5,2020,194,8,Algeria,DZ,DZA,42228429,Africa,617,8697,76
2020-03-27T00:00:00Z,27,3,2020,36,3,Andorra,AD,AND,77006,Europe,3,224,1
2020-03-28T00:00:00Z,28,3,2020,43,0,Andorra,AD,AND,77006,Europe,3,267,2
2020-03-29T00:00:00Z,29,3,2020,41,1,Andorra,AD,AND,77006,Europe,4,308,3
2020-03-30T00:00:00Z,30,3,2020,26,2,Andorra,AD,AND,77006,Europe,6,334,4
2020-03-31T00:00:00Z,31,3,2020,36,2,Andorra,AD,AND,77006,Europe,8,370,5
2020-04-01T00:00:00Z,1,4,2020,6,4,Andorra,AD,AND,77006,Europe,12,376,6
2020-04-02T00:00:00Z,2,4,2020,14,2,Andorra,AD,AND,77006,Europe,14,390,7
2020-04-03T00:00:00Z,3,4,2020,38,1,Andorra,AD,AND,77006,Europe,15,428,8
2020-04-04T00:00:00Z,4,4,2020,11,1,Andorra,AD,AND,77006,Europe,16,439,9
2020-04-05T00:00:00Z,5,4,2020,27,1,Andorra,AD,AND,77006,Europe,17,466,10
2020-04-06T00:00:00Z,6,4,2020,35,1,Andorra,AD,AND,77006,Europe,18,501,11
2020-04-07T00:00:00Z,7,4,2020,25,3,Andorra,AD,AND,77006,Europe,21,526,12
2020-04-08T00:00:00Z,8,4,2020,19,1,Andorra,AD,AND,77006,Europe,22,545,13
2020-04-09T00:00:00Z,9,4,2020,19,1,Andorra,AD,AND,77006,Europe,23,564,14
2020-04-10T00:00:00Z,10,4,2020,19,2,Andorra,AD,AND,77006,Europe,25,583,15
2020-04-11T00:00:00Z,11,4,2020,18,1,Andorra,AD,AND,77006,Europe,26,601,16
2020-04-12T00:00:00Z,12,4,2020,21,2,Andorra,AD,AND,77006,Europe,28,622,17
2020-04-13T00:00:00Z,13,4,2020,16,1,Andorra,AD,AND,77006,Europe,29,638,18
2020-04-14T00:00:00Z,14,4,2020,8,0,Andorra,AD,AND,77006,Europe,29,646,19
2020-04-15T00:00:00Z,15,4,2020,13,2,Andorra,AD,AND,77006,Europe,31,659,20
2020-04-16T00:00:00Z,16,4,2020,14,2,Andorra,AD,AND,77006,Europe,33,673,21
2020-04-17T00:00:00Z,17,4,2020,9,0,Andorra,AD,AND,77006,Europe,33,682,22
2020-04-18T00:00:00Z,18,4,2020,14,2,Andorra,AD,AND,77006,Europe,35,696,23
2020-04-19T00:00:00Z,19,4,2020,8,0,Andorra,AD,AND,77006,Europe,35,704,24
2020-04-20T00:00:00Z,20,4,2020,9,1,Andorra,AD,AND,77006,Europe,36,713,25
2020-04-21T00:00:00Z,21,4,2020,4,0,Andorra,AD,AND,77006,Europe,36,717,26
2020-04-22T00:00:00Z,22,4,2020,0,1,Andorra,AD,AND,77006,Europe,37,717,27
2020-04-23T00:00:00Z,23,4,2020,6,0,Andorra,AD,AND,77006,Europe,37,723,28
2020-04-24T00:00:00Z,24,4,2020,1,0,Andorra,AD,AND,77006,Europe,37,724,29
2020-04-25T00:00:00Z,25,4,2020,7,3,Andorra,AD,AND,77006,Europe,40,731,30
2020-04-26T00:00:00Z,26,4,2020,2,0,Andorra,AD,AND,77006,Europe,40,733,31
2020-04-27T00:00:00Z,27,4,2020,7,0,Andorra,AD,AND,77006,Europe,40,740,32
2020-04-28T00:00:00Z,28,4,2020,3,0,Andorra,AD,AND,77006,Europe,40,743,33
2020-04-29T00:00:00Z,29,4,2020,0,1,Andorra,AD,AND,77006,Europe,41,743,34
2020-04-30T00:00:00Z,30,4,2020,0,1,Andorra,AD,AND,77006,Europe,42,743,35
2020-05-01T00:00:00Z,1,5,2020,2,0,Andorra,AD,AND,77006,Europe,42,745,36
2020-05-02T00:00:00Z,2,5,2020,1,1,Andorra,AD,AND,77006,Europe,43,746,37
2020-05-03T00:00:00Z,3,5,2020,1,1,Andorra,AD,AND,77006,Europe,44,747,38
2020-05-04T00:00:00Z,4,5,2020,1,1,Andorra,AD,AND,77006,Europe,45,748,39
2020-05-05T00:00:00Z,5,5,2020,2,0,Andorra,AD,AND,77006,Europe,45,750,40
2020-05-06T00:00:00Z,6,5,2020,1,1,Andorra,AD,AND,77006,Europe,46,751,41
2020-05-07T00:00:00Z,7,5,2020,0,0,Andorra,AD,AND,77006,Europe,46,751,42
2020-05-08T00:00:00Z,8,5,2020,1,1,Andorra,AD,AND,77006,Europe,47,752,43
2020-05-09T00:00:00Z,9,5,2020,0,0,Andorra,AD,AND,77006,Europe,47,752,44
2020-05-10T00:00:00Z,10,5,2020,2,1,Andorra,AD,AND,77006,Europe,48,754,45
2020-05-11T00:00:00Z,11,5,2020,1,0,Andorra,AD,AND,77006,Europe,48,755,46
2020-05-12T00:00:00Z,12,5,2020,1,0,Andorra,AD,AND,77006,Europe,48,756,47
2020-05-13T00:00:00Z,13,5,2020,2,0,Andorra,AD,AND,77006,Europe,48,758,48
2020-05-14T00:00:00Z,14,5,2020,2,1,Andorra,AD,AND,77006,Europe,49,760,49
2020-05-15T00:00:00Z,15,5,2020,1,0,Andorra,AD,AND,77006,Europe,49,761,50
2020-05-16T00:00:00Z,16,5,2020,0,0,Andorra,AD,AND,77006,Europe,49,761,51
2020-05-17T00:00:00Z,17,5,2020,0,2,Andorra,AD,AND,77006,Europe,51,761,52
2020-05-18T00:00:00Z,18,5,2020,0,0,Andorra,AD,AND,77006,Europe,51,761,53
2020-05-19T00:00:00Z,19,5,2020,0,0,Andorra,AD,AND,77006,Europe,51,761,54
2020-05-20T00:00:00Z,20,5,2020,0,0,Andorra,AD,AND,77006,Europe,51,761,55
2020-05-21T00:00:00Z,21,5,2020,1,0,Andorra,AD,AND,77006,Europe,51,762,56
2020-05-22T00:00:00Z,22,5,2020,0,0,Andorra,AD,AND,77006,Europe,51,762,57
2020-05-23T00:00:00Z,23,5,2020,0,0,Andorra,AD,AND,77006,Europe,51,762,58
2020-05-24T00:00:00Z,24,5,2020,0,0,Andorra,AD,AND,77006,Europe,51,762,59
2020-05-25T00:00:00Z,25,5,2020,1,0,Andorra,AD,AND,77006,Europe,51,763,60
2020-05-26T00:00:00Z,26,5,2020,0,0,Andorra,AD,AND,77006,Europe,51,763,61
2020-05-27T00:00:00Z,27,5,2020,0,0,Andorra,AD,AND,77006,Europe,51,763,62
2020-03-30T00:00:00Z,30,3,2020,3,2,Angola,AO,AGO,30809762,Africa,2,7,1
2020-03-31T00:00:00Z,31,3,2020,0,0,Angola,AO,AGO,30809762,Africa,2,7,2
2020-04-01T00:00:00Z,1,4,2020,0,0,Angola,AO,AGO,30809762,Africa,2,7,3
2020-04-02T00:00:00Z,2,4,2020,1,0,Angola,AO,AGO,30809762,Africa,2,8,4
2020-04-03T00:00:00Z,3,4,2020,0,0,Angola,AO,AGO,30809762,Africa,2,8,5
2020-04-04T00:00:00Z,4,4,2020,0,0,Angola,AO,AGO,30809762,Africa,2,8,6
2020-04-05T00:00:00Z,5,4,2020,2,0,Angola,AO,AGO,30809762,Africa,2,10,7
2020-04-06T00:00:00Z,6,4,2020,4,0,Angola,AO,AGO,30809762,Africa,2,14,8
2020-04-07T00:00:00Z,7,4,2020,2,0,Angola,AO,AGO,30809762,Africa,2,16,9
2020-04-08T00:00:00Z,8,4,2020,1,0,Angola,AO,AGO,30809762,Africa,2,17,10
2020-04-09T00:00:00Z,9,4,2020,2,0,Angola,AO,AGO,30809762,Africa,2,19,11
2020-04-10T00:00:00Z,10,4,2020,0,0,Angola,AO,AGO,30809762,Africa,2,19,12
2020-04-11T00:00:00Z,11,4,2020,0,0,Angola,AO,AGO,30809762,Africa,2,19,13
2020-04-12T00:00:00Z,12,4,2020,0,0,Angola,AO,AGO,30809762,Africa,2,19,14
2020-04-13T00:00:00Z,13,4,2020,0,0,Angola,AO,AGO,30809762,Africa,2,19,15
2020-04-14T00:00:00Z,14,4,2020,0,0,Angola,AO,AGO,30809762,Africa,2,19,16
2020-04-15T00:00:00Z,15,4,2020,0,0,Angola,AO,AGO,30809762,Africa,2,19,17
2020-04-16T00:00:00Z,16,4,2020,0,0,Angola,AO,AGO,30809762,Africa,2,19,18
2020-04-17T00:00:00Z,17,4,2020,0,0,Angola,AO,AGO,30809762,Africa,2,19,19
2020-04-18T00:00:00Z,18,4,2020,0,0,Angola,AO,AGO,30809762,Africa,2,19,20
2020-04-19T00:00:00Z,19,4,2020,5,0,Angola,AO,AGO,30809762,Africa,2,24,21
2020-04-20T00:00:00Z,20,4,2020,0,0,Angola,AO,AGO,30809762,Africa,2,24,22
2020-04-21T00:00:00Z,21,4,2020,0,0,Angola,AO,AGO,30809762,Africa,2,24,23
2020-04-22T00:00:00Z,22,4,2020,0,0,Angola,AO,AGO,30809762,Africa,2,24,24
2020-04-23T00:00:00Z,23,4,2020,0,0,Angola,AO,AGO,30809762,Africa,2,24,25
2020-04-24T00:00:00Z,24,4,2020,1,0,Angola,AO,AGO,30809762,Africa,2,25,26
2020-04-25T00:00:00Z,25,4,2020,0,0,Angola,AO,AGO,30809762,Africa,2,25,27
2020-04-26T00:00:00Z,26,4,2020,0,0,Angola,AO,AGO,30809762,Africa,2,25,28
2020-04-27T00:00:00Z,27,4,2020,1,0,Angola,AO,AGO,30809762,Africa,2,26,29
2020-04-28T00:00:00Z,28,4,2020,1,0,Angola,AO,AGO,30809762,Africa,2,27,30
2020-04-29T00:00:00Z,29,4,2020,0,0,Angola,AO,AGO,30809762,Africa,2,27,31
2020-04-30T00:00:00Z,30,4,2020,0,0,Angola,AO,AGO,30809762,Africa,2,27,32
2020-05-01T00:00:00Z,1,5,2020,0,0,Angola,AO,AGO,30809762,Africa,2,27,33
2020-05-02T00:00:00Z,2,5,2020,2,0,Angola,AO,AGO,30809762,Africa,2,29,34
2020-05-03T00:00:00Z,3,5,2020,6,0,Angola,AO,AGO,30809762,Africa,2,35,35
2020-05-04T00:00:00Z,4,5,2020,0,0,Angola,AO,AGO,30809762,Africa,2,35,36
2020-05-05T00:00:00Z,5,5,2020,0,0,Angola,AO,AGO,30809762,Africa,2,35,37
2020-05-06T00:00:00Z,6,5,2020,1,0,Angola,AO,AGO,30809762,Africa,2,36,38
2020-05-07T00:00:00Z,7,5,2020,0,0,Angola,AO,AGO,30809762,Africa,2,36,39
2020-05-08T00:00:00Z,8,5,2020,0,0,Angola,AO,AGO,30809762,Africa,2,36,40
2020-05-09T00:00:00Z,9,5,2020,7,0,Angola,AO,AGO,30809762,Africa,2,43,41
2020-05-10T00:00:00Z,10,5,2020,0,0,Angola,AO,AGO,30809762,Africa,2,43,42
2020-05-11T00:00:00Z,11,5,2020,2,0,Angola,AO,AGO,30809762,Africa,2,45,43
2020-05-12T00:00:00Z,12,5,2020,0,0,Angola,AO,AGO,30809762,Africa,2,45,44
2020-05-13T00:00:00Z,13,5,2020,0,0,Angola,AO,AGO,30809762,Africa,2,45,45
2020-05-14T00:00:00Z,14,5,2020,0,0,Angola,AO,AGO,30809762,Africa,2,45,46
2020-05-15T00:00:00Z,15,5,2020,3,0,Angola,AO,AGO,30809762,Africa,2,48,47
2020-05-16T00:00:00Z,16,5,2020,0,0,Angola,AO,AGO,30809762,Africa,2,48,48
2020-05-17T00:00:00Z,17,5,2020,0,0,Angola,AO,AGO,30809762,Africa,2,48,49
2020-05-18T00:00:00Z,18,5,2020,0,0,Angola,AO,AGO,30809762,Africa,2,48,50
2020-05-19T00:00:00Z,19,5,2020,0,0,Angola,AO,AGO,30809762,Africa,2,48,51
2020-05-20T00:00:00Z,20,5,2020,2,0,Angola,AO,AGO,30809762,Africa,2,50,52
2020-05-21T00:00:00Z,21,5,2020,2,1,Angola,AO,AGO,30809762,Africa,3,52,53
2020-05-22T00:00:00Z,22,5,2020,6,0,Angola,AO,AGO,30809762,Africa,3,58,54
2020-05-23T00:00:00Z,23,5,2020,2,0,Angola,AO,AGO,30809762,Africa,3,60,55
2020-05-24T00:00:00Z,24,5,2020,0,0,Angola,AO,AGO,30809762,Africa,3,60,56
2020-05-25T00:00:00Z,25,5,2020,9,1,Angola,AO,AGO,30809762,Africa,4,69,57
2020-05-26T00:00:00Z,26,5,2020,0,0,Angola,AO,AGO,30809762,Africa,4,69,58
2020-05-27T00:00:00Z,27,5,2020,2,0,Angola,AO,AGO,30809762,Africa,4,71,59
2020-04-10T00:00:00Z,10,4,2020,4,2,Antigua_and_Barbuda,AG,ATG,96286,America,2,19,1
2020-04-11T00:00:00Z,11,4,2020,2,0,Antigua_and_Barbuda,AG,ATG,96286,America,2,21,2
2020-04-12T00:00:00Z,12,4,2020,0,0,Antigua_and_Barbuda,AG,ATG,96286,America,2,21,3
2020-04-13T00:00:00Z,13,4,2020,0,0,Antigua_and_Barbuda,AG,ATG,96286,America,2,21,4
2020-04-14T00:00:00Z,14,4,2020,2,0,Antigua_and_Barbuda,AG,ATG,96286,America,2,23,5
2020-04-15T00:00:00Z,15,4,2020,0,0,Antigua_and_Barbuda,AG,ATG,96286,America,2,23,6
2020-04-16T00:00:00Z,16,4,2020,0,0,Antigua_and_Barbuda,AG,ATG,96286,America,2,23,7
2020-04-17T00:00:00Z,17,4,2020,0,0,Antigua_and_Barbuda,AG,ATG,96286,America,2,23,8
2020-04-18T00:00:00Z,18,4,2020,0,0,Antigua_and_Barbuda,AG,ATG,96286,America,2,23,9
2020-04-19T00:00:00Z,19,4,2020,0,0,Antigua_and_Barbuda,AG,ATG,96286,America,2,23,10
2020-04-20T00:00:00Z,20,4,2020,0,0,Antigua_and_Barbuda,AG,ATG,96286,America,2,23,11
2020-04-21T00:00:00Z,21,4,2020,0,1,Antigua_and_Barbuda,AG,ATG,96286,America,3,23,12
2020-04-22T00:00:00Z,22,4,2020,1,0,Antigua_and_Barbuda,AG,ATG,96286,America,3,24,13
2020-04-23T00:00:00Z,23,4,2020,0,0,Antigua_and_Barbuda,AG,ATG,96286,America,3,24,14
2020-04-24T00:00:00Z,24,4,2020,0,0,Antigua_and_Barbuda,AG,ATG,96286,America,3,24,15
2020-04-25T00:00:00Z,25,4,2020,0,0,Antigua_and_Barbuda,AG,ATG,96286,America,3,24,16
2020-04-26T00:00:00Z,26,4,2020,0,0,Antigua_and_Barbuda,AG,ATG,96286,America,3,24,17
2020-04-27T00:00:00Z,27,4,2020,0,0,Antigua_and_Barbuda,AG,ATG,96286,America,3,24,18
2020-04-28T00:00:00Z,28,4,2020,0,0,Antigua_and_Barbuda,AG,ATG,96286,America,3,24,19
2020-04-29T00:00:00Z,29,4,2020,0,0,Antigua_and_Barbuda,AG,ATG,96286,America,3,24,20
2020-04-30T00:00:00Z,30,4,2020,0,0,Antigua_and_Barbuda,AG,ATG,96286,America,3,24,21
2020-05-01T00:00:00Z,1,5,2020,0,0,Antigua_and_Barbuda,AG,ATG,96286,America,3,24,22
2020-05-02T00:00:00Z,2,5,2020,1,0,Antigua_and_Barbuda,AG,ATG,96286,America,3,25,23
2020-05-03T00:00:00Z,3,5,2020,0,0,Antigua_and_Barbuda,AG,ATG,96286,America,3,25,24
2020-05-04T00:00:00Z,4,5,2020,0,0,Antigua_and_Barbuda,AG,ATG,96286,America,3,25,25
2020-05-05T00:00:00Z,5,5,2020,0,0,Antigua_and_Barbuda,AG,ATG,96286,America,3,25,26
2020-05-06T00:00:00Z,6,5,2020,0,0,Antigua_and_Barbuda,AG,ATG,96286,America,3,25,27
2020-05-07T00:00:00Z,7,5,2020,0,0,Antigua_and_Barbuda,AG,ATG,96286,America,3,25,28
2020-05-08T00:00:00Z,8,5,2020,0,0,Antigua_and_Barbuda,AG,ATG,96286,America,3,25,29
2020-05-09T00:00:00Z,9,5,2020,0,0,Antigua_and_Barbuda,AG,ATG,96286,America,3,25,30
2020-05-10T00:00:00Z,10,5,2020,0,0,Antigua_and_Barbuda,AG,ATG,96286,America,3,25,31
2020-05-11T00:00:00Z,11,5,2020,0,0,Antigua_and_Barbuda,AG,ATG,96286,America,3,25,32
2020-05-12T00:00:00Z,12,5,2020,0,0,Antigua_and_Barbuda,AG,ATG,96286,America,3,25,33
2020-05-13T00:00:00Z,13,5,2020,0,0,Antigua_and_Barbuda,AG,ATG,96286,America,3,25,34
2020-05-14T00:00:00Z,14,5,2020,0,0,Antigua_and_Barbuda,AG,ATG,96286,America,3,25,35
2020-05-15T00:00:00Z,15,5,2020,0,0,Antigua_and_Barbuda,AG,ATG,96286,America,3,25,36
2020-05-16T00:00:00Z,16,5,2020,0,0,Antigua_and_Barbuda,AG,ATG,96286,America,3,25,37
2020-05-17T00:00:00Z,17,5,2020,0,0,Antigua_and_Barbuda,AG,ATG,96286,America,3,25,38
2020-05-18T00:00:00Z,18,5,2020,0,0,Antigua_and_Barbuda,AG,ATG,96286,America,3,25,39
2020-05-19T00:00:00Z,19,5,2020,0,0,Antigua_and_Barbuda,AG,ATG,96286,America,3,25,40
2020-05-20T00:00:00Z,20,5,2020,0,0,Antigua_and_Barbuda,AG,ATG,96286,America,3,25,41
2020-05-21T00:00:00Z,21,5,2020,0,0,Antigua_and_Barbuda,AG,ATG,96286,America,3,25,42
2020-05-22T00:00:00Z,22,5,2020,0,0,Antigua_and_Barbuda,AG,ATG,96286,America,3,25,43
2020-05-23T00:00:00Z,23,5,2020,0,0,Antigua_and_Barbuda,AG,ATG,96286,America,3,25,44
2020-05-24T00:00:00Z,24,5,2020,0,0,Antigua_and_Barbuda,AG,ATG,96286,America,3,25,45
2020-05-25T00:00:00Z,25,5,2020,0,0,Antigua_and_Barbuda,AG,ATG,96286,America,3,25,46
2020-05-26T00:00:00Z,26,5,2020,0,0,Antigua_and_Barbuda,AG,ATG,96286,America,3,25,47
2020-05-27T00:00:00Z,27,5,2020,0,0,Antigua_and_Barbuda,AG,ATG,96286,America,3,25,48
2020-03-08T00:00:00Z,8,3,2020,1,1,Argentina,AR,ARG,44494502,America,1,9,1
2020-03-09T00:00:00Z,9,3,2020,3,0,Argentina,AR,ARG,44494502,America,1,12,2
2020-03-11T00:00:00Z,11,3,2020,7,0,Argentina,AR,ARG,44494502,America,1,19,3
2020-03-13T00:00:00Z,13,3,2020,12,0,Argentina,AR,ARG,44494502,America,1,31,4
2020-03-14T00:00:00Z,14,3,2020,3,1,Argentina,AR,ARG,44494502,America,2,34,5
2020-03-15T00:00:00Z,15,3,2020,11,0,Argentina,AR,ARG,44494502,America,2,45,6
2020-03-16T00:00:00Z,16,3,2020,11,0,Argentina,AR,ARG,44494502,America,2,56,7
2020-03-17T00:00:00Z,17,3,2020,9,0,Argentina,AR,ARG,44494502,America,2,65,8
2020-03-18T00:00:00Z,18,3,2020,14,0,Argentina,AR,ARG,44494502,America,2,79,9
2020-03-19T00:00:00Z,19,3,2020,18,0,Argentina,AR,ARG,44494502,America,2,97,10
2020-03-20T00:00:00Z,20,3,2020,31,1,Argentina,AR,ARG,44494502,America,3,128,11
2020-03-21T00:00:00Z,21,3,2020,30,0,Argentina,AR,ARG,44494502,America,3,158,12
2020-03-22T00:00:00Z,22,3,2020,67,1,Argentina,AR,ARG,44494502,America,4,225,13
2020-03-23T00:00:00Z,23,3,2020,41,0,Argentina,AR,ARG,44494502,America,4,266,14
2020-03-24T00:00:00Z,24,3,2020,35,0,Argentina,AR,ARG,44494502,America,4,301,15
2020-03-25T00:00:00Z,25,3,2020,86,2,Argentina,AR,ARG,44494502,America,6,387,16
2020-03-26T00:00:00Z,26,3,2020,115,2,Argentina,AR,ARG,44494502,America,8,502,17
2020-03-27T00:00:00Z,27,3,2020,87,4,Argentina,AR,ARG,44494502,America,12,589,18
2020-03-28T00:00:00Z,28,3,2020,101,5,Argentina,AR,ARG,44494502,America,17,690,19
2020-03-29T00:00:00Z,29,3,2020,55,2,Argentina,AR,ARG,44494502,America,19,745,20
2020-03-30T00:00:00Z,30,3,2020,75,1,Argentina,AR,ARG,44494502,America,20,820,21
2020-03-31T00:00:00Z,31,3,2020,146,4,Argentina,AR,ARG,44494502,America,24,966,22
2020-04-01T00:00:00Z,1,4,2020,0,0,Argentina,AR,ARG,44494502,America,24,966,23
2020-04-02T00:00:00Z,2,4,2020,167,7,Argentina,AR,ARG,44494502,America,31,1133,24
2020-04-03T00:00:00Z,3,4,2020,0,3,Argentina,AR,ARG,44494502,America,34,1133,25
2020-04-04T00:00:00Z,4,4,2020,132,3,Argentina,AR,ARG,44494502,America,37,1265,26
2020-04-05T00:00:00Z,5,4,2020,186,6,Argentina,AR,ARG,44494502,America,43,1451,27
2020-04-06T00:00:00Z,6,4,2020,103,3,Argentina,AR,ARG,44494502,America,46,1554,28
2020-04-07T00:00:00Z,7,4,2020,74,7,Argentina,AR,ARG,44494502,America,53,1628,29
2020-04-08T00:00:00Z,8,4,2020,87,7,Argentina,AR,ARG,44494502,America,60,1715,30
2020-04-09T00:00:00Z,9,4,2020,80,5,Argentina,AR,ARG,44494502,America,65,1795,31
2020-04-10T00:00:00Z,10,4,2020,99,14,Argentina,AR,ARG,44494502,America,79,1894,32
2020-04-11T00:00:00Z,11,4,2020,81,3,Argentina,AR,ARG,44494502,America,82,1975,33
2020-04-12T00:00:00Z,12,4,2020,162,7,Argentina,AR,ARG,44494502,America,89,2137,34
2020-04-13T00:00:00Z,13,4,2020,66,6,Argentina,AR,ARG,44494502,America,95,2203,35
2020-04-14T00:00:00Z,14,4,2020,69,3,Argentina,AR,ARG,44494502,America,98,2272,36
2020-04-15T00:00:00Z,15,4,2020,160,7,Argentina,AR,ARG,44494502,America,105,2432,37
2020-04-16T00:00:00Z,16,4,2020,0,4,Argentina,AR,ARG,44494502,America,109,2432,38
2020-04-17T00:00:00Z,17,4,2020,128,6,Argentina,AR,ARG,44494502,America,115,2560,39
2020-04-18T00:00:00Z,18,4,2020,98,7,Argentina,AR,ARG,44494502,America,122,2658,40
2020-04-19T00:00:00Z,19,4,2020,170,10,Argentina,AR,ARG,44494502,America,132,2828,41
2020-04-20T00:00:00Z,20,4,2020,102,2,Argentina,AR,ARG,44494502,America,134,2930,42
2020-04-21T00:00:00Z,21,4,2020,90,8,Argentina,AR,ARG,44494502,America,142,3020,43
2020-04-22T00:00:00Z,22,4,2020,112,9,Argentina,AR,ARG,44494502,America,151,3132,44
2020-04-23T00:00:00Z,23,4,2020,144,8,Argentina,AR,ARG,44494502,America,159,3276,45
2020-04-24T00:00:00Z,24,4,2020,147,6,Argentina,AR,ARG,44494502,America,165,3423,46
2020-04-25T00:00:00Z,25,4,2020,0,2,Argentina,AR,ARG,44494502,America,167,3423,47
2020-04-26T00:00:00Z,26,4,2020,344,18,Argentina,AR,ARG,44494502,America,185,3767,48
2020-04-27T00:00:00Z,27,4,2020,0,1,Argentina,AR,ARG,44494502,America,186,3767,49
2020-04-28T00:00:00Z,28,4,2020,223,11,Argentina,AR,ARG,44494502,America,197,3990,50
2020-04-29T00:00:00Z,29,4,2020,124,10,Argentina,AR,ARG,44494502,America,207,4114,51
2020-04-30T00:00:00Z,30,4,2020,158,7,Argentina,AR,ARG,44494502,America,214,4272,52
2020-05-01T00:00:00Z,1,5,2020,143,4,Argentina,AR,ARG,44494502,America,218,4415,53
2020-05-02T00:00:00Z,2,5,2020,104,7,Argentina,AR,ARG,44494502,America,225,4519,54
2020-05-03T00:00:00Z,3,5,2020,149,12,Argentina,AR,ARG,44494502,America,237,4668,55
2020-05-04T00:00:00Z,4,5,2020,102,9,Argentina,AR,ARG,44494502,America,246,4770,56
2020-05-05T00:00:00Z,5,5,2020,104,14,Argentina,AR,ARG,44494502,America,260,4874,57
2020-05-06T00:00:00Z,6,5,2020,133,4,Argentina,AR,ARG,44494502,America,264,5007,58
2020-05-07T00:00:00Z,7,5,2020,188,9,Argentina,AR,ARG,44494502,America,273,5195,59
2020-05-08T00:00:00Z,8,5,2020,163,9,Argentina,AR,ARG,44494502,America,282,5358,60
2020-05-09T00:00:00Z,9,5,2020,240,11,Argentina,AR,ARG,44494502,America,293,5598,61
2020-05-10T00:00:00Z,10,5,2020,165,7,Argentina,AR,ARG,44494502,America,300,5763,62
2020-05-11T00:00:00Z,11,5,2020,13,0,Argentina,AR,ARG,44494502,America,300,5776,63
2020-05-12T00:00:00Z,12,5,2020,245,5,Argentina,AR,ARG,44494502,America,305,6021,64
2020-05-13T00:00:00Z,13,5,2020,529,14,Argentina,AR,ARG,44494502,America,319,6550,65
2020-05-14T00:00:00Z,14,5,2020,316,10,Argentina,AR,ARG,44494502,America,329,6866,66
2020-05-15T00:00:00Z,15,5,2020,255,24,Argentina,AR,ARG,44494502,America,353,7121,67
2020-05-16T00:00:00Z,16,5,2020,345,3,Argentina,AR,ARG,44494502,America,356,7466,68
2020-05-17T00:00:00Z,17,5,2020,326,7,Argentina,AR,ARG,44494502,America,363,7792,69
2020-05-18T00:00:00Z,18,5,2020,0,3,Argentina,AR,ARG,44494502,America,366,7792,70
2020-05-19T00:00:00Z,19,5,2020,566,16,Argentina,AR,ARG,44494502,America,382,8358,71
2020-05-20T00:00:00Z,20,5,2020,438,11,Argentina,AR,ARG,44494502,America,393,8796,72
2020-05-21T00:00:00Z,21,5,2020,474,10,Argentina,AR,ARG,44494502,America,403,9270,73
2020-05-22T00:00:00Z,22,5,2020,648,13,Argentina,AR,ARG,44494502,America,416,9918,74
2020-05-23T00:00:00Z,23,5,2020,718,17,Argentina,AR,ARG,44494502,America,433,10636,75
2020-05-24T00:00:00Z,24,5,2020,704,12,Argentina,AR,ARG,44494502,America,445,11340,76
2020-05-25T00:00:00Z,25,5,2020,723,7,Argentina,AR,ARG,44494502,America,452,12063,77
2020-05-26T00:00:00Z,26,5,2020,552,15,Argentina,AR,ARG,44494502,America,467,12615,78
2020-05-27T00:00:00Z,27,5,2020,600,17,Argentina,AR,ARG,44494502,America,484,13215,79
2020-03-27T00:00:00Z,27,3,2020,39,1,Armenia,AM,ARM,2951776,Europe,1,329,1
2020-03-28T00:00:00Z,28,3,2020,43,0,Armenia,AM,ARM,2951776,Europe,1,372,2
2020-03-29T00:00:00Z,29,3,2020,52,2,Armenia,AM,ARM,2951776,Europe,3,424,3
2020-03-30T00:00:00Z,30,3,2020,0,0,Armenia,AM,ARM,2951776,Europe,3,424,4
2020-03-31T00:00:00Z,31,3,2020,58,0,Armenia,AM,ARM,2951776,Europe,3,482,5
2020-04-01T00:00:00Z,1,4,2020,50,0,Armenia,AM,ARM,2951776,Europe,3,532,6
2020-04-02T00:00:00Z,2,4,2020,39,0,Armenia,AM,ARM,2951776,Europe,3,571,7
2020-04-03T00:00:00Z,3,4,2020,92,1,Armenia,AM,ARM,2951776,Europe,4,663,8
2020-04-04T00:00:00Z,4,4,2020,73,3,Armenia,AM,ARM,2951776,Europe,7,736,9
2020-04-05T00:00:00Z,5,4,2020,34,0,Armenia,AM,ARM,2951776,Europe,7,770,10
2020-04-06T00:00:00Z,6,4,2020,52,0,Armenia,AM,ARM,2951776,Europe,7,822,11
2020-04-07T00:00:00Z,7,4,2020,11,1,Armenia,AM,ARM,2951776,Europe,8,833,12
2020-04-08T00:00:00Z,8,4,2020,20,0,Armenia,AM,ARM,2951776,Europe,8,853,13
2020-04-09T00:00:00Z,9,4,2020,28,1,Armenia,AM,ARM,2951776,Europe,9,881,14
2020-04-10T00:00:00Z,10,4,2020,40,1,Armenia,AM,ARM,2951776,Europe,10,921,15
2020-04-11T00:00:00Z,11,4,2020,16,1,Armenia,AM,ARM,2951776,Europe,11,937,16
2020-04-12T00:00:00Z,12,4,2020,30,2,Armenia,AM,ARM,2951776,Europe,13,967,17
2020-04-13T00:00:00Z,13,4,2020,46,0,Armenia,AM,ARM,2951776,Europe,13,1013,18
2020-04-14T00:00:00Z,14,4,2020,26,1,Armenia,AM,ARM,2951776,Europe,14,1039,19
2020-04-15T00:00:00Z,15,4,2020,72,3,Armenia,AM,ARM,2951776,Europe,17,1111,20
2020-04-16T00:00:00Z,16,4,2020,48,1,Armenia,AM,ARM,2951776,Europe,18,1159,21
2020-04-17T00:00:00Z,17,4,2020,42,1,Armenia,AM,ARM,2951776,Europe,19,1201,22
2020-04-18T00:00:00Z,18,4,2020,47,1,Armenia,AM,ARM,2951776,Europe,20,1248,23
2020-04-19T00:00:00Z,19,4,2020,43,0,Armenia,AM,ARM,2951776,Europe,20,1291,24
2020-04-20T00:00:00Z,20,4,2020,48,2,Armenia,AM,ARM,2951776,Europe,22,1339,25
2020-04-21T00:00:00Z,21,4,2020,62,2,Armenia,AM,ARM,2951776,Europe,24,1401,26
2020-04-22T00:00:00Z,22,4,2020,72,0,Armenia,AM,ARM,2951776,Europe,24,1473,27
2020-04-23T00:00:00Z,23,4,2020,50,0,Armenia,AM,ARM,2951776,Europe,24,1523,28
2020-04-24T00:00:00Z,24,4,2020,73,3,Armenia,AM,ARM,2951776,Europe,27,1596,29
2020-04-25T00:00:00Z,25,4,2020,81,1,Armenia,AM,ARM,2951776,Europe,28,1677,30
2020-04-26T00:00:00Z,26,4,2020,69,0,Armenia,AM,ARM,2951776,Europe,28,1746,31
2020-04-27T00:00:00Z,27,4,2020,62,1,Armenia,AM,ARM,2951776,Europe,29,1808,32
2020-04-28T00:00:00Z,28,4,2020,59,1,Armenia,AM,ARM,2951776,Europe,30,1867,33
2020-04-29T00:00:00Z,29,4,2020,65,0,Armenia,AM,ARM,2951776,Europe,30,1932,34
2020-04-30T00:00:00Z,30,4,2020,0,0,Armenia,AM,ARM,2951776,Europe,30,1932,35
2020-05-01T00:00:00Z,1,5,2020,134,2,Armenia,AM,ARM,2951776,Europe,32,2066,36
2020-05-02T00:00:00Z,2,5,2020,82,1,Armenia,AM,ARM,2951776,Europe,33,2148,37
2020-05-03T00:00:00Z,3,5,2020,125,0,Armenia,AM,ARM,2951776,Europe,33,2273,38
2020-05-04T00:00:00Z,4,5,2020,113,2,Armenia,AM,ARM,2951776,Europe,35,2386,39
2020-05-05T00:00:00Z,5,5,2020,121,4,Armenia,AM,ARM,2951776,Europe,39,2507,40
2020-05-06T00:00:00Z,6,5,2020,112,1,Armenia,AM,ARM,2951776,Europe,40,2619,41
2020-05-07T00:00:00Z,7,5,2020,163,0,Armenia,AM,ARM,2951776,Europe,40,2782,42
2020-05-08T00:00:00Z,8,5,2020,102,2,Armenia,AM,ARM,2951776,Europe,42,2884,43
2020-05-09T00:00:00Z,9,5,2020,145,1,Armenia,AM,ARM,2951776,Europe,43,3029,44
2020-05-10T00:00:00Z,10,5,2020,146,1,Armenia,AM,ARM,2951776,Europe,44,3175,45
2020-05-11T00:00:00Z,11,5,2020,138,1,Armenia,AM,ARM,2951776,Europe,45,3313,46
2020-05-12T00:00:00Z,12,5,2020,79,1,Armenia,AM,ARM,2951776,Europe,46,3392,47
2020-05-13T00:00:00Z,13,5,2020,146,1,Armenia,AM,ARM,2951776,Europe,47,3538,48
2020-05-14T00:00:00Z,14,5,2020,180,1,Armenia,AM,ARM,2951776,Europe,48,3718,49
2020-05-15T00:00:00Z,15,5,2020,142,1,Armenia,AM,ARM,2951776,Europe,49,3860,50
2020-05-16T00:00:00Z,16,5,2020,184,3,Armenia,AM,ARM,2951776,Europe,52,4044,51
2020-05-17T00:00:00Z,17,5,2020,239,3,Armenia,AM,ARM,2951776,Europe,55,4283,52
2020-05-18T00:00:00Z,18,5,2020,189,5,Armenia,AM,ARM,2951776,Europe,60,4472,53
2020-05-19T00:00:00Z,19,5,2020,351,1,Armenia,AM,ARM,2951776,Europe,61,4823,54
2020-05-20T00:00:00Z,20,5,2020,218,3,Armenia,AM,ARM,2951776,Europe,64,5041,55
2020-05-21T00:00:00Z,21,5,2020,230,3,Armenia,AM,ARM,2951776,Europe,67,5271,56
2020-05-22T00:00:00Z,22,5,2020,335,3,Armenia,AM,ARM,2951776,Europe,70,5606,57
2020-05-23T00:00:00Z,23,5,2020,322,4,Armenia,AM,ARM,2951776,Europe,74,5928,58
2020-05-24T00:00:00Z,24,5,2020,374,3,Armenia,AM,ARM,2951776,Europe,77,6302,59
2020-05-25T00:00:00Z,25,5,2020,359,4,Armenia,AM,ARM,2951776,Europe,81,6661,60
2020-05-26T00:00:00Z,26,5,2020,452,6,Armenia,AM,ARM,2951776,Europe,87,7113,61
2020-05-27T00:00:00Z,27,5,2020,289,4,Armenia,AM,ARM,2951776,Europe,91,7402,62
2020-04-16T00:00:00Z,16,4,2020,1,1,Aruba,AW,ABW,105845,America,1,93,1
2020-04-17T00:00:00Z,17,4,2020,2,0,Aruba,AW,ABW,105845,America,1,95,2
2020-04-18T00:00:00Z,18,4,2020,1,1,Aruba,AW,ABW,105845,America,2,96,3
2020-04-19T00:00:00Z,19,4,2020,0,0,Aruba,AW,ABW,105845,America,2,96,4
2020-04-20T00:00:00Z,20,4,2020,1,0,Aruba,AW,ABW,105845,America,2,97,5
2020-04-21T00:00:00Z,21,4,2020,0,0,Aruba,AW,ABW,105845,America,2,97,6
2020-04-22T00:00:00Z,22,4,2020,0,0,Aruba,AW,ABW,105845,America,2,97,7
2020-04-23T00:00:00Z,23,4,2020,3,0,Aruba,AW,ABW,105845,America,2,100,8
2020-04-24T00:00:00Z,24,4,2020,0,0,Aruba,AW,ABW,105845,America,2,100,9
2020-04-25T00:00:00Z,25,4,2020,0,0,Aruba,AW,ABW,105845,America,2,100,10
2020-04-26T00:00:00Z,26,4,2020,0,0,Aruba,AW,ABW,105845,America,2,100,11
2020-04-27T00:00:00Z,27,4,2020,0,0,Aruba,AW,ABW,105845,America,2,100,12
2020-04-28T00:00:00Z,28,4,2020,0,0,Aruba,AW,ABW,105845,America,2,100,13
2020-04-29T00:00:00Z,29,4,2020,0,0,Aruba,AW,ABW,105845,America,2,100,14
2020-04-30T00:00:00Z,30,4,2020,0,0,Aruba,AW,ABW,105845,America,2,100,15
2020-05-01T00:00:00Z,1,5,2020,0,0,Aruba,AW,ABW,105845,America,2,100,16
2020-05-02T00:00:00Z,2,5,2020,0,0,Aruba,AW,ABW,105845,America,2,100,17
2020-05-03T00:00:00Z,3,5,2020,0,0,Aruba,AW,ABW,105845,America,2,100,18
2020-05-04T00:00:00Z,4,5,2020,0,0,Aruba,AW,ABW,105845,America,2,100,19
2020-05-05T00:00:00Z,5,5,2020,0,0,Aruba,AW,ABW,105845,America,2,100,20
2020-05-06T00:00:00Z,6,5,2020,0,0,Aruba,AW,ABW,105845,America,2,100,21
2020-05-07T00:00:00Z,7,5,2020,1,0,Aruba,AW,ABW,105845,America,2,101,22
2020-05-08T00:00:00Z,8,5,2020,0,1,Aruba,AW,ABW,105845,America,3,101,23
2020-05-09T00:00:00Z,9,5,2020,0,0,Aruba,AW,ABW,105845,America,3,101,24
2020-05-10T00:00:00Z,10,5,2020,0,0,Aruba,AW,ABW,105845,America,3,101,25
2020-05-11T00:00:00Z,11,5,2020,0,0,Aruba,AW,ABW,105845,America,3,101,26
2020-05-12T00:00:00Z,12,5,2020,0,0,Aruba,AW,ABW,105845,America,3,101,27
2020-05-13T00:00:00Z,13,5,2020,0,0,Aruba,AW,ABW,105845,America,3,101,28
2020-05-14T00:00:00Z,14,5,2020,0,0,Aruba,AW,ABW,105845,America,3,101,29
2020-05-15T00:00:00Z,15,5,2020,0,0,Aruba,AW,ABW,105845,America,3,101,30
2020-05-16T00:00:00Z,16,5,2020,0,0,Aruba,AW,ABW,105845,America,3,101,31
2020-05-17T00:00:00Z,17,5,2020,0,0,Aruba,AW,ABW,105845,America,3,101,32
2020-05-18T00:00:00Z,18,5,2020,0,0,Aruba,AW,ABW,105845,America,3,101,33
2020-05-19T00:00:00Z,19,5,2020,0,0,Aruba,AW,ABW,105845,America,3,101,34
2020-05-20T00:00:00Z,20,5,2020,0,0,Aruba,AW,ABW,105845,America,3,101,35
2020-05-21T00:00:00Z,21,5,2020,0,0,Aruba,AW,ABW,105845,America,3,101,36
2020-05-22T00:00:00Z,22,5,2020,0,0,Aruba,AW,ABW,105845,America,3,101,37
2020-05-23T00:00:00Z,23,5,2020,0,0,Aruba,AW,ABW,105845,America,3,101,38
2020-05-24T00:00:00Z,24,5,2020,0,0,Aruba,AW,ABW,105845,America,3,101,39
2020-05-25T00:00:00Z,25,5,2020,0,0,Aruba,AW,ABW,105845,America,3,101,40
2020-05-26T00:00:00Z,26,5,2020,0,0,Aruba,AW,ABW,105845,America,3,101,41
2020-05-27T00:00:00Z,27,5,2020,0,0,Aruba,AW,ABW,105845,America,3,101,42
2020-03-01T00:00:00Z,1,3,2020,1,1,Australia,AU,AUS,24992369,Oceania,1,26,1
2020-03-02T00:00:00Z,2,3,2020,3,0,Australia,AU,AUS,24992369,Oceania,1,29,2
2020-03-03T00:00:00Z,3,3,2020,4,0,Australia,AU,AUS,24992369,Oceania,1,33,3
2020-03-04T00:00:00Z,4,3,2020,8,0,Australia,AU,AUS,24992369,Oceania,1,41,4
2020-03-05T00:00:00Z,5,3,2020,11,1,Australia,AU,AUS,24992369,Oceania,2,52,5
2020-03-06T00:00:00Z,6,3,2020,7,0,Australia,AU,AUS,24992369,Oceania,2,59,6
2020-03-07T00:00:00Z,7,3,2020,4,0,Australia,AU,AUS,24992369,Oceania,2,63,7
2020-03-08T00:00:00Z,8,3,2020,11,1,Australia,AU,AUS,24992369,Oceania,3,74,8
2020-03-09T00:00:00Z,9,3,2020,6,0,Australia,AU,AUS,24992369,Oceania,3,80,9
2020-03-10T00:00:00Z,10,3,2020,20,0,Australia,AU,AUS,24992369,Oceania,3,100,10
2020-03-11T00:00:00Z,11,3,2020,12,0,Australia,AU,AUS,24992369,Oceania,3,112,11
2020-03-12T00:00:00Z,12,3,2020,14,0,Australia,AU,AUS,24992369,Oceania,3,126,12
2020-03-13T00:00:00Z,13,3,2020,30,0,Australia,AU,AUS,24992369,Oceania,3,156,13
2020-03-14T00:00:00Z,14,3,2020,41,0,Australia,AU,AUS,24992369,Oceania,3,197,14
2020-03-15T00:00:00Z,15,3,2020,52,0,Australia,AU,AUS,24992369,Oceania,3,249,15
2020-03-16T00:00:00Z,16,3,2020,49,2,Australia,AU,AUS,24992369,Oceania,5,298,16
2020-03-17T00:00:00Z,17,3,2020,77,0,Australia,AU,AUS,24992369,Oceania,5,375,17
2020-03-18T00:00:00Z,18,3,2020,79,0,Australia,AU,AUS,24992369,Oceania,5,454,18
2020-03-19T00:00:00Z,19,3,2020,111,1,Australia,AU,AUS,24992369,Oceania,6,565,19
2020-03-20T00:00:00Z,20,3,2020,144,0,Australia,AU,AUS,24992369,Oceania,6,709,20
2020-03-21T00:00:00Z,21,3,2020,165,1,Australia,AU,AUS,24992369,Oceania,7,874,21
2020-03-22T00:00:00Z,22,3,2020,224,0,Australia,AU,AUS,24992369,Oceania,7,1098,22
2020-03-23T00:00:00Z,23,3,2020,611,0,Australia,AU,AUS,24992369,Oceania,7,1709,23
2020-03-24T00:00:00Z,24,3,2020,114,0,Australia,AU,AUS,24992369,Oceania,7,1823,24
2020-03-25T00:00:00Z,25,3,2020,600,1,Australia,AU,AUS,24992369,Oceania,8,2423,25
2020-03-26T00:00:00Z,26,3,2020,376,3,Australia,AU,AUS,24992369,Oceania,11,2799,26
2020-03-27T00:00:00Z,27,3,2020,367,2,Australia,AU,AUS,24992369,Oceania,13,3166,27
2020-03-28T00:00:00Z,28,3,2020,212,0,Australia,AU,AUS,24992369,Oceania,13,3378,28
2020-03-29T00:00:00Z,29,3,2020,431,1,Australia,AU,AUS,24992369,Oceania,14,3809,29
2020-03-30T00:00:00Z,30,3,2020,284,2,Australia,AU,AUS,24992369,Oceania,16,4093,30
2020-03-31T00:00:00Z,31,3,2020,464,3,Australia,AU,AUS,24992369,Oceania,19,4557,31
2020-04-01T00:00:00Z,1,4,2020,150,1,Australia,AU,AUS,24992369,Oceania,20,4707,32
2020-04-02T00:00:00Z,2,4,2020,269,1,Australia,AU,AUS,24992369,Oceania,21,4976,33
2020-04-03T00:00:00Z,3,4,2020,248,2,Australia,AU,AUS,24992369,Oceania,23,5224,34
2020-04-04T00:00:00Z,4,4,2020,324,7,Australia,AU,AUS,24992369,Oceania,30,5548,35
2020-04-05T00:00:00Z,5,4,2020,139,4,Australia,AU,AUS,24992369,Oceania,34,5687,36
2020-04-06T00:00:00Z,6,4,2020,57,2,Australia,AU,AUS,24992369,Oceania,36,5744,37
2020-04-07T00:00:00Z,7,4,2020,100,6,Australia,AU,AUS,24992369,Oceania,42,5844,38
2020-04-08T00:00:00Z,8,4,2020,112,3,Australia,AU,AUS,24992369,Oceania,45,5956,39
2020-04-09T00:00:00Z,9,4,2020,96,5,Australia,AU,AUS,24992369,Oceania,50,6052,40
2020-04-10T00:00:00Z,10,4,2020,100,2,Australia,AU,AUS,24992369,Oceania,52,6152,41
2020-04-11T00:00:00Z,11,4,2020,86,2,Australia,AU,AUS,24992369,Oceania,54,6238,42
2020-04-12T00:00:00Z,12,4,2020,51,3,Australia,AU,AUS,24992369,Oceania,57,6289,43
2020-04-13T00:00:00Z,13,4,2020,33,4,Australia,AU,AUS,24992369,Oceania,61,6322,44
2020-04-14T00:00:00Z,14,4,2020,44,0,Australia,AU,AUS,24992369,Oceania,61,6366,45
2020-04-15T00:00:00Z,15,4,2020,50,0,Australia,AU,AUS,24992369,Oceania,61,6416,46
2020-04-16T00:00:00Z,16,4,2020,42,2,Australia,AU,AUS,24992369,Oceania,63,6458,47
2020-04-17T00:00:00Z,17,4,2020,39,0,Australia,AU,AUS,24992369,Oceania,63,6497,48
2020-04-18T00:00:00Z,18,4,2020,36,4,Australia,AU,AUS,24992369,Oceania,67,6533,49
2020-04-19T00:00:00Z,19,4,2020,53,2,Australia,AU,AUS,24992369,Oceania,69,6586,50
2020-04-20T00:00:00Z,20,4,2020,26,1,Australia,AU,AUS,24992369,Oceania,70,6612,51
2020-04-21T00:00:00Z,21,4,2020,13,1,Australia,AU,AUS,24992369,Oceania,71,6625,52
2020-04-22T00:00:00Z,22,4,2020,22,3,Australia,AU,AUS,24992369,Oceania,74,6647,53
2020-04-23T00:00:00Z,23,4,2020,7,0,Australia,AU,AUS,24992369,Oceania,74,6654,54
2020-04-24T00:00:00Z,24,4,2020,13,1,Australia,AU,AUS,24992369,Oceania,75,6667,55
2020-04-25T00:00:00Z,25,4,2020,20,4,Australia,AU,AUS,24992369,Oceania,79,6687,56
2020-04-26T00:00:00Z,26,4,2020,16,2,Australia,AU,AUS,24992369,Oceania,81,6703,57
2020-04-27T00:00:00Z,27,4,2020,10,2,Australia,AU,AUS,24992369,Oceania,83,6713,58
2020-04-28T00:00:00Z,28,4,2020,12,1,Australia,AU,AUS,24992369,Oceania,84,6725,59
2020-04-29T00:00:00Z,29,4,2020,13,4,Australia,AU,AUS,24992369,Oceania,88,6738,60
2020-04-30T00:00:00Z,30,4,2020,8,2,Australia,AU,AUS,24992369,Oceania,90,6746,61
2020-05-01T00:00:00Z,1,5,2020,16,2,Australia,AU,AUS,24992369,Oceania,92,6762,62
2020-05-02T00:00:00Z,2,5,2020,5,1,Australia,AU,AUS,24992369,Oceania,93,6767,63
2020-05-03T00:00:00Z,3,5,2020,16,0,Australia,AU,AUS,24992369,Oceania,93,6783,64
2020-05-04T00:00:00Z,4,5,2020,18,2,Australia,AU,AUS,24992369,Oceania,95,6801,65
2020-05-05T00:00:00Z,5,5,2020,24,0,Australia,AU,AUS,24992369,Oceania,95,6825,66
2020-05-06T00:00:00Z,6,5,2020,24,1,Australia,AU,AUS,24992369,Oceania,96,6849,67
2020-05-07T00:00:00Z,7,5,2020,26,1,Australia,AU,AUS,24992369,Oceania,97,6875,68
2020-05-08T00:00:00Z,8,5,2020,21,0,Australia,AU,AUS,24992369,Oceania,97,6896,69
2020-05-09T00:00:00Z,9,5,2020,18,0,Australia,AU,AUS,24992369,Oceania,97,6914,70
2020-05-10T00:00:00Z,10,5,2020,15,0,Australia,AU,AUS,24992369,Oceania,97,6929,71
2020-05-11T00:00:00Z,11,5,2020,12,0,Australia,AU,AUS,24992369,Oceania,97,6941,72
2020-05-12T00:00:00Z,12,5,2020,7,0,Australia,AU,AUS,24992369,Oceania,97,6948,73
2020-05-13T00:00:00Z,13,5,2020,16,0,Australia,AU,AUS,24992369,Oceania,97,6964,74
2020-05-14T00:00:00Z,14,5,2020,11,1,Australia,AU,AUS,24992369,Oceania,98,6975,75
2020-05-15T00:00:00Z,15,5,2020,14,0,Australia,AU,AUS,24992369,Oceania,98,6989,76
2020-05-16T00:00:00Z,16,5,2020,30,0,Australia,AU,AUS,24992369,Oceania,98,7019,77
2020-05-17T00:00:00Z,17,5,2020,17,0,Australia,AU,AUS,24992369,Oceania,98,7036,78
2020-05-18T00:00:00Z,18,5,2020,9,0,Australia,AU,AUS,24992369,Oceania,98,7045,79
2020-05-19T00:00:00Z,19,5,2020,15,1,Australia,AU,AUS,24992369,Oceania,99,7060,80
2020-05-20T00:00:00Z,20,5,2020,8,0,Australia,AU,AUS,24992369,Oceania,99,7068,81
2020-05-21T00:00:00Z,21,5,2020,11,1,Australia,AU,AUS,24992369,Oceania,100,7079,82
2020-05-22T00:00:00Z,22,5,2020,2,0,Australia,AU,AUS,24992369,Oceania,100,7081,83
2020-05-23T00:00:00Z,23,5,2020,14,1,Australia,AU,AUS,24992369,Oceania,101,7095,84
2020-05-24T00:00:00Z,24,5,2020,11,1,Australia,AU,AUS,24992369,Oceania,102,7106,85
2020-05-25T00:00:00Z,25,5,2020,3,0,Australia,AU,AUS,24992369,Oceania,102,7109,86
2020-05-26T00:00:00Z,26,5,2020,9,0,Australia,AU,AUS,24992369,Oceania,102,7118,87
2020-05-27T00:00:00Z,27,5,2020,15,0,Australia,AU,AUS,24992369,Oceania,102,7133,88
2020-03-13T00:00:00Z,13,3,2020,115,1,Austria,AT,AUT,8847037,Europe,1,361,1
2020-03-14T00:00:00Z,14,3,2020,143,0,Austria,AT,AUT,8847037,Europe,1,504,2
2020-03-15T00:00:00Z,15,3,2020,151,0,Austria,AT,AUT,8847037,Europe,1,655,3
2020-03-16T00:00:00Z,16,3,2020,205,0,Austria,AT,AUT,8847037,Europe,1,860,4
2020-03-17T00:00:00Z,17,3,2020,156,2,Austria,AT,AUT,8847037,Europe,3,1016,5
2020-03-18T00:00:00Z,18,3,2020,316,0,Austria,AT,AUT,8847037,Europe,3,1332,6
2020-03-19T00:00:00Z,19,3,2020,314,1,Austria,AT,AUT,8847037,Europe,4,1646,7
2020-03-20T00:00:00Z,20,3,2020,550,2,Austria,AT,AUT,8847037,Europe,6,2196,8
2020-03-21T00:00:00Z,21,3,2020,453,0,Austria,AT,AUT,8847037,Europe,6,2649,9
2020-03-22T00:00:00Z,22,3,2020,375,2,Austria,AT,AUT,8847037,Europe,8,3024,10
2020-03-23T00:00:00Z,23,3,2020,607,8,Austria,AT,AUT,8847037,Europe,16,3631,11
2020-03-24T00:00:00Z,24,3,2020,855,9,Austria,AT,AUT,8847037,Europe,25,4486,12
2020-03-25T00:00:00Z,25,3,2020,796,5,Austria,AT,AUT,8847037,Europe,30,5282,13
2020-03-26T00:00:00Z,26,3,2020,606,4,Austria,AT,AUT,8847037,Europe,34,5888,14
2020-03-27T00:00:00Z,27,3,2020,1141,18,Austria,AT,AUT,8847037,Europe,52,7029,15
2020-03-28T00:00:00Z,28,3,2020,668,16,Austria,AT,AUT,8847037,Europe,68,7697,16
2020-03-29T00:00:00Z,29,3,2020,594,0,Austria,AT,AUT,8847037,Europe,68,8291,17
2020-03-30T00:00:00Z,30,3,2020,522,18,Austria,AT,AUT,8847037,Europe,86,8813,18
2020-03-31T00:00:00Z,31,3,2020,805,22,Austria,AT,AUT,8847037,Europe,108,9618,19
2020-04-01T00:00:00Z,1,4,2020,564,20,Austria,AT,AUT,8847037,Europe,128,10182,20
2020-04-02T00:00:00Z,2,4,2020,529,18,Austria,AT,AUT,8847037,Europe,146,10711,21
2020-04-03T00:00:00Z,3,4,2020,418,12,Austria,AT,AUT,8847037,Europe,158,11129,22
2020-04-04T00:00:00Z,4,4,2020,396,10,Austria,AT,AUT,8847037,Europe,168,11525,23
2020-04-05T00:00:00Z,5,4,2020,241,18,Austria,AT,AUT,8847037,Europe,186,11766,24
2020-04-06T00:00:00Z,6,4,2020,217,18,Austria,AT,AUT,8847037,Europe,204,11983,25
2020-04-07T00:00:00Z,7,4,2020,314,16,Austria,AT,AUT,8847037,Europe,220,12297,26
2020-04-08T00:00:00Z,8,4,2020,343,23,Austria,AT,AUT,8847037,Europe,243,12640,27
2020-04-09T00:00:00Z,9,4,2020,329,30,Austria,AT,AUT,8847037,Europe,273,12969,28
2020-04-10T00:00:00Z,10,4,2020,279,22,Austria,AT,AUT,8847037,Europe,295,13248,29
2020-04-11T00:00:00Z,11,4,2020,312,24,Austria,AT,AUT,8847037,Europe,319,13560,30
2020-04-12T00:00:00Z,12,4,2020,247,18,Austria,AT,AUT,8847037,Europe,337,13807,31
2020-04-13T00:00:00Z,13,4,2020,130,13,Austria,AT,AUT,8847037,Europe,350,13937,32
2020-04-14T00:00:00Z,14,4,2020,106,18,Austria,AT,AUT,8847037,Europe,368,14043,33
2020-04-15T00:00:00Z,15,4,2020,191,16,Austria,AT,AUT,8847037,Europe,384,14234,34
2020-04-16T00:00:00Z,16,4,2020,136,9,Austria,AT,AUT,8847037,Europe,393,14370,35
2020-04-17T00:00:00Z,17,4,2020,78,17,Austria,AT,AUT,8847037,Europe,410,14448,36
2020-04-18T00:00:00Z,18,4,2020,155,21,Austria,AT,AUT,8847037,Europe,431,14603,37
2020-04-19T00:00:00Z,19,4,2020,59,12,Austria,AT,AUT,8847037,Europe,443,14662,38
2020-04-20T00:00:00Z,20,4,2020,48,9,Austria,AT,AUT,8847037,Europe,452,14710,39
2020-04-21T00:00:00Z,21,4,2020,73,10,Austria,AT,AUT,8847037,Europe,462,14783,40
2020-04-22T00:00:00Z,22,4,2020,50,1,Austria,AT,AUT,8847037,Europe,463,14833,41
2020-04-23T00:00:00Z,23,4,2020,91,31,Austria,AT,AUT,8847037,Europe,494,14924,42
2020-04-24T00:00:00Z,24,4,2020,61,14,Austria,AT,AUT,8847037,Europe,508,14985,43
2020-04-25T00:00:00Z,25,4,2020,83,5,Austria,AT,AUT,8847037,Europe,513,15068,44
2020-04-26T00:00:00Z,26,4,2020,66,23,Austria,AT,AUT,8847037,Europe,536,15134,45
2020-04-27T00:00:00Z,27,4,2020,55,6,Austria,AT,AUT,8847037,Europe,542,15189,46
2020-04-28T00:00:00Z,28,4,2020,67,7,Austria,AT,AUT,8847037,Europe,549,15256,47
2020-04-29T00:00:00Z,29,4,2020,58,20,Austria,AT,AUT,8847037,Europe,569,15314,48
2020-04-30T00:00:00Z,30,4,2020,50,11,Austria,AT,AUT,8847037,Europe,580,15364,49
2020-05-01T00:00:00Z,1,5,2020,60,4,Austria,AT,AUT,8847037,Europe,584,15424,50
2020-05-02T00:00:00Z,2,5,2020,34,5,Austria,AT,AUT,8847037,Europe,589,15458,51
2020-05-03T00:00:00Z,3,5,2020,12,7,Austria,AT,AUT,8847037,Europe,596,15470,52
2020-05-04T00:00:00Z,4,5,2020,68,2,Austria,AT,AUT,8847037,Europe,598,15538,53
2020-05-05T00:00:00Z,5,5,2020,31,2,Austria,AT,AUT,8847037,Europe,600,15569,54
2020-05-06T00:00:00Z,6,5,2020,17,6,Austria,AT,AUT,8847037,Europe,606,15586,55
2020-05-07T00:00:00Z,7,5,2020,65,2,Austria,AT,AUT,8847037,Europe,608,15651,56
2020-05-08T00:00:00Z,8,5,2020,22,1,Austria,AT,AUT,8847037,Europe,609,15673,57
2020-05-09T00:00:00Z,9,5,2020,62,5,Austria,AT,AUT,8847037,Europe,614,15735,58
2020-05-10T00:00:00Z,10,5,2020,42,1,Austria,AT,AUT,8847037,Europe,615,15777,59
2020-05-11T00:00:00Z,11,5,2020,10,3,Austria,AT,AUT,8847037,Europe,618,15787,60
2020-05-12T00:00:00Z,12,5,2020,87,2,Austria,AT,AUT,8847037,Europe,620,15874,61
2020-05-13T00:00:00Z,13,5,2020,36,3,Austria,AT,AUT,8847037,Europe,623,15910,62
2020-05-14T00:00:00Z,14,5,2020,54,1,Austria,AT,AUT,8847037,Europe,624,15964,63
2020-05-15T00:00:00Z,15,5,2020,41,2,Austria,AT,AUT,8847037,Europe,626,16005,64
2020-05-16T00:00:00Z,16,5,2020,63,2,Austria,AT,AUT,8847037,Europe,628,16068,65
2020-05-17T00:00:00Z,17,5,2020,72,0,Austria,AT,AUT,8847037,Europe,628,16140,66
2020-05-18T00:00:00Z,18,5,2020,14,1,Austria,AT,AUT,8847037,Europe,629,16154,67
2020-05-19T00:00:00Z,19,5,2020,25,0,Austria,AT,AUT,8847037,Europe,629,16179,68
2020-05-20T00:00:00Z,20,5,2020,78,3,Austria,AT,AUT,8847037,Europe,632,16257,69
2020-05-21T00:00:00Z,21,5,2020,18,1,Austria,AT,AUT,8847037,Europe,633,16275,70
2020-05-22T00:00:00Z,22,5,2020,57,0,Austria,AT,AUT,8847037,Europe,633,16332,71
2020-05-23T00:00:00Z,23,5,2020,29,2,Austria,AT,AUT,8847037,Europe,635,16361,72
2020-05-24T00:00:00Z,24,5,2020,46,4,Austria,AT,AUT,8847037,Europe,639,16407,73
2020-05-25T00:00:00Z,25,5,2020,32,1,Austria,AT,AUT,8847037,Europe,640,16439,74
2020-05-26T00:00:00Z,26,5,2020,20,1,Austria,AT,AUT,8847037,Europe,641,16459,75
2020-05-27T00:00:00Z,27,5,2020,38,2,Austria,AT,AUT,8847037,Europe,643,16497,76
2020-03-21T00:00:00Z,21,3,2020,0,1,Azerbaijan,AZ,AZE,9942334,Europe,1,44,1
2020-03-22T00:00:00Z,22,3,2020,9,0,Azerbaijan,AZ,AZE,9942334,Europe,1,53,2
2020-03-23T00:00:00Z,23,3,2020,12,0,Azerbaijan,AZ,AZE,9942334,Europe,1,65,3
2020-03-24T00:00:00Z,24,3,2020,7,0,Azerbaijan,AZ,AZE,9942334,Europe,1,72,4
2020-03-25T00:00:00Z,25,3,2020,15,0,Azerbaijan,AZ,AZE,9942334,Europe,1,87,5
2020-03-26T00:00:00Z,26,3,2020,6,1,Azerbaijan,AZ,AZE,9942334,Europe,2,93,6
2020-03-27T00:00:00Z,27,3,2020,29,1,Azerbaijan,AZ,AZE,9942334,Europe,3,122,7
2020-03-28T00:00:00Z,28,3,2020,43,0,Azerbaijan,AZ,AZE,9942334,Europe,3,165,8
2020-03-29T00:00:00Z,29,3,2020,17,1,Azerbaijan,AZ,AZE,9942334,Europe,4,182,9
2020-03-30T00:00:00Z,30,3,2020,27,0,Azerbaijan,AZ,AZE,9942334,Europe,4,209,10
2020-03-31T00:00:00Z,31,3,2020,64,0,Azerbaijan,AZ,AZE,9942334,Europe,4,273,11
2020-04-01T00:00:00Z,1,4,2020,25,1,Azerbaijan,AZ,AZE,9942334,Europe,5,298,12
2020-04-02T00:00:00Z,2,4,2020,61,0,Azerbaijan,AZ,AZE,9942334,Europe,5,359,13
2020-04-03T00:00:00Z,3,4,2020,41,0,Azerbaijan,AZ,AZE,9942334,Europe,5,400,14
2020-04-04T00:00:00Z,4,4,2020,43,0,Azerbaijan,AZ,AZE,9942334,Europe,5,443,15
2020-04-05T00:00:00Z,5,4,2020,78,0,Azerbaijan,AZ,AZE,9942334,Europe,5,521,16
2020-04-06T00:00:00Z,6,4,2020,63,2,Azerbaijan,AZ,AZE,9942334,Europe,7,584,17
2020-04-07T00:00:00Z,7,4,2020,57,0,Azerbaijan,AZ,AZE,9942334,Europe,7,641,18
2020-04-08T00:00:00Z,8,4,2020,76,1,Azerbaijan,AZ,AZE,9942334,Europe,8,717,19
2020-04-09T00:00:00Z,9,4,2020,105,0,Azerbaijan,AZ,AZE,9942334,Europe,8,822,20
2020-04-10T00:00:00Z,10,4,2020,104,1,Azerbaijan,AZ,AZE,9942334,Europe,9,926,21
2020-04-11T00:00:00Z,11,4,2020,65,1,Azerbaijan,AZ,AZE,9942334,Europe,10,991,22
2020-04-12T00:00:00Z,12,4,2020,67,1,Azerbaijan,AZ,AZE,9942334,Europe,11,1058,23
2020-04-13T00:00:00Z,13,4,2020,40,0,Azerbaijan,AZ,AZE,9942334,Europe,11,1098,24
2020-04-14T00:00:00Z,14,4,2020,50,1,Azerbaijan,AZ,AZE,9942334,Europe,12,1148,25
2020-04-15T00:00:00Z,15,4,2020,49,1,Azerbaijan,AZ,AZE,9942334,Europe,13,1197,26
2020-04-16T00:00:00Z,16,4,2020,56,0,Azerbaijan,AZ,AZE,9942334,Europe,13,1253,27
2020-04-17T00:00:00Z,17,4,2020,30,2,Azerbaijan,AZ,AZE,9942334,Europe,15,1283,28
2020-04-18T00:00:00Z,18,4,2020,57,0,Azerbaijan,AZ,AZE,9942334,Europe,15,1340,29
2020-04-19T00:00:00Z,19,4,2020,33,3,Azerbaijan,AZ,AZE,9942334,Europe,18,1373,30
2020-04-20T00:00:00Z,20,4,2020,25,1,Azerbaijan,AZ,AZE,9942334,Europe,19,1398,31
2020-04-21T00:00:00Z,21,4,2020,38,0,Azerbaijan,AZ,AZE,9942334,Europe,19,1436,32
2020-04-22T00:00:00Z,22,4,2020,44,1,Azerbaijan,AZ,AZE,9942334,Europe,20,1480,33
2020-04-23T00:00:00Z,23,4,2020,38,0,Azerbaijan,AZ,AZE,9942334,Europe,20,1518,34
2020-04-24T00:00:00Z,24,4,2020,30,0,Azerbaijan,AZ,AZE,9942334,Europe,20,1548,35
2020-04-25T00:00:00Z,25,4,2020,44,1,Azerbaijan,AZ,AZE,9942334,Europe,21,1592,36
2020-04-26T00:00:00Z,26,4,2020,25,0,Azerbaijan,AZ,AZE,9942334,Europe,21,1617,37
2020-04-27T00:00:00Z,27,4,2020,28,0,Azerbaijan,AZ,AZE,9942334,Europe,21,1645,38
2020-04-28T00:00:00Z,28,4,2020,33,1,Azerbaijan,AZ,AZE,9942334,Europe,22,1678,39
2020-04-29T00:00:00Z,29,4,2020,39,0,Azerbaijan,AZ,AZE,9942334,Europe,22,1717,40
2020-04-30T00:00:00Z,30,4,2020,49,1,Azerbaijan,AZ,AZE,9942334,Europe,23,1766,41
2020-05-01T00:00:00Z,1,5,2020,38,1,Azerbaijan,AZ,AZE,9942334,Europe,24,1804,42
2020-05-02T00:00:00Z,2,5,2020,50,1,Azerbaijan,AZ,AZE,9942334,Europe,25,1854,43
2020-05-03T00:00:00Z,3,5,2020,40,0,Azerbaijan,AZ,AZE,9942334,Europe,25,1894,44
2020-05-04T00:00:00Z,4,5,2020,38,0,Azerbaijan,AZ,AZE,9942334,Europe,25,1932,45
2020-05-05T00:00:00Z,5,5,2020,52,1,Azerbaijan,AZ,AZE,9942334,Europe,26,1984,46
2020-05-06T00:00:00Z,6,5,2020,76,0,Azerbaijan,AZ,AZE,9942334,Europe,26,2060,47
2020-05-07T00:00:00Z,7,5,2020,67,2,Azerbaijan,AZ,AZE,9942334,Europe,28,2127,48
2020-05-08T00:00:00Z,8,5,2020,77,0,Azerbaijan,AZ,AZE,9942334,Europe,28,2204,49
2020-05-09T00:00:00Z,9,5,2020,75,0,Azerbaijan,AZ,AZE,9942334,Europe,28,2279,50
2020-05-10T00:00:00Z,10,5,2020,143,3,Azerbaijan,AZ,AZE,9942334,Europe,31,2422,51
2020-05-11T00:00:00Z,11,5,2020,97,1,Azerbaijan,AZ,AZE,9942334,Europe,32,2519,52
2020-05-12T00:00:00Z,12,5,2020,70,0,Azerbaijan,AZ,AZE,9942334,Europe,32,2589,53
2020-05-13T00:00:00Z,13,5,2020,104,1,Azerbaijan,AZ,AZE,9942334,Europe,33,2693,54
2020-05-14T00:00:00Z,14,5,2020,65,2,Azerbaijan,AZ,AZE,9942334,Europe,35,2758,55
2020-05-15T00:00:00Z,15,5,2020,121,0,Azerbaijan,AZ,AZE,9942334,Europe,35,2879,56
2020-05-16T00:00:00Z,16,5,2020,101,1,Azerbaijan,AZ,AZE,9942334,Europe,36,2980,57
2020-05-17T00:00:00Z,17,5,2020,158,0,Azerbaijan,AZ,AZE,9942334,Europe,36,3138,58
2020-05-18T00:00:00Z,18,5,2020,136,3,Azerbaijan,AZ,AZE,9942334,Europe,39,3274,59
2020-05-19T00:00:00Z,19,5,2020,13,1,Azerbaijan,AZ,AZE,9942334,Europe,40,3287,60
2020-05-20T00:00:00Z,20,5,2020,231,1,Azerbaijan,AZ,AZE,9942334,Europe,41,3518,61
2020-05-21T00:00:00Z,21,5,2020,113,2,Azerbaijan,AZ,AZE,9942334,Europe,43,3631,62
2020-05-22T00:00:00Z,22,5,2020,118,1,Azerbaijan,AZ,AZE,9942334,Europe,44,3749,63
2020-05-23T00:00:00Z,23,5,2020,106,2,Azerbaijan,AZ,AZE,9942334,Europe,46,3855,64
2020-05-24T00:00:00Z,24,5,2020,127,3,Azerbaijan,AZ,AZE,9942334,Europe,49,3982,65
2020-05-25T00:00:00Z,25,5,2020,140,0,Azerbaijan,AZ,AZE,9942334,Europe,49,4122,66
2020-05-26T00:00:00Z,26,5,2020,149,2,Azerbaijan,AZ,AZE,9942334,Europe,51,4271,67
2020-05-27T00:00:00Z,27,5,2020,132,1,Azerbaijan,AZ,AZE,9942334,Europe,52,4403,68
2020-04-02T00:00:00Z,2,4,2020,6,1,Bahamas,BS,BHS,385640,America,1,21,1
2020-04-03T00:00:00Z,3,4,2020,3,0,Bahamas,BS,BHS,385640,America,1,24,2
2020-04-04T00:00:00Z,4,4,2020,0,2,Bahamas,BS,BHS,385640,America,3,24,3
2020-04-05T00:00:00Z,5,4,2020,4,1,Bahamas,BS,BHS,385640,America,4,28,4
2020-04-06T00:00:00Z,6,4,2020,1,1,Bahamas,BS,BHS,385640,America,5,29,5
2020-04-07T00:00:00Z,7,4,2020,4,0,Bahamas,BS,BHS,385640,America,5,33,6
2020-04-08T00:00:00Z,8,4,2020,3,1,Bahamas,BS,BHS,385640,America,6,36,7
2020-04-09T00:00:00Z,9,4,2020,4,1,Bahamas,BS,BHS,385640,America,7,40,8
2020-04-10T00:00:00Z,10,4,2020,1,1,Bahamas,BS,BHS,385640,America,8,41,9
2020-04-11T00:00:00Z,11,4,2020,1,0,Bahamas,BS,BHS,385640,America,8,42,10
2020-04-12T00:00:00Z,12,4,2020,4,0,Bahamas,BS,BHS,385640,America,8,46,11
2020-04-13T00:00:00Z,13,4,2020,1,0,Bahamas,BS,BHS,385640,America,8,47,12
2020-04-14T00:00:00Z,14,4,2020,2,0,Bahamas,BS,BHS,385640,America,8,49,13
2020-04-15T00:00:00Z,15,4,2020,0,0,Bahamas,BS,BHS,385640,America,8,49,14
2020-04-16T00:00:00Z,16,4,2020,4,0,Bahamas,BS,BHS,385640,America,8,53,15
2020-04-17T00:00:00Z,17,4,2020,1,1,Bahamas,BS,BHS,385640,America,9,54,16
2020-04-18T00:00:00Z,18,4,2020,1,0,Bahamas,BS,BHS,385640,America,9,55,17
2020-04-19T00:00:00Z,19,4,2020,3,0,Bahamas,BS,BHS,385640,America,9,58,18
2020-04-20T00:00:00Z,20,4,2020,2,0,Bahamas,BS,BHS,385640,America,9,60,19
2020-04-21T00:00:00Z,21,4,2020,4,0,Bahamas,BS,BHS,385640,America,9,64,20
2020-04-22T00:00:00Z,22,4,2020,1,0,Bahamas,BS,BHS,385640,America,9,65,21
2020-04-23T00:00:00Z,23,4,2020,5,0,Bahamas,BS,BHS,385640,America,9,70,22
2020-04-24T00:00:00Z,24,4,2020,2,2,Bahamas,BS,BHS,385640,America,11,72,23
2020-04-25T00:00:00Z,25,4,2020,1,0,Bahamas,BS,BHS,385640,America,11,73,24
2020-04-26T00:00:00Z,26,4,2020,5,0,Bahamas,BS,BHS,385640,America,11,78,25
2020-04-27T00:00:00Z,27,4,2020,2,0,Bahamas,BS,BHS,385640,America,11,80,26
2020-04-28T00:00:00Z,28,4,2020,0,0,Bahamas,BS,BHS,385640,America,11,80,27
2020-04-29T00:00:00Z,29,4,2020,0,0,Bahamas,BS,BHS,385640,America,11,80,28
2020-04-30T00:00:00Z,30,4,2020,0,0,Bahamas,BS,BHS,385640,America,11,80,29
2020-05-01T00:00:00Z,1,5,2020,1,0,Bahamas,BS,BHS,385640,America,11,81,30
2020-05-02T00:00:00Z,2,5,2020,1,0,Bahamas,BS,BHS,385640,America,11,82,31
2020-05-03T00:00:00Z,3,5,2020,1,0,Bahamas,BS,BHS,385640,America,11,83,32
2020-05-04T00:00:00Z,4,5,2020,0,0,Bahamas,BS,BHS,385640,America,11,83,33
2020-05-05T00:00:00Z,5,5,2020,0,0,Bahamas,BS,BHS,385640,America,11,83,34
2020-05-06T00:00:00Z,6,5,2020,6,0,Bahamas,BS,BHS,385640,America,11,89,35
2020-05-07T00:00:00Z,7,5,2020,3,0,Bahamas,BS,BHS,385640,America,11,92,36
2020-05-08T00:00:00Z,8,5,2020,0,0,Bahamas,BS,BHS,385640,America,11,92,37
2020-05-09T00:00:00Z,9,5,2020,0,0,Bahamas,BS,BHS,385640,America,11,92,38
2020-05-10T00:00:00Z,10,5,2020,0,0,Bahamas,BS,BHS,385640,America,11,92,39
2020-05-11T00:00:00Z,11,5,2020,0,0,Bahamas,BS,BHS,385640,America,11,92,40
2020-05-12T00:00:00Z,12,5,2020,1,0,Bahamas,BS,BHS,385640,America,11,93,41
2020-05-13T00:00:00Z,13,5,2020,0,0,Bahamas,BS,BHS,385640,America,11,93,42
2020-05-14T00:00:00Z,14,5,2020,1,0,Bahamas,BS,BHS,385640,America,11,94,43
2020-05-15T00:00:00Z,15,5,2020,2,0,Bahamas,BS,BHS,385640,America,11,96,44
2020-05-16T00:00:00Z,16,5,2020,0,0,Bahamas,BS,BHS,385640,America,11,96,45
2020-05-17T00:00:00Z,17,5,2020,0,0,Bahamas,BS,BHS,385640,America,11,96,46
2020-05-18T00:00:00Z,18,5,2020,0,0,Bahamas,BS,BHS,385640,America,11,96,47
2020-05-19T00:00:00Z,19,5,2020,0,0,Bahamas,BS,BHS,385640,America,11,96,48
2020-05-20T00:00:00Z,20,5,2020,0,0,Bahamas,BS,BHS,385640,America,11,96,49
2020-05-21T00:00:00Z,21,5,2020,1,0,Bahamas,BS,BHS,385640,America,11,97,50
2020-05-22T00:00:00Z,22,5,2020,0,0,Bahamas,BS,BHS,385640,America,11,97,51
2020-05-23T00:00:00Z,23,5,2020,0,0,Bahamas,BS,BHS,385640,America,11,97,52
2020-05-24T00:00:00Z,24,5,2020,3,0,Bahamas,BS,BHS,385640,America,11,100,53
2020-05-25T00:00:00Z,25,5,2020,0,0,Bahamas,BS,BHS,385640,America,11,100,54
2020-05-26T00:00:00Z,26,5,2020,0,0,Bahamas,BS,BHS,385640,America,11,100,55
2020-05-27T00:00:00Z,27,5,2020,0,0,Bahamas,BS,BHS,385640,America,11,100,56
2020-03-17T00:00:00Z,17,3,2020,7,1,Bahrain,BH,BHR,1569439,Asia,1,221,1
2020-03-18T00:00:00Z,18,3,2020,16,0,Bahrain,BH,BHR,1569439,Asia,1,237,2
2020-03-19T00:00:00Z,19,3,2020,19,0,Bahrain,BH,BHR,1569439,Asia,1,256,3
2020-03-20T00:00:00Z,20,3,2020,13,0,Bahrain,BH,BHR,1569439,Asia,1,269,4
2020-03-21T00:00:00Z,21,3,2020,16,0,Bahrain,BH,BHR,1569439,Asia,1,285,5
2020-03-22T00:00:00Z,22,3,2020,21,0,Bahrain,BH,BHR,1569439,Asia,1,306,6
2020-03-23T00:00:00Z,23,3,2020,28,1,Bahrain,BH,BHR,1569439,Asia,2,334,7
2020-03-24T00:00:00Z,24,3,2020,5,0,Bahrain,BH,BHR,1569439,Asia,2,339,8
2020-03-25T00:00:00Z,25,3,2020,51,1,Bahrain,BH,BHR,1569439,Asia,3,390,9
2020-03-26T00:00:00Z,26,3,2020,29,0,Bahrain,BH,BHR,1569439,Asia,3,419,10
2020-03-27T00:00:00Z,27,3,2020,39,1,Bahrain,BH,BHR,1569439,Asia,4,458,11
2020-03-28T00:00:00Z,28,3,2020,8,0,Bahrain,BH,BHR,1569439,Asia,4,466,12
2020-03-29T00:00:00Z,29,3,2020,7,0,Bahrain,BH,BHR,1569439,Asia,4,473,13
2020-03-30T00:00:00Z,30,3,2020,27,0,Bahrain,BH,BHR,1569439,Asia,4,500,14
2020-03-31T00:00:00Z,31,3,2020,15,0,Bahrain,BH,BHR,1569439,Asia,4,515,15
2020-04-01T00:00:00Z,1,4,2020,52,0,Bahrain,BH,BHR,1569439,Asia,4,567,16
2020-04-02T00:00:00Z,2,4,2020,2,0,Bahrain,BH,BHR,1569439,Asia,4,569,17
2020-04-03T00:00:00Z,3,4,2020,74,0,Bahrain,BH,BHR,1569439,Asia,4,643,18
2020-04-04T00:00:00Z,4,4,2020,0,0,Bahrain,BH,BHR,1569439,Asia,4,643,19
2020-04-05T00:00:00Z,5,4,2020,45,0,Bahrain,BH,BHR,1569439,Asia,4,688,20
2020-04-06T00:00:00Z,6,4,2020,12,0,Bahrain,BH,BHR,1569439,Asia,4,700,21
2020-04-07T00:00:00Z,7,4,2020,56,0,Bahrain,BH,BHR,1569439,Asia,4,756,22
2020-04-08T00:00:00Z,8,4,2020,55,1,Bahrain,BH,BHR,1569439,Asia,5,811,23
2020-04-09T00:00:00Z,9,4,2020,12,0,Bahrain,BH,BHR,1569439,Asia,5,823,24
2020-04-10T00:00:00Z,10,4,2020,64,0,Bahrain,BH,BHR,1569439,Asia,5,887,25
2020-04-11T00:00:00Z,11,4,2020,111,1,Bahrain,BH,BHR,1569439,Asia,6,998,26
2020-04-12T00:00:00Z,12,4,2020,42,0,Bahrain,BH,BHR,1569439,Asia,6,1040,27
2020-04-13T00:00:00Z,13,4,2020,96,0,Bahrain,BH,BHR,1569439,Asia,6,1136,28
2020-04-14T00:00:00Z,14,4,2020,225,1,Bahrain,BH,BHR,1569439,Asia,7,1361,29
2020-04-15T00:00:00Z,15,4,2020,167,0,Bahrain,BH,BHR,1569439,Asia,7,1528,30
2020-04-16T00:00:00Z,16,4,2020,145,0,Bahrain,BH,BHR,1569439,Asia,7,1673,31
2020-04-17T00:00:00Z,17,4,2020,27,0,Bahrain,BH,BHR,1569439,Asia,7,1700,32
2020-04-18T00:00:00Z,18,4,2020,44,0,Bahrain,BH,BHR,1569439,Asia,7,1744,33
2020-04-19T00:00:00Z,19,4,2020,29,0,Bahrain,BH,BHR,1569439,Asia,7,1773,34
2020-04-20T00:00:00Z,20,4,2020,100,0,Bahrain,BH,BHR,1569439,Asia,7,1873,35
2020-04-21T00:00:00Z,21,4,2020,34,0,Bahrain,BH,BHR,1569439,Asia,7,1907,36
2020-04-22T00:00:00Z,22,4,2020,66,0,Bahrain,BH,BHR,1569439,Asia,7,1973,37
2020-04-23T00:00:00Z,23,4,2020,34,0,Bahrain,BH,BHR,1569439,Asia,7,2007,38
2020-04-24T00:00:00Z,24,4,2020,210,1,Bahrain,BH,BHR,1569439,Asia,8,2217,39
2020-04-25T00:00:00Z,25,4,2020,301,0,Bahrain,BH,BHR,1569439,Asia,8,2518,40
2020-04-26T00:00:00Z,26,4,2020,71,0,Bahrain,BH,BHR,1569439,Asia,8,2589,41
2020-04-27T00:00:00Z,27,4,2020,58,0,Bahrain,BH,BHR,1569439,Asia,8,2647,42
2020-04-28T00:00:00Z,28,4,2020,76,0,Bahrain,BH,BHR,1569439,Asia,8,2723,43
2020-04-29T00:00:00Z,29,4,2020,88,0,Bahrain,BH,BHR,1569439,Asia,8,2811,44
2020-04-30T00:00:00Z,30,4,2020,110,0,Bahrain,BH,BHR,1569439,Asia,8,2921,45
2020-05-01T00:00:00Z,1,5,2020,119,0,Bahrain,BH,BHR,1569439,Asia,8,3040,46
2020-05-02T00:00:00Z,2,5,2020,130,0,Bahrain,BH,BHR,1569439,Asia,8,3170,47
2020-05-03T00:00:00Z,3,5,2020,114,0,Bahrain,BH,BHR,1569439,Asia,8,3284,48
2020-05-04T00:00:00Z,4,5,2020,99,0,Bahrain,BH,BHR,1569439,Asia,8,3383,49
2020-05-05T00:00:00Z,5,5,2020,150,0,Bahrain,BH,BHR,1569439,Asia,8,3533,50
2020-05-06T00:00:00Z,6,5,2020,187,0,Bahrain,BH,BHR,1569439,Asia,8,3720,51
2020-05-07T00:00:00Z,7,5,2020,214,0,Bahrain,BH,BHR,1569439,Asia,8,3934,52
2020-05-08T00:00:00Z,8,5,2020,265,0,Bahrain,BH,BHR,1569439,Asia,8,4199,53
2020-05-09T00:00:00Z,9,5,2020,245,0,Bahrain,BH,BHR,1569439,Asia,8,4444,54
2020-05-10T00:00:00Z,10,5,2020,330,0,Bahrain,BH,BHR,1569439,Asia,8,4774,55
2020-05-11T00:00:00Z,11,5,2020,167,0,Bahrain,BH,BHR,1569439,Asia,8,4941,56
2020-05-12T00:00:00Z,12,5,2020,295,0,Bahrain,BH,BHR,1569439,Asia,8,5236,57
2020-05-13T00:00:00Z,13,5,2020,295,1,Bahrain,BH,BHR,1569439,Asia,9,5531,58
2020-05-14T00:00:00Z,14,5,2020,285,1,Bahrain,BH,BHR,1569439,Asia,10,5816,59
2020-05-15T00:00:00Z,15,5,2020,382,0,Bahrain,BH,BHR,1569439,Asia,10,6198,60
2020-05-16T00:00:00Z,16,5,2020,385,2,Bahrain,BH,BHR,1569439,Asia,12,6583,61
2020-05-17T00:00:00Z,17,5,2020,164,0,Bahrain,BH,BHR,1569439,Asia,12,6747,62
2020-05-18T00:00:00Z,18,5,2020,209,0,Bahrain,BH,BHR,1569439,Asia,12,6956,63
2020-05-19T00:00:00Z,19,5,2020,228,0,Bahrain,BH,BHR,1569439,Asia,12,7184,64
2020-05-20T00:00:00Z,20,5,2020,348,0,Bahrain,BH,BHR,1569439,Asia,12,7532,65
2020-05-21T00:00:00Z,21,5,2020,356,0,Bahrain,BH,BHR,1569439,Asia,12,7888,66
2020-05-22T00:00:00Z,22,5,2020,286,0,Bahrain,BH,BHR,1569439,Asia,12,8174,67
2020-05-23T00:00:00Z,23,5,2020,240,0,Bahrain,BH,BHR,1569439,Asia,12,8414,68
2020-05-24T00:00:00Z,24,5,2020,388,1,Bahrain,BH,BHR,1569439,Asia,13,8802,69
2020-05-25T00:00:00Z,25,5,2020,336,1,Bahrain,BH,BHR,1569439,Asia,14,9138,70
2020-05-26T00:00:00Z,26,5,2020,33,0,Bahrain,BH,BHR,1569439,Asia,14,9171,71
2020-05-27T00:00:00Z,27,5,2020,195,0,Bahrain,BH,BHR,1569439,Asia,14,9366,72
2020-03-22T00:00:00Z,22,3,2020,7,2,Bangladesh,BD,BGD,161356039,Asia,2,24,1
2020-03-23T00:00:00Z,23,3,2020,3,1,Bangladesh,BD,BGD,161356039,Asia,3,27,2
2020-03-24T00:00:00Z,24,3,2020,6,0,Bangladesh,BD,BGD,161356039,Asia,3,33,3
2020-03-25T00:00:00Z,25,3,2020,6,1,Bangladesh,BD,BGD,161356039,Asia,4,39,4
2020-03-26T00:00:00Z,26,3,2020,0,1,Bangladesh,BD,BGD,161356039,Asia,5,39,5
2020-03-27T00:00:00Z,27,3,2020,9,0,Bangladesh,BD,BGD,161356039,Asia,5,48,6
2020-03-28T00:00:00Z,28,3,2020,0,0,Bangladesh,BD,BGD,161356039,Asia,5,48,7
2020-03-29T00:00:00Z,29,3,2020,0,0,Bangladesh,BD,BGD,161356039,Asia,5,48,8
2020-03-30T00:00:00Z,30,3,2020,1,0,Bangladesh,BD,BGD,161356039,Asia,5,49,9
2020-03-31T00:00:00Z,31,3,2020,0,0,Bangladesh,BD,BGD,161356039,Asia,5,49,10
2020-04-01T00:00:00Z,1,4,2020,2,0,Bangladesh,BD,BGD,161356039,Asia,5,51,11
2020-04-02T00:00:00Z,2,4,2020,3,1,Bangladesh,BD,BGD,161356039,Asia,6,54,12
2020-04-03T00:00:00Z,3,4,2020,2,0,Bangladesh,BD,BGD,161356039,Asia,6,56,13
2020-04-04T00:00:00Z,4,4,2020,5,0,Bangladesh,BD,BGD,161356039,Asia,6,61,14
2020-04-05T00:00:00Z,5,4,2020,9,2,Bangladesh,BD,BGD,161356039,Asia,8,70,15
2020-04-06T00:00:00Z,6,4,2020,18,1,Bangladesh,BD,BGD,161356039,Asia,9,88,16
2020-04-07T00:00:00Z,7,4,2020,35,3,Bangladesh,BD,BGD,161356039,Asia,12,123,17
2020-04-08T00:00:00Z,8,4,2020,41,5,Bangladesh,BD,BGD,161356039,Asia,17,164,18
2020-04-09T00:00:00Z,9,4,2020,54,3,Bangladesh,BD,BGD,161356039,Asia,20,218,19
2020-04-10T00:00:00Z,10,4,2020,112,1,Bangladesh,BD,BGD,161356039,Asia,21,330,20
2020-04-11T00:00:00Z,11,4,2020,94,6,Bangladesh,BD,BGD,161356039,Asia,27,424,21
2020-04-12T00:00:00Z,12,4,2020,58,3,Bangladesh,BD,BGD,161356039,Asia,30,482,22
2020-04-13T00:00:00Z,13,4,2020,139,4,Bangladesh,BD,BGD,161356039,Asia,34,621,23
2020-04-14T00:00:00Z,14,4,2020,182,5,Bangladesh,BD,BGD,161356039,Asia,39,803,24
2020-04-15T00:00:00Z,15,4,2020,209,7,Bangladesh,BD,BGD,161356039,Asia,46,1012,25
2020-04-16T00:00:00Z,16,4,2020,219,4,Bangladesh,BD,BGD,161356039,Asia,50,1231,26
2020-04-17T00:00:00Z,17,4,2020,341,10,Bangladesh,BD,BGD,161356039,Asia,60,1572,27
2020-04-18T00:00:00Z,18,4,2020,266,15,Bangladesh,BD,BGD,161356039,Asia,75,1838,28
2020-04-19T00:00:00Z,19,4,2020,306,9,Bangladesh,BD,BGD,161356039,Asia,84,2144,29
2020-04-20T00:00:00Z,20,4,2020,312,7,Bangladesh,BD,BGD,161356039,Asia,91,2456,30
2020-04-21T00:00:00Z,21,4,2020,492,10,Bangladesh,BD,BGD,161356039,Asia,101,2948,31
2020-04-22T00:00:00Z,22,4,2020,434,9,Bangladesh,BD,BGD,161356039,Asia,110,3382,32
2020-04-23T00:00:00Z,23,4,2020,390,10,Bangladesh,BD,BGD,161356039,Asia,120,3772,33
2020-04-24T00:00:00Z,24,4,2020,414,7,Bangladesh,BD,BGD,161356039,Asia,127,4186,34
2020-04-25T00:00:00Z,25,4,2020,503,4,Bangladesh,BD,BGD,161356039,Asia,131,4689,35
2020-04-26T00:00:00Z,26,4,2020,309,9,Bangladesh,BD,BGD,161356039,Asia,140,4998,36
2020-04-27T00:00:00Z,27,4,2020,418,5,Bangladesh,BD,BGD,161356039,Asia,145,5416,37
2020-04-28T00:00:00Z,28,4,2020,497,7,Bangladesh,BD,BGD,161356039,Asia,152,5913,38
2020-04-29T00:00:00Z,29,4,2020,549,3,Bangladesh,BD,BGD,161356039,Asia,155,6462,39
2020-04-30T00:00:00Z,30,4,2020,641,8,Bangladesh,BD,BGD,161356039,Asia,163,7103,40
2020-05-01T00:00:00Z,1,5,2020,564,5,Bangladesh,BD,BGD,161356039,Asia,168,7667,41
2020-05-02T00:00:00Z,2,5,2020,571,2,Bangladesh,BD,BGD,161356039,Asia,170,8238,42
2020-05-03T00:00:00Z,3,5,2020,552,5,Bangladesh,BD,BGD,161356039,Asia,175,8790,43
2020-05-04T00:00:00Z,4,5,2020,665,2,Bangladesh,BD,BGD,161356039,Asia,177,9455,44
2020-05-05T00:00:00Z,5,5,2020,688,5,Bangladesh,BD,BGD,161356039,Asia,182,10143,45
2020-05-06T00:00:00Z,6,5,2020,786,1,Bangladesh,BD,BGD,161356039,Asia,183,10929,46
2020-05-07T00:00:00Z,7,5,2020,790,3,Bangladesh,BD,BGD,161356039,Asia,186,11719,47
2020-05-08T00:00:00Z,8,5,2020,706,13,Bangladesh,BD,BGD,161356039,Asia,199,12425,48
2020-05-09T00:00:00Z,9,5,2020,709,7,Bangladesh,BD,BGD,161356039,Asia,206,13134,49
2020-05-10T00:00:00Z,10,5,2020,636,8,Bangladesh,BD,BGD,161356039,Asia,214,13770,50
2020-05-11T00:00:00Z,11,5,2020,887,14,Bangladesh,BD,BGD,161356039,Asia,228,14657,51
2020-05-12T00:00:00Z,12,5,2020,1034,11,Bangladesh,BD,BGD,161356039,Asia,239,15691,52
2020-05-13T00:00:00Z,13,5,2020,969,11,Bangladesh,BD,BGD,161356039,Asia,250,16660,53
2020-05-14T00:00:00Z,14,5,2020,1162,19,Bangladesh,BD,BGD,161356039,Asia,269,17822,54
2020-05-15T00:00:00Z,15,5,2020,1041,14,Bangladesh,BD,BGD,161356039,Asia,283,18863,55
2020-05-16T00:00:00Z,16,5,2020,1202,15,Bangladesh,BD,BGD,161356039,Asia,298,20065,56
2020-05-17T00:00:00Z,17,5,2020,930,16,Bangladesh,BD,BGD,161356039,Asia,314,20995,57
2020-05-18T00:00:00Z,18,5,2020,1273,14,Bangladesh,BD,BGD,161356039,Asia,328,22268,58
2020-05-19T00:00:00Z,19,5,2020,1602,21,Bangladesh,BD,BGD,161356039,Asia,349,23870,59
2020-05-20T00:00:00Z,20,5,2020,1251,21,Bangladesh,BD,BGD,161356039,Asia,370,25121,60
2020-05-21T00:00:00Z,21,5,2020,1617,16,Bangladesh,BD,BGD,161356039,Asia,386,26738,61
2020-05-22T00:00:00Z,22,5,2020,1773,22,Bangladesh,BD,BGD,161356039,Asia,408,28511,62
2020-05-23T00:00:00Z,23,5,2020,1694,24,Bangladesh,BD,BGD,161356039,Asia,432,30205,63
2020-05-24T00:00:00Z,24,5,2020,1873,20,Bangladesh,BD,BGD,161356039,Asia,452,32078,64
2020-05-25T00:00:00Z,25,5,2020,1532,28,Bangladesh,BD,BGD,161356039,Asia,480,33610,65
2020-05-26T00:00:00Z,26,5,2020,1975,21,Bangladesh,BD,BGD,161356039,Asia,501,35585,66
2020-05-27T00:00:00Z,27,5,2020,1166,21,Bangladesh,BD,BGD,161356039,Asia,522,36751,67
2020-04-06T00:00:00Z,6,4,2020,5,1,Barbados,BB,BRB,286641,America,1,56,1
2020-04-07T00:00:00Z,7,4,2020,4,1,Barbados,BB,BRB,286641,America,2,60,2
2020-04-08T00:00:00Z,8,4,2020,3,1,Barbados,BB,BRB,286641,America,3,63,3
2020-04-09T00:00:00Z,9,4,2020,0,0,Barbados,BB,BRB,286641,America,3,63,4
2020-04-10T00:00:00Z,10,4,2020,3,0,Barbados,BB,BRB,286641,America,3,66,5
2020-04-11T00:00:00Z,11,4,2020,1,1,Barbados,BB,BRB,286641,America,4,67,6
2020-04-12T00:00:00Z,12,4,2020,1,0,Barbados,BB,BRB,286641,America,4,68,7
2020-04-13T00:00:00Z,13,4,2020,3,0,Barbados,BB,BRB,286641,America,4,71,8
2020-04-14T00:00:00Z,14,4,2020,1,0,Barbados,BB,BRB,286641,America,4,72,9
2020-04-15T00:00:00Z,15,4,2020,1,1,Barbados,BB,BRB,286641,America,5,73,10
2020-04-16T00:00:00Z,16,4,2020,2,0,Barbados,BB,BRB,286641,America,5,75,11
2020-04-17T00:00:00Z,17,4,2020,0,0,Barbados,BB,BRB,286641,America,5,75,12
2020-04-18T00:00:00Z,18,4,2020,0,0,Barbados,BB,BRB,286641,America,5,75,13
2020-04-19T00:00:00Z,19,4,2020,0,0,Barbados,BB,BRB,286641,America,5,75,14
2020-04-20T00:00:00Z,20,4,2020,0,0,Barbados,BB,BRB,286641,America,5,75,15
2020-04-21T00:00:00Z,21,4,2020,0,0,Barbados,BB,BRB,286641,America,5,75,16
2020-04-22T00:00:00Z,22,4,2020,0,0,Barbados,BB,BRB,286641,America,5,75,17
2020-04-23T00:00:00Z,23,4,2020,1,1,Barbados,BB,BRB,286641,America,6,76,18
2020-04-24T00:00:00Z,24,4,2020,0,0,Barbados,BB,BRB,286641,America,6,76,19
2020-04-25T00:00:00Z,25,4,2020,0,0,Barbados,BB,BRB,286641,America,6,76,20
2020-04-26T00:00:00Z,26,4,2020,3,0,Barbados,BB,BRB,286641,America,6,79,21
2020-04-27T00:00:00Z,27,4,2020,0,0,Barbados,BB,BRB,286641,America,6,79,22
2020-04-28T00:00:00Z,28,4,2020,1,0,Barbados,BB,BRB,286641,America,6,80,23
2020-04-29T00:00:00Z,29,4,2020,0,0,Barbados,BB,BRB,286641,America,6,80,24
2020-04-30T00:00:00Z,30,4,2020,0,1,Barbados,BB,BRB,286641,America,7,80,25
2020-05-01T00:00:00Z,1,5,2020,1,0,Barbados,BB,BRB,286641,America,7,81,26
2020-05-02T00:00:00Z,2,5,2020,0,0,Barbados,BB,BRB,286641,America,7,81,27
2020-05-03T00:00:00Z,3,5,2020,0,0,Barbados,BB,BRB,286641,America,7,81,28
2020-05-04T00:00:00Z,4,5,2020,1,0,Barbados,BB,BRB,286641,America,7,82,29
2020-05-05T00:00:00Z,5,5,2020,0,0,Barbados,BB,BRB,286641,America,7,82,30
2020-05-06T00:00:00Z,6,5,2020,0,0,Barbados,BB,BRB,286641,America,7,82,31
2020-05-07T00:00:00Z,7,5,2020,0,0,Barbados,BB,BRB,286641,America,7,82,32
2020-05-08T00:00:00Z,8,5,2020,0,0,Barbados,BB,BRB,286641,America,7,82,33
2020-05-09T00:00:00Z,9,5,2020,1,0,Barbados,BB,BRB,286641,America,7,83,34
2020-05-10T00:00:00Z,10,5,2020,1,0,Barbados,BB,BRB,286641,America,7,84,35
2020-05-11T00:00:00Z,11,5,2020,0,0,Barbados,BB,BRB,286641,America,7,84,36
2020-05-12T00:00:00Z,12,5,2020,0,0,Barbados,BB,BRB,286641,America,7,84,37
2020-05-13T00:00:00Z,13,5,2020,1,0,Barbados,BB,BRB,286641,America,7,85,38
2020-05-14T00:00:00Z,14,5,2020,0,0,Barbados,BB,BRB,286641,America,7,85,39
2020-05-15T00:00:00Z,15,5,2020,0,0,Barbados,BB,BRB,286641,America,7,85,40
2020-05-16T00:00:00Z,16,5,2020,0,0,Barbados,BB,BRB,286641,America,7,85,41
2020-05-17T00:00:00Z,17,5,2020,1,0,Barbados,BB,BRB,286641,America,7,86,42
2020-05-18T00:00:00Z,18,5,2020,2,0,Barbados,BB,BRB,286641,America,7,88,43
2020-05-19T00:00:00Z,19,5,2020,0,0,Barbados,BB,BRB,286641,America,7,88,44
2020-05-20T00:00:00Z,20,5,2020,2,0,Barbados,BB,BRB,286641,America,7,90,45
2020-05-21T00:00:00Z,21,5,2020,0,0,Barbados,BB,BRB,286641,America,7,90,46
2020-05-22T00:00:00Z,22,5,2020,0,0,Barbados,BB,BRB,286641,America,7,90,47
2020-05-23T00:00:00Z,23,5,2020,0,0,Barbados,BB,BRB,286641,America,7,90,48
2020-05-24T00:00:00Z,24,5,2020,2,0,Barbados,BB,BRB,286641,America,7,92,49
2020-05-25T00:00:00Z,25,5,2020,0,0,Barbados,BB,BRB,286641,America,7,92,50
2020-05-26T00:00:00Z,26,5,2020,0,0,Barbados,BB,BRB,286641,America,7,92,51
2020-05-27T00:00:00Z,27,5,2020,0,0,Barbados,BB,BRB,286641,America,7,92,52
2020-04-03T00:00:00Z,3,4,2020,102,4,Belarus,BY,BLR,9485386,Europe,4,254,1
2020-04-04T00:00:00Z,4,4,2020,97,0,Belarus,BY,BLR,9485386,Europe,4,351,2
2020-04-05T00:00:00Z,5,4,2020,43,1,Belarus,BY,BLR,9485386,Europe,5,394,3
2020-04-06T00:00:00Z,6,4,2020,170,3,Belarus,BY,BLR,9485386,Europe,8,564,4
2020-04-07T00:00:00Z,7,4,2020,136,5,Belarus,BY,BLR,9485386,Europe,13,700,5
2020-04-08T00:00:00Z,8,4,2020,161,0,Belarus,BY,BLR,9485386,Europe,13,861,6
2020-04-09T00:00:00Z,9,4,2020,205,0,Belarus,BY,BLR,9485386,Europe,13,1066,7
2020-04-10T00:00:00Z,10,4,2020,420,3,Belarus,BY,BLR,9485386,Europe,16,1486,8
2020-04-11T00:00:00Z,11,4,2020,495,3,Belarus,BY,BLR,9485386,Europe,19,1981,9
2020-04-12T00:00:00Z,12,4,2020,245,4,Belarus,BY,BLR,9485386,Europe,23,2226,10
2020-04-13T00:00:00Z,13,4,2020,352,3,Belarus,BY,BLR,9485386,Europe,26,2578,11
2020-04-14T00:00:00Z,14,4,2020,341,3,Belarus,BY,BLR,9485386,Europe,29,2919,12
2020-04-15T00:00:00Z,15,4,2020,362,4,Belarus,BY,BLR,9485386,Europe,33,3281,13
2020-04-16T00:00:00Z,16,4,2020,447,3,Belarus,BY,BLR,9485386,Europe,36,3728,14
2020-04-17T00:00:00Z,17,4,2020,476,4,Belarus,BY,BLR,9485386,Europe,40,4204,15
2020-04-18T00:00:00Z,18,4,2020,575,2,Belarus,BY,BLR,9485386,Europe,42,4779,16
2020-04-19T00:00:00Z,19,4,2020,0,3,Belarus,BY,BLR,9485386,Europe,45,4779,17
2020-04-20T00:00:00Z,20,4,2020,0,2,Belarus,BY,BLR,9485386,Europe,47,4779,18
2020-04-21T00:00:00Z,21,4,2020,1485,4,Belarus,BY,BLR,9485386,Europe,51,6264,19
2020-04-22T00:00:00Z,22,4,2020,459,4,Belarus,BY,BLR,9485386,Europe,55,6723,20
2020-04-23T00:00:00Z,23,4,2020,558,3,Belarus,BY,BLR,9485386,Europe,58,7281,21
2020-04-24T00:00:00Z,24,4,2020,741,2,Belarus,BY,BLR,9485386,Europe,60,8022,22
2020-04-25T00:00:00Z,25,4,2020,751,3,Belarus,BY,BLR,9485386,Europe,63,8773,23
2020-04-26T00:00:00Z,26,4,2020,817,4,Belarus,BY,BLR,9485386,Europe,67,9590,24
2020-04-27T00:00:00Z,27,4,2020,873,5,Belarus,BY,BLR,9485386,Europe,72,10463,25
2020-04-28T00:00:00Z,28,4,2020,826,3,Belarus,BY,BLR,9485386,Europe,75,11289,26
2020-04-29T00:00:00Z,29,4,2020,919,4,Belarus,BY,BLR,9485386,Europe,79,12208,27
2020-04-30T00:00:00Z,30,4,2020,973,5,Belarus,BY,BLR,9485386,Europe,84,13181,28
2020-05-01T00:00:00Z,1,5,2020,846,5,Belarus,BY,BLR,9485386,Europe,89,14027,29
2020-05-02T00:00:00Z,2,5,2020,890,4,Belarus,BY,BLR,9485386,Europe,93,14917,30
2020-05-03T00:00:00Z,3,5,2020,911,4,Belarus,BY,BLR,9485386,Europe,97,15828,31
2020-05-04T00:00:00Z,4,5,2020,877,2,Belarus,BY,BLR,9485386,Europe,99,16705,32
2020-05-05T00:00:00Z,5,5,2020,784,4,Belarus,BY,BLR,9485386,Europe,103,17489,33
2020-05-06T00:00:00Z,6,5,2020,861,4,Belarus,BY,BLR,9485386,Europe,107,18350,34
2020-05-07T00:00:00Z,7,5,2020,905,5,Belarus,BY,BLR,9485386,Europe,112,19255,35
2020-05-08T00:00:00Z,8,5,2020,913,4,Belarus,BY,BLR,9485386,Europe,116,20168,36
2020-05-09T00:00:00Z,9,5,2020,933,5,Belarus,BY,BLR,9485386,Europe,121,21101,37
2020-05-10T00:00:00Z,10,5,2020,951,5,Belarus,BY,BLR,9485386,Europe,126,22052,38
2020-05-11T00:00:00Z,11,5,2020,921,5,Belarus,BY,BLR,9485386,Europe,131,22973,39
2020-05-12T00:00:00Z,12,5,2020,933,4,Belarus,BY,BLR,9485386,Europe,135,23906,40
2020-05-13T00:00:00Z,13,5,2020,967,7,Belarus,BY,BLR,9485386,Europe,142,24873,41
2020-05-14T00:00:00Z,14,5,2020,952,4,Belarus,BY,BLR,9485386,Europe,146,25825,42
2020-05-15T00:00:00Z,15,5,2020,947,5,Belarus,BY,BLR,9485386,Europe,151,26772,43
2020-05-16T00:00:00Z,16,5,2020,958,5,Belarus,BY,BLR,9485386,Europe,156,27730,44
2020-05-17T00:00:00Z,17,5,2020,951,4,Belarus,BY,BLR,9485386,Europe,160,28681,45
2020-05-18T00:00:00Z,18,5,2020,969,5,Belarus,BY,BLR,9485386,Europe,165,29650,46
2020-05-19T00:00:00Z,19,5,2020,922,6,Belarus,BY,BLR,9485386,Europe,171,30572,47
2020-05-20T00:00:00Z,20,5,2020,936,4,Belarus,BY,BLR,9485386,Europe,175,31508,48
2020-05-21T00:00:00Z,21,5,2020,918,4,Belarus,BY,BLR,9485386,Europe,179,32426,49
2020-05-22T00:00:00Z,22,5,2020,945,6,Belarus,BY,BLR,9485386,Europe,185,33371,50
2020-05-23T00:00:00Z,23,5,2020,932,5,Belarus,BY,BLR,9485386,Europe,190,34303,51
2020-05-24T00:00:00Z,24,5,2020,941,4,Belarus,BY,BLR,9485386,Europe,194,35244,52
2020-05-25T00:00:00Z,25,5,2020,954,5,Belarus,BY,BLR,9485386,Europe,199,36198,53
2020-05-26T00:00:00Z,26,5,2020,946,5,Belarus,BY,BLR,9485386,Europe,204,37144,54
2020-05-27T00:00:00Z,27,5,2020,915,4,Belarus,BY,BLR,9485386,Europe,208,38059,55
2020-03-12T00:00:00Z,12,3,2020,47,3,Belgium,BE,BEL,11422068,Europe,3,314,1
2020-03-13T00:00:00Z,13,3,2020,85,0,Belgium,BE,BEL,11422068,Europe,3,399,2
2020-03-14T00:00:00Z,14,3,2020,160,0,Belgium,BE,BEL,11422068,Europe,3,559,3
2020-03-15T00:00:00Z,15,3,2020,130,1,Belgium,BE,BEL,11422068,Europe,4,689,4
2020-03-16T00:00:00Z,16,3,2020,197,0,Belgium,BE,BEL,11422068,Europe,4,886,5
2020-03-17T00:00:00Z,17,3,2020,199,1,Belgium,BE,BEL,11422068,Europe,5,1085,6
2020-03-18T00:00:00Z,18,3,2020,158,0,Belgium,BE,BEL,11422068,Europe,5,1243,7
2020-03-19T00:00:00Z,19,3,2020,243,9,Belgium,BE,BEL,11422068,Europe,14,1486,8
2020-03-20T00:00:00Z,20,3,2020,309,7,Belgium,BE,BEL,11422068,Europe,21,1795,9
2020-03-21T00:00:00Z,21,3,2020,462,16,Belgium,BE,BEL,11422068,Europe,37,2257,10
2020-03-22T00:00:00Z,22,3,2020,558,30,Belgium,BE,BEL,11422068,Europe,67,2815,11
2020-03-23T00:00:00Z,23,3,2020,586,8,Belgium,BE,BEL,11422068,Europe,75,3401,12
2020-03-24T00:00:00Z,24,3,2020,342,13,Belgium,BE,BEL,11422068,Europe,88,3743,13
2020-03-25T00:00:00Z,25,3,2020,526,34,Belgium,BE,BEL,11422068,Europe,122,4269,14
2020-03-26T00:00:00Z,26,3,2020,668,56,Belgium,BE,BEL,11422068,Europe,178,4937,15
2020-03-27T00:00:00Z,27,3,2020,1298,42,Belgium,BE,BEL,11422068,Europe,220,6235,16
2020-03-28T00:00:00Z,28,3,2020,1049,69,Belgium,BE,BEL,11422068,Europe,289,7284,17
2020-03-29T00:00:00Z,29,3,2020,1850,64,Belgium,BE,BEL,11422068,Europe,353,9134,18
2020-03-30T00:00:00Z,30,3,2020,1702,78,Belgium,BE,BEL,11422068,Europe,431,10836,19
2020-03-31T00:00:00Z,31,3,2020,1063,82,Belgium,BE,BEL,11422068,Europe,513,11899,20
2020-04-01T00:00:00Z,1,4,2020,876,192,Belgium,BE,BEL,11422068,Europe,705,12775,21
2020-04-02T00:00:00Z,2,4,2020,1189,123,Belgium,BE,BEL,11422068,Europe,828,13964,22
2020-04-03T00:00:00Z,3,4,2020,1384,183,Belgium,BE,BEL,11422068,Europe,1011,15348,23
2020-04-04T00:00:00Z,4,4,2020,1422,132,Belgium,BE,BEL,11422068,Europe,1143,16770,24
2020-04-05T00:00:00Z,5,4,2020,1661,140,Belgium,BE,BEL,11422068,Europe,1283,18431,25
2020-04-06T00:00:00Z,6,4,2020,1260,164,Belgium,BE,BEL,11422068,Europe,1447,19691,26
2020-04-07T00:00:00Z,7,4,2020,1123,185,Belgium,BE,BEL,11422068,Europe,1632,20814,27
2020-04-08T00:00:00Z,8,4,2020,1380,403,Belgium,BE,BEL,11422068,Europe,2035,22194,28
2020-04-09T00:00:00Z,9,4,2020,1209,205,Belgium,BE,BEL,11422068,Europe,2240,23403,29
2020-04-10T00:00:00Z,10,4,2020,1580,283,Belgium,BE,BEL,11422068,Europe,2523,24983,30
2020-04-11T00:00:00Z,11,4,2020,1684,496,Belgium,BE,BEL,11422068,Europe,3019,26667,31
2020-04-12T00:00:00Z,12,4,2020,1351,327,Belgium,BE,BEL,11422068,Europe,3346,28018,32
2020-04-13T00:00:00Z,13,4,2020,1629,254,Belgium,BE,BEL,11422068,Europe,3600,29647,33
2020-04-14T00:00:00Z,14,4,2020,942,303,Belgium,BE,BEL,11422068,Europe,3903,30589,34
2020-04-15T00:00:00Z,15,4,2020,530,254,Belgium,BE,BEL,11422068,Europe,4157,31119,35
2020-04-16T00:00:00Z,16,4,2020,2454,283,Belgium,BE,BEL,11422068,Europe,4440,33573,36
2020-04-17T00:00:00Z,17,4,2020,1236,417,Belgium,BE,BEL,11422068,Europe,4857,34809,37
2020-04-18T00:00:00Z,18,4,2020,1329,306,Belgium,BE,BEL,11422068,Europe,5163,36138,38
2020-04-19T00:00:00Z,19,4,2020,1045,290,Belgium,BE,BEL,11422068,Europe,5453,37183,39
2020-04-20T00:00:00Z,20,4,2020,1313,230,Belgium,BE,BEL,11422068,Europe,5683,38496,40
2020-04-21T00:00:00Z,21,4,2020,1487,145,Belgium,BE,BEL,11422068,Europe,5828,39983,41
2020-04-22T00:00:00Z,22,4,2020,973,170,Belgium,BE,BEL,11422068,Europe,5998,40956,42
2020-04-23T00:00:00Z,23,4,2020,933,264,Belgium,BE,BEL,11422068,Europe,6262,41889,43
2020-04-24T00:00:00Z,24,4,2020,908,228,Belgium,BE,BEL,11422068,Europe,6490,42797,44
2020-04-25T00:00:00Z,25,4,2020,1496,189,Belgium,BE,BEL,11422068,Europe,6679,44293,45
2020-04-26T00:00:00Z,26,4,2020,1032,238,Belgium,BE,BEL,11422068,Europe,6917,45325,46
2020-04-27T00:00:00Z,27,4,2020,809,177,Belgium,BE,BEL,11422068,Europe,7094,46134,47
2020-04-28T00:00:00Z,28,4,2020,553,113,Belgium,BE,BEL,11422068,Europe,7207,46687,48
2020-04-29T00:00:00Z,29,4,2020,647,124,Belgium,BE,BEL,11422068,Europe,7331,47334,49
2020-04-30T00:00:00Z,30,4,2020,525,170,Belgium,BE,BEL,11422068,Europe,7501,47859,50
2020-05-01T00:00:00Z,1,5,2020,660,93,Belgium,BE,BEL,11422068,Europe,7594,48519,51
2020-05-02T00:00:00Z,2,5,2020,513,109,Belgium,BE,BEL,11422068,Europe,7703,49032,52
2020-05-03T00:00:00Z,3,5,2020,485,62,Belgium,BE,BEL,11422068,Europe,7765,49517,53
2020-05-04T00:00:00Z,4,5,2020,389,79,Belgium,BE,BEL,11422068,Europe,7844,49906,54
2020-05-05T00:00:00Z,5,5,2020,361,80,Belgium,BE,BEL,11422068,Europe,7924,50267,55
2020-05-06T00:00:00Z,6,5,2020,242,92,Belgium,BE,BEL,11422068,Europe,8016,50509,56
2020-05-07T00:00:00Z,7,5,2020,272,323,Belgium,BE,BEL,11422068,Europe,8339,50781,57
2020-05-08T00:00:00Z,8,5,2020,639,76,Belgium,BE,BEL,11422068,Europe,8415,51420,58
2020-05-09T00:00:00Z,9,5,2020,591,106,Belgium,BE,BEL,11422068,Europe,8521,52011,59
2020-05-10T00:00:00Z,10,5,2020,585,60,Belgium,BE,BEL,11422068,Europe,8581,52596,60
2020-05-11T00:00:00Z,11,5,2020,485,75,Belgium,BE,BEL,11422068,Europe,8656,53081,61
2020-05-12T00:00:00Z,12,5,2020,368,51,Belgium,BE,BEL,11422068,Europe,8707,53449,62
2020-05-13T00:00:00Z,13,5,2020,330,54,Belgium,BE,BEL,11422068,Europe,8761,53779,63
2020-05-14T00:00:00Z,14,5,2020,202,82,Belgium,BE,BEL,11422068,Europe,8843,53981,64
2020-05-15T00:00:00Z,15,5,2020,307,60,Belgium,BE,BEL,11422068,Europe,8903,54288,65
2020-05-16T00:00:00Z,16,5,2020,356,56,Belgium,BE,BEL,11422068,Europe,8959,54644,66
2020-05-17T00:00:00Z,17,5,2020,345,46,Belgium,BE,BEL,11422068,Europe,9005,54989,67
2020-05-18T00:00:00Z,18,5,2020,291,47,Belgium,BE,BEL,11422068,Europe,9052,55280,68
2020-05-19T00:00:00Z,19,5,2020,279,28,Belgium,BE,BEL,11422068,Europe,9080,55559,69
2020-05-20T00:00:00Z,20,5,2020,232,28,Belgium,BE,BEL,11422068,Europe,9108,55791,70
2020-05-21T00:00:00Z,21,5,2020,192,42,Belgium,BE,BEL,11422068,Europe,9150,55983,71
2020-05-22T00:00:00Z,22,5,2020,252,36,Belgium,BE,BEL,11422068,Europe,9186,56235,72
2020-05-23T00:00:00Z,23,5,2020,276,26,Belgium,BE,BEL,11422068,Europe,9212,56511,73
2020-05-24T00:00:00Z,24,5,2020,299,25,Belgium,BE,BEL,11422068,Europe,9237,56810,74
2020-05-25T00:00:00Z,25,5,2020,282,43,Belgium,BE,BEL,11422068,Europe,9280,57092,75
2020-05-26T00:00:00Z,26,5,2020,250,32,Belgium,BE,BEL,11422068,Europe,9312,57342,76
2020-05-27T00:00:00Z,27,5,2020,113,22,Belgium,BE,BEL,11422068,Europe,9334,57455,77
2020-04-06T00:00:00Z,6,4,2020,1,1,Belize,BZ,BLZ,383071,America,1,5,1
2020-04-07T00:00:00Z,7,4,2020,2,0,Belize,BZ,BLZ,383071,America,1,7,2
2020-04-08T00:00:00Z,8,4,2020,0,0,Belize,BZ,BLZ,383071,America,1,7,3
2020-04-09T00:00:00Z,9,4,2020,1,0,Belize,BZ,BLZ,383071,America,1,8,4
2020-04-10T00:00:00Z,10,4,2020,1,0,Belize,BZ,BLZ,383071,America,1,9,5
2020-04-11T00:00:00Z,11,4,2020,1,1,Belize,BZ,BLZ,383071,America,2,10,6
2020-04-12T00:00:00Z,12,4,2020,3,0,Belize,BZ,BLZ,383071,America,2,13,7
2020-04-13T00:00:00Z,13,4,2020,1,0,Belize,BZ,BLZ,383071,America,2,14,8
2020-04-14T00:00:00Z,14,4,2020,4,0,Belize,BZ,BLZ,383071,America,2,18,9
2020-04-15T00:00:00Z,15,4,2020,0,0,Belize,BZ,BLZ,383071,America,2,18,10
2020-04-16T00:00:00Z,16,4,2020,0,0,Belize,BZ,BLZ,383071,America,2,18,11
2020-04-17T00:00:00Z,17,4,2020,0,0,Belize,BZ,BLZ,383071,America,2,18,12
2020-04-18T00:00:00Z,18,4,2020,0,0,Belize,BZ,BLZ,383071,America,2,18,13
2020-04-19T00:00:00Z,19,4,2020,0,0,Belize,BZ,BLZ,383071,America,2,18,14
2020-04-20T00:00:00Z,20,4,2020,0,0,Belize,BZ,BLZ,383071,America,2,18,15
2020-04-21T00:00:00Z,21,4,2020,0,0,Belize,BZ,BLZ,383071,America,2,18,16
2020-04-22T00:00:00Z,22,4,2020,0,0,Belize,BZ,BLZ,383071,America,2,18,17
2020-04-23T00:00:00Z,23,4,2020,0,0,Belize,BZ,BLZ,383071,America,2,18,18
2020-04-24T00:00:00Z,24,4,2020,0,0,Belize,BZ,BLZ,383071,America,2,18,19
2020-04-25T00:00:00Z,25,4,2020,0,0,Belize,BZ,BLZ,383071,America,2,18,20
2020-04-26T00:00:00Z,26,4,2020,0,0,Belize,BZ,BLZ,383071,America,2,18,21
2020-04-27T00:00:00Z,27,4,2020,0,0,Belize,BZ,BLZ,383071,America,2,18,22
2020-04-28T00:00:00Z,28,4,2020,0,0,Belize,BZ,BLZ,383071,America,2,18,23
2020-04-29T00:00:00Z,29,4,2020,0,0,Belize,BZ,BLZ,383071,America,2,18,24
2020-04-30T00:00:00Z,30,4,2020,0,0,Belize,BZ,BLZ,383071,America,2,18,25
2020-05-01T00:00:00Z,1,5,2020,0,0,Belize,BZ,BLZ,383071,America,2,18,26
2020-05-02T00:00:00Z,2,5,2020,0,0,Belize,BZ,BLZ,383071,America,2,18,27
2020-05-03T00:00:00Z,3,5,2020,0,0,Belize,BZ,BLZ,383071,America,2,18,28
2020-05-04T00:00:00Z,4,5,2020,0,0,Belize,BZ,BLZ,383071,America,2,18,29
2020-05-05T00:00:00Z,5,5,2020,0,0,Belize,BZ,BLZ,383071,America,2,18,30
2020-05-06T00:00:00Z,6,5,2020,0,0,Belize,BZ,BLZ,383071,America,2,18,31
2020-05-07T00:00:00Z,7,5,2020,0,0,Belize,BZ,BLZ,383071,America,2,18,32
2020-05-08T00:00:00Z,8,5,2020,0,0,Belize,BZ,BLZ,383071,America,2,18,33
2020-05-09T00:00:00Z,9,5,2020,0,0,Belize,BZ,BLZ,383071,America,2,18,34
2020-05-10T00:00:00Z,10,5,2020,0,0,Belize,BZ,BLZ,383071,America,2,18,35
2020-05-11T00:00:00Z,11,5,2020,0,0,Belize,BZ,BLZ,383071,America,2,18,36
2020-05-12T00:00:00Z,12,5,2020,0,0,Belize,BZ,BLZ,383071,America,2,18,37
2020-05-13T00:00:00Z,13,5,2020,0,0,Belize,BZ,BLZ,383071,America,2,18,38
2020-05-14T00:00:00Z,14,5,2020,0,0,Belize,BZ,BLZ,383071,America,2,18,39
2020-05-15T00:00:00Z,15,5,2020,0,0,Belize,BZ,BLZ,383071,America,2,18,40
2020-05-16T00:00:00Z,16,5,2020,0,0,Belize,BZ,BLZ,383071,America,2,18,41
2020-05-17T00:00:00Z,17,5,2020,0,0,Belize,BZ,BLZ,383071,America,2,18,42
2020-05-18T00:00:00Z,18,5,2020,0,0,Belize,BZ,BLZ,383071,America,2,18,43
2020-05-19T00:00:00Z,19,5,2020,0,0,Belize,BZ,BLZ,383071,America,2,18,44
2020-05-20T00:00:00Z,20,5,2020,0,0,Belize,BZ,BLZ,383071,America,2,18,45
2020-05-21T00:00:00Z,21,5,2020,0,0,Belize,BZ,BLZ,383071,America,2,18,46
2020-05-22T00:00:00Z,22,5,2020,0,0,Belize,BZ,BLZ,383071,America,2,18,47
2020-05-23T00:00:00Z,23,5,2020,0,0,Belize,BZ,BLZ,383071,America,2,18,48
2020-05-24T00:00:00Z,24,5,2020,0,0,Belize,BZ,BLZ,383071,America,2,18,49
2020-05-25T00:00:00Z,25,5,2020,0,0,Belize,BZ,BLZ,383071,America,2,18,50
2020-05-26T00:00:00Z,26,5,2020,0,0,Belize,BZ,BLZ,383071,America,2,18,51
2020-05-27T00:00:00Z,27,5,2020,0,0,Belize,BZ,BLZ,383071,America,2,18,52
2020-04-07T00:00:00Z,7,4,2020,4,1,Benin,BJ,BEN,11485048,Africa,1,26,1
2020-04-08T00:00:00Z,8,4,2020,0,0,Benin,BJ,BEN,11485048,Africa,1,26,2
2020-04-09T00:00:00Z,9,4,2020,0,0,Benin,BJ,BEN,11485048,Africa,1,26,3
2020-04-10T00:00:00Z,10,4,2020,4,0,Benin,BJ,BEN,11485048,Africa,1,30,4
2020-04-11T00:00:00Z,11,4,2020,5,0,Benin,BJ,BEN,11485048,Africa,1,35,5
2020-04-12T00:00:00Z,12,4,2020,0,0,Benin,BJ,BEN,11485048,Africa,1,35,6
2020-04-13T00:00:00Z,13,4,2020,0,0,Benin,BJ,BEN,11485048,Africa,1,35,7
2020-04-14T00:00:00Z,14,4,2020,0,0,Benin,BJ,BEN,11485048,Africa,1,35,8
2020-04-15T00:00:00Z,15,4,2020,0,0,Benin,BJ,BEN,11485048,Africa,1,35,9
2020-04-16T00:00:00Z,16,4,2020,0,0,Benin,BJ,BEN,11485048,Africa,1,35,10
2020-04-17T00:00:00Z,17,4,2020,2,0,Benin,BJ,BEN,11485048,Africa,1,37,11
2020-04-18T00:00:00Z,18,4,2020,0,0,Benin,BJ,BEN,11485048,Africa,1,37,12
2020-04-19T00:00:00Z,19,4,2020,0,0,Benin,BJ,BEN,11485048,Africa,1,37,13
2020-04-20T00:00:00Z,20,4,2020,0,0,Benin,BJ,BEN,11485048,Africa,1,37,14
2020-04-21T00:00:00Z,21,4,2020,17,0,Benin,BJ,BEN,11485048,Africa,1,54,15
2020-04-22T00:00:00Z,22,4,2020,0,0,Benin,BJ,BEN,11485048,Africa,1,54,16
2020-04-23T00:00:00Z,23,4,2020,0,0,Benin,BJ,BEN,11485048,Africa,1,54,17
2020-04-24T00:00:00Z,24,4,2020,4,0,Benin,BJ,BEN,11485048,Africa,1,58,18
2020-04-25T00:00:00Z,25,4,2020,0,0,Benin,BJ,BEN,11485048,Africa,1,58,19
2020-04-26T00:00:00Z,26,4,2020,0,0,Benin,BJ,BEN,11485048,Africa,1,58,20
2020-04-27T00:00:00Z,27,4,2020,6,0,Benin,BJ,BEN,11485048,Africa,1,64,21
2020-04-28T00:00:00Z,28,4,2020,0,0,Benin,BJ,BEN,11485048,Africa,1,64,22
2020-04-29T00:00:00Z,29,4,2020,0,0,Benin,BJ,BEN,11485048,Africa,1,64,23
2020-04-30T00:00:00Z,30,4,2020,5,1,Benin,BJ,BEN,11485048,Africa,2,69,24
2020-05-01T00:00:00Z,1,5,2020,15,0,Benin,BJ,BEN,11485048,Africa,2,84,25
2020-05-02T00:00:00Z,2,5,2020,6,0,Benin,BJ,BEN,11485048,Africa,2,90,26
2020-05-03T00:00:00Z,3,5,2020,0,0,Benin,BJ,BEN,11485048,Africa,2,90,27
2020-05-04T00:00:00Z,4,5,2020,0,0,Benin,BJ,BEN,11485048,Africa,2,90,28
2020-05-05T00:00:00Z,5,5,2020,6,0,Benin,BJ,BEN,11485048,Africa,2,96,29
2020-05-06T00:00:00Z,6,5,2020,0,0,Benin,BJ,BEN,11485048,Africa,2,96,30
2020-05-07T00:00:00Z,7,5,2020,6,0,Benin,BJ,BEN,11485048,Africa,2,102,31
2020-05-08T00:00:00Z,8,5,2020,38,0,Benin,BJ,BEN,11485048,Africa,2,140,32
2020-05-09T00:00:00Z,9,5,2020,102,0,Benin,BJ,BEN,11485048,Africa,2,242,33
2020-05-10T00:00:00Z,10,5,2020,42,0,Benin,BJ,BEN,11485048,Africa,2,284,34
2020-05-11T00:00:00Z,11,5,2020,35,0,Benin,BJ,BEN,11485048,Africa,2,319,35
2020-05-12T00:00:00Z,12,5,2020,0,0,Benin,BJ,BEN,11485048,Africa,2,319,36
2020-05-13T00:00:00Z,13,5,2020,8,0,Benin,BJ,BEN,11485048,Africa,2,327,37
2020-05-14T00:00:00Z,14,5,2020,0,0,Benin,BJ,BEN,11485048,Africa,2,327,38
2020-05-15T00:00:00Z,15,5,2020,12,0,Benin,BJ,BEN,11485048,Africa,2,339,39
2020-05-16T00:00:00Z,16,5,2020,0,0,Benin,BJ,BEN,11485048,Africa,2,339,40
2020-05-17T00:00:00Z,17,5,2020,0,0,Benin,BJ,BEN,11485048,Africa,2,339,41
2020-05-18T00:00:00Z,18,5,2020,0,0,Benin,BJ,BEN,11485048,Africa,2,339,42
2020-05-19T00:00:00Z,19,5,2020,0,0,Benin,BJ,BEN,11485048,Africa,2,339,43
2020-05-20T00:00:00Z,20,5,2020,-209,0,Benin,BJ,BEN,11485048,Africa,2,130,44
2020-05-21T00:00:00Z,21,5,2020,0,0,Benin,BJ,BEN,11485048,Africa,2,130,45
2020-05-22T00:00:00Z,22,5,2020,5,1,Benin,BJ,BEN,11485048,Africa,3,135,46
2020-05-23T00:00:00Z,23,5,2020,0,0,Benin,BJ,BEN,11485048,Africa,3,135,47
2020-05-24T00:00:00Z,24,5,2020,0,0,Benin,BJ,BEN,11485048,Africa,3,135,48
2020-05-25T00:00:00Z,25,5,2020,56,0,Benin,BJ,BEN,11485048,Africa,3,191,49
2020-05-26T00:00:00Z,26,5,2020,0,0,Benin,BJ,BEN,11485048,Africa,3,191,50
2020-05-27T00:00:00Z,27,5,2020,17,0,Benin,BJ,BEN,11485048,Africa,3,208,51
2020-04-07T00:00:00Z,7,4,2020,2,2,Bermuda,BM,BMU,63968,America,2,39,1
2020-04-08T00:00:00Z,8,4,2020,0,0,Bermuda,BM,BMU,63968,America,2,39,2
2020-04-09T00:00:00Z,9,4,2020,0,1,Bermuda,BM,BMU,63968,America,3,39,3
2020-04-10T00:00:00Z,10,4,2020,9,1,Bermuda,BM,BMU,63968,America,4,48,4
2020-04-11T00:00:00Z,11,4,2020,0,0,Bermuda,BM,BMU,63968,America,4,48,5
2020-04-12T00:00:00Z,12,4,2020,2,0,Bermuda,BM,BMU,63968,America,4,50,6
2020-04-13T00:00:00Z,13,4,2020,7,0,Bermuda,BM,BMU,63968,America,4,57,7
2020-04-14T00:00:00Z,14,4,2020,0,0,Bermuda,BM,BMU,63968,America,4,57,8
2020-04-15T00:00:00Z,15,4,2020,0,1,Bermuda,BM,BMU,63968,America,5,57,9
2020-04-16T00:00:00Z,16,4,2020,24,0,Bermuda,BM,BMU,63968,America,5,81,10
2020-04-17T00:00:00Z,17,4,2020,2,0,Bermuda,BM,BMU,63968,America,5,83,11
2020-04-18T00:00:00Z,18,4,2020,0,0,Bermuda,BM,BMU,63968,America,5,83,12
2020-04-19T00:00:00Z,19,4,2020,3,0,Bermuda,BM,BMU,63968,America,5,86,13
2020-04-20T00:00:00Z,20,4,2020,0,0,Bermuda,BM,BMU,63968,America,5,86,14
2020-04-21T00:00:00Z,21,4,2020,0,0,Bermuda,BM,BMU,63968,America,5,86,15
2020-04-22T00:00:00Z,22,4,2020,12,0,Bermuda,BM,BMU,63968,America,5,98,16
2020-04-23T00:00:00Z,23,4,2020,1,0,Bermuda,BM,BMU,63968,America,5,99,17
2020-04-24T00:00:00Z,24,4,2020,0,0,Bermuda,BM,BMU,63968,America,5,99,18
2020-04-25T00:00:00Z,25,4,2020,0,0,Bermuda,BM,BMU,63968,America,5,99,19
2020-04-26T00:00:00Z,26,4,2020,0,0,Bermuda,BM,BMU,63968,America,5,99,20
2020-04-27T00:00:00Z,27,4,2020,10,0,Bermuda,BM,BMU,63968,America,5,109,21
2020-04-28T00:00:00Z,28,4,2020,1,1,Bermuda,BM,BMU,63968,America,6,110,22
2020-04-29T00:00:00Z,29,4,2020,0,0,Bermuda,BM,BMU,63968,America,6,110,23
2020-04-30T00:00:00Z,30,4,2020,1,0,Bermuda,BM,BMU,63968,America,6,111,24
2020-05-01T00:00:00Z,1,5,2020,3,0,Bermuda,BM,BMU,63968,America,6,114,25
2020-05-02T00:00:00Z,2,5,2020,0,0,Bermuda,BM,BMU,63968,America,6,114,26
2020-05-03T00:00:00Z,3,5,2020,0,1,Bermuda,BM,BMU,63968,America,7,114,27
2020-05-04T00:00:00Z,4,5,2020,1,0,Bermuda,BM,BMU,63968,America,7,115,28
2020-05-05T00:00:00Z,5,5,2020,0,0,Bermuda,BM,BMU,63968,America,7,115,29
2020-05-06T00:00:00Z,6,5,2020,0,0,Bermuda,BM,BMU,63968,America,7,115,30
2020-05-07T00:00:00Z,7,5,2020,3,0,Bermuda,BM,BMU,63968,America,7,118,31
2020-05-08T00:00:00Z,8,5,2020,0,0,Bermuda,BM,BMU,63968,America,7,118,32
2020-05-09T00:00:00Z,9,5,2020,0,0,Bermuda,BM,BMU,63968,America,7,118,33
2020-05-10T00:00:00Z,10,5,2020,0,0,Bermuda,BM,BMU,63968,America,7,118,34
2020-05-11T00:00:00Z,11,5,2020,0,0,Bermuda,BM,BMU,63968,America,7,118,35
2020-05-12T00:00:00Z,12,5,2020,1,1,Bermuda,BM,BMU,63968,America,8,119,36
2020-05-13T00:00:00Z,13,5,2020,2,0,Bermuda,BM,BMU,63968,America,8,121,37
2020-05-14T00:00:00Z,14,5,2020,0,0,Bermuda,BM,BMU,63968,America,8,121,38
2020-05-15T00:00:00Z,15,5,2020,1,1,Bermuda,BM,BMU,63968,America,9,122,39
2020-05-16T00:00:00Z,16,5,2020,1,0,Bermuda,BM,BMU,63968,America,9,123,40
2020-05-17T00:00:00Z,17,5,2020,0,0,Bermuda,BM,BMU,63968,America,9,123,41
2020-05-18T00:00:00Z,18,5,2020,0,0,Bermuda,BM,BMU,63968,America,9,123,42
2020-05-19T00:00:00Z,19,5,2020,2,0,Bermuda,BM,BMU,63968,America,9,125,43
2020-05-20T00:00:00Z,20,5,2020,0,0,Bermuda,BM,BMU,63968,America,9,125,44
2020-05-21T00:00:00Z,21,5,2020,0,0,Bermuda,BM,BMU,63968,America,9,125,45
2020-05-22T00:00:00Z,22,5,2020,0,0,Bermuda,BM,BMU,63968,America,9,125,46
2020-05-23T00:00:00Z,23,5,2020,3,0,Bermuda,BM,BMU,63968,America,9,128,47
2020-05-24T00:00:00Z,24,5,2020,5,0,Bermuda,BM,BMU,63968,America,9,133,48
2020-05-25T00:00:00Z,25,5,2020,0,0,Bermuda,BM,BMU,63968,America,9,133,49
2020-05-26T00:00:00Z,26,5,2020,0,0,Bermuda,BM,BMU,63968,America,9,133,50
2020-05-27T00:00:00Z,27,5,2020,6,0,Bermuda,BM,BMU,63968,America,9,139,51
2020-03-30T00:00:00Z,30,3,2020,15,3,Bolivia,BO,BOL,11353142,America,3,96,1
2020-03-31T00:00:00Z,31,3,2020,11,3,Bolivia,BO,BOL,11353142,America,6,107,2
2020-04-01T00:00:00Z,1,4,2020,8,1,Bolivia,BO,BOL,11353142,America,7,115,3
2020-04-02T00:00:00Z,2,4,2020,8,1,Bolivia,BO,BOL,11353142,America,8,123,4
2020-04-03T00:00:00Z,3,4,2020,9,1,Bolivia,BO,BOL,11353142,America,9,132,5
2020-04-04T00:00:00Z,4,4,2020,7,1,Bolivia,BO,BOL,11353142,America,10,139,6
2020-04-05T00:00:00Z,5,4,2020,18,0,Bolivia,BO,BOL,11353142,America,10,157,7
2020-04-06T00:00:00Z,6,4,2020,26,1,Bolivia,BO,BOL,11353142,America,11,183,8
2020-04-07T00:00:00Z,7,4,2020,11,3,Bolivia,BO,BOL,11353142,America,14,194,9
2020-04-08T00:00:00Z,8,4,2020,16,1,Bolivia,BO,BOL,11353142,America,15,210,10
2020-04-09T00:00:00Z,9,4,2020,54,3,Bolivia,BO,BOL,11353142,America,18,264,11
2020-04-10T00:00:00Z,10,4,2020,4,1,Bolivia,BO,BOL,11353142,America,19,268,12
2020-04-11T00:00:00Z,11,4,2020,8,1,Bolivia,BO,BOL,11353142,America,20,276,13
2020-04-12T00:00:00Z,12,4,2020,24,4,Bolivia,BO,BOL,11353142,America,24,300,14
2020-04-13T00:00:00Z,13,4,2020,30,3,Bolivia,BO,BOL,11353142,America,27,330,15
2020-04-14T00:00:00Z,14,4,2020,24,1,Bolivia,BO,BOL,11353142,America,28,354,16
2020-04-15T00:00:00Z,15,4,2020,43,0,Bolivia,BO,BOL,11353142,America,28,397,17
2020-04-16T00:00:00Z,16,4,2020,44,1,Bolivia,BO,BOL,11353142,America,29,441,18
2020-04-17T00:00:00Z,17,4,2020,24,2,Bolivia,BO,BOL,11353142,America,31,465,19
2020-04-18T00:00:00Z,18,4,2020,28,0,Bolivia,BO,BOL,11353142,America,31,493,20
2020-04-19T00:00:00Z,19,4,2020,27,1,Bolivia,BO,BOL,11353142,America,32,520,21
2020-04-20T00:00:00Z,20,4,2020,44,1,Bolivia,BO,BOL,11353142,America,33,564,22
2020-04-21T00:00:00Z,21,4,2020,34,1,Bolivia,BO,BOL,11353142,America,34,598,23
2020-04-22T00:00:00Z,22,4,2020,11,3,Bolivia,BO,BOL,11353142,America,37,609,24
2020-04-23T00:00:00Z,23,4,2020,63,3,Bolivia,BO,BOL,11353142,America,40,672,25
2020-04-24T00:00:00Z,24,4,2020,31,3,Bolivia,BO,BOL,11353142,America,43,703,26
2020-04-25T00:00:00Z,25,4,2020,104,1,Bolivia,BO,BOL,11353142,America,44,807,27
2020-04-26T00:00:00Z,26,4,2020,59,2,Bolivia,BO,BOL,11353142,America,46,866,28
2020-04-27T00:00:00Z,27,4,2020,84,4,Bolivia,BO,BOL,11353142,America,50,950,29
2020-04-28T00:00:00Z,28,4,2020,64,3,Bolivia,BO,BOL,11353142,America,53,1014,30
2020-04-29T00:00:00Z,29,4,2020,39,2,Bolivia,BO,BOL,11353142,America,55,1053,31
2020-04-30T00:00:00Z,30,4,2020,57,4,Bolivia,BO,BOL,11353142,America,59,1110,32
2020-05-01T00:00:00Z,1,5,2020,57,3,Bolivia,BO,BOL,11353142,America,62,1167,33
2020-05-02T00:00:00Z,2,5,2020,62,4,Bolivia,BO,BOL,11353142,America,66,1229,34
2020-05-03T00:00:00Z,3,5,2020,241,5,Bolivia,BO,BOL,11353142,America,71,1470,35
2020-05-04T00:00:00Z,4,5,2020,124,5,Bolivia,BO,BOL,11353142,America,76,1594,36
2020-05-05T00:00:00Z,5,5,2020,87,6,Bolivia,BO,BOL,11353142,America,82,1681,37
2020-05-06T00:00:00Z,6,5,2020,121,4,Bolivia,BO,BOL,11353142,America,86,1802,38
2020-05-07T00:00:00Z,7,5,2020,84,5,Bolivia,BO,BOL,11353142,America,91,1886,39
2020-05-08T00:00:00Z,8,5,2020,195,11,Bolivia,BO,BOL,11353142,America,102,2081,40
2020-05-09T00:00:00Z,9,5,2020,185,4,Bolivia,BO,BOL,11353142,America,106,2266,41
2020-05-10T00:00:00Z,10,5,2020,171,8,Bolivia,BO,BOL,11353142,America,114,2437,42
2020-05-11T00:00:00Z,11,5,2020,119,4,Bolivia,BO,BOL,11353142,America,118,2556,43
2020-05-12T00:00:00Z,12,5,2020,275,4,Bolivia,BO,BOL,11353142,America,122,2831,44
2020-05-13T00:00:00Z,13,5,2020,133,6,Bolivia,BO,BOL,11353142,America,128,2964,45
2020-05-14T00:00:00Z,14,5,2020,184,14,Bolivia,BO,BOL,11353142,America,142,3148,46
2020-05-15T00:00:00Z,15,5,2020,224,10,Bolivia,BO,BOL,11353142,America,152,3372,47
2020-05-16T00:00:00Z,16,5,2020,205,12,Bolivia,BO,BOL,11353142,America,164,3577,48
2020-05-17T00:00:00Z,17,5,2020,249,1,Bolivia,BO,BOL,11353142,America,165,3826,49
2020-05-18T00:00:00Z,18,5,2020,262,4,Bolivia,BO,BOL,11353142,America,169,4088,50
2020-05-19T00:00:00Z,19,5,2020,175,5,Bolivia,BO,BOL,11353142,America,174,4263,51
2020-05-20T00:00:00Z,20,5,2020,218,15,Bolivia,BO,BOL,11353142,America,189,4481,52
2020-05-21T00:00:00Z,21,5,2020,438,10,Bolivia,BO,BOL,11353142,America,199,4919,53
2020-05-22T00:00:00Z,22,5,2020,268,16,Bolivia,BO,BOL,11353142,America,215,5187,54
2020-05-23T00:00:00Z,23,5,2020,392,15,Bolivia,BO,BOL,11353142,America,230,5579,55
2020-05-24T00:00:00Z,24,5,2020,336,10,Bolivia,BO,BOL,11353142,America,240,5915,56
2020-05-25T00:00:00Z,25,5,2020,348,10,Bolivia,BO,BOL,11353142,America,250,6263,57
2020-05-26T00:00:00Z,26,5,2020,397,11,Bolivia,BO,BOL,11353142,America,261,6660,58
2020-05-27T00:00:00Z,27,5,2020,476,13,Bolivia,BO,BOL,11353142,America,274,7136,59
2020-03-22T00:00:00Z,22,3,2020,48,1,Bosnia_and_Herzegovina,BA,BIH,3323929,Europe,1,92,1
2020-03-23T00:00:00Z,23,3,2020,33,0,Bosnia_and_Herzegovina,BA,BIH,3323929,Europe,1,125,2
2020-03-24T00:00:00Z,24,3,2020,4,0,Bosnia_and_Herzegovina,BA,BIH,3323929,Europe,1,129,3
2020-03-25T00:00:00Z,25,3,2020,33,1,Bosnia_and_Herzegovina,BA,BIH,3323929,Europe,2,162,4
2020-03-26T00:00:00Z,26,3,2020,19,1,Bosnia_and_Herzegovina,BA,BIH,3323929,Europe,3,181,5
2020-03-27T00:00:00Z,27,3,2020,0,0,Bosnia_and_Herzegovina,BA,BIH,3323929,Europe,3,181,6
2020-03-28T00:00:00Z,28,3,2020,48,0,Bosnia_and_Herzegovina,BA,BIH,3323929,Europe,3,229,7
2020-03-29T00:00:00Z,29,3,2020,28,2,Bosnia_and_Herzegovina,BA,BIH,3323929,Europe,5,257,8
2020-03-30T00:00:00Z,30,3,2020,66,1,Bosnia_and_Herzegovina,BA,BIH,3323929,Europe,6,323,9
2020-03-31T00:00:00Z,31,3,2020,30,2,Bosnia_and_Herzegovina,BA,BIH,3323929,Europe,8,353,10
2020-04-01T00:00:00Z,1,4,2020,60,4,Bosnia_and_Herzegovina,BA,BIH,3323929,Europe,12,413,11
2020-04-02T00:00:00Z,2,4,2020,51,1,Bosnia_and_Herzegovina,BA,BIH,3323929,Europe,13,464,12
2020-04-03T00:00:00Z,3,4,2020,68,4,Bosnia_and_Herzegovina,BA,BIH,3323929,Europe,17,532,13
2020-04-04T00:00:00Z,4,4,2020,54,1,Bosnia_and_Herzegovina,BA,BIH,3323929,Europe,18,586,14
2020-04-05T00:00:00Z,5,4,2020,46,3,Bosnia_and_Herzegovina,BA,BIH,3323929,Europe,21,632,15
2020-04-06T00:00:00Z,6,4,2020,31,3,Bosnia_and_Herzegovina,BA,BIH,3323929,Europe,24,663,16
2020-04-07T00:00:00Z,7,4,2020,32,4,Bosnia_and_Herzegovina,BA,BIH,3323929,Europe,28,695,17
2020-04-08T00:00:00Z,8,4,2020,86,4,Bosnia_and_Herzegovina,BA,BIH,3323929,Europe,32,781,18
2020-04-09T00:00:00Z,9,4,2020,35,3,Bosnia_and_Herzegovina,BA,BIH,3323929,Europe,35,816,19
2020-04-10T00:00:00Z,10,4,2020,59,1,Bosnia_and_Herzegovina,BA,BIH,3323929,Europe,36,875,20
2020-04-11T00:00:00Z,11,4,2020,26,1,Bosnia_and_Herzegovina,BA,BIH,3323929,Europe,37,901,21
2020-04-12T00:00:00Z,12,4,2020,47,0,Bosnia_and_Herzegovina,BA,BIH,3323929,Europe,37,948,22
2020-04-13T00:00:00Z,13,4,2020,59,1,Bosnia_and_Herzegovina,BA,BIH,3323929,Europe,38,1007,23
2020-04-14T00:00:00Z,14,4,2020,21,0,Bosnia_and_Herzegovina,BA,BIH,3323929,Europe,38,1028,24
2020-04-15T00:00:00Z,15,4,2020,45,1,Bosnia_and_Herzegovina,BA,BIH,3323929,Europe,39,1073,25
2020-04-16T00:00:00Z,16,4,2020,27,1,Bosnia_and_Herzegovina,BA,BIH,3323929,Europe,40,1100,26
2020-04-17T00:00:00Z,17,4,2020,52,1,Bosnia_and_Herzegovina,BA,BIH,3323929,Europe,41,1152,27
2020-04-18T00:00:00Z,18,4,2020,58,3,Bosnia_and_Herzegovina,BA,BIH,3323929,Europe,44,1210,28
2020-04-19T00:00:00Z,19,4,2020,44,1,Bosnia_and_Herzegovina,BA,BIH,3323929,Europe,45,1254,29
2020-04-20T00:00:00Z,20,4,2020,15,1,Bosnia_and_Herzegovina,BA,BIH,3323929,Europe,46,1269,30
2020-04-21T00:00:00Z,21,4,2020,31,2,Bosnia_and_Herzegovina,BA,BIH,3323929,Europe,48,1300,31
2020-04-22T00:00:00Z,22,4,2020,40,2,Bosnia_and_Herzegovina,BA,BIH,3323929,Europe,50,1340,32
2020-04-23T00:00:00Z,23,4,2020,27,2,Bosnia_and_Herzegovina,BA,BIH,3323929,Europe,52,1367,33
2020-04-24T00:00:00Z,24,4,2020,46,1,Bosnia_and_Herzegovina,BA,BIH,3323929,Europe,53,1413,34
2020-04-25T00:00:00Z,25,4,2020,7,1,Bosnia_and_Herzegovina,BA,BIH,3323929,Europe,54,1420,35
2020-04-26T00:00:00Z,26,4,2020,65,2,Bosnia_and_Herzegovina,BA,BIH,3323929,Europe,56,1485,36
2020-04-27T00:00:00Z,27,4,2020,31,2,Bosnia_and_Herzegovina,BA,BIH,3323929,Europe,58,1516,37
2020-04-28T00:00:00Z,28,4,2020,48,2,Bosnia_and_Herzegovina,BA,BIH,3323929,Europe,60,1564,38
2020-04-29T00:00:00Z,29,4,2020,24,2,Bosnia_and_Herzegovina,BA,BIH,3323929,Europe,62,1588,39
2020-04-30T00:00:00Z,30,4,2020,0,0,Bosnia_and_Herzegovina,BA,BIH,3323929,Europe,62,1588,40
2020-05-01T00:00:00Z,1,5,2020,101,2,Bosnia_and_Herzegovina,BA,BIH,3323929,Europe,64,1689,41
2020-05-02T00:00:00Z,2,5,2020,92,6,Bosnia_and_Herzegovina,BA,BIH,3323929,Europe,70,1781,42
2020-05-03T00:00:00Z,3,5,2020,58,2,Bosnia_and_Herzegovina,BA,BIH,3323929,Europe,72,1839,43
2020-05-04T00:00:00Z,4,5,2020,18,5,Bosnia_and_Herzegovina,BA,BIH,3323929,Europe,77,1857,44
2020-05-05T00:00:00Z,5,5,2020,69,1,Bosnia_and_Herzegovina,BA,BIH,3323929,Europe,78,1926,45
2020-05-06T00:00:00Z,6,5,2020,20,1,Bosnia_and_Herzegovina,BA,BIH,3323929,Europe,79,1946,46
2020-05-07T00:00:00Z,7,5,2020,41,7,Bosnia_and_Herzegovina,BA,BIH,3323929,Europe,86,1987,47
2020-05-08T00:00:00Z,8,5,2020,40,4,Bosnia_and_Herzegovina,BA,BIH,3323929,Europe,90,2027,48
2020-05-09T00:00:00Z,9,5,2020,43,8,Bosnia_and_Herzegovina,BA,BIH,3323929,Europe,98,2070,49
2020-05-10T00:00:00Z,10,5,2020,0,0,Bosnia_and_Herzegovina,BA,BIH,3323929,Europe,98,2070,50
2020-05-11T00:00:00Z,11,5,2020,20,4,Bosnia_and_Herzegovina,BA,BIH,3323929,Europe,102,2090,51
2020-05-12T00:00:00Z,12,5,2020,52,10,Bosnia_and_Herzegovina,BA,BIH,3323929,Europe,112,2142,52
2020-05-13T00:00:00Z,13,5,2020,16,5,Bosnia_and_Herzegovina,BA,BIH,3323929,Europe,117,2158,53
2020-05-14T00:00:00Z,14,5,2020,23,3,Bosnia_and_Herzegovina,BA,BIH,3323929,Europe,120,2181,54
2020-05-15T00:00:00Z,15,5,2020,35,3,Bosnia_and_Herzegovina,BA,BIH,3323929,Europe,123,2216,55
2020-05-16T00:00:00Z,16,5,2020,21,4,Bosnia_and_Herzegovina,BA,BIH,3323929,Europe,127,2237,56
2020-05-17T00:00:00Z,17,5,2020,30,2,Bosnia_and_Herzegovina,BA,BIH,3323929,Europe,129,2267,57
2020-05-18T00:00:00Z,18,5,2020,22,3,Bosnia_and_Herzegovina,BA,BIH,3323929,Europe,132,2289,58
2020-05-19T00:00:00Z,19,5,2020,14,0,Bosnia_and_Herzegovina,BA,BIH,3323929,Europe,132,2303,59
2020-05-20T00:00:00Z,20,5,2020,16,1,Bosnia_and_Herzegovina,BA,BIH,3323929,Europe,133,2319,60
2020-05-21T00:00:00Z,21,5,2020,15,2,Bosnia_and_Herzegovina,BA,BIH,3323929,Europe,135,2334,61
2020-05-22T00:00:00Z,22,5,2020,18,4,Bosnia_and_Herzegovina,BA,BIH,3323929,Europe,139,2352,62
2020-05-23T00:00:00Z,23,5,2020,20,2,Bosnia_and_Herzegovina,BA,BIH,3323929,Europe,141,2372,63
2020-05-24T00:00:00Z,24,5,2020,19,0,Bosnia_and_Herzegovina,BA,BIH,3323929,Europe,141,2391,64
2020-05-25T00:00:00Z,25,5,2020,10,3,Bosnia_and_Herzegovina,BA,BIH,3323929,Europe,144,2401,65
2020-05-26T00:00:00Z,26,5,2020,5,2,Bosnia_and_Herzegovina,BA,BIH,3323929,Europe,146,2406,66
2020-05-27T00:00:00Z,27,5,2020,10,3,Bosnia_and_Herzegovina,BA,BIH,3323929,Europe,149,2416,67
2020-04-02T00:00:00Z,2,4,2020,1,1,Botswana,BW,BWA,2254126,Africa,1,4,1
2020-04-03T00:00:00Z,3,4,2020,0,0,Botswana,BW,BWA,2254126,Africa,1,4,2
2020-04-04T00:00:00Z,4,4,2020,0,0,Botswana,BW,BWA,2254126,Africa,1,4,3
2020-04-05T00:00:00Z,5,4,2020,0,0,Botswana,BW,BWA,2254126,Africa,1,4,4
2020-04-06T00:00:00Z,6,4,2020,2,0,Botswana,BW,BWA,2254126,Africa,1,6,5
2020-04-07T00:00:00Z,7,4,2020,0,0,Botswana,BW,BWA,2254126,Africa,1,6,6
2020-04-08T00:00:00Z,8,4,2020,0,0,Botswana,BW,BWA,2254126,Africa,1,6,7
2020-04-09T00:00:00Z,9,4,2020,1,0,Botswana,BW,BWA,2254126,Africa,1,7,8
2020-04-10T00:00:00Z,10,4,2020,6,0,Botswana,BW,BWA,2254126,Africa,1,13,9
2020-04-11T00:00:00Z,11,4,2020,0,0,Botswana,BW,BWA,2254126,Africa,1,13,10
2020-04-12T00:00:00Z,12,4,2020,0,0,Botswana,BW,BWA,2254126,Africa,1,13,11
2020-04-13T00:00:00Z,13,4,2020,0,0,Botswana,BW,BWA,2254126,Africa,1,13,12
2020-04-14T00:00:00Z,14,4,2020,0,0,Botswana,BW,BWA,2254126,Africa,1,13,13
2020-04-15T00:00:00Z,15,4,2020,0,0,Botswana,BW,BWA,2254126,Africa,1,13,14
2020-04-16T00:00:00Z,16,4,2020,0,0,Botswana,BW,BWA,2254126,Africa,1,13,15
2020-04-17T00:00:00Z,17,4,2020,2,0,Botswana,BW,BWA,2254126,Africa,1,15,16
2020-04-18T00:00:00Z,18,4,2020,0,0,Botswana,BW,BWA,2254126,Africa,1,15,17
2020-04-19T00:00:00Z,19,4,2020,0,0,Botswana,BW,BWA,2254126,Africa,1,15,18
2020-04-20T00:00:00Z,20,4,2020,5,0,Botswana,BW,BWA,2254126,Africa,1,20,19
2020-04-21T00:00:00Z,21,4,2020,0,0,Botswana,BW,BWA,2254126,Africa,1,20,20
2020-04-22T00:00:00Z,22,4,2020,0,0,Botswana,BW,BWA,2254126,Africa,1,20,21
2020-04-23T00:00:00Z,23,4,2020,2,0,Botswana,BW,BWA,2254126,Africa,1,22,22
2020-04-24T00:00:00Z,24,4,2020,0,0,Botswana,BW,BWA,2254126,Africa,1,22,23
2020-04-25T00:00:00Z,25,4,2020,0,0,Botswana,BW,BWA,2254126,Africa,1,22,24
2020-04-26T00:00:00Z,26,4,2020,0,0,Botswana,BW,BWA,2254126,Africa,1,22,25
2020-04-27T00:00:00Z,27,4,2020,0,0,Botswana,BW,BWA,2254126,Africa,1,22,26
2020-04-28T00:00:00Z,28,4,2020,0,0,Botswana,BW,BWA,2254126,Africa,1,22,27
2020-04-29T00:00:00Z,29,4,2020,1,0,Botswana,BW,BWA,2254126,Africa,1,23,28
2020-04-30T00:00:00Z,30,4,2020,0,0,Botswana,BW,BWA,2254126,Africa,1,23,29
2020-05-01T00:00:00Z,1,5,2020,0,0,Botswana,BW,BWA,2254126,Africa,1,23,30
2020-05-02T00:00:00Z,2,5,2020,0,0,Botswana,BW,BWA,2254126,Africa,1,23,31
2020-05-03T00:00:00Z,3,5,2020,0,0,Botswana,BW,BWA,2254126,Africa,1,23,32
2020-05-04T00:00:00Z,4,5,2020,0,0,Botswana,BW,BWA,2254126,Africa,1,23,33
2020-05-05T00:00:00Z,5,5,2020,0,0,Botswana,BW,BWA,2254126,Africa,1,23,34
2020-05-06T00:00:00Z,6,5,2020,0,0,Botswana,BW,BWA,2254126,Africa,1,23,35
2020-05-07T00:00:00Z,7,5,2020,0,0,Botswana,BW,BWA,2254126,Africa,1,23,36
2020-05-08T00:00:00Z,8,5,2020,0,0,Botswana,BW,BWA,2254126,Africa,1,23,37
2020-05-09T00:00:00Z,9,5,2020,0,0,Botswana,BW,BWA,2254126,Africa,1,23,38
2020-05-10T00:00:00Z,10,5,2020,0,0,Botswana,BW,BWA,2254126,Africa,1,23,39
2020-05-11T00:00:00Z,11,5,2020,0,0,Botswana,BW,BWA,2254126,Africa,1,23,40
2020-05-12T00:00:00Z,12,5,2020,1,0,Botswana,BW,BWA,2254126,Africa,1,24,41
2020-05-13T00:00:00Z,13,5,2020,0,0,Botswana,BW,BWA,2254126,Africa,1,24,42
2020-05-14T00:00:00Z,14,5,2020,0,0,Botswana,BW,BWA,2254126,Africa,1,24,43
2020-05-15T00:00:00Z,15,5,2020,0,0,Botswana,BW,BWA,2254126,Africa,1,24,44
2020-05-16T00:00:00Z,16,5,2020,0,0,Botswana,BW,BWA,2254126,Africa,1,24,45
2020-05-17T00:00:00Z,17,5,2020,0,0,Botswana,BW,BWA,2254126,Africa,1,24,46
2020-05-18T00:00:00Z,18,5,2020,1,0,Botswana,BW,BWA,2254126,Africa,1,25,47
2020-05-19T00:00:00Z,19,5,2020,0,0,Botswana,BW,BWA,2254126,Africa,1,25,48
2020-05-20T00:00:00Z,20,5,2020,0,0,Botswana,BW,BWA,2254126,Africa,1,25,49
2020-05-21T00:00:00Z,21,5,2020,4,0,Botswana,BW,BWA,2254126,Africa,1,29,50
2020-05-22T00:00:00Z,22,5,2020,0,0,Botswana,BW,BWA,2254126,Africa,1,29,51
2020-05-23T00:00:00Z,23,5,2020,1,0,Botswana,BW,BWA,2254126,Africa,1,30,52
2020-05-24T00:00:00Z,24,5,2020,0,0,Botswana,BW,BWA,2254126,Africa,1,30,53
2020-05-25T00:00:00Z,25,5,2020,5,0,Botswana,BW,BWA,2254126,Africa,1,35,54
2020-05-26T00:00:00Z,26,5,2020,0,0,Botswana,BW,BWA,2254126,Africa,1,35,55
2020-05-27T00:00:00Z,27,5,2020,0,0,Botswana,BW,BWA,2254126,Africa,1,35,56
2020-03-18T00:00:00Z,18,3,2020,57,1,Brazil,BR,BRA,209469333,America,1,291,1
2020-03-19T00:00:00Z,19,3,2020,137,3,Brazil,BR,BRA,209469333,America,4,428,2
2020-03-20T00:00:00Z,20,3,2020,193,2,Brazil,BR,BRA,209469333,America,6,621,3
2020-03-21T00:00:00Z,21,3,2020,283,5,Brazil,BR,BRA,209469333,America,11,904,4
2020-03-22T00:00:00Z,22,3,2020,224,7,Brazil,BR,BRA,209469333,America,18,1128,5
2020-03-23T00:00:00Z,23,3,2020,418,7,Brazil,BR,BRA,209469333,America,25,1546,6
2020-03-24T00:00:00Z,24,3,2020,345,9,Brazil,BR,BRA,209469333,America,34,1891,7
2020-03-25T00:00:00Z,25,3,2020,310,12,Brazil,BR,BRA,209469333,America,46,2201,8
2020-03-26T00:00:00Z,26,3,2020,232,11,Brazil,BR,BRA,209469333,America,57,2433,9
2020-03-27T00:00:00Z,27,3,2020,482,20,Brazil,BR,BRA,209469333,America,77,2915,10
2020-03-28T00:00:00Z,28,3,2020,502,15,Brazil,BR,BRA,209469333,America,92,3417,11
2020-03-29T00:00:00Z,29,3,2020,487,22,Brazil,BR,BRA,209469333,America,114,3904,12
2020-03-30T00:00:00Z,30,3,2020,352,22,Brazil,BR,BRA,209469333,America,136,4256,13
2020-03-31T00:00:00Z,31,3,2020,323,23,Brazil,BR,BRA,209469333,America,159,4579,14
2020-04-01T00:00:00Z,1,4,2020,1138,42,Brazil,BR,BRA,209469333,America,201,5717,15
2020-04-02T00:00:00Z,2,4,2020,1119,40,Brazil,BR,BRA,209469333,America,241,6836,16
2020-04-03T00:00:00Z,3,4,2020,1074,58,Brazil,BR,BRA,209469333,America,299,7910,17
2020-04-04T00:00:00Z,4,4,2020,1146,60,Brazil,BR,BRA,209469333,America,359,9056,18
2020-04-05T00:00:00Z,5,4,2020,1222,73,Brazil,BR,BRA,209469333,America,432,10278,19
2020-04-06T00:00:00Z,6,4,2020,852,54,Brazil,BR,BRA,209469333,America,486,11130,20
2020-04-07T00:00:00Z,7,4,2020,926,67,Brazil,BR,BRA,209469333,America,553,12056,21
2020-04-08T00:00:00Z,8,4,2020,1661,114,Brazil,BR,BRA,209469333,America,667,13717,22
2020-04-09T00:00:00Z,9,4,2020,2210,133,Brazil,BR,BRA,209469333,America,800,15927,23
2020-04-10T00:00:00Z,10,4,2020,1930,141,Brazil,BR,BRA,209469333,America,941,17857,24
2020-04-11T00:00:00Z,11,4,2020,1781,115,Brazil,BR,BRA,209469333,America,1056,19638,25
2020-04-12T00:00:00Z,12,4,2020,1089,68,Brazil,BR,BRA,209469333,America,1124,20727,26
2020-04-13T00:00:00Z,13,4,2020,1442,99,Brazil,BR,BRA,209469333,America,1223,22169,27
2020-04-14T00:00:00Z,14,4,2020,1261,105,Brazil,BR,BRA,209469333,America,1328,23430,28
2020-04-15T00:00:00Z,15,4,2020,1832,204,Brazil,BR,BRA,209469333,America,1532,25262,29
2020-04-16T00:00:00Z,16,4,2020,3058,204,Brazil,BR,BRA,209469333,America,1736,28320,30
2020-04-17T00:00:00Z,17,4,2020,2105,188,Brazil,BR,BRA,209469333,America,1924,30425,31
2020-04-18T00:00:00Z,18,4,2020,3257,217,Brazil,BR,BRA,209469333,America,2141,33682,32
2020-04-19T00:00:00Z,19,4,2020,2917,206,Brazil,BR,BRA,209469333,America,2347,36599,33
2020-04-20T00:00:00Z,20,4,2020,2055,115,Brazil,BR,BRA,209469333,America,2462,38654,34
2020-04-21T00:00:00Z,21,4,2020,1927,113,Brazil,BR,BRA,209469333,America,2575,40581,35
2020-04-22T00:00:00Z,22,4,2020,2498,166,Brazil,BR,BRA,209469333,America,2741,43079,36
2020-04-23T00:00:00Z,23,4,2020,2678,165,Brazil,BR,BRA,209469333,America,2906,45757,37
2020-04-24T00:00:00Z,24,4,2020,3735,407,Brazil,BR,BRA,209469333,America,3313,49492,38
2020-04-25T00:00:00Z,25,4,2020,3503,357,Brazil,BR,BRA,209469333,America,3670,52995,39
2020-04-26T00:00:00Z,26,4,2020,5514,346,Brazil,BR,BRA,209469333,America,4016,58509,40
2020-04-27T00:00:00Z,27,4,2020,3379,189,Brazil,BR,BRA,209469333,America,4205,61888,41
2020-04-28T00:00:00Z,28,4,2020,4613,338,Brazil,BR,BRA,209469333,America,4543,66501,42
2020-04-29T00:00:00Z,29,4,2020,5385,474,Brazil,BR,BRA,209469333,America,5017,71886,43
2020-04-30T00:00:00Z,30,4,2020,6276,449,Brazil,BR,BRA,209469333,America,5466,78162,44
2020-05-01T00:00:00Z,1,5,2020,7218,435,Brazil,BR,BRA,209469333,America,5901,85380,45
2020-05-02T00:00:00Z,2,5,2020,6209,428,Brazil,BR,BRA,209469333,America,6329,91589,46
2020-05-03T00:00:00Z,3,5,2020,4970,421,Brazil,BR,BRA,209469333,America,6750,96559,47
2020-05-04T00:00:00Z,4,5,2020,4588,275,Brazil,BR,BRA,209469333,America,7025,101147,48
2020-05-05T00:00:00Z,5,5,2020,6633,296,Brazil,BR,BRA,209469333,America,7321,107780,49
2020-05-06T00:00:00Z,6,5,2020,6935,600,Brazil,BR,BRA,209469333,America,7921,114715,50
2020-05-07T00:00:00Z,7,5,2020,10503,615,Brazil,BR,BRA,209469333,America,8536,125218,51
2020-05-08T00:00:00Z,8,5,2020,9888,610,Brazil,BR,BRA,209469333,America,9146,135106,52
2020-05-09T00:00:00Z,9,5,2020,10222,751,Brazil,BR,BRA,209469333,America,9897,145328,53
2020-05-10T00:00:00Z,10,5,2020,10611,730,Brazil,BR,BRA,209469333,America,10627,155939,54
2020-05-11T00:00:00Z,11,5,2020,6760,496,Brazil,BR,BRA,209469333,America,11123,162699,55
2020-05-12T00:00:00Z,12,5,2020,5632,396,Brazil,BR,BRA,209469333,America,11519,168331,56
2020-05-13T00:00:00Z,13,5,2020,9258,881,Brazil,BR,BRA,209469333,America,12400,177589,57
2020-05-14T00:00:00Z,14,5,2020,11385,749,Brazil,BR,BRA,209469333,America,13149,188974,58
2020-05-15T00:00:00Z,15,5,2020,13944,844,Brazil,BR,BRA,209469333,America,13993,202918,59
2020-05-16T00:00:00Z,16,5,2020,15305,824,Brazil,BR,BRA,209469333,America,14817,218223,60
2020-05-17T00:00:00Z,17,5,2020,14919,816,Brazil,BR,BRA,209469333,America,15633,233142,61
2020-05-18T00:00:00Z,18,5,2020,7938,485,Brazil,BR,BRA,209469333,America,16118,241080,62
2020-05-19T00:00:00Z,19,5,2020,13140,674,Brazil,BR,BRA,209469333,America,16792,254220,63
2020-05-20T00:00:00Z,20,5,2020,17408,1179,Brazil,BR,BRA,209469333,America,17971,271628,64
2020-05-21T00:00:00Z,21,5,2020,19951,888,Brazil,BR,BRA,209469333,America,18859,291579,65
2020-05-22T00:00:00Z,22,5,2020,18508,1188,Brazil,BR,BRA,209469333,America,20047,310087,66
2020-05-23T00:00:00Z,23,5,2020,20803,1001,Brazil,BR,BRA,209469333,America,21048,330890,67
2020-05-24T00:00:00Z,24,5,2020,16508,965,Brazil,BR,BRA,209469333,America,22013,347398,68
2020-05-25T00:00:00Z,25,5,2020,15813,653,Brazil,BR,BRA,209469333,America,22666,363211,69
2020-05-26T00:00:00Z,26,5,2020,11687,807,Brazil,BR,BRA,209469333,America,23473,374898,70
2020-05-27T00:00:00Z,27,5,2020,16324,1039,Brazil,BR,BRA,209469333,America,24512,391222,71
2020-04-20T00:00:00Z,20,4,2020,1,1,British_Virgin_Islands,VG,VGB,29802,America,1,4,1
2020-04-21T00:00:00Z,21,4,2020,1,0,British_Virgin_Islands,VG,VGB,29802,America,1,5,2
2020-04-22T00:00:00Z,22,4,2020,0,0,British_Virgin_Islands,VG,VGB,29802,America,1,5,3
2020-04-23T00:00:00Z,23,4,2020,0,0,British_Virgin_Islands,VG,VGB,29802,America,1,5,4
2020-04-24T00:00:00Z,24,4,2020,0,0,British_Virgin_Islands,VG,VGB,29802,America,1,5,5
2020-04-25T00:00:00Z,25,4,2020,1,0,British_Virgin_Islands,VG,VGB,29802,America,1,6,6
2020-04-26T00:00:00Z,26,4,2020,0,0,British_Virgin_Islands,VG,VGB,29802,America,1,6,7
2020-04-27T00:00:00Z,27,4,2020,0,0,British_Virgin_Islands,VG,VGB,29802,America,1,6,8
2020-04-28T00:00:00Z,28,4,2020,0,0,British_Virgin_Islands,VG,VGB,29802,America,1,6,9
2020-04-29T00:00:00Z,29,4,2020,0,0,British_Virgin_Islands,VG,VGB,29802,America,1,6,10
2020-04-30T00:00:00Z,30,4,2020,0,0,British_Virgin_Islands,VG,VGB,29802,America,1,6,11
2020-05-01T00:00:00Z,1,5,2020,0,0,British_Virgin_Islands,VG,VGB,29802,America,1,6,12
2020-05-02T00:00:00Z,2,5,2020,0,0,British_Virgin_Islands,VG,VGB,29802,America,1,6,13
2020-05-03T00:00:00Z,3,5,2020,0,0,British_Virgin_Islands,VG,VGB,29802,America,1,6,14
2020-05-04T00:00:00Z,4,5,2020,0,0,British_Virgin_Islands,VG,VGB,29802,America,1,6,15
2020-05-05T00:00:00Z,5,5,2020,1,0,British_Virgin_Islands,VG,VGB,29802,America,1,7,16
2020-05-06T00:00:00Z,6,5,2020,0,0,British_Virgin_Islands,VG,VGB,29802,America,1,7,17
2020-05-07T00:00:00Z,7,5,2020,0,0,British_Virgin_Islands,VG,VGB,29802,America,1,7,18
2020-05-08T00:00:00Z,8,5,2020,0,0,British_Virgin_Islands,VG,VGB,29802,America,1,7,19
2020-05-09T00:00:00Z,9,5,2020,0,0,British_Virgin_Islands,VG,VGB,29802,America,1,7,20
2020-05-10T00:00:00Z,10,5,2020,0,0,British_Virgin_Islands,VG,VGB,29802,America,1,7,21
2020-05-11T00:00:00Z,11,5,2020,0,0,British_Virgin_Islands,VG,VGB,29802,America,1,7,22
2020-05-12T00:00:00Z,12,5,2020,0,0,British_Virgin_Islands,VG,VGB,29802,America,1,7,23
2020-05-13T00:00:00Z,13,5,2020,0,0,British_Virgin_Islands,VG,VGB,29802,America,1,7,24
2020-05-14T00:00:00Z,14,5,2020,0,0,British_Virgin_Islands,VG,VGB,29802,America,1,7,25
2020-05-15T00:00:00Z,15,5,2020,1,0,British_Virgin_Islands,VG,VGB,29802,America,1,8,26
2020-05-16T00:00:00Z,16,5,2020,0,0,British_Virgin_Islands,VG,VGB,29802,America,1,8,27
2020-05-17T00:00:00Z,17,5,2020,0,0,British_Virgin_Islands,VG,VGB,29802,America,1,8,28
2020-05-18T00:00:00Z,18,5,2020,0,0,British_Virgin_Islands,VG,VGB,29802,America,1,8,29
2020-05-19T00:00:00Z,19,5,2020,0,0,British_Virgin_Islands,VG,VGB,29802,America,1,8,30
2020-05-20T00:00:00Z,20,5,2020,0,0,British_Virgin_Islands,VG,VGB,29802,America,1,8,31
2020-05-21T00:00:00Z,21,5,2020,0,0,British_Virgin_Islands,VG,VGB,29802,America,1,8,32
2020-05-22T00:00:00Z,22,5,2020,0,0,British_Virgin_Islands,VG,VGB,29802,America,1,8,33
2020-05-23T00:00:00Z,23,5,2020,0,0,British_Virgin_Islands,VG,VGB,29802,America,1,8,34
2020-05-24T00:00:00Z,24,5,2020,0,0,British_Virgin_Islands,VG,VGB,29802,America,1,8,35
2020-05-25T00:00:00Z,25,5,2020,0,0,British_Virgin_Islands,VG,VGB,29802,America,1,8,36
2020-05-26T00:00:00Z,26,5,2020,0,0,British_Virgin_Islands,VG,VGB,29802,America,1,8,37
2020-05-27T00:00:00Z,27,5,2020,0,0,British_Virgin_Islands,VG,VGB,29802,America,1,8,38
2020-03-29T00:00:00Z,29,3,2020,5,1,Brunei_Darussalam,BN,BRN,428962,Asia,1,120,1
2020-03-30T00:00:00Z,30,3,2020,6,0,Brunei_Darussalam,BN,BRN,428962,Asia,1,126,2
2020-03-31T00:00:00Z,31,3,2020,1,0,Brunei_Darussalam,BN,BRN,428962,Asia,1,127,3
2020-04-01T00:00:00Z,1,4,2020,2,0,Brunei_Darussalam,BN,BRN,428962,Asia,1,129,4
2020-04-02T00:00:00Z,2,4,2020,2,0,Brunei_Darussalam,BN,BRN,428962,Asia,1,131,5
2020-04-03T00:00:00Z,3,4,2020,2,0,Brunei_Darussalam,BN,BRN,428962,Asia,1,133,6
2020-04-04T00:00:00Z,4,4,2020,0,0,Brunei_Darussalam,BN,BRN,428962,Asia,1,133,7
2020-04-05T00:00:00Z,5,4,2020,2,0,Brunei_Darussalam,BN,BRN,428962,Asia,1,135,8
2020-04-06T00:00:00Z,6,4,2020,0,0,Brunei_Darussalam,BN,BRN,428962,Asia,1,135,9
2020-04-07T00:00:00Z,7,4,2020,0,0,Brunei_Darussalam,BN,BRN,428962,Asia,1,135,10
2020-04-08T00:00:00Z,8,4,2020,0,0,Brunei_Darussalam,BN,BRN,428962,Asia,1,135,11
2020-04-09T00:00:00Z,9,4,2020,0,0,Brunei_Darussalam,BN,BRN,428962,Asia,1,135,12
2020-04-10T00:00:00Z,10,4,2020,0,0,Brunei_Darussalam,BN,BRN,428962,Asia,1,135,13
2020-04-11T00:00:00Z,11,4,2020,1,0,Brunei_Darussalam,BN,BRN,428962,Asia,1,136,14
2020-04-12T00:00:00Z,12,4,2020,0,0,Brunei_Darussalam,BN,BRN,428962,Asia,1,136,15
2020-04-13T00:00:00Z,13,4,2020,0,0,Brunei_Darussalam,BN,BRN,428962,Asia,1,136,16
2020-04-14T00:00:00Z,14,4,2020,0,0,Brunei_Darussalam,BN,BRN,428962,Asia,1,136,17
2020-04-15T00:00:00Z,15,4,2020,0,0,Brunei_Darussalam,BN,BRN,428962,Asia,1,136,18
2020-04-16T00:00:00Z,16,4,2020,0,0,Brunei_Darussalam,BN,BRN,428962,Asia,1,136,19
2020-04-17T00:00:00Z,17,4,2020,0,0,Brunei_Darussalam,BN,BRN,428962,Asia,1,136,20
2020-04-18T00:00:00Z,18,4,2020,0,0,Brunei_Darussalam,BN,BRN,428962,Asia,1,136,21
2020-04-19T00:00:00Z,19,4,2020,1,0,Brunei_Darussalam,BN,BRN,428962,Asia,1,137,22
2020-04-20T00:00:00Z,20,4,2020,1,0,Brunei_Darussalam,BN,BRN,428962,Asia,1,138,23
2020-04-21T00:00:00Z,21,4,2020,0,0,Brunei_Darussalam,BN,BRN,428962,Asia,1,138,24
2020-04-22T00:00:00Z,22,4,2020,0,0,Brunei_Darussalam,BN,BRN,428962,Asia,1,138,25
2020-04-23T00:00:00Z,23,4,2020,0,0,Brunei_Darussalam,BN,BRN,428962,Asia,1,138,26
2020-04-24T00:00:00Z,24,4,2020,0,0,Brunei_Darussalam,BN,BRN,428962,Asia,1,138,27
2020-04-25T00:00:00Z,25,4,2020,0,0,Brunei_Darussalam,BN,BRN,428962,Asia,1,138,28
2020-04-26T00:00:00Z,26,4,2020,0,0,Brunei_Darussalam,BN,BRN,428962,Asia,1,138,29
2020-04-27T00:00:00Z,27,4,2020,0,0,Brunei_Darussalam,BN,BRN,428962,Asia,1,138,30
2020-04-28T00:00:00Z,28,4,2020,0,0,Brunei_Darussalam,BN,BRN,428962,Asia,1,138,31
2020-04-29T00:00:00Z,29,4,2020,0,0,Brunei_Darussalam,BN,BRN,428962,Asia,1,138,32
2020-04-30T00:00:00Z,30,4,2020,0,0,Brunei_Darussalam,BN,BRN,428962,Asia,1,138,33
2020-05-01T00:00:00Z,1,5,2020,0,0,Brunei_Darussalam,BN,BRN,428962,Asia,1,138,34
2020-05-02T00:00:00Z,2,5,2020,0,0,Brunei_Darussalam,BN,BRN,428962,Asia,1,138,35
2020-05-03T00:00:00Z,3,5,2020,0,0,Brunei_Darussalam,BN,BRN,428962,Asia,1,138,36
2020-05-04T00:00:00Z,4,5,2020,0,0,Brunei_Darussalam,BN,BRN,428962,Asia,1,138,37
2020-05-05T00:00:00Z,5,5,2020,0,0,Brunei_Darussalam,BN,BRN,428962,Asia,1,138,38
2020-05-06T00:00:00Z,6,5,2020,0,0,Brunei_Darussalam,BN,BRN,428962,Asia,1,138,39
2020-05-07T00:00:00Z,7,5,2020,1,0,Brunei_Darussalam,BN,BRN,428962,Asia,1,139,40
2020-05-08T00:00:00Z,8,5,2020,2,0,Brunei_Darussalam,BN,BRN,428962,Asia,1,141,41
2020-05-09T00:00:00Z,9,5,2020,0,0,Brunei_Darussalam,BN,BRN,428962,Asia,1,141,42
2020-05-10T00:00:00Z,10,5,2020,0,0,Brunei_Darussalam,BN,BRN,428962,Asia,1,141,43
2020-05-11T00:00:00Z,11,5,2020,0,0,Brunei_Darussalam,BN,BRN,428962,Asia,1,141,44
2020-05-12T00:00:00Z,12,5,2020,0,0,Brunei_Darussalam,BN,BRN,428962,Asia,1,141,45
2020-05-13T00:00:00Z,13,5,2020,0,0,Brunei_Darussalam,BN,BRN,428962,Asia,1,141,46
2020-05-14T00:00:00Z,14,5,2020,0,0,Brunei_Darussalam,BN,BRN,428962,Asia,1,141,47
2020-05-15T00:00:00Z,15,5,2020,0,0,Brunei_Darussalam,BN,BRN,428962,Asia,1,141,48
2020-05-16T00:00:00Z,16,5,2020,0,0,Brunei_Darussalam,BN,BRN,428962,Asia,1,141,49
2020-05-17T00:00:00Z,17,5,2020,0,0,Brunei_Darussalam,BN,BRN,428962,Asia,1,141,50
2020-05-18T00:00:00Z,18,5,2020,0,0,Brunei_Darussalam,BN,BRN,428962,Asia,1,141,51
2020-05-19T00:00:00Z,19,5,2020,0,0,Brunei_Darussalam,BN,BRN,428962,Asia,1,141,52
2020-05-20T00:00:00Z,20,5,2020,0,0,Brunei_Darussalam,BN,BRN,428962,Asia,1,141,53
2020-05-21T00:00:00Z,21,5,2020,0,0,Brunei_Darussalam,BN,BRN,428962,Asia,1,141,54
2020-05-22T00:00:00Z,22,5,2020,0,0,Brunei_Darussalam,BN,BRN,428962,Asia,1,141,55
2020-05-23T00:00:00Z,23,5,2020,0,0,Brunei_Darussalam,BN,BRN,428962,Asia,1,141,56
2020-05-24T00:00:00Z,24,5,2020,0,0,Brunei_Darussalam,BN,BRN,428962,Asia,1,141,57
2020-05-25T00:00:00Z,25,5,2020,0,0,Brunei_Darussalam,BN,BRN,428962,Asia,1,141,58
2020-05-26T00:00:00Z,26,5,2020,0,0,Brunei_Darussalam,BN,BRN,428962,Asia,1,141,59
2020-05-27T00:00:00Z,27,5,2020,0,0,Brunei_Darussalam,BN,BRN,428962,Asia,1,141,60
2020-03-12T00:00:00Z,12,3,2020,3,1,Bulgaria,BG,BGR,7024216,Europe,1,7,1
2020-03-13T00:00:00Z,13,3,2020,16,0,Bulgaria,BG,BGR,7024216,Europe,1,23,2
2020-03-14T00:00:00Z,14,3,2020,8,0,Bulgaria,BG,BGR,7024216,Europe,1,31,3
2020-03-15T00:00:00Z,15,3,2020,10,1,Bulgaria,BG,BGR,7024216,Europe,2,41,4
2020-03-16T00:00:00Z,16,3,2020,10,0,Bulgaria,BG,BGR,7024216,Europe,2,51,5
2020-03-17T00:00:00Z,17,3,2020,11,0,Bulgaria,BG,BGR,7024216,Europe,2,62,6
2020-03-18T00:00:00Z,18,3,2020,19,0,Bulgaria,BG,BGR,7024216,Europe,2,81,7
2020-03-19T00:00:00Z,19,3,2020,11,0,Bulgaria,BG,BGR,7024216,Europe,2,92,8
2020-03-20T00:00:00Z,20,3,2020,13,1,Bulgaria,BG,BGR,7024216,Europe,3,105,9
2020-03-21T00:00:00Z,21,3,2020,22,0,Bulgaria,BG,BGR,7024216,Europe,3,127,10
2020-03-22T00:00:00Z,22,3,2020,36,0,Bulgaria,BG,BGR,7024216,Europe,3,163,11
2020-03-23T00:00:00Z,23,3,2020,22,0,Bulgaria,BG,BGR,7024216,Europe,3,185,12
2020-03-24T00:00:00Z,24,3,2020,16,0,Bulgaria,BG,BGR,7024216,Europe,3,201,13
2020-03-25T00:00:00Z,25,3,2020,19,0,Bulgaria,BG,BGR,7024216,Europe,3,220,14
2020-03-26T00:00:00Z,26,3,2020,22,0,Bulgaria,BG,BGR,7024216,Europe,3,242,15
2020-03-27T00:00:00Z,27,3,2020,22,0,Bulgaria,BG,BGR,7024216,Europe,3,264,16
2020-03-28T00:00:00Z,28,3,2020,29,0,Bulgaria,BG,BGR,7024216,Europe,3,293,17
2020-03-29T00:00:00Z,29,3,2020,38,4,Bulgaria,BG,BGR,7024216,Europe,7,331,18
2020-03-30T00:00:00Z,30,3,2020,15,1,Bulgaria,BG,BGR,7024216,Europe,8,346,19
2020-03-31T00:00:00Z,31,3,2020,13,0,Bulgaria,BG,BGR,7024216,Europe,8,359,20
2020-04-01T00:00:00Z,1,4,2020,40,0,Bulgaria,BG,BGR,7024216,Europe,8,399,21
2020-04-02T00:00:00Z,2,4,2020,23,2,Bulgaria,BG,BGR,7024216,Europe,10,422,22
2020-04-03T00:00:00Z,3,4,2020,35,0,Bulgaria,BG,BGR,7024216,Europe,10,457,23
2020-04-04T00:00:00Z,4,4,2020,28,4,Bulgaria,BG,BGR,7024216,Europe,14,485,24
2020-04-05T00:00:00Z,5,4,2020,18,3,Bulgaria,BG,BGR,7024216,Europe,17,503,25
2020-04-06T00:00:00Z,6,4,2020,28,3,Bulgaria,BG,BGR,7024216,Europe,20,531,26
2020-04-07T00:00:00Z,7,4,2020,18,2,Bulgaria,BG,BGR,7024216,Europe,22,549,27
2020-04-08T00:00:00Z,8,4,2020,28,1,Bulgaria,BG,BGR,7024216,Europe,23,577,28
2020-04-09T00:00:00Z,9,4,2020,16,1,Bulgaria,BG,BGR,7024216,Europe,24,593,29
2020-04-10T00:00:00Z,10,4,2020,31,0,Bulgaria,BG,BGR,7024216,Europe,24,624,30
2020-04-11T00:00:00Z,11,4,2020,11,1,Bulgaria,BG,BGR,7024216,Europe,25,635,31
2020-04-12T00:00:00Z,12,4,2020,26,3,Bulgaria,BG,BGR,7024216,Europe,28,661,32
2020-04-13T00:00:00Z,13,4,2020,14,1,Bulgaria,BG,BGR,7024216,Europe,29,675,33
2020-04-14T00:00:00Z,14,4,2020,10,3,Bulgaria,BG,BGR,7024216,Europe,32,685,34
2020-04-15T00:00:00Z,15,4,2020,28,3,Bulgaria,BG,BGR,7024216,Europe,35,713,35
2020-04-16T00:00:00Z,16,4,2020,34,1,Bulgaria,BG,BGR,7024216,Europe,36,747,36
2020-04-17T00:00:00Z,17,4,2020,53,2,Bulgaria,BG,BGR,7024216,Europe,38,800,37
2020-04-18T00:00:00Z,18,4,2020,46,3,Bulgaria,BG,BGR,7024216,Europe,41,846,38
2020-04-19T00:00:00Z,19,4,2020,32,0,Bulgaria,BG,BGR,7024216,Europe,41,878,39
2020-04-20T00:00:00Z,20,4,2020,37,2,Bulgaria,BG,BGR,7024216,Europe,43,915,40
2020-04-21T00:00:00Z,21,4,2020,14,0,Bulgaria,BG,BGR,7024216,Europe,43,929,41
2020-04-22T00:00:00Z,22,4,2020,46,2,Bulgaria,BG,BGR,7024216,Europe,45,975,42
2020-04-23T00:00:00Z,23,4,2020,49,4,Bulgaria,BG,BGR,7024216,Europe,49,1024,43
2020-04-24T00:00:00Z,24,4,2020,73,3,Bulgaria,BG,BGR,7024216,Europe,52,1097,44
2020-04-25T00:00:00Z,25,4,2020,91,2,Bulgaria,BG,BGR,7024216,Europe,54,1188,45
2020-04-26T00:00:00Z,26,4,2020,59,1,Bulgaria,BG,BGR,7024216,Europe,55,1247,46
2020-04-27T00:00:00Z,27,4,2020,53,1,Bulgaria,BG,BGR,7024216,Europe,56,1300,47
2020-04-28T00:00:00Z,28,4,2020,63,2,Bulgaria,BG,BGR,7024216,Europe,58,1363,48
2020-04-29T00:00:00Z,29,4,2020,36,0,Bulgaria,BG,BGR,7024216,Europe,58,1399,49
2020-04-30T00:00:00Z,30,4,2020,48,6,Bulgaria,BG,BGR,7024216,Europe,64,1447,50
2020-05-01T00:00:00Z,1,5,2020,59,2,Bulgaria,BG,BGR,7024216,Europe,66,1506,51
2020-05-02T00:00:00Z,2,5,2020,82,3,Bulgaria,BG,BGR,7024216,Europe,69,1588,52
2020-05-03T00:00:00Z,3,5,2020,6,3,Bulgaria,BG,BGR,7024216,Europe,72,1594,53
2020-05-04T00:00:00Z,4,5,2020,24,1,Bulgaria,BG,BGR,7024216,Europe,73,1618,54
2020-05-05T00:00:00Z,5,5,2020,34,5,Bulgaria,BG,BGR,7024216,Europe,78,1652,55
2020-05-06T00:00:00Z,6,5,2020,37,0,Bulgaria,BG,BGR,7024216,Europe,78,1689,56
2020-05-07T00:00:00Z,7,5,2020,89,6,Bulgaria,BG,BGR,7024216,Europe,84,1778,57
2020-05-08T00:00:00Z,8,5,2020,51,0,Bulgaria,BG,BGR,7024216,Europe,84,1829,58
2020-05-09T00:00:00Z,9,5,2020,82,4,Bulgaria,BG,BGR,7024216,Europe,88,1911,59
2020-05-10T00:00:00Z,10,5,2020,44,2,Bulgaria,BG,BGR,7024216,Europe,90,1955,60
2020-05-11T00:00:00Z,11,5,2020,10,1,Bulgaria,BG,BGR,7024216,Europe,91,1965,61
2020-05-12T00:00:00Z,12,5,2020,25,2,Bulgaria,BG,BGR,7024216,Europe,93,1990,62
2020-05-13T00:00:00Z,13,5,2020,33,2,Bulgaria,BG,BGR,7024216,Europe,95,2023,63
2020-05-14T00:00:00Z,14,5,2020,46,1,Bulgaria,BG,BGR,7024216,Europe,96,2069,64
2020-05-15T00:00:00Z,15,5,2020,31,3,Bulgaria,BG,BGR,7024216,Europe,99,2100,65
2020-05-16T00:00:00Z,16,5,2020,38,3,Bulgaria,BG,BGR,7024216,Europe,102,2138,66
2020-05-17T00:00:00Z,17,5,2020,73,6,Bulgaria,BG,BGR,7024216,Europe,108,2211,67
2020-05-18T00:00:00Z,18,5,2020,24,2,Bulgaria,BG,BGR,7024216,Europe,110,2235,68
2020-05-19T00:00:00Z,19,5,2020,24,2,Bulgaria,BG,BGR,7024216,Europe,112,2259,69
2020-05-20T00:00:00Z,20,5,2020,33,4,Bulgaria,BG,BGR,7024216,Europe,116,2292,70
2020-05-21T00:00:00Z,21,5,2020,39,4,Bulgaria,BG,BGR,7024216,Europe,120,2331,71
2020-05-22T00:00:00Z,22,5,2020,41,5,Bulgaria,BG,BGR,7024216,Europe,125,2372,72
2020-05-23T00:00:00Z,23,5,2020,36,1,Bulgaria,BG,BGR,7024216,Europe,126,2408,73
2020-05-24T00:00:00Z,24,5,2020,0,0,Bulgaria,BG,BGR,7024216,Europe,126,2408,74
2020-05-25T00:00:00Z,25,5,2020,25,4,Bulgaria,BG,BGR,7024216,Europe,130,2433,75
2020-05-26T00:00:00Z,26,5,2020,0,0,Bulgaria,BG,BGR,7024216,Europe,130,2433,76
2020-05-27T00:00:00Z,27,5,2020,27,3,Bulgaria,BG,BGR,7024216,Europe,133,2460,77
2020-03-19T00:00:00Z,19,3,2020,6,1,Burkina_Faso,BF,BFA,19751535,Africa,1,26,1
2020-03-20T00:00:00Z,20,3,2020,7,0,Burkina_Faso,BF,BFA,19751535,Africa,1,33,2
2020-03-21T00:00:00Z,21,3,2020,7,0,Burkina_Faso,BF,BFA,19751535,Africa,1,40,3
2020-03-22T00:00:00Z,22,3,2020,24,2,Burkina_Faso,BF,BFA,19751535,Africa,3,64,4
2020-03-23T00:00:00Z,23,3,2020,0,0,Burkina_Faso,BF,BFA,19751535,Africa,3,64,5
2020-03-24T00:00:00Z,24,3,2020,11,0,Burkina_Faso,BF,BFA,19751535,Africa,3,75,6
2020-03-25T00:00:00Z,25,3,2020,24,0,Burkina_Faso,BF,BFA,19751535,Africa,3,99,7
2020-03-26T00:00:00Z,26,3,2020,15,0,Burkina_Faso,BF,BFA,19751535,Africa,3,114,8
2020-03-27T00:00:00Z,27,3,2020,32,0,Burkina_Faso,BF,BFA,19751535,Africa,3,146,9
2020-03-28T00:00:00Z,28,3,2020,0,0,Burkina_Faso,BF,BFA,19751535,Africa,3,146,10
2020-03-29T00:00:00Z,29,3,2020,34,6,Burkina_Faso,BF,BFA,19751535,Africa,9,180,11
2020-03-30T00:00:00Z,30,3,2020,0,0,Burkina_Faso,BF,BFA,19751535,Africa,9,180,12
2020-03-31T00:00:00Z,31,3,2020,42,3,Burkina_Faso,BF,BFA,19751535,Africa,12,222,13
2020-04-01T00:00:00Z,1,4,2020,24,0,Burkina_Faso,BF,BFA,19751535,Africa,12,246,14
2020-04-02T00:00:00Z,2,4,2020,15,2,Burkina_Faso,BF,BFA,19751535,Africa,14,261,15
2020-04-03T00:00:00Z,3,4,2020,27,2,Burkina_Faso,BF,BFA,19751535,Africa,16,288,16
2020-04-04T00:00:00Z,4,4,2020,0,0,Burkina_Faso,BF,BFA,19751535,Africa,16,288,17
2020-04-05T00:00:00Z,5,4,2020,14,0,Burkina_Faso,BF,BFA,19751535,Africa,16,302,18
2020-04-06T00:00:00Z,6,4,2020,43,1,Burkina_Faso,BF,BFA,19751535,Africa,17,345,19
2020-04-07T00:00:00Z,7,4,2020,19,0,Burkina_Faso,BF,BFA,19751535,Africa,17,364,20
2020-04-08T00:00:00Z,8,4,2020,20,2,Burkina_Faso,BF,BFA,19751535,Africa,19,384,21
2020-04-09T00:00:00Z,9,4,2020,30,4,Burkina_Faso,BF,BFA,19751535,Africa,23,414,22
2020-04-10T00:00:00Z,10,4,2020,29,1,Burkina_Faso,BF,BFA,19751535,Africa,24,443,23
2020-04-11T00:00:00Z,11,4,2020,5,2,Burkina_Faso,BF,BFA,19751535,Africa,26,448,24
2020-04-12T00:00:00Z,12,4,2020,36,1,Burkina_Faso,BF,BFA,19751535,Africa,27,484,25
2020-04-13T00:00:00Z,13,4,2020,13,0,Burkina_Faso,BF,BFA,19751535,Africa,27,497,26
2020-04-14T00:00:00Z,14,4,2020,18,1,Burkina_Faso,BF,BFA,19751535,Africa,28,515,27
2020-04-15T00:00:00Z,15,4,2020,13,2,Burkina_Faso,BF,BFA,19751535,Africa,30,528,28
2020-04-16T00:00:00Z,16,4,2020,14,2,Burkina_Faso,BF,BFA,19751535,Africa,32,542,29
2020-04-17T00:00:00Z,17,4,2020,1,0,Burkina_Faso,BF,BFA,19751535,Africa,32,543,30
2020-04-18T00:00:00Z,18,4,2020,14,3,Burkina_Faso,BF,BFA,19751535,Africa,35,557,31
2020-04-19T00:00:00Z,19,4,2020,8,1,Burkina_Faso,BF,BFA,19751535,Africa,36,565,32
2020-04-20T00:00:00Z,20,4,2020,11,0,Burkina_Faso,BF,BFA,19751535,Africa,36,576,33
2020-04-21T00:00:00Z,21,4,2020,5,2,Burkina_Faso,BF,BFA,19751535,Africa,38,581,34
2020-04-22T00:00:00Z,22,4,2020,19,0,Burkina_Faso,BF,BFA,19751535,Africa,38,600,35
2020-04-23T00:00:00Z,23,4,2020,9,1,Burkina_Faso,BF,BFA,19751535,Africa,39,609,36
2020-04-24T00:00:00Z,24,4,2020,7,2,Burkina_Faso,BF,BFA,19751535,Africa,41,616,37
2020-04-25T00:00:00Z,25,4,2020,10,0,Burkina_Faso,BF,BFA,19751535,Africa,41,626,38
2020-04-26T00:00:00Z,26,4,2020,3,0,Burkina_Faso,BF,BFA,19751535,Africa,41,629,39
2020-04-27T00:00:00Z,27,4,2020,3,1,Burkina_Faso,BF,BFA,19751535,Africa,42,632,40
2020-04-28T00:00:00Z,28,4,2020,3,0,Burkina_Faso,BF,BFA,19751535,Africa,42,635,41
2020-04-29T00:00:00Z,29,4,2020,3,0,Burkina_Faso,BF,BFA,19751535,Africa,42,638,42
2020-04-30T00:00:00Z,30,4,2020,3,1,Burkina_Faso,BF,BFA,19751535,Africa,43,641,43
2020-05-01T00:00:00Z,1,5,2020,4,0,Burkina_Faso,BF,BFA,19751535,Africa,43,645,44
2020-05-02T00:00:00Z,2,5,2020,4,1,Burkina_Faso,BF,BFA,19751535,Africa,44,649,45
2020-05-03T00:00:00Z,3,5,2020,3,0,Burkina_Faso,BF,BFA,19751535,Africa,44,652,46
2020-05-04T00:00:00Z,4,5,2020,10,1,Burkina_Faso,BF,BFA,19751535,Africa,45,662,47
2020-05-05T00:00:00Z,5,5,2020,10,1,Burkina_Faso,BF,BFA,19751535,Africa,46,672,48
2020-05-06T00:00:00Z,6,5,2020,16,2,Burkina_Faso,BF,BFA,19751535,Africa,48,688,49
2020-05-07T00:00:00Z,7,5,2020,41,0,Burkina_Faso,BF,BFA,19751535,Africa,48,729,50
2020-05-08T00:00:00Z,8,5,2020,7,0,Burkina_Faso,BF,BFA,19751535,Africa,48,736,51
2020-05-09T00:00:00Z,9,5,2020,8,0,Burkina_Faso,BF,BFA,19751535,Africa,48,744,52
2020-05-10T00:00:00Z,10,5,2020,4,0,Burkina_Faso,BF,BFA,19751535,Africa,48,748,53
2020-05-11T00:00:00Z,11,5,2020,3,1,Burkina_Faso,BF,BFA,19751535,Africa,49,751,54
2020-05-12T00:00:00Z,12,5,2020,9,1,Burkina_Faso,BF,BFA,19751535,Africa,50,760,55
2020-05-13T00:00:00Z,13,5,2020,6,1,Burkina_Faso,BF,BFA,19751535,Africa,51,766,56
2020-05-14T00:00:00Z,14,5,2020,7,0,Burkina_Faso,BF,BFA,19751535,Africa,51,773,57
2020-05-15T00:00:00Z,15,5,2020,0,0,Burkina_Faso,BF,BFA,19751535,Africa,51,773,58
2020-05-16T00:00:00Z,16,5,2020,9,0,Burkina_Faso,BF,BFA,19751535,Africa,51,782,59
2020-05-17T00:00:00Z,17,5,2020,0,0,Burkina_Faso,BF,BFA,19751535,Africa,51,782,60
2020-05-18T00:00:00Z,18,5,2020,14,0,Burkina_Faso,BF,BFA,19751535,Africa,51,796,61
2020-05-19T00:00:00Z,19,5,2020,0,0,Burkina_Faso,BF,BFA,19751535,Africa,51,796,62
2020-05-20T00:00:00Z,20,5,2020,10,1,Burkina_Faso,BF,BFA,19751535,Africa,52,806,63
2020-05-21T00:00:00Z,21,5,2020,3,0,Burkina_Faso,BF,BFA,19751535,Africa,52,809,64
2020-05-22T00:00:00Z,22,5,2020,3,0,Burkina_Faso,BF,BFA,19751535,Africa,52,812,65
2020-05-23T00:00:00Z,23,5,2020,2,0,Burkina_Faso,BF,BFA,19751535,Africa,52,814,66
2020-05-24T00:00:00Z,24,5,2020,0,0,Burkina_Faso,BF,BFA,19751535,Africa,52,814,67
2020-05-25T00:00:00Z,25,5,2020,18,0,Burkina_Faso,BF,BFA,19751535,Africa,52,832,68
2020-05-26T00:00:00Z,26,5,2020,9,0,Burkina_Faso,BF,BFA,19751535,Africa,52,841,69
2020-05-27T00:00:00Z,27,5,2020,4,1,Burkina_Faso,BF,BFA,19751535,Africa,53,845,70
2020-04-15T00:00:00Z,15,4,2020,0,1,Burundi,BI,BDI,11175378,Africa,1,5,1
2020-04-16T00:00:00Z,16,4,2020,0,0,Burundi,BI,BDI,11175378,Africa,1,5,2
2020-04-17T00:00:00Z,17,4,2020,0,0,Burundi,BI,BDI,11175378,Africa,1,5,3
2020-04-18T00:00:00Z,18,4,2020,1,0,Burundi,BI,BDI,11175378,Africa,1,6,4
2020-04-19T00:00:00Z,19,4,2020,0,0,Burundi,BI,BDI,11175378,Africa,1,6,5
2020-04-20T00:00:00Z,20,4,2020,0,0,Burundi,BI,BDI,11175378,Africa,1,6,6
2020-04-21T00:00:00Z,21,4,2020,0,0,Burundi,BI,BDI,11175378,Africa,1,6,7
2020-04-22T00:00:00Z,22,4,2020,0,0,Burundi,BI,BDI,11175378,Africa,1,6,8
2020-04-23T00:00:00Z,23,4,2020,5,0,Burundi,BI,BDI,11175378,Africa,1,11,9
2020-04-24T00:00:00Z,24,4,2020,0,0,Burundi,BI,BDI,11175378,Africa,1,11,10
2020-04-25T00:00:00Z,25,4,2020,1,0,Burundi,BI,BDI,11175378,Africa,1,12,11
2020-04-26T00:00:00Z,26,4,2020,3,0,Burundi,BI,BDI,11175378,Africa,1,15,12
2020-04-27T00:00:00Z,27,4,2020,0,0,Burundi,BI,BDI,11175378,Africa,1,15,13
2020-04-28T00:00:00Z,28,4,2020,0,0,Burundi,BI,BDI,11175378,Africa,1,15,14
2020-04-29T00:00:00Z,29,4,2020,0,0,Burundi,BI,BDI,11175378,Africa,1,15,15
2020-04-30T00:00:00Z,30,4,2020,0,0,Burundi,BI,BDI,11175378,Africa,1,15,16
2020-05-01T00:00:00Z,1,5,2020,0,0,Burundi,BI,BDI,11175378,Africa,1,15,17
2020-05-02T00:00:00Z,2,5,2020,0,0,Burundi,BI,BDI,11175378,Africa,1,15,18
2020-05-03T00:00:00Z,3,5,2020,4,0,Burundi,BI,BDI,11175378,Africa,1,19,19
2020-05-04T00:00:00Z,4,5,2020,0,0,Burundi,BI,BDI,11175378,Africa,1,19,20
2020-05-05T00:00:00Z,5,5,2020,0,0,Burundi,BI,BDI,11175378,Africa,1,19,21
2020-05-06T00:00:00Z,6,5,2020,0,0,Burundi,BI,BDI,11175378,Africa,1,19,22
2020-05-07T00:00:00Z,7,5,2020,0,0,Burundi,BI,BDI,11175378,Africa,1,19,23
2020-05-08T00:00:00Z,8,5,2020,0,0,Burundi,BI,BDI,11175378,Africa,1,19,24
2020-05-09T00:00:00Z,9,5,2020,0,0,Burundi,BI,BDI,11175378,Africa,1,19,25
2020-05-10T00:00:00Z,10,5,2020,0,0,Burundi,BI,BDI,11175378,Africa,1,19,26
2020-05-11T00:00:00Z,11,5,2020,0,0,Burundi,BI,BDI,11175378,Africa,1,19,27
2020-05-12T00:00:00Z,12,5,2020,0,0,Burundi,BI,BDI,11175378,Africa,1,19,28
2020-05-13T00:00:00Z,13,5,2020,8,0,Burundi,BI,BDI,11175378,Africa,1,27,29
2020-05-14T00:00:00Z,14,5,2020,0,0,Burundi,BI,BDI,11175378,Africa,1,27,30
2020-05-15T00:00:00Z,15,5,2020,0,0,Burundi,BI,BDI,11175378,Africa,1,27,31
2020-05-16T00:00:00Z,16,5,2020,0,0,Burundi,BI,BDI,11175378,Africa,1,27,32
2020-05-17T00:00:00Z,17,5,2020,0,0,Burundi,BI,BDI,11175378,Africa,1,27,33
2020-05-18T00:00:00Z,18,5,2020,15,0,Burundi,BI,BDI,11175378,Africa,1,42,34
2020-05-19T00:00:00Z,19,5,2020,0,0,Burundi,BI,BDI,11175378,Africa,1,42,35
2020-05-20T00:00:00Z,20,5,2020,0,0,Burundi,BI,BDI,11175378,Africa,1,42,36
2020-05-21T00:00:00Z,21,5,2020,0,0,Burundi,BI,BDI,11175378,Africa,1,42,37
2020-05-22T00:00:00Z,22,5,2020,0,0,Burundi,BI,BDI,11175378,Africa,1,42,38
2020-05-23T00:00:00Z,23,5,2020,0,0,Burundi,BI,BDI,11175378,Africa,1,42,39
2020-05-24T00:00:00Z,24,5,2020,0,0,Burundi,BI,BDI,11175378,Africa,1,42,40
2020-05-25T00:00:00Z,25,5,2020,0,0,Burundi,BI,BDI,11175378,Africa,1,42,41
2020-05-26T00:00:00Z,26,5,2020,0,0,Burundi,BI,BDI,11175378,Africa,1,42,42
2020-05-27T00:00:00Z,27,5,2020,0,0,Burundi,BI,BDI,11175378,Africa,1,42,43
2020-03-25T00:00:00Z,25,3,2020,16,1,Cameroon,CM,CMR,25216237,Africa,1,72,1
2020-03-26T00:00:00Z,26,3,2020,0,0,Cameroon,CM,CMR,25216237,Africa,1,72,2
2020-03-27T00:00:00Z,27,3,2020,16,0,Cameroon,CM,CMR,25216237,Africa,1,88,3
2020-03-28T00:00:00Z,28,3,2020,0,0,Cameroon,CM,CMR,25216237,Africa,1,88,4
2020-03-29T00:00:00Z,29,3,2020,11,1,Cameroon,CM,CMR,25216237,Africa,2,99,5
2020-03-30T00:00:00Z,30,3,2020,0,0,Cameroon,CM,CMR,25216237,Africa,2,99,6
2020-03-31T00:00:00Z,31,3,2020,43,0,Cameroon,CM,CMR,25216237,Africa,2,142,7
2020-04-01T00:00:00Z,1,4,2020,51,4,Cameroon,CM,CMR,25216237,Africa,6,193,8
2020-04-02T00:00:00Z,2,4,2020,40,0,Cameroon,CM,CMR,25216237,Africa,6,233,9
2020-04-03T00:00:00Z,3,4,2020,38,1,Cameroon,CM,CMR,25216237,Africa,7,271,10
2020-04-04T00:00:00Z,4,4,2020,238,1,Cameroon,CM,CMR,25216237,Africa,8,509,11
2020-04-05T00:00:00Z,5,4,2020,46,1,Cameroon,CM,CMR,25216237,Africa,9,555,12
2020-04-06T00:00:00Z,6,4,2020,95,0,Cameroon,CM,CMR,25216237,Africa,9,650,13
2020-04-07T00:00:00Z,7,4,2020,8,0,Cameroon,CM,CMR,25216237,Africa,9,658,14
2020-04-08T00:00:00Z,8,4,2020,27,0,Cameroon,CM,CMR,25216237,Africa,9,685,15
2020-04-09T00:00:00Z,9,4,2020,45,1,Cameroon,CM,CMR,25216237,Africa,10,730,16
2020-04-10T00:00:00Z,10,4,2020,0,0,Cameroon,CM,CMR,25216237,Africa,10,730,17
2020-04-11T00:00:00Z,11,4,2020,73,0,Cameroon,CM,CMR,25216237,Africa,10,803,18
2020-04-12T00:00:00Z,12,4,2020,17,1,Cameroon,CM,CMR,25216237,Africa,11,820,19
2020-04-13T00:00:00Z,13,4,2020,0,1,Cameroon,CM,CMR,25216237,Africa,12,820,20
2020-04-14T00:00:00Z,14,4,2020,0,0,Cameroon,CM,CMR,25216237,Africa,12,820,21
2020-04-15T00:00:00Z,15,4,2020,35,5,Cameroon,CM,CMR,25216237,Africa,17,855,22
2020-04-16T00:00:00Z,16,4,2020,0,0,Cameroon,CM,CMR,25216237,Africa,17,855,23
2020-04-17T00:00:00Z,17,4,2020,0,4,Cameroon,CM,CMR,25216237,Africa,21,855,24
2020-04-18T00:00:00Z,18,4,2020,161,0,Cameroon,CM,CMR,25216237,Africa,21,1016,25
2020-04-19T00:00:00Z,19,4,2020,0,0,Cameroon,CM,CMR,25216237,Africa,21,1016,26
2020-04-20T00:00:00Z,20,4,2020,0,21,Cameroon,CM,CMR,25216237,Africa,42,1016,27
2020-04-21T00:00:00Z,21,4,2020,1,0,Cameroon,CM,CMR,25216237,Africa,42,1017,28
2020-04-22T00:00:00Z,22,4,2020,146,0,Cameroon,CM,CMR,25216237,Africa,42,1163,29
2020-04-23T00:00:00Z,23,4,2020,0,1,Cameroon,CM,CMR,25216237,Africa,43,1163,30
2020-04-24T00:00:00Z,24,4,2020,238,6,Cameroon,CM,CMR,25216237,Africa,49,1401,31
2020-04-25T00:00:00Z,25,4,2020,2,0,Cameroon,CM,CMR,25216237,Africa,49,1403,32
2020-04-26T00:00:00Z,26,4,2020,115,4,Cameroon,CM,CMR,25216237,Africa,53,1518,33
2020-04-27T00:00:00Z,27,4,2020,103,3,Cameroon,CM,CMR,25216237,Africa,56,1621,34
2020-04-28T00:00:00Z,28,4,2020,0,2,Cameroon,CM,CMR,25216237,Africa,58,1621,35
2020-04-29T00:00:00Z,29,4,2020,185,1,Cameroon,CM,CMR,25216237,Africa,59,1806,36
2020-04-30T00:00:00Z,30,4,2020,26,2,Cameroon,CM,CMR,25216237,Africa,61,1832,37
2020-05-01T00:00:00Z,1,5,2020,0,0,Cameroon,CM,CMR,25216237,Africa,61,1832,38
2020-05-02T00:00:00Z,2,5,2020,237,0,Cameroon,CM,CMR,25216237,Africa,61,2069,39
2020-05-03T00:00:00Z,3,5,2020,8,3,Cameroon,CM,CMR,25216237,Africa,64,2077,40
2020-05-04T00:00:00Z,4,5,2020,0,0,Cameroon,CM,CMR,25216237,Africa,64,2077,41
2020-05-05T00:00:00Z,5,5,2020,27,0,Cameroon,CM,CMR,25216237,Africa,64,2104,42
2020-05-06T00:00:00Z,6,5,2020,0,0,Cameroon,CM,CMR,25216237,Africa,64,2104,43
2020-05-07T00:00:00Z,7,5,2020,161,44,Cameroon,CM,CMR,25216237,Africa,108,2265,44
2020-05-08T00:00:00Z,8,5,2020,0,0,Cameroon,CM,CMR,25216237,Africa,108,2265,45
2020-05-09T00:00:00Z,9,5,2020,0,0,Cameroon,CM,CMR,25216237,Africa,108,2265,46
2020-05-10T00:00:00Z,10,5,2020,9,0,Cameroon,CM,CMR,25216237,Africa,108,2274,47
2020-05-11T00:00:00Z,11,5,2020,305,6,Cameroon,CM,CMR,25216237,Africa,114,2579,48
2020-05-12T00:00:00Z,12,5,2020,110,11,Cameroon,CM,CMR,25216237,Africa,125,2689,49
2020-05-13T00:00:00Z,13,5,2020,0,0,Cameroon,CM,CMR,25216237,Africa,125,2689,50
2020-05-14T00:00:00Z,14,5,2020,111,11,Cameroon,CM,CMR,25216237,Africa,136,2800,51
2020-05-15T00:00:00Z,15,5,2020,154,3,Cameroon,CM,CMR,25216237,Africa,139,2954,52
2020-05-16T00:00:00Z,16,5,2020,151,1,Cameroon,CM,CMR,25216237,Africa,140,3105,53
2020-05-17T00:00:00Z,17,5,2020,187,0,Cameroon,CM,CMR,25216237,Africa,140,3292,54
2020-05-18T00:00:00Z,18,5,2020,0,0,Cameroon,CM,CMR,25216237,Africa,140,3292,55
2020-05-19T00:00:00Z,19,5,2020,0,0,Cameroon,CM,CMR,25216237,Africa,140,3292,56
2020-05-20T00:00:00Z,20,5,2020,237,0,Cameroon,CM,CMR,25216237,Africa,140,3529,57
2020-05-21T00:00:00Z,21,5,2020,204,6,Cameroon,CM,CMR,25216237,Africa,146,3733,58
2020-05-22T00:00:00Z,22,5,2020,555,10,Cameroon,CM,CMR,25216237,Africa,156,4288,59
2020-05-23T00:00:00Z,23,5,2020,112,3,Cameroon,CM,CMR,25216237,Africa,159,4400,60
2020-05-24T00:00:00Z,24,5,2020,197,0,Cameroon,CM,CMR,25216237,Africa,159,4597,61
2020-05-25T00:00:00Z,25,5,2020,293,6,Cameroon,CM,CMR,25216237,Africa,165,4890,62
2020-05-26T00:00:00Z,26,5,2020,154,6,Cameroon,CM,CMR,25216237,Africa,171,5044,63
2020-05-27T00:00:00Z,27,5,2020,318,4,Cameroon,CM,CMR,25216237,Africa,175,5362,64
2020-03-10T00:00:00Z,10,3,2020,15,1,Canada,CA,CAN,37058856,America,1,77,1
2020-03-11T00:00:00Z,11,3,2020,16,0,Canada,CA,CAN,37058856,America,1,93,2
2020-03-12T00:00:00Z,12,3,2020,10,0,Canada,CA,CAN,37058856,America,1,103,3
2020-03-13T00:00:00Z,13,3,2020,35,0,Canada,CA,CAN,37058856,America,1,138,4
2020-03-14T00:00:00Z,14,3,2020,38,0,Canada,CA,CAN,37058856,America,1,176,5
2020-03-15T00:00:00Z,15,3,2020,68,0,Canada,CA,CAN,37058856,America,1,244,6
2020-03-16T00:00:00Z,16,3,2020,60,0,Canada,CA,CAN,37058856,America,1,304,7
2020-03-17T00:00:00Z,17,3,2020,120,3,Canada,CA,CAN,37058856,America,4,424,8
2020-03-18T00:00:00Z,18,3,2020,145,4,Canada,CA,CAN,37058856,America,8,569,9
2020-03-19T00:00:00Z,19,3,2020,121,1,Canada,CA,CAN,37058856,America,9,690,10
2020-03-20T00:00:00Z,20,3,2020,156,1,Canada,CA,CAN,37058856,America,10,846,11
2020-03-21T00:00:00Z,21,3,2020,125,2,Canada,CA,CAN,37058856,America,12,971,12
2020-03-22T00:00:00Z,22,3,2020,331,6,Canada,CA,CAN,37058856,America,18,1302,13
2020-03-23T00:00:00Z,23,3,2020,128,2,Canada,CA,CAN,37058856,America,20,1430,14
2020-03-24T00:00:00Z,24,3,2020,216,4,Canada,CA,CAN,37058856,America,24,1646,15
2020-03-25T00:00:00Z,25,3,2020,313,3,Canada,CA,CAN,37058856,America,27,1959,16
2020-03-26T00:00:00Z,26,3,2020,1426,8,Canada,CA,CAN,37058856,America,35,3385,17
2020-03-27T00:00:00Z,27,3,2020,633,4,Canada,CA,CAN,37058856,America,39,4018,18
2020-03-28T00:00:00Z,28,3,2020,657,14,Canada,CA,CAN,37058856,America,53,4675,19
2020-03-29T00:00:00Z,29,3,2020,711,7,Canada,CA,CAN,37058856,America,60,5386,20
2020-03-30T00:00:00Z,30,3,2020,869,1,Canada,CA,CAN,37058856,America,61,6255,21
2020-03-31T00:00:00Z,31,3,2020,1169,28,Canada,CA,CAN,37058856,America,89,7424,22
2020-04-01T00:00:00Z,1,4,2020,1112,7,Canada,CA,CAN,37058856,America,96,8536,23
2020-04-02T00:00:00Z,2,4,2020,1059,13,Canada,CA,CAN,37058856,America,109,9595,24
2020-04-03T00:00:00Z,3,4,2020,1673,29,Canada,CA,CAN,37058856,America,138,11268,25
2020-04-04T00:00:00Z,4,4,2020,1251,49,Canada,CA,CAN,37058856,America,187,12519,26
2020-04-05T00:00:00Z,5,4,2020,1363,44,Canada,CA,CAN,37058856,America,231,13882,27
2020-04-06T00:00:00Z,6,4,2020,1614,49,Canada,CA,CAN,37058856,America,280,15496,28
2020-04-07T00:00:00Z,7,4,2020,1157,43,Canada,CA,CAN,37058856,America,323,16653,29
2020-04-08T00:00:00Z,8,4,2020,1230,57,Canada,CA,CAN,37058856,America,380,17883,30
2020-04-09T00:00:00Z,9,4,2020,1391,55,Canada,CA,CAN,37058856,America,435,19274,31
2020-04-10T00:00:00Z,10,4,2020,1474,74,Canada,CA,CAN,37058856,America,509,20748,32
2020-04-11T00:00:00Z,11,4,2020,1385,60,Canada,CA,CAN,37058856,America,569,22133,33
2020-04-12T00:00:00Z,12,4,2020,1168,84,Canada,CA,CAN,37058856,America,653,23301,34
2020-04-13T00:00:00Z,13,4,2020,1064,64,Canada,CA,CAN,37058856,America,717,24365,35
2020-04-14T00:00:00Z,14,4,2020,1298,63,Canada,CA,CAN,37058856,America,780,25663,36
2020-04-15T00:00:00Z,15,4,2020,1383,123,Canada,CA,CAN,37058856,America,903,27046,37
2020-04-16T00:00:00Z,16,4,2020,1318,107,Canada,CA,CAN,37058856,America,1010,28364,38
2020-04-17T00:00:00Z,17,4,2020,1717,183,Canada,CA,CAN,37058856,America,1193,30081,39
2020-04-18T00:00:00Z,18,4,2020,1791,116,Canada,CA,CAN,37058856,America,1309,31872,40
2020-04-19T00:00:00Z,19,4,2020,1469,158,Canada,CA,CAN,37058856,America,1467,33341,41
2020-04-20T00:00:00Z,20,4,2020,1436,113,Canada,CA,CAN,37058856,America,1580,34777,42
2020-04-21T00:00:00Z,21,4,2020,2046,110,Canada,CA,CAN,37058856,America,1690,36823,43
2020-04-22T00:00:00Z,22,4,2020,1590,144,Canada,CA,CAN,37058856,America,1834,38413,44
2020-04-23T00:00:00Z,23,4,2020,1766,140,Canada,CA,CAN,37058856,America,1974,40179,45
2020-04-24T00:00:00Z,24,4,2020,1920,172,Canada,CA,CAN,37058856,America,2146,42099,46
2020-04-25T00:00:00Z,25,4,2020,1778,156,Canada,CA,CAN,37058856,America,2302,43877,47
2020-04-26T00:00:00Z,26,4,2020,1464,163,Canada,CA,CAN,37058856,America,2465,45341,48
2020-04-27T00:00:00Z,27,4,2020,1543,95,Canada,CA,CAN,37058856,America,2560,46884,49
2020-04-28T00:00:00Z,28,4,2020,1605,147,Canada,CA,CAN,37058856,America,2707,48489,50
2020-04-29T00:00:00Z,29,4,2020,1526,152,Canada,CA,CAN,37058856,America,2859,50015,51
2020-04-30T00:00:00Z,30,4,2020,1572,137,Canada,CA,CAN,37058856,America,2996,51587,52
2020-05-01T00:00:00Z,1,5,2020,1649,188,Canada,CA,CAN,37058856,America,3184,53236,53
2020-05-02T00:00:00Z,2,5,2020,1825,207,Canada,CA,CAN,37058856,America,3391,55061,54
2020-05-03T00:00:00Z,3,5,2020,1653,175,Canada,CA,CAN,37058856,America,3566,56714,55
2020-05-04T00:00:00Z,4,5,2020,2760,116,Canada,CA,CAN,37058856,America,3682,59474,56
2020-05-05T00:00:00Z,5,5,2020,1298,172,Canada,CA,CAN,37058856,America,3854,60772,57
2020-05-06T00:00:00Z,6,5,2020,1274,189,Canada,CA,CAN,37058856,America,4043,62046,58
2020-05-07T00:00:00Z,7,5,2020,1450,189,Canada,CA,CAN,37058856,America,4232,63496,59
2020-05-08T00:00:00Z,8,5,2020,1426,176,Canada,CA,CAN,37058856,America,4408,64922,60
2020-05-09T00:00:00Z,9,5,2020,1512,161,Canada,CA,CAN,37058856,America,4569,66434,61
2020-05-10T00:00:00Z,10,5,2020,1268,124,Canada,CA,CAN,37058856,America,4693,67702,62
2020-05-11T00:00:00Z,11,5,2020,1146,178,Canada,CA,CAN,37058856,America,4871,68848,63
2020-05-12T00:00:00Z,12,5,2020,1133,122,Canada,CA,CAN,37058856,America,4993,69981,64
2020-05-13T00:00:00Z,13,5,2020,1176,176,Canada,CA,CAN,37058856,America,5169,71157,65
2020-05-14T00:00:00Z,14,5,2020,1121,135,Canada,CA,CAN,37058856,America,5304,72278,66
2020-05-15T00:00:00Z,15,5,2020,1123,168,Canada,CA,CAN,37058856,America,5472,73401,67
2020-05-16T00:00:00Z,16,5,2020,1201,90,Canada,CA,CAN,37058856,America,5562,74602,68
2020-05-17T00:00:00Z,17,5,2020,1251,117,Canada,CA,CAN,37058856,America,5679,75853,69
2020-05-18T00:00:00Z,18,5,2020,1138,103,Canada,CA,CAN,37058856,America,5782,76991,70
2020-05-19T00:00:00Z,19,5,2020,1070,60,Canada,CA,CAN,37058856,America,5842,78061,71
2020-05-20T00:00:00Z,20,5,2020,1040,70,Canada,CA,CAN,37058856,America,5912,79101,72
2020-05-21T00:00:00Z,21,5,2020,990,118,Canada,CA,CAN,37058856,America,6030,80091,73
2020-05-22T00:00:00Z,22,5,2020,1222,122,Canada,CA,CAN,37058856,America,6152,81313,74
2020-05-23T00:00:00Z,23,5,2020,1156,98,Canada,CA,CAN,37058856,America,6250,82469,75
2020-05-24T00:00:00Z,24,5,2020,1141,105,Canada,CA,CAN,37058856,America,6355,83610,76
2020-05-25T00:00:00Z,25,5,2020,1078,69,Canada,CA,CAN,37058856,America,6424,84688,77
2020-05-26T00:00:00Z,26,5,2020,1012,121,Canada,CA,CAN,37058856,America,6545,85700,78
2020-05-27T00:00:00Z,27,5,2020,936,94,Canada,CA,CAN,37058856,America,6639,86636,79
2020-03-25T00:00:00Z,25,3,2020,0,1,Cape_Verde,CV,CPV,543767,Africa,1,3,1
2020-03-26T00:00:00Z,26,3,2020,1,0,Cape_Verde,CV,CPV,543767,Africa,1,4,2
2020-03-27T00:00:00Z,27,3,2020,1,0,Cape_Verde,CV,CPV,543767,Africa,1,5,3
2020-03-28T00:00:00Z,28,3,2020,0,0,Cape_Verde,CV,CPV,543767,Africa,1,5,4
2020-03-29T00:00:00Z,29,3,2020,0,0,Cape_Verde,CV,CPV,543767,Africa,1,5,5
2020-03-30T00:00:00Z,30,3,2020,0,0,Cape_Verde,CV,CPV,543767,Africa,1,5,6
2020-03-31T00:00:00Z,31,3,2020,0,0,Cape_Verde,CV,CPV,543767,Africa,1,5,7
2020-04-01T00:00:00Z,1,4,2020,1,0,Cape_Verde,CV,CPV,543767,Africa,1,6,8
2020-04-02T00:00:00Z,2,4,2020,0,0,Cape_Verde,CV,CPV,543767,Africa,1,6,9
2020-04-03T00:00:00Z,3,4,2020,0,0,Cape_Verde,CV,CPV,543767,Africa,1,6,10
2020-04-04T00:00:00Z,4,4,2020,0,0,Cape_Verde,CV,CPV,543767,Africa,1,6,11
2020-04-05T00:00:00Z,5,4,2020,1,0,Cape_Verde,CV,CPV,543767,Africa,1,7,12
2020-04-06T00:00:00Z,6,4,2020,0,0,Cape_Verde,CV,CPV,543767,Africa,1,7,13
2020-04-07T00:00:00Z,7,4,2020,0,0,Cape_Verde,CV,CPV,543767,Africa,1,7,14
2020-04-08T00:00:00Z,8,4,2020,0,0,Cape_Verde,CV,CPV,543767,Africa,1,7,15
2020-04-09T00:00:00Z,9,4,2020,0,0,Cape_Verde,CV,CPV,543767,Africa,1,7,16
2020-04-10T00:00:00Z,10,4,2020,0,0,Cape_Verde,CV,CPV,543767,Africa,1,7,17
2020-04-11T00:00:00Z,11,4,2020,0,0,Cape_Verde,CV,CPV,543767,Africa,1,7,18
2020-04-12T00:00:00Z,12,4,2020,1,0,Cape_Verde,CV,CPV,543767,Africa,1,8,19
2020-04-13T00:00:00Z,13,4,2020,2,0,Cape_Verde,CV,CPV,543767,Africa,1,10,20
2020-04-14T00:00:00Z,14,4,2020,0,0,Cape_Verde,CV,CPV,543767,Africa,1,10,21
2020-04-15T00:00:00Z,15,4,2020,1,0,Cape_Verde,CV,CPV,543767,Africa,1,11,22
2020-04-16T00:00:00Z,16,4,2020,44,0,Cape_Verde,CV,CPV,543767,Africa,1,55,23
2020-04-17T00:00:00Z,17,4,2020,0,0,Cape_Verde,CV,CPV,543767,Africa,1,55,24
2020-04-18T00:00:00Z,18,4,2020,1,0,Cape_Verde,CV,CPV,543767,Africa,1,56,25
2020-04-19T00:00:00Z,19,4,2020,2,0,Cape_Verde,CV,CPV,543767,Africa,1,58,26
2020-04-20T00:00:00Z,20,4,2020,3,0,Cape_Verde,CV,CPV,543767,Africa,1,61,27
2020-04-21T00:00:00Z,21,4,2020,6,0,Cape_Verde,CV,CPV,543767,Africa,1,67,28
2020-04-22T00:00:00Z,22,4,2020,0,0,Cape_Verde,CV,CPV,543767,Africa,1,67,29
2020-04-23T00:00:00Z,23,4,2020,6,0,Cape_Verde,CV,CPV,543767,Africa,1,73,30
2020-04-24T00:00:00Z,24,4,2020,9,0,Cape_Verde,CV,CPV,543767,Africa,1,82,31
2020-04-25T00:00:00Z,25,4,2020,6,0,Cape_Verde,CV,CPV,543767,Africa,1,88,32
2020-04-26T00:00:00Z,26,4,2020,2,0,Cape_Verde,CV,CPV,543767,Africa,1,90,33
2020-04-27T00:00:00Z,27,4,2020,16,0,Cape_Verde,CV,CPV,543767,Africa,1,106,34
2020-04-28T00:00:00Z,28,4,2020,3,0,Cape_Verde,CV,CPV,543767,Africa,1,109,35
2020-04-29T00:00:00Z,29,4,2020,4,0,Cape_Verde,CV,CPV,543767,Africa,1,113,36
2020-04-30T00:00:00Z,30,4,2020,0,0,Cape_Verde,CV,CPV,543767,Africa,1,113,37
2020-05-01T00:00:00Z,1,5,2020,8,0,Cape_Verde,CV,CPV,543767,Africa,1,121,38
2020-05-02T00:00:00Z,2,5,2020,2,1,Cape_Verde,CV,CPV,543767,Africa,2,123,39
2020-05-03T00:00:00Z,3,5,2020,29,0,Cape_Verde,CV,CPV,543767,Africa,2,152,40
2020-05-04T00:00:00Z,4,5,2020,13,0,Cape_Verde,CV,CPV,543767,Africa,2,165,41
2020-05-05T00:00:00Z,5,5,2020,10,0,Cape_Verde,CV,CPV,543767,Africa,2,175,42
2020-05-06T00:00:00Z,6,5,2020,11,0,Cape_Verde,CV,CPV,543767,Africa,2,186,43
2020-05-07T00:00:00Z,7,5,2020,5,0,Cape_Verde,CV,CPV,543767,Africa,2,191,44
2020-05-08T00:00:00Z,8,5,2020,27,0,Cape_Verde,CV,CPV,543767,Africa,2,218,45
2020-05-09T00:00:00Z,9,5,2020,12,0,Cape_Verde,CV,CPV,543767,Africa,2,230,46
2020-05-10T00:00:00Z,10,5,2020,6,0,Cape_Verde,CV,CPV,543767,Africa,2,236,47
2020-05-11T00:00:00Z,11,5,2020,10,0,Cape_Verde,CV,CPV,543767,Africa,2,246,48
2020-05-12T00:00:00Z,12,5,2020,14,0,Cape_Verde,CV,CPV,543767,Africa,2,260,49
2020-05-13T00:00:00Z,13,5,2020,10,0,Cape_Verde,CV,CPV,543767,Africa,2,270,50
2020-05-14T00:00:00Z,14,5,2020,19,0,Cape_Verde,CV,CPV,543767,Africa,2,289,51
2020-05-15T00:00:00Z,15,5,2020,26,0,Cape_Verde,CV,CPV,543767,Africa,2,315,52
2020-05-16T00:00:00Z,16,5,2020,11,0,Cape_Verde,CV,CPV,543767,Africa,2,326,53
2020-05-17T00:00:00Z,17,5,2020,2,1,Cape_Verde,CV,CPV,543767,Africa,3,328,54
2020-05-18T00:00:00Z,18,5,2020,0,0,Cape_Verde,CV,CPV,543767,Africa,3,328,55
2020-05-19T00:00:00Z,19,5,2020,0,0,Cape_Verde,CV,CPV,543767,Africa,3,328,56
2020-05-20T00:00:00Z,20,5,2020,7,0,Cape_Verde,CV,CPV,543767,Africa,3,335,57
2020-05-21T00:00:00Z,21,5,2020,14,0,Cape_Verde,CV,CPV,543767,Africa,3,349,58
2020-05-22T00:00:00Z,22,5,2020,7,0,Cape_Verde,CV,CPV,543767,Africa,3,356,59
2020-05-23T00:00:00Z,23,5,2020,6,0,Cape_Verde,CV,CPV,543767,Africa,3,362,60
2020-05-24T00:00:00Z,24,5,2020,9,0,Cape_Verde,CV,CPV,543767,Africa,3,371,61
2020-05-25T00:00:00Z,25,5,2020,9,0,Cape_Verde,CV,CPV,543767,Africa,3,380,62
2020-05-26T00:00:00Z,26,5,2020,10,0,Cape_Verde,CV,CPV,543767,Africa,3,390,63
2020-05-27T00:00:00Z,27,5,2020,0,1,Cape_Verde,CV,CPV,543767,Africa,4,390,64
2020-02-20T00:00:00Z,20,2,2020,79,2,Cases_on_an_international_conveyance_Japan,JPG11668,N/A,3000,Other,2,621,1
2020-02-21T00:00:00Z,21,2,2020,13,0,Cases_on_an_international_conveyance_Japan,JPG11668,N/A,3000,Other,2,634,2
2020-02-22T00:00:00Z,22,2,2020,0,0,Cases_on_an_international_conveyance_Japan,JPG11668,N/A,3000,Other,2,634,3
2020-02-23T00:00:00Z,23,2,2020,0,0,Cases_on_an_international_conveyance_Japan,JPG11668,N/A,3000,Other,2,634,4
2020-02-24T00:00:00Z,24,2,2020,57,1,Cases_on_an_international_conveyance_Japan,JPG11668,N/A,3000,Other,3,691,5
2020-02-25T00:00:00Z,25,2,2020,0,0,Cases_on_an_international_conveyance_Japan,JPG11668,N/A,3000,Other,3,691,6
2020-02-26T00:00:00Z,26,2,2020,0,1,Cases_on_an_international_conveyance_Japan,JPG11668,N/A,3000,Other,4,691,7
2020-02-27T00:00:00Z,27,2,2020,14,0,Cases_on_an_international_conveyance_Japan,JPG11668,N/A,3000,Other,4,705,8
2020-02-28T00:00:00Z,28,2,2020,0,0,Cases_on_an_international_conveyance_Japan,JPG11668,N/A,3000,Other,4,705,9
2020-02-29T00:00:00Z,29,2,2020,0,2,Cases_on_an_international_conveyance_Japan,JPG11668,N/A,3000,Other,6,705,10
2020-03-01T00:00:00Z,1,3,2020,0,0,Cases_on_an_international_conveyance_Japan,JPG11668,N/A,3000,Other,6,705,11
2020-03-02T00:00:00Z,2,3,2020,0,0,Cases_on_an_international_conveyance_Japan,JPG11668,N/A,3000,Other,6,705,12
2020-03-10T00:00:00Z,10,3,2020,-9,1,Cases_on_an_international_conveyance_Japan,JPG11668,N/A,3000,Other,7,696,13
2020-03-21T00:00:00Z,21,3,2020,2,1,Cayman_Islands,KY,CYM,64174,America,1,3,1
2020-03-22T00:00:00Z,22,3,2020,0,0,Cayman_Islands,KY,CYM,64174,America,1,3,2
2020-03-23T00:00:00Z,23,3,2020,0,0,Cayman_Islands,KY,CYM,64174,America,1,3,3
2020-03-24T00:00:00Z,24,3,2020,0,0,Cayman_Islands,KY,CYM,64174,America,1,3,4
2020-03-25T00:00:00Z,25,3,2020,0,0,Cayman_Islands,KY,CYM,64174,America,1,3,5
2020-03-26T00:00:00Z,26,3,2020,0,0,Cayman_Islands,KY,CYM,64174,America,1,3,6
2020-03-27T00:00:00Z,27,3,2020,3,0,Cayman_Islands,KY,CYM,64174,America,1,6,7
2020-03-28T00:00:00Z,28,3,2020,2,0,Cayman_Islands,KY,CYM,64174,America,1,8,8
2020-03-29T00:00:00Z,29,3,2020,0,0,Cayman_Islands,KY,CYM,64174,America,1,8,9
2020-03-30T00:00:00Z,30,3,2020,0,0,Cayman_Islands,KY,CYM,64174,America,1,8,10
2020-03-31T00:00:00Z,31,3,2020,4,0,Cayman_Islands,KY,CYM,64174,America,1,12,11
2020-04-01T00:00:00Z,1,4,2020,2,0,Cayman_Islands,KY,CYM,64174,America,1,14,12
2020-04-02T00:00:00Z,2,4,2020,8,0,Cayman_Islands,KY,CYM,64174,America,1,22,13
2020-04-03T00:00:00Z,3,4,2020,6,0,Cayman_Islands,KY,CYM,64174,America,1,28,14
2020-04-04T00:00:00Z,4,4,2020,1,0,Cayman_Islands,KY,CYM,64174,America,1,29,15
2020-04-05T00:00:00Z,5,4,2020,6,0,Cayman_Islands,KY,CYM,64174,America,1,35,16
2020-04-06T00:00:00Z,6,4,2020,4,0,Cayman_Islands,KY,CYM,64174,America,1,39,17
2020-04-07T00:00:00Z,7,4,2020,0,0,Cayman_Islands,KY,CYM,64174,America,1,39,18
2020-04-08T00:00:00Z,8,4,2020,6,0,Cayman_Islands,KY,CYM,64174,America,1,45,19
2020-04-09T00:00:00Z,9,4,2020,0,0,Cayman_Islands,KY,CYM,64174,America,1,45,20
2020-04-10T00:00:00Z,10,4,2020,0,0,Cayman_Islands,KY,CYM,64174,America,1,45,21
2020-04-11T00:00:00Z,11,4,2020,0,0,Cayman_Islands,KY,CYM,64174,America,1,45,22
2020-04-12T00:00:00Z,12,4,2020,8,0,Cayman_Islands,KY,CYM,64174,America,1,53,23
2020-04-13T00:00:00Z,13,4,2020,0,0,Cayman_Islands,KY,CYM,64174,America,1,53,24
2020-04-14T00:00:00Z,14,4,2020,0,0,Cayman_Islands,KY,CYM,64174,America,1,53,25
2020-04-15T00:00:00Z,15,4,2020,1,0,Cayman_Islands,KY,CYM,64174,America,1,54,26
2020-04-16T00:00:00Z,16,4,2020,6,0,Cayman_Islands,KY,CYM,64174,America,1,60,27
2020-04-17T00:00:00Z,17,4,2020,1,0,Cayman_Islands,KY,CYM,64174,America,1,61,28
2020-04-18T00:00:00Z,18,4,2020,0,0,Cayman_Islands,KY,CYM,64174,America,1,61,29
2020-04-19T00:00:00Z,19,4,2020,0,0,Cayman_Islands,KY,CYM,64174,America,1,61,30
2020-04-20T00:00:00Z,20,4,2020,0,0,Cayman_Islands,KY,CYM,64174,America,1,61,31
2020-04-21T00:00:00Z,21,4,2020,5,0,Cayman_Islands,KY,CYM,64174,America,1,66,32
2020-04-22T00:00:00Z,22,4,2020,0,0,Cayman_Islands,KY,CYM,64174,America,1,66,33
2020-04-23T00:00:00Z,23,4,2020,0,0,Cayman_Islands,KY,CYM,64174,America,1,66,34
2020-04-24T00:00:00Z,24,4,2020,0,0,Cayman_Islands,KY,CYM,64174,America,1,66,35
2020-04-25T00:00:00Z,25,4,2020,0,0,Cayman_Islands,KY,CYM,64174,America,1,66,36
2020-04-26T00:00:00Z,26,4,2020,4,0,Cayman_Islands,KY,CYM,64174,America,1,70,37
2020-04-27T00:00:00Z,27,4,2020,0,0,Cayman_Islands,KY,CYM,64174,America,1,70,38
2020-04-28T00:00:00Z,28,4,2020,0,0,Cayman_Islands,KY,CYM,64174,America,1,70,39
2020-04-29T00:00:00Z,29,4,2020,0,0,Cayman_Islands,KY,CYM,64174,America,1,70,40
2020-04-30T00:00:00Z,30,4,2020,3,0,Cayman_Islands,KY,CYM,64174,America,1,73,41
2020-05-01T00:00:00Z,1,5,2020,0,0,Cayman_Islands,KY,CYM,64174,America,1,73,42
2020-05-02T00:00:00Z,2,5,2020,1,0,Cayman_Islands,KY,CYM,64174,America,1,74,43
2020-05-03T00:00:00Z,3,5,2020,0,0,Cayman_Islands,KY,CYM,64174,America,1,74,44
2020-05-04T00:00:00Z,4,5,2020,0,0,Cayman_Islands,KY,CYM,64174,America,1,74,45
2020-05-05T00:00:00Z,5,5,2020,1,0,Cayman_Islands,KY,CYM,64174,America,1,75,46
2020-05-06T00:00:00Z,6,5,2020,0,0,Cayman_Islands,KY,CYM,64174,America,1,75,47
2020-05-07T00:00:00Z,7,5,2020,3,0,Cayman_Islands,KY,CYM,64174,America,1,78,48
2020-05-08T00:00:00Z,8,5,2020,0,0,Cayman_Islands,KY,CYM,64174,America,1,78,49
2020-05-09T00:00:00Z,9,5,2020,3,0,Cayman_Islands,KY,CYM,64174,America,1,81,50
2020-05-10T00:00:00Z,10,5,2020,0,0,Cayman_Islands,KY,CYM,64174,America,1,81,51
2020-05-11T00:00:00Z,11,5,2020,0,0,Cayman_Islands,KY,CYM,64174,America,1,81,52
2020-05-12T00:00:00Z,12,5,2020,3,0,Cayman_Islands,KY,CYM,64174,America,1,84,53
2020-05-13T00:00:00Z,13,5,2020,1,0,Cayman_Islands,KY,CYM,64174,America,1,85,54
2020-05-14T00:00:00Z,14,5,2020,0,0,Cayman_Islands,KY,CYM,64174,America,1,85,55
2020-05-15T00:00:00Z,15,5,2020,8,0,Cayman_Islands,KY,CYM,64174,America,1,93,56
2020-05-16T00:00:00Z,16,5,2020,0,0,Cayman_Islands,KY,CYM,64174,America,1,93,57
2020-05-17T00:00:00Z,17,5,2020,1,0,Cayman_Islands,KY,CYM,64174,America,1,94,58
2020-05-18T00:00:00Z,18,5,2020,0,0,Cayman_Islands,KY,CYM,64174,America,1,94,59
2020-05-19T00:00:00Z,19,5,2020,0,0,Cayman_Islands,KY,CYM,64174,America,1,94,60
2020-05-20T00:00:00Z,20,5,2020,17,0,Cayman_Islands,KY,CYM,64174,America,1,111,61
2020-05-21T00:00:00Z,21,5,2020,0,0,Cayman_Islands,KY,CYM,64174,America,1,111,62
2020-05-22T00:00:00Z,22,5,2020,0,0,Cayman_Islands,KY,CYM,64174,America,1,111,63
2020-05-23T00:00:00Z,23,5,2020,10,0,Cayman_Islands,KY,CYM,64174,America,1,121,64
2020-05-24T00:00:00Z,24,5,2020,8,0,Cayman_Islands,KY,CYM,64174,America,1,129,65
2020-05-25T00:00:00Z,25,5,2020,0,0,Cayman_Islands,KY,CYM,64174,America,1,129,66
2020-05-26T00:00:00Z,26,5,2020,5,0,Cayman_Islands,KY,CYM,64174,America,1,134,67
2020-05-27T00:00:00Z,27,5,2020,3,0,Cayman_Islands,KY,CYM,64174,America,1,137,68
2020-05-24T00:00:00Z,24,5,2020,73,1,Central_African_Republic,CF,CAF,4666377,Africa,1,552,1
2020-05-25T00:00:00Z,25,5,2020,52,0,Central_African_Republic,CF,CAF,4666377,Africa,1,604,2
2020-05-26T00:00:00Z,26,5,2020,48,0,Central_African_Republic,CF,CAF,4666377,Africa,1,652,3
2020-05-27T00:00:00Z,27,5,2020,19,0,Central_African_Republic,CF,CAF,4666377,Africa,1,671,4
2020-04-29T00:00:00Z,29,4,2020,6,2,Chad,TD,TCD,15477751,Africa,2,52,1
2020-04-30T00:00:00Z,30,4,2020,0,0,Chad,TD,TCD,15477751,Africa,2,52,2
2020-05-01T00:00:00Z,1,5,2020,21,3,Chad,TD,TCD,15477751,Africa,5,73,3
2020-05-02T00:00:00Z,2,5,2020,0,0,Chad,TD,TCD,15477751,Africa,5,73,4
2020-05-03T00:00:00Z,3,5,2020,44,5,Chad,TD,TCD,15477751,Africa,10,117,5
2020-05-04T00:00:00Z,4,5,2020,0,0,Chad,TD,TCD,15477751,Africa,10,117,6
2020-05-05T00:00:00Z,5,5,2020,0,0,Chad,TD,TCD,15477751,Africa,10,117,7
2020-05-06T00:00:00Z,6,5,2020,53,7,Chad,TD,TCD,15477751,Africa,17,170,8
2020-05-07T00:00:00Z,7,5,2020,0,0,Chad,TD,TCD,15477751,Africa,17,170,9
2020-05-08T00:00:00Z,8,5,2020,83,10,Chad,TD,TCD,15477751,Africa,27,253,10
2020-05-09T00:00:00Z,9,5,2020,7,1,Chad,TD,TCD,15477751,Africa,28,260,11
2020-05-10T00:00:00Z,10,5,2020,62,3,Chad,TD,TCD,15477751,Africa,31,322,12
2020-05-11T00:00:00Z,11,5,2020,0,0,Chad,TD,TCD,15477751,Africa,31,322,13
2020-05-12T00:00:00Z,12,5,2020,0,0,Chad,TD,TCD,15477751,Africa,31,322,14
2020-05-13T00:00:00Z,13,5,2020,35,9,Chad,TD,TCD,15477751,Africa,40,357,15
2020-05-14T00:00:00Z,14,5,2020,15,2,Chad,TD,TCD,15477751,Africa,42,372,16
2020-05-15T00:00:00Z,15,5,2020,27,4,Chad,TD,TCD,15477751,Africa,46,399,17
2020-05-16T00:00:00Z,16,5,2020,29,2,Chad,TD,TCD,15477751,Africa,48,428,18
2020-05-17T00:00:00Z,17,5,2020,46,2,Chad,TD,TCD,15477751,Africa,50,474,19
2020-05-18T00:00:00Z,18,5,2020,29,3,Chad,TD,TCD,15477751,Africa,53,503,20
2020-05-19T00:00:00Z,19,5,2020,16,0,Chad,TD,TCD,15477751,Africa,53,519,21
2020-05-20T00:00:00Z,20,5,2020,26,3,Chad,TD,TCD,15477751,Africa,56,545,22
2020-05-21T00:00:00Z,21,5,2020,20,1,Chad,TD,TCD,15477751,Africa,57,565,23
2020-05-22T00:00:00Z,22,5,2020,23,1,Chad,TD,TCD,15477751,Africa,58,588,24
2020-05-23T00:00:00Z,23,5,2020,23,1,Chad,TD,TCD,15477751,Africa,59,611,25
2020-05-24T00:00:00Z,24,5,2020,37,1,Chad,TD,TCD,15477751,Africa,60,648,26
2020-05-25T00:00:00Z,25,5,2020,27,0,Chad,TD,TCD,15477751,Africa,60,675,27
2020-05-26T00:00:00Z,26,5,2020,12,1,Chad,TD,TCD,15477751,Africa,61,687,28
2020-05-27T00:00:00Z,27,5,2020,13,1,Chad,TD,TCD,15477751,Africa,62,700,29
2020-03-23T00:00:00Z,23,3,2020,95,1,Chile,CL,CHL,18729160,America,1,632,1
2020-03-24T00:00:00Z,24,3,2020,114,1,Chile,CL,CHL,18729160,America,2,746,2
2020-03-25T00:00:00Z,25,3,2020,176,0,Chile,CL,CHL,18729160,America,2,922,3
2020-03-26T00:00:00Z,26,3,2020,220,1,Chile,CL,CHL,18729160,America,3,1142,4
2020-03-27T00:00:00Z,27,3,2020,164,1,Chile,CL,CHL,18729160,America,4,1306,5
2020-03-28T00:00:00Z,28,3,2020,304,1,Chile,CL,CHL,18729160,America,5,1610,6
2020-03-29T00:00:00Z,29,3,2020,299,1,Chile,CL,CHL,18729160,America,6,1909,7
2020-03-30T00:00:00Z,30,3,2020,230,1,Chile,CL,CHL,18729160,America,7,2139,8
2020-03-31T00:00:00Z,31,3,2020,310,1,Chile,CL,CHL,18729160,America,8,2449,9
2020-04-01T00:00:00Z,1,4,2020,289,4,Chile,CL,CHL,18729160,America,12,2738,10
2020-04-02T00:00:00Z,2,4,2020,293,4,Chile,CL,CHL,18729160,America,16,3031,11
2020-04-03T00:00:00Z,3,4,2020,373,2,Chile,CL,CHL,18729160,America,18,3404,12
2020-04-04T00:00:00Z,4,4,2020,333,4,Chile,CL,CHL,18729160,America,22,3737,13
2020-04-05T00:00:00Z,5,4,2020,424,5,Chile,CL,CHL,18729160,America,27,4161,14
2020-04-06T00:00:00Z,6,4,2020,310,7,Chile,CL,CHL,18729160,America,34,4471,15
2020-04-07T00:00:00Z,7,4,2020,344,3,Chile,CL,CHL,18729160,America,37,4815,16
2020-04-08T00:00:00Z,8,4,2020,301,6,Chile,CL,CHL,18729160,America,43,5116,17
2020-04-09T00:00:00Z,9,4,2020,430,5,Chile,CL,CHL,18729160,America,48,5546,18
2020-04-10T00:00:00Z,10,4,2020,426,9,Chile,CL,CHL,18729160,America,57,5972,19
2020-04-11T00:00:00Z,11,4,2020,529,8,Chile,CL,CHL,18729160,America,65,6501,20
2020-04-12T00:00:00Z,12,4,2020,426,8,Chile,CL,CHL,18729160,America,73,6927,21
2020-04-13T00:00:00Z,13,4,2020,286,7,Chile,CL,CHL,18729160,America,80,7213,22
2020-04-14T00:00:00Z,14,4,2020,312,2,Chile,CL,CHL,18729160,America,82,7525,23
2020-04-15T00:00:00Z,15,4,2020,392,10,Chile,CL,CHL,18729160,America,92,7917,24
2020-04-16T00:00:00Z,16,4,2020,356,2,Chile,CL,CHL,18729160,America,94,8273,25
2020-04-17T00:00:00Z,17,4,2020,534,11,Chile,CL,CHL,18729160,America,105,8807,26
2020-04-18T00:00:00Z,18,4,2020,445,11,Chile,CL,CHL,18729160,America,116,9252,27
2020-04-19T00:00:00Z,19,4,2020,478,10,Chile,CL,CHL,18729160,America,126,9730,28
2020-04-20T00:00:00Z,20,4,2020,358,7,Chile,CL,CHL,18729160,America,133,10088,29
2020-04-21T00:00:00Z,21,4,2020,419,6,Chile,CL,CHL,18729160,America,139,10507,30
2020-04-22T00:00:00Z,22,4,2020,325,8,Chile,CL,CHL,18729160,America,147,10832,31
2020-04-23T00:00:00Z,23,4,2020,464,13,Chile,CL,CHL,18729160,America,160,11296,32
2020-04-24T00:00:00Z,24,4,2020,516,8,Chile,CL,CHL,18729160,America,168,11812,33
2020-04-25T00:00:00Z,25,4,2020,494,6,Chile,CL,CHL,18729160,America,174,12306,34
2020-04-26T00:00:00Z,26,4,2020,552,7,Chile,CL,CHL,18729160,America,181,12858,35
2020-04-27T00:00:00Z,27,4,2020,473,8,Chile,CL,CHL,18729160,America,189,13331,36
2020-04-28T00:00:00Z,28,4,2020,482,9,Chile,CL,CHL,18729160,America,198,13813,37
2020-04-29T00:00:00Z,29,4,2020,552,9,Chile,CL,CHL,18729160,America,207,14365,38
2020-04-30T00:00:00Z,30,4,2020,520,9,Chile,CL,CHL,18729160,America,216,14885,39
2020-05-01T00:00:00Z,1,5,2020,1138,11,Chile,CL,CHL,18729160,America,227,16023,40
2020-05-02T00:00:00Z,2,5,2020,985,7,Chile,CL,CHL,18729160,America,234,17008,41
2020-05-03T00:00:00Z,3,5,2020,1427,13,Chile,CL,CHL,18729160,America,247,18435,42
2020-05-04T00:00:00Z,4,5,2020,1228,13,Chile,CL,CHL,18729160,America,260,19663,43
2020-05-05T00:00:00Z,5,5,2020,980,10,Chile,CL,CHL,18729160,America,270,20643,44
2020-05-06T00:00:00Z,6,5,2020,1373,5,Chile,CL,CHL,18729160,America,275,22016,45
2020-05-07T00:00:00Z,7,5,2020,1032,6,Chile,CL,CHL,18729160,America,281,23048,46
2020-05-08T00:00:00Z,8,5,2020,1533,4,Chile,CL,CHL,18729160,America,285,24581,47
2020-05-09T00:00:00Z,9,5,2020,1391,9,Chile,CL,CHL,18729160,America,294,25972,48
2020-05-10T00:00:00Z,10,5,2020,1247,10,Chile,CL,CHL,18729160,America,304,27219,49
2020-05-11T00:00:00Z,11,5,2020,1647,8,Chile,CL,CHL,18729160,America,312,28866,50
2020-05-12T00:00:00Z,12,5,2020,1197,11,Chile,CL,CHL,18729160,America,323,30063,51
2020-05-13T00:00:00Z,13,5,2020,1658,12,Chile,CL,CHL,18729160,America,335,31721,52
2020-05-14T00:00:00Z,14,5,2020,2660,11,Chile,CL,CHL,18729160,America,346,34381,53
2020-05-15T00:00:00Z,15,5,2020,2659,12,Chile,CL,CHL,18729160,America,358,37040,54
2020-05-16T00:00:00Z,16,5,2020,2502,36,Chile,CL,CHL,18729160,America,394,39542,55
2020-05-17T00:00:00Z,17,5,2020,1886,27,Chile,CL,CHL,18729160,America,421,41428,56
2020-05-18T00:00:00Z,18,5,2020,2353,29,Chile,CL,CHL,18729160,America,450,43781,57
2020-05-19T00:00:00Z,19,5,2020,2278,28,Chile,CL,CHL,18729160,America,478,46059,58
2020-05-20T00:00:00Z,20,5,2020,3520,31,Chile,CL,CHL,18729160,America,509,49579,59
2020-05-21T00:00:00Z,21,5,2020,4038,35,Chile,CL,CHL,18729160,America,544,53617,60
2020-05-22T00:00:00Z,22,5,2020,3964,45,Chile,CL,CHL,18729160,America,589,57581,61
2020-05-23T00:00:00Z,23,5,2020,4276,41,Chile,CL,CHL,18729160,America,630,61857,62
2020-05-24T00:00:00Z,24,5,2020,3536,43,Chile,CL,CHL,18729160,America,673,65393,63
2020-05-25T00:00:00Z,25,5,2020,3709,45,Chile,CL,CHL,18729160,America,718,69102,64
2020-05-26T00:00:00Z,26,5,2020,4895,43,Chile,CL,CHL,18729160,America,761,73997,65
2020-05-27T00:00:00Z,27,5,2020,3964,45,Chile,CL,CHL,18729160,America,806,77961,66
2020-01-11T00:00:00Z,11,1,2020,0,1,China,CN,CHN,1392730000,Asia,1,59,1
2020-01-12T00:00:00Z,12,1,2020,0,0,China,CN,CHN,1392730000,Asia,1,59,2
2020-01-13T00:00:00Z,13,1,2020,0,0,China,CN,CHN,1392730000,Asia,1,59,3
2020-01-14T00:00:00Z,14,1,2020,0,0,China,CN,CHN,1392730000,Asia,1,59,4
2020-01-15T00:00:00Z,15,1,2020,0,1,China,CN,CHN,1392730000,Asia,2,59,5
2020-01-16T00:00:00Z,16,1,2020,0,0,China,CN,CHN,1392730000,Asia,2,59,6
2020-01-17T00:00:00Z,17,1,2020,4,0,China,CN,CHN,1392730000,Asia,2,63,7
2020-01-18T00:00:00Z,18,1,2020,17,0,China,CN,CHN,1392730000,Asia,2,80,8
2020-01-19T00:00:00Z,19,1,2020,136,1,China,CN,CHN,1392730000,Asia,3,216,9
2020-01-20T00:00:00Z,20,1,2020,19,0,China,CN,CHN,1392730000,Asia,3,235,10
2020-01-21T00:00:00Z,21,1,2020,151,3,China,CN,CHN,1392730000,Asia,6,386,11
2020-01-22T00:00:00Z,22,1,2020,140,11,China,CN,CHN,1392730000,Asia,17,526,12
2020-01-23T00:00:00Z,23,1,2020,97,0,China,CN,CHN,1392730000,Asia,17,623,13
2020-01-24T00:00:00Z,24,1,2020,259,9,China,CN,CHN,1392730000,Asia,26,882,14
2020-01-25T00:00:00Z,25,1,2020,441,15,China,CN,CHN,1392730000,Asia,41,1323,15
2020-01-26T00:00:00Z,26,1,2020,665,15,China,CN,CHN,1392730000,Asia,56,1988,16
2020-01-27T00:00:00Z,27,1,2020,787,25,China,CN,CHN,1392730000,Asia,81,2775,17
2020-01-28T00:00:00Z,28,1,2020,1753,25,China,CN,CHN,1392730000,Asia,106,4528,18
2020-01-29T00:00:00Z,29,1,2020,1466,26,China,CN,CHN,1392730000,Asia,132,5994,19
2020-01-30T00:00:00Z,30,1,2020,1740,38,China,CN,CHN,1392730000,Asia,170,7734,20
2020-01-31T00:00:00Z,31,1,2020,1980,43,China,CN,CHN,1392730000,Asia,213,9714,21
2020-02-01T00:00:00Z,1,2,2020,2095,46,China,CN,CHN,1392730000,Asia,259,11809,22
2020-02-02T00:00:00Z,2,2,2020,2590,45,China,CN,CHN,1392730000,Asia,304,14399,23
2020-02-03T00:00:00Z,3,2,2020,2812,57,China,CN,CHN,1392730000,Asia,361,17211,24
2020-02-04T00:00:00Z,4,2,2020,3237,65,China,CN,CHN,1392730000,Asia,426,20448,25
2020-02-05T00:00:00Z,5,2,2020,3872,66,China,CN,CHN,1392730000,Asia,492,24320,26
2020-02-06T00:00:00Z,6,2,2020,3727,72,China,CN,CHN,1392730000,Asia,564,28047,27
2020-02-07T00:00:00Z,7,2,2020,3160,73,China,CN,CHN,1392730000,Asia,637,31207,28
2020-02-08T00:00:00Z,8,2,2020,3418,86,China,CN,CHN,1392730000,Asia,723,34625,29
2020-02-09T00:00:00Z,9,2,2020,2607,89,China,CN,CHN,1392730000,Asia,812,37232,30
2020-02-10T00:00:00Z,10,2,2020,2974,97,China,CN,CHN,1392730000,Asia,909,40206,31
2020-02-11T00:00:00Z,11,2,2020,2490,108,China,CN,CHN,1392730000,Asia,1017,42696,32
2020-02-12T00:00:00Z,12,2,2020,2028,97,China,CN,CHN,1392730000,Asia,1114,44724,33
2020-02-13T00:00:00Z,13,2,2020,15141,254,China,CN,CHN,1392730000,Asia,1368,59865,34
2020-02-14T00:00:00Z,14,2,2020,4156,13,China,CN,CHN,1392730000,Asia,1381,64021,35
2020-02-15T00:00:00Z,15,2,2020,2538,143,China,CN,CHN,1392730000,Asia,1524,66559,36
2020-02-16T00:00:00Z,16,2,2020,2007,142,China,CN,CHN,1392730000,Asia,1666,68566,37
2020-02-17T00:00:00Z,17,2,2020,2052,105,China,CN,CHN,1392730000,Asia,1771,70618,38
2020-02-18T00:00:00Z,18,2,2020,1890,98,China,CN,CHN,1392730000,Asia,1869,72508,39
2020-02-19T00:00:00Z,19,2,2020,1750,139,China,CN,CHN,1392730000,Asia,2008,74258,40
2020-02-20T00:00:00Z,20,2,2020,394,112,China,CN,CHN,1392730000,Asia,2120,74652,41
2020-02-21T00:00:00Z,21,2,2020,891,118,China,CN,CHN,1392730000,Asia,2238,75543,42
2020-02-22T00:00:00Z,22,2,2020,826,109,China,CN,CHN,1392730000,Asia,2347,76369,43
2020-02-23T00:00:00Z,23,2,2020,647,98,China,CN,CHN,1392730000,Asia,2445,77016,44
2020-02-24T00:00:00Z,24,2,2020,218,150,China,CN,CHN,1392730000,Asia,2595,77234,45
2020-02-25T00:00:00Z,25,2,2020,515,70,China,CN,CHN,1392730000,Asia,2665,77749,46
2020-02-26T00:00:00Z,26,2,2020,410,52,China,CN,CHN,1392730000,Asia,2717,78159,47
2020-02-27T00:00:00Z,27,2,2020,439,29,China,CN,CHN,1392730000,Asia,2746,78598,48
2020-02-28T00:00:00Z,28,2,2020,329,44,China,CN,CHN,1392730000,Asia,2790,78927,49
2020-02-29T00:00:00Z,29,2,2020,428,47,China,CN,CHN,1392730000,Asia,2837,79355,50
2020-03-01T00:00:00Z,1,3,2020,574,35,China,CN,CHN,1392730000,Asia,2872,79929,51
2020-03-02T00:00:00Z,2,3,2020,205,42,China,CN,CHN,1392730000,Asia,2914,80134,52
2020-03-03T00:00:00Z,3,3,2020,127,32,China,CN,CHN,1392730000,Asia,2946,80261,53
2020-03-04T00:00:00Z,4,3,2020,119,37,China,CN,CHN,1392730000,Asia,2983,80380,54
2020-03-05T00:00:00Z,5,3,2020,117,31,China,CN,CHN,1392730000,Asia,3014,80497,55
2020-03-06T00:00:00Z,6,3,2020,170,30,China,CN,CHN,1392730000,Asia,3044,80667,56
2020-03-07T00:00:00Z,7,3,2020,101,28,China,CN,CHN,1392730000,Asia,3072,80768,57
2020-03-08T00:00:00Z,8,3,2020,46,27,China,CN,CHN,1392730000,Asia,3099,80814,58
2020-03-09T00:00:00Z,9,3,2020,45,23,China,CN,CHN,1392730000,Asia,3122,80859,59
2020-03-10T00:00:00Z,10,3,2020,20,17,China,CN,CHN,1392730000,Asia,3139,80879,60
2020-03-11T00:00:00Z,11,3,2020,29,22,China,CN,CHN,1392730000,Asia,3161,80908,61
2020-03-12T00:00:00Z,12,3,2020,24,11,China,CN,CHN,1392730000,Asia,3172,80932,62
2020-03-13T00:00:00Z,13,3,2020,22,7,China,CN,CHN,1392730000,Asia,3179,80954,63
2020-03-14T00:00:00Z,14,3,2020,19,15,China,CN,CHN,1392730000,Asia,3194,80973,64
2020-03-15T00:00:00Z,15,3,2020,22,9,China,CN,CHN,1392730000,Asia,3203,80995,65
2020-03-16T00:00:00Z,16,3,2020,25,13,China,CN,CHN,1392730000,Asia,3216,81020,66
2020-03-17T00:00:00Z,17,3,2020,43,9,China,CN,CHN,1392730000,Asia,3225,81063,67
2020-03-18T00:00:00Z,18,3,2020,23,16,China,CN,CHN,1392730000,Asia,3241,81086,68
2020-03-19T00:00:00Z,19,3,2020,44,8,China,CN,CHN,1392730000,Asia,3249,81130,69
2020-03-20T00:00:00Z,20,3,2020,99,4,China,CN,CHN,1392730000,Asia,3253,81229,70
2020-03-21T00:00:00Z,21,3,2020,52,6,China,CN,CHN,1392730000,Asia,3259,81281,71
2020-03-22T00:00:00Z,22,3,2020,65,6,China,CN,CHN,1392730000,Asia,3265,81346,72
2020-03-23T00:00:00Z,23,3,2020,138,9,China,CN,CHN,1392730000,Asia,3274,81484,73
2020-03-24T00:00:00Z,24,3,2020,69,7,China,CN,CHN,1392730000,Asia,3281,81553,74
2020-03-25T00:00:00Z,25,3,2020,78,4,China,CN,CHN,1392730000,Asia,3285,81631,75
2020-03-26T00:00:00Z,26,3,2020,102,6,China,CN,CHN,1392730000,Asia,3291,81733,76
2020-03-27T00:00:00Z,27,3,2020,94,5,China,CN,CHN,1392730000,Asia,3296,81827,77
2020-03-28T00:00:00Z,28,3,2020,119,3,China,CN,CHN,1392730000,Asia,3299,81946,78
2020-03-29T00:00:00Z,29,3,2020,113,5,China,CN,CHN,1392730000,Asia,3304,82059,79
2020-03-30T00:00:00Z,30,3,2020,98,2,China,CN,CHN,1392730000,Asia,3306,82157,80
2020-03-31T00:00:00Z,31,3,2020,84,3,China,CN,CHN,1392730000,Asia,3309,82241,81
2020-04-01T00:00:00Z,1,4,2020,54,1,China,CN,CHN,1392730000,Asia,3310,82295,82
2020-04-02T00:00:00Z,2,4,2020,100,6,China,CN,CHN,1392730000,Asia,3316,82395,83
2020-04-03T00:00:00Z,3,4,2020,70,10,China,CN,CHN,1392730000,Asia,3326,82465,84
2020-04-04T00:00:00Z,4,4,2020,62,4,China,CN,CHN,1392730000,Asia,3330,82527,85
2020-04-05T00:00:00Z,5,4,2020,48,3,China,CN,CHN,1392730000,Asia,3333,82575,86
2020-04-06T00:00:00Z,6,4,2020,67,2,China,CN,CHN,1392730000,Asia,3335,82642,87
2020-04-07T00:00:00Z,7,4,2020,56,0,China,CN,CHN,1392730000,Asia,3335,82698,88
2020-04-08T00:00:00Z,8,4,2020,86,2,China,CN,CHN,1392730000,Asia,3337,82784,89
2020-04-09T00:00:00Z,9,4,2020,86,2,China,CN,CHN,1392730000,Asia,3339,82870,90
2020-04-10T00:00:00Z,10,4,2020,55,1,China,CN,CHN,1392730000,Asia,3340,82925,91
2020-04-11T00:00:00Z,11,4,2020,79,3,China,CN,CHN,1392730000,Asia,3343,83004,92
2020-04-12T00:00:00Z,12,4,2020,93,0,China,CN,CHN,1392730000,Asia,3343,83097,93
2020-04-13T00:00:00Z,13,4,2020,112,2,China,CN,CHN,1392730000,Asia,3345,83209,94
2020-04-14T00:00:00Z,14,4,2020,94,0,China,CN,CHN,1392730000,Asia,3345,83303,95
2020-04-15T00:00:00Z,15,4,2020,49,1,China,CN,CHN,1392730000,Asia,3346,83352,96
2020-04-16T00:00:00Z,16,4,2020,50,0,China,CN,CHN,1392730000,Asia,3346,83402,97
2020-04-17T00:00:00Z,17,4,2020,352,1290,China,CN,CHN,1392730000,Asia,4636,83754,98
2020-04-18T00:00:00Z,18,4,2020,31,0,China,CN,CHN,1392730000,Asia,4636,83785,99
2020-04-19T00:00:00Z,19,4,2020,18,0,China,CN,CHN,1392730000,Asia,4636,83803,100
2020-04-20T00:00:00Z,20,4,2020,14,0,China,CN,CHN,1392730000,Asia,4636,83817,101
2020-04-21T00:00:00Z,21,4,2020,32,0,China,CN,CHN,1392730000,Asia,4636,83849,102
2020-04-22T00:00:00Z,22,4,2020,15,0,China,CN,CHN,1392730000,Asia,4636,83864,103
2020-04-23T00:00:00Z,23,4,2020,12,0,China,CN,CHN,1392730000,Asia,4636,83876,104
2020-04-24T00:00:00Z,24,4,2020,8,0,China,CN,CHN,1392730000,Asia,4636,83884,105
2020-04-25T00:00:00Z,25,4,2020,15,0,China,CN,CHN,1392730000,Asia,4636,83899,106
2020-04-26T00:00:00Z,26,4,2020,10,0,China,CN,CHN,1392730000,Asia,4636,83909,107
2020-04-27T00:00:00Z,27,4,2020,3,1,China,CN,CHN,1392730000,Asia,4637,83912,108
2020-04-28T00:00:00Z,28,4,2020,26,0,China,CN,CHN,1392730000,Asia,4637,83938,109
2020-04-29T00:00:00Z,29,4,2020,2,0,China,CN,CHN,1392730000,Asia,4637,83940,110
2020-04-30T00:00:00Z,30,4,2020,4,0,China,CN,CHN,1392730000,Asia,4637,83944,111
2020-05-01T00:00:00Z,1,5,2020,12,0,China,CN,CHN,1392730000,Asia,4637,83956,112
2020-05-02T00:00:00Z,2,5,2020,3,0,China,CN,CHN,1392730000,Asia,4637,83959,113
2020-05-03T00:00:00Z,3,5,2020,2,0,China,CN,CHN,1392730000,Asia,4637,83961,114
2020-05-04T00:00:00Z,4,5,2020,3,0,China,CN,CHN,1392730000,Asia,4637,83964,115
2020-05-05T00:00:00Z,5,5,2020,2,0,China,CN,CHN,1392730000,Asia,4637,83966,116
2020-05-06T00:00:00Z,6,5,2020,2,0,China,CN,CHN,1392730000,Asia,4637,83968,117
2020-05-07T00:00:00Z,7,5,2020,2,0,China,CN,CHN,1392730000,Asia,4637,83970,118
2020-05-08T00:00:00Z,8,5,2020,6,0,China,CN,CHN,1392730000,Asia,4637,83976,119
2020-05-09T00:00:00Z,9,5,2020,0,0,China,CN,CHN,1392730000,Asia,4637,83976,120
2020-05-10T00:00:00Z,10,5,2020,15,0,China,CN,CHN,1392730000,Asia,4637,83991,121
2020-05-11T00:00:00Z,11,5,2020,19,0,China,CN,CHN,1392730000,Asia,4637,84010,122
2020-05-12T00:00:00Z,12,5,2020,1,0,China,CN,CHN,1392730000,Asia,4637,84011,123
2020-05-13T00:00:00Z,13,5,2020,7,0,China,CN,CHN,1392730000,Asia,4637,84018,124
2020-05-14T00:00:00Z,14,5,2020,6,0,China,CN,CHN,1392730000,Asia,4637,84024,125
2020-05-15T00:00:00Z,15,5,2020,5,0,China,CN,CHN,1392730000,Asia,4637,84029,126
2020-05-16T00:00:00Z,16,5,2020,9,0,China,CN,CHN,1392730000,Asia,4637,84038,127
2020-05-17T00:00:00Z,17,5,2020,6,1,China,CN,CHN,1392730000,Asia,4638,84044,128
2020-05-18T00:00:00Z,18,5,2020,10,0,China,CN,CHN,1392730000,Asia,4638,84054,129
2020-05-19T00:00:00Z,19,5,2020,9,0,China,CN,CHN,1392730000,Asia,4638,84063,130
2020-05-20T00:00:00Z,20,5,2020,2,0,China,CN,CHN,1392730000,Asia,4638,84065,131
2020-05-21T00:00:00Z,21,5,2020,2,0,China,CN,CHN,1392730000,Asia,4638,84067,132
2020-05-22T00:00:00Z,22,5,2020,12,0,China,CN,CHN,1392730000,Asia,4638,84079,133
2020-05-23T00:00:00Z,23,5,2020,2,0,China,CN,CHN,1392730000,Asia,4638,84081,134
2020-05-24T00:00:00Z,24,5,2020,3,0,China,CN,CHN,1392730000,Asia,4638,84084,135
2020-05-25T00:00:00Z,25,5,2020,11,0,China,CN,CHN,1392730000,Asia,4638,84095,136
2020-05-26T00:00:00Z,26,5,2020,7,0,China,CN,CHN,1392730000,Asia,4638,84102,137
2020-05-27T00:00:00Z,27,5,2020,1,0,China,CN,CHN,1392730000,Asia,4638,84103,138
2020-03-22T00:00:00Z,22,3,2020,52,1,Colombia,CO,COL,49648685,America,1,210,1
2020-03-23T00:00:00Z,23,3,2020,25,1,Colombia,CO,COL,49648685,America,2,235,2
2020-03-24T00:00:00Z,24,3,2020,71,1,Colombia,CO,COL,49648685,America,3,306,3
2020-03-25T00:00:00Z,25,3,2020,72,0,Colombia,CO,COL,49648685,America,3,378,4
2020-03-26T00:00:00Z,26,3,2020,92,1,Colombia,CO,COL,49648685,America,4,470,5
2020-03-27T00:00:00Z,27,3,2020,21,2,Colombia,CO,COL,49648685,America,6,491,6
2020-03-28T00:00:00Z,28,3,2020,48,0,Colombia,CO,COL,49648685,America,6,539,7
2020-03-29T00:00:00Z,29,3,2020,69,0,Colombia,CO,COL,49648685,America,6,608,8
2020-03-30T00:00:00Z,30,3,2020,94,4,Colombia,CO,COL,49648685,America,10,702,9
2020-03-31T00:00:00Z,31,3,2020,96,4,Colombia,CO,COL,49648685,America,14,798,10
2020-04-01T00:00:00Z,1,4,2020,108,2,Colombia,CO,COL,49648685,America,16,906,11
2020-04-02T00:00:00Z,2,4,2020,159,1,Colombia,CO,COL,49648685,America,17,1065,12
2020-04-03T00:00:00Z,3,4,2020,96,2,Colombia,CO,COL,49648685,America,19,1161,13
2020-04-04T00:00:00Z,4,4,2020,106,6,Colombia,CO,COL,49648685,America,25,1267,14
2020-04-05T00:00:00Z,5,4,2020,139,7,Colombia,CO,COL,49648685,America,32,1406,15
2020-04-06T00:00:00Z,6,4,2020,79,3,Colombia,CO,COL,49648685,America,35,1485,16
2020-04-07T00:00:00Z,7,4,2020,94,11,Colombia,CO,COL,49648685,America,46,1579,17
2020-04-08T00:00:00Z,8,4,2020,201,4,Colombia,CO,COL,49648685,America,50,1780,18
2020-04-09T00:00:00Z,9,4,2020,274,5,Colombia,CO,COL,49648685,America,55,2054,19
2020-04-10T00:00:00Z,10,4,2020,169,14,Colombia,CO,COL,49648685,America,69,2223,20
2020-04-11T00:00:00Z,11,4,2020,250,11,Colombia,CO,COL,49648685,America,80,2473,21
2020-04-12T00:00:00Z,12,4,2020,236,20,Colombia,CO,COL,49648685,America,100,2709,22
2020-04-13T00:00:00Z,13,4,2020,67,9,Colombia,CO,COL,49648685,America,109,2776,23
2020-04-14T00:00:00Z,14,4,2020,76,3,Colombia,CO,COL,49648685,America,112,2852,24
2020-04-15T00:00:00Z,15,4,2020,127,15,Colombia,CO,COL,49648685,America,127,2979,25
2020-04-16T00:00:00Z,16,4,2020,126,4,Colombia,CO,COL,49648685,America,131,3105,26
2020-04-17T00:00:00Z,17,4,2020,128,13,Colombia,CO,COL,49648685,America,144,3233,27
2020-04-18T00:00:00Z,18,4,2020,206,9,Colombia,CO,COL,49648685,America,153,3439,28
2020-04-19T00:00:00Z,19,4,2020,182,13,Colombia,CO,COL,49648685,America,166,3621,29
2020-04-20T00:00:00Z,20,4,2020,171,13,Colombia,CO,COL,49648685,America,179,3792,30
2020-04-21T00:00:00Z,21,4,2020,185,10,Colombia,CO,COL,49648685,America,189,3977,31
2020-04-22T00:00:00Z,22,4,2020,172,7,Colombia,CO,COL,49648685,America,196,4149,32
2020-04-23T00:00:00Z,23,4,2020,207,10,Colombia,CO,COL,49648685,America,206,4356,33
2020-04-24T00:00:00Z,24,4,2020,205,9,Colombia,CO,COL,49648685,America,215,4561,34
2020-04-25T00:00:00Z,25,4,2020,320,10,Colombia,CO,COL,49648685,America,225,4881,35
2020-04-26T00:00:00Z,26,4,2020,261,8,Colombia,CO,COL,49648685,America,233,5142,36
2020-04-27T00:00:00Z,27,4,2020,237,10,Colombia,CO,COL,49648685,America,243,5379,37
2020-04-28T00:00:00Z,28,4,2020,218,10,Colombia,CO,COL,49648685,America,253,5597,38
2020-04-29T00:00:00Z,29,4,2020,352,16,Colombia,CO,COL,49648685,America,269,5949,39
2020-04-30T00:00:00Z,30,4,2020,262,9,Colombia,CO,COL,49648685,America,278,6211,40
2020-05-01T00:00:00Z,1,5,2020,296,15,Colombia,CO,COL,49648685,America,293,6507,41
2020-05-02T00:00:00Z,2,5,2020,499,21,Colombia,CO,COL,49648685,America,314,7006,42
2020-05-03T00:00:00Z,3,5,2020,279,10,Colombia,CO,COL,49648685,America,324,7285,43
2020-05-04T00:00:00Z,4,5,2020,383,16,Colombia,CO,COL,49648685,America,340,7668,44
2020-05-05T00:00:00Z,5,5,2020,305,18,Colombia,CO,COL,49648685,America,358,7973,45
2020-05-06T00:00:00Z,6,5,2020,640,20,Colombia,CO,COL,49648685,America,378,8613,46
2020-05-07T00:00:00Z,7,5,2020,346,19,Colombia,CO,COL,49648685,America,397,8959,47
2020-05-08T00:00:00Z,8,5,2020,497,10,Colombia,CO,COL,49648685,America,407,9456,48
2020-05-09T00:00:00Z,9,5,2020,595,21,Colombia,CO,COL,49648685,America,428,10051,49
2020-05-10T00:00:00Z,10,5,2020,444,17,Colombia,CO,COL,49648685,America,445,10495,50
2020-05-11T00:00:00Z,11,5,2020,568,18,Colombia,CO,COL,49648685,America,463,11063,51
2020-05-12T00:00:00Z,12,5,2020,550,16,Colombia,CO,COL,49648685,America,479,11613,52
2020-05-13T00:00:00Z,13,5,2020,659,14,Colombia,CO,COL,49648685,America,493,12272,53
2020-05-14T00:00:00Z,14,5,2020,658,16,Colombia,CO,COL,49648685,America,509,12930,54
2020-05-15T00:00:00Z,15,5,2020,680,16,Colombia,CO,COL,49648685,America,525,13610,55
2020-05-16T00:00:00Z,16,5,2020,606,21,Colombia,CO,COL,49648685,America,546,14216,56
2020-05-17T00:00:00Z,17,5,2020,723,16,Colombia,CO,COL,49648685,America,562,14939,57
2020-05-18T00:00:00Z,18,5,2020,635,12,Colombia,CO,COL,49648685,America,574,15574,58
2020-05-19T00:00:00Z,19,5,2020,721,18,Colombia,CO,COL,49648685,America,592,16295,59
2020-05-20T00:00:00Z,20,5,2020,640,21,Colombia,CO,COL,49648685,America,613,16935,60
2020-05-21T00:00:00Z,21,5,2020,752,17,Colombia,CO,COL,49648685,America,630,17687,61
2020-05-22T00:00:00Z,22,5,2020,643,22,Colombia,CO,COL,49648685,America,652,18330,62
2020-05-23T00:00:00Z,23,5,2020,801,30,Colombia,CO,COL,49648685,America,682,19131,63
2020-05-24T00:00:00Z,24,5,2020,1046,23,Colombia,CO,COL,49648685,America,705,20177,64
2020-05-25T00:00:00Z,25,5,2020,998,22,Colombia,CO,COL,49648685,America,727,21175,65
2020-05-26T00:00:00Z,26,5,2020,806,23,Colombia,CO,COL,49648685,America,750,21981,66
2020-05-27T00:00:00Z,27,5,2020,1022,26,Colombia,CO,COL,49648685,America,776,23003,67
2020-05-05T00:00:00Z,5,5,2020,1,1,Comoros,KM,COM,832322,Africa,1,4,1
2020-05-06T00:00:00Z,6,5,2020,0,0,Comoros,KM,COM,832322,Africa,1,4,2
2020-05-07T00:00:00Z,7,5,2020,4,0,Comoros,KM,COM,832322,Africa,1,8,3
2020-05-08T00:00:00Z,8,5,2020,0,0,Comoros,KM,COM,832322,Africa,1,8,4
2020-05-09T00:00:00Z,9,5,2020,0,0,Comoros,KM,COM,832322,Africa,1,8,5
2020-05-10T00:00:00Z,10,5,2020,3,0,Comoros,KM,COM,832322,Africa,1,11,6
2020-05-11T00:00:00Z,11,5,2020,0,0,Comoros,KM,COM,832322,Africa,1,11,7
2020-05-12T00:00:00Z,12,5,2020,0,0,Comoros,KM,COM,832322,Africa,1,11,8
2020-05-13T00:00:00Z,13,5,2020,0,0,Comoros,KM,COM,832322,Africa,1,11,9
2020-05-14T00:00:00Z,14,5,2020,0,0,Comoros,KM,COM,832322,Africa,1,11,10
2020-05-15T00:00:00Z,15,5,2020,0,0,Comoros,KM,COM,832322,Africa,1,11,11
2020-05-16T00:00:00Z,16,5,2020,0,0,Comoros,KM,COM,832322,Africa,1,11,12
2020-05-17T00:00:00Z,17,5,2020,0,0,Comoros,KM,COM,832322,Africa,1,11,13
2020-05-18T00:00:00Z,18,5,2020,0,0,Comoros,KM,COM,832322,Africa,1,11,14
2020-05-19T00:00:00Z,19,5,2020,0,0,Comoros,KM,COM,832322,Africa,1,11,15
2020-05-20T00:00:00Z,20,5,2020,23,0,Comoros,KM,COM,832322,Africa,1,34,16
2020-05-21T00:00:00Z,21,5,2020,0,0,Comoros,KM,COM,832322,Africa,1,34,17
2020-05-22T00:00:00Z,22,5,2020,0,0,Comoros,KM,COM,832322,Africa,1,34,18
2020-05-23T00:00:00Z,23,5,2020,44,0,Comoros,KM,COM,832322,Africa,1,78,19
2020-05-24T00:00:00Z,24,5,2020,0,0,Comoros,KM,COM,832322,Africa,1,78,20
2020-05-25T00:00:00Z,25,5,2020,9,0,Comoros,KM,COM,832322,Africa,1,87,21
2020-05-26T00:00:00Z,26,5,2020,0,0,Comoros,KM,COM,832322,Africa,1,87,22
2020-05-27T00:00:00Z,27,5,2020,0,0,Comoros,KM,COM,832322,Africa,1,87,23
2020-04-01T00:00:00Z,1,4,2020,3,2,Congo,CG,COG,5244363,Africa,2,22,1
2020-04-02T00:00:00Z,2,4,2020,0,0,Congo,CG,COG,5244363,Africa,2,22,2
2020-04-03T00:00:00Z,3,4,2020,19,1,Congo,CG,COG,5244363,Africa,3,41,3
2020-04-04T00:00:00Z,4,4,2020,0,0,Congo,CG,COG,5244363,Africa,3,41,4
2020-04-05T00:00:00Z,5,4,2020,4,2,Congo,CG,COG,5244363,Africa,5,45,5
2020-04-06T00:00:00Z,6,4,2020,0,0,Congo,CG,COG,5244363,Africa,5,45,6
2020-04-07T00:00:00Z,7,4,2020,0,0,Congo,CG,COG,5244363,Africa,5,45,7
2020-04-08T00:00:00Z,8,4,2020,0,0,Congo,CG,COG,5244363,Africa,5,45,8
2020-04-09T00:00:00Z,9,4,2020,15,0,Congo,CG,COG,5244363,Africa,5,60,9
2020-04-10T00:00:00Z,10,4,2020,0,0,Congo,CG,COG,5244363,Africa,5,60,10
2020-04-11T00:00:00Z,11,4,2020,0,0,Congo,CG,COG,5244363,Africa,5,60,11
2020-04-12T00:00:00Z,12,4,2020,0,0,Congo,CG,COG,5244363,Africa,5,60,12
2020-04-13T00:00:00Z,13,4,2020,10,0,Congo,CG,COG,5244363,Africa,5,70,13
2020-04-14T00:00:00Z,14,4,2020,0,0,Congo,CG,COG,5244363,Africa,5,70,14
2020-04-15T00:00:00Z,15,4,2020,4,0,Congo,CG,COG,5244363,Africa,5,74,15
2020-04-16T00:00:00Z,16,4,2020,43,0,Congo,CG,COG,5244363,Africa,5,117,16
2020-04-17T00:00:00Z,17,4,2020,0,0,Congo,CG,COG,5244363,Africa,5,117,17
2020-04-18T00:00:00Z,18,4,2020,26,1,Congo,CG,COG,5244363,Africa,6,143,18
2020-04-19T00:00:00Z,19,4,2020,0,0,Congo,CG,COG,5244363,Africa,6,143,19
2020-04-20T00:00:00Z,20,4,2020,17,0,Congo,CG,COG,5244363,Africa,6,160,20
2020-04-21T00:00:00Z,21,4,2020,0,0,Congo,CG,COG,5244363,Africa,6,160,21
2020-04-22T00:00:00Z,22,4,2020,5,0,Congo,CG,COG,5244363,Africa,6,165,22
2020-04-23T00:00:00Z,23,4,2020,21,0,Congo,CG,COG,5244363,Africa,6,186,23
2020-04-24T00:00:00Z,24,4,2020,0,0,Congo,CG,COG,5244363,Africa,6,186,24
2020-04-25T00:00:00Z,25,4,2020,14,0,Congo,CG,COG,5244363,Africa,6,200,25
2020-04-26T00:00:00Z,26,4,2020,0,2,Congo,CG,COG,5244363,Africa,8,200,26
2020-04-27T00:00:00Z,27,4,2020,0,0,Congo,CG,COG,5244363,Africa,8,200,27
2020-04-28T00:00:00Z,28,4,2020,7,0,Congo,CG,COG,5244363,Africa,8,207,28
2020-04-29T00:00:00Z,29,4,2020,0,0,Congo,CG,COG,5244363,Africa,8,207,29
2020-04-30T00:00:00Z,30,4,2020,13,1,Congo,CG,COG,5244363,Africa,9,220,30
2020-05-01T00:00:00Z,1,5,2020,0,0,Congo,CG,COG,5244363,Africa,9,220,31
2020-05-02T00:00:00Z,2,5,2020,9,1,Congo,CG,COG,5244363,Africa,10,229,32
2020-05-03T00:00:00Z,3,5,2020,0,0,Congo,CG,COG,5244363,Africa,10,229,33
2020-05-04T00:00:00Z,4,5,2020,0,0,Congo,CG,COG,5244363,Africa,10,229,34
2020-05-05T00:00:00Z,5,5,2020,7,0,Congo,CG,COG,5244363,Africa,10,236,35
2020-05-06T00:00:00Z,6,5,2020,0,0,Congo,CG,COG,5244363,Africa,10,236,36
2020-05-07T00:00:00Z,7,5,2020,28,0,Congo,CG,COG,5244363,Africa,10,264,37
2020-05-08T00:00:00Z,8,5,2020,10,0,Congo,CG,COG,5244363,Africa,10,274,38
2020-05-09T00:00:00Z,9,5,2020,13,0,Congo,CG,COG,5244363,Africa,10,287,39
2020-05-10T00:00:00Z,10,5,2020,0,0,Congo,CG,COG,5244363,Africa,10,287,40
2020-05-11T00:00:00Z,11,5,2020,0,0,Congo,CG,COG,5244363,Africa,10,287,41
2020-05-12T00:00:00Z,12,5,2020,46,1,Congo,CG,COG,5244363,Africa,11,333,42
2020-05-13T00:00:00Z,13,5,2020,0,0,Congo,CG,COG,5244363,Africa,11,333,43
2020-05-14T00:00:00Z,14,5,2020,8,0,Congo,CG,COG,5244363,Africa,11,341,44
2020-05-15T00:00:00Z,15,5,2020,50,4,Congo,CG,COG,5244363,Africa,15,391,45
2020-05-16T00:00:00Z,16,5,2020,0,0,Congo,CG,COG,5244363,Africa,15,391,46
2020-05-17T00:00:00Z,17,5,2020,21,0,Congo,CG,COG,5244363,Africa,15,412,47
2020-05-18T00:00:00Z,18,5,2020,0,0,Congo,CG,COG,5244363,Africa,15,412,48
2020-05-19T00:00:00Z,19,5,2020,0,0,Congo,CG,COG,5244363,Africa,15,412,49
2020-05-20T00:00:00Z,20,5,2020,8,0,Congo,CG,COG,5244363,Africa,15,420,50
2020-05-21T00:00:00Z,21,5,2020,0,0,Congo,CG,COG,5244363,Africa,15,420,51
2020-05-22T00:00:00Z,22,5,2020,49,1,Congo,CG,COG,5244363,Africa,16,469,52
2020-05-23T00:00:00Z,23,5,2020,0,0,Congo,CG,COG,5244363,Africa,16,469,53
2020-05-24T00:00:00Z,24,5,2020,18,0,Congo,CG,COG,5244363,Africa,16,487,54
2020-05-25T00:00:00Z,25,5,2020,0,0,Congo,CG,COG,5244363,Africa,16,487,55
2020-05-26T00:00:00Z,26,5,2020,44,1,Congo,CG,COG,5244363,Africa,17,531,56
2020-05-27T00:00:00Z,27,5,2020,38,2,Congo,CG,COG,5244363,Africa,19,569,57
2020-03-19T00:00:00Z,19,3,2020,19,1,Costa_Rica,CR,CRI,4999441,America,1,69,1
2020-03-20T00:00:00Z,20,3,2020,18,0,Costa_Rica,CR,CRI,4999441,America,1,87,2
2020-03-21T00:00:00Z,21,3,2020,26,1,Costa_Rica,CR,CRI,4999441,America,2,113,3
2020-03-22T00:00:00Z,22,3,2020,4,0,Costa_Rica,CR,CRI,4999441,America,2,117,4
2020-03-23T00:00:00Z,23,3,2020,17,0,Costa_Rica,CR,CRI,4999441,America,2,134,5
2020-03-24T00:00:00Z,24,3,2020,24,0,Costa_Rica,CR,CRI,4999441,America,2,158,6
2020-03-25T00:00:00Z,25,3,2020,19,0,Costa_Rica,CR,CRI,4999441,America,2,177,7
2020-03-26T00:00:00Z,26,3,2020,24,0,Costa_Rica,CR,CRI,4999441,America,2,201,8
2020-03-27T00:00:00Z,27,3,2020,30,0,Costa_Rica,CR,CRI,4999441,America,2,231,9
2020-03-28T00:00:00Z,28,3,2020,32,0,Costa_Rica,CR,CRI,4999441,America,2,263,10
2020-03-29T00:00:00Z,29,3,2020,32,0,Costa_Rica,CR,CRI,4999441,America,2,295,11
2020-03-30T00:00:00Z,30,3,2020,19,0,Costa_Rica,CR,CRI,4999441,America,2,314,12
2020-03-31T00:00:00Z,31,3,2020,16,0,Costa_Rica,CR,CRI,4999441,America,2,330,13
2020-04-01T00:00:00Z,1,4,2020,17,0,Costa_Rica,CR,CRI,4999441,America,2,347,14
2020-04-02T00:00:00Z,2,4,2020,28,0,Costa_Rica,CR,CRI,4999441,America,2,375,15
2020-04-03T00:00:00Z,3,4,2020,21,0,Costa_Rica,CR,CRI,4999441,America,2,396,16
2020-04-04T00:00:00Z,4,4,2020,20,0,Costa_Rica,CR,CRI,4999441,America,2,416,17
2020-04-05T00:00:00Z,5,4,2020,19,0,Costa_Rica,CR,CRI,4999441,America,2,435,18
2020-04-06T00:00:00Z,6,4,2020,19,0,Costa_Rica,CR,CRI,4999441,America,2,454,19
2020-04-07T00:00:00Z,7,4,2020,13,0,Costa_Rica,CR,CRI,4999441,America,2,467,20
2020-04-08T00:00:00Z,8,4,2020,16,0,Costa_Rica,CR,CRI,4999441,America,2,483,21
2020-04-09T00:00:00Z,9,4,2020,19,0,Costa_Rica,CR,CRI,4999441,America,2,502,22
2020-04-10T00:00:00Z,10,4,2020,37,1,Costa_Rica,CR,CRI,4999441,America,3,539,23
2020-04-11T00:00:00Z,11,4,2020,19,0,Costa_Rica,CR,CRI,4999441,America,3,558,24
2020-04-12T00:00:00Z,12,4,2020,19,0,Costa_Rica,CR,CRI,4999441,America,3,577,25
2020-04-13T00:00:00Z,13,4,2020,18,0,Costa_Rica,CR,CRI,4999441,America,3,595,26
2020-04-14T00:00:00Z,14,4,2020,17,0,Costa_Rica,CR,CRI,4999441,America,3,612,27
2020-04-15T00:00:00Z,15,4,2020,6,0,Costa_Rica,CR,CRI,4999441,America,3,618,28
2020-04-16T00:00:00Z,16,4,2020,8,1,Costa_Rica,CR,CRI,4999441,America,4,626,29
2020-04-17T00:00:00Z,17,4,2020,16,0,Costa_Rica,CR,CRI,4999441,America,4,642,30
2020-04-18T00:00:00Z,18,4,2020,7,0,Costa_Rica,CR,CRI,4999441,America,4,649,31
2020-04-19T00:00:00Z,19,4,2020,6,0,Costa_Rica,CR,CRI,4999441,America,4,655,32
2020-04-20T00:00:00Z,20,4,2020,5,0,Costa_Rica,CR,CRI,4999441,America,4,660,33
2020-04-21T00:00:00Z,21,4,2020,2,2,Costa_Rica,CR,CRI,4999441,America,6,662,34
2020-04-22T00:00:00Z,22,4,2020,7,0,Costa_Rica,CR,CRI,4999441,America,6,669,35
2020-04-23T00:00:00Z,23,4,2020,12,0,Costa_Rica,CR,CRI,4999441,America,6,681,36
2020-04-24T00:00:00Z,24,4,2020,6,0,Costa_Rica,CR,CRI,4999441,America,6,687,37
2020-04-25T00:00:00Z,25,4,2020,0,0,Costa_Rica,CR,CRI,4999441,America,6,687,38
2020-04-26T00:00:00Z,26,4,2020,6,0,Costa_Rica,CR,CRI,4999441,America,6,693,39
2020-04-27T00:00:00Z,27,4,2020,2,0,Costa_Rica,CR,CRI,4999441,America,6,695,40
2020-04-28T00:00:00Z,28,4,2020,2,0,Costa_Rica,CR,CRI,4999441,America,6,697,41
2020-04-29T00:00:00Z,29,4,2020,8,0,Costa_Rica,CR,CRI,4999441,America,6,705,42
2020-04-30T00:00:00Z,30,4,2020,8,0,Costa_Rica,CR,CRI,4999441,America,6,713,43
2020-05-01T00:00:00Z,1,5,2020,6,0,Costa_Rica,CR,CRI,4999441,America,6,719,44
2020-05-02T00:00:00Z,2,5,2020,6,0,Costa_Rica,CR,CRI,4999441,America,6,725,45
2020-05-03T00:00:00Z,3,5,2020,8,0,Costa_Rica,CR,CRI,4999441,America,6,733,46
2020-05-04T00:00:00Z,4,5,2020,6,0,Costa_Rica,CR,CRI,4999441,America,6,739,47
2020-05-05T00:00:00Z,5,5,2020,3,0,Costa_Rica,CR,CRI,4999441,America,6,742,48
2020-05-06T00:00:00Z,6,5,2020,13,0,Costa_Rica,CR,CRI,4999441,America,6,755,49
2020-05-07T00:00:00Z,7,5,2020,6,0,Costa_Rica,CR,CRI,4999441,America,6,761,50
2020-05-08T00:00:00Z,8,5,2020,4,0,Costa_Rica,CR,CRI,4999441,America,6,765,51
2020-05-09T00:00:00Z,9,5,2020,8,0,Costa_Rica,CR,CRI,4999441,America,6,773,52
2020-05-10T00:00:00Z,10,5,2020,7,0,Costa_Rica,CR,CRI,4999441,America,6,780,53
2020-05-11T00:00:00Z,11,5,2020,12,0,Costa_Rica,CR,CRI,4999441,America,6,792,54
2020-05-12T00:00:00Z,12,5,2020,9,1,Costa_Rica,CR,CRI,4999441,America,7,801,55
2020-05-13T00:00:00Z,13,5,2020,3,0,Costa_Rica,CR,CRI,4999441,America,7,804,56
2020-05-14T00:00:00Z,14,5,2020,11,0,Costa_Rica,CR,CRI,4999441,America,7,815,57
2020-05-15T00:00:00Z,15,5,2020,15,1,Costa_Rica,CR,CRI,4999441,America,8,830,58
2020-05-16T00:00:00Z,16,5,2020,13,0,Costa_Rica,CR,CRI,4999441,America,8,843,59
2020-05-17T00:00:00Z,17,5,2020,10,2,Costa_Rica,CR,CRI,4999441,America,10,853,60
2020-05-18T00:00:00Z,18,5,2020,10,0,Costa_Rica,CR,CRI,4999441,America,10,863,61
2020-05-19T00:00:00Z,19,5,2020,3,0,Costa_Rica,CR,CRI,4999441,America,10,866,62
2020-05-20T00:00:00Z,20,5,2020,16,0,Costa_Rica,CR,CRI,4999441,America,10,882,63
2020-05-21T00:00:00Z,21,5,2020,15,0,Costa_Rica,CR,CRI,4999441,America,10,897,64
2020-05-22T00:00:00Z,22,5,2020,6,0,Costa_Rica,CR,CRI,4999441,America,10,903,65
2020-05-23T00:00:00Z,23,5,2020,8,0,Costa_Rica,CR,CRI,4999441,America,10,911,66
2020-05-24T00:00:00Z,24,5,2020,7,0,Costa_Rica,CR,CRI,4999441,America,10,918,67
2020-05-25T00:00:00Z,25,5,2020,12,0,Costa_Rica,CR,CRI,4999441,America,10,930,68
2020-05-26T00:00:00Z,26,5,2020,21,0,Costa_Rica,CR,CRI,4999441,America,10,951,69
2020-05-27T00:00:00Z,27,5,2020,5,0,Costa_Rica,CR,CRI,4999441,America,10,956,70
2020-03-30T00:00:00Z,30,3,2020,25,1,Cote_dIvoire,CI,CIV,25069229,Africa,1,165,1
2020-03-31T00:00:00Z,31,3,2020,3,0,Cote_dIvoire,CI,CIV,25069229,Africa,1,168,2
2020-04-01T00:00:00Z,1,4,2020,0,0,Cote_dIvoire,CI,CIV,25069229,Africa,1,168,3
2020-04-02T00:00:00Z,2,4,2020,22,0,Cote_dIvoire,CI,CIV,25069229,Africa,1,190,4
2020-04-03T00:00:00Z,3,4,2020,4,0,Cote_dIvoire,CI,CIV,25069229,Africa,1,194,5
2020-04-04T00:00:00Z,4,4,2020,24,0,Cote_dIvoire,CI,CIV,25069229,Africa,1,218,6
2020-04-05T00:00:00Z,5,4,2020,27,1,Cote_dIvoire,CI,CIV,25069229,Africa,2,245,7
2020-04-06T00:00:00Z,6,4,2020,16,1,Cote_dIvoire,CI,CIV,25069229,Africa,3,261,8
2020-04-07T00:00:00Z,7,4,2020,62,0,Cote_dIvoire,CI,CIV,25069229,Africa,3,323,9
2020-04-08T00:00:00Z,8,4,2020,26,0,Cote_dIvoire,CI,CIV,25069229,Africa,3,349,10
2020-04-09T00:00:00Z,9,4,2020,35,0,Cote_dIvoire,CI,CIV,25069229,Africa,3,384,11
2020-04-10T00:00:00Z,10,4,2020,60,0,Cote_dIvoire,CI,CIV,25069229,Africa,3,444,12
2020-04-11T00:00:00Z,11,4,2020,36,0,Cote_dIvoire,CI,CIV,25069229,Africa,3,480,13
2020-04-12T00:00:00Z,12,4,2020,53,1,Cote_dIvoire,CI,CIV,25069229,Africa,4,533,14
2020-04-13T00:00:00Z,13,4,2020,41,1,Cote_dIvoire,CI,CIV,25069229,Africa,5,574,15
2020-04-14T00:00:00Z,14,4,2020,52,1,Cote_dIvoire,CI,CIV,25069229,Africa,6,626,16
2020-04-15T00:00:00Z,15,4,2020,0,0,Cote_dIvoire,CI,CIV,25069229,Africa,6,626,17
2020-04-16T00:00:00Z,16,4,2020,28,0,Cote_dIvoire,CI,CIV,25069229,Africa,6,654,18
2020-04-17T00:00:00Z,17,4,2020,34,0,Cote_dIvoire,CI,CIV,25069229,Africa,6,688,19
2020-04-18T00:00:00Z,18,4,2020,54,0,Cote_dIvoire,CI,CIV,25069229,Africa,6,742,20
2020-04-19T00:00:00Z,19,4,2020,59,2,Cote_dIvoire,CI,CIV,25069229,Africa,8,801,21
2020-04-20T00:00:00Z,20,4,2020,46,1,Cote_dIvoire,CI,CIV,25069229,Africa,9,847,22
2020-04-21T00:00:00Z,21,4,2020,32,1,Cote_dIvoire,CI,CIV,25069229,Africa,10,879,23
2020-04-22T00:00:00Z,22,4,2020,37,3,Cote_dIvoire,CI,CIV,25069229,Africa,13,916,24
2020-04-23T00:00:00Z,23,4,2020,36,1,Cote_dIvoire,CI,CIV,25069229,Africa,14,952,25
2020-04-24T00:00:00Z,24,4,2020,52,0,Cote_dIvoire,CI,CIV,25069229,Africa,14,1004,26
2020-04-25T00:00:00Z,25,4,2020,73,0,Cote_dIvoire,CI,CIV,25069229,Africa,14,1077,27
2020-04-26T00:00:00Z,26,4,2020,34,0,Cote_dIvoire,CI,CIV,25069229,Africa,14,1111,28
2020-04-27T00:00:00Z,27,4,2020,39,0,Cote_dIvoire,CI,CIV,25069229,Africa,14,1150,29
2020-04-28T00:00:00Z,28,4,2020,14,0,Cote_dIvoire,CI,CIV,25069229,Africa,14,1164,30
2020-04-29T00:00:00Z,29,4,2020,19,0,Cote_dIvoire,CI,CIV,25069229,Africa,14,1183,31
2020-04-30T00:00:00Z,30,4,2020,55,0,Cote_dIvoire,CI,CIV,25069229,Africa,14,1238,32
2020-05-01T00:00:00Z,1,5,2020,37,0,Cote_dIvoire,CI,CIV,25069229,Africa,14,1275,33
2020-05-02T00:00:00Z,2,5,2020,58,1,Cote_dIvoire,CI,CIV,25069229,Africa,15,1333,34
2020-05-03T00:00:00Z,3,5,2020,29,0,Cote_dIvoire,CI,CIV,25069229,Africa,15,1362,35
2020-05-04T00:00:00Z,4,5,2020,36,2,Cote_dIvoire,CI,CIV,25069229,Africa,17,1398,36
2020-05-05T00:00:00Z,5,5,2020,34,0,Cote_dIvoire,CI,CIV,25069229,Africa,17,1432,37
2020-05-06T00:00:00Z,6,5,2020,32,1,Cote_dIvoire,CI,CIV,25069229,Africa,18,1464,38
2020-05-07T00:00:00Z,7,5,2020,52,0,Cote_dIvoire,CI,CIV,25069229,Africa,18,1516,39
2020-05-08T00:00:00Z,8,5,2020,55,2,Cote_dIvoire,CI,CIV,25069229,Africa,20,1571,40
2020-05-09T00:00:00Z,9,5,2020,31,0,Cote_dIvoire,CI,CIV,25069229,Africa,20,1602,41
2020-05-10T00:00:00Z,10,5,2020,65,1,Cote_dIvoire,CI,CIV,25069229,Africa,21,1667,42
2020-05-11T00:00:00Z,11,5,2020,33,0,Cote_dIvoire,CI,CIV,25069229,Africa,21,1700,43
2020-05-12T00:00:00Z,12,5,2020,30,0,Cote_dIvoire,CI,CIV,25069229,Africa,21,1730,44
2020-05-13T00:00:00Z,13,5,2020,127,0,Cote_dIvoire,CI,CIV,25069229,Africa,21,1857,45
2020-05-14T00:00:00Z,14,5,2020,55,3,Cote_dIvoire,CI,CIV,25069229,Africa,24,1912,46
2020-05-15T00:00:00Z,15,5,2020,59,0,Cote_dIvoire,CI,CIV,25069229,Africa,24,1971,47
2020-05-16T00:00:00Z,16,5,2020,46,0,Cote_dIvoire,CI,CIV,25069229,Africa,24,2017,48
2020-05-17T00:00:00Z,17,5,2020,44,1,Cote_dIvoire,CI,CIV,25069229,Africa,25,2061,49
2020-05-18T00:00:00Z,18,5,2020,48,2,Cote_dIvoire,CI,CIV,25069229,Africa,27,2109,50
2020-05-19T00:00:00Z,19,5,2020,10,1,Cote_dIvoire,CI,CIV,25069229,Africa,28,2119,51
2020-05-20T00:00:00Z,20,5,2020,34,0,Cote_dIvoire,CI,CIV,25069229,Africa,28,2153,52
2020-05-21T00:00:00Z,21,5,2020,78,1,Cote_dIvoire,CI,CIV,25069229,Africa,29,2231,53
2020-05-22T00:00:00Z,22,5,2020,0,0,Cote_dIvoire,CI,CIV,25069229,Africa,29,2231,54
2020-05-23T00:00:00Z,23,5,2020,70,0,Cote_dIvoire,CI,CIV,25069229,Africa,29,2301,55
2020-05-24T00:00:00Z,24,5,2020,65,1,Cote_dIvoire,CI,CIV,25069229,Africa,30,2366,56
2020-05-25T00:00:00Z,25,5,2020,10,0,Cote_dIvoire,CI,CIV,25069229,Africa,30,2376,57
2020-05-26T00:00:00Z,26,5,2020,47,0,Cote_dIvoire,CI,CIV,25069229,Africa,30,2423,58
2020-05-27T00:00:00Z,27,5,2020,54,0,Cote_dIvoire,CI,CIV,25069229,Africa,30,2477,59
2020-03-25T00:00:00Z,25,3,2020,76,1,Croatia,HR,HRV,4089400,Europe,1,382,1
2020-03-26T00:00:00Z,26,3,2020,36,0,Croatia,HR,HRV,4089400,Europe,1,418,2
2020-03-27T00:00:00Z,27,3,2020,77,1,Croatia,HR,HRV,4089400,Europe,2,495,3
2020-03-28T00:00:00Z,28,3,2020,91,1,Croatia,HR,HRV,4089400,Europe,3,586,4
2020-03-29T00:00:00Z,29,3,2020,71,2,Croatia,HR,HRV,4089400,Europe,5,657,5
2020-03-30T00:00:00Z,30,3,2020,56,1,Croatia,HR,HRV,4089400,Europe,6,713,6
2020-03-31T00:00:00Z,31,3,2020,77,0,Croatia,HR,HRV,4089400,Europe,6,790,7
2020-04-01T00:00:00Z,1,4,2020,77,0,Croatia,HR,HRV,4089400,Europe,6,867,8
2020-04-02T00:00:00Z,2,4,2020,96,0,Croatia,HR,HRV,4089400,Europe,6,963,9
2020-04-03T00:00:00Z,3,4,2020,48,1,Croatia,HR,HRV,4089400,Europe,7,1011,10
2020-04-04T00:00:00Z,4,4,2020,68,1,Croatia,HR,HRV,4089400,Europe,8,1079,11
2020-04-05T00:00:00Z,5,4,2020,47,4,Croatia,HR,HRV,4089400,Europe,12,1126,12
2020-04-06T00:00:00Z,6,4,2020,56,3,Croatia,HR,HRV,4089400,Europe,15,1182,13
2020-04-07T00:00:00Z,7,4,2020,40,1,Croatia,HR,HRV,4089400,Europe,16,1222,14
2020-04-08T00:00:00Z,8,4,2020,60,2,Croatia,HR,HRV,4089400,Europe,18,1282,15
2020-04-09T00:00:00Z,9,4,2020,61,1,Croatia,HR,HRV,4089400,Europe,19,1343,16
2020-04-10T00:00:00Z,10,4,2020,64,1,Croatia,HR,HRV,4089400,Europe,20,1407,17
2020-04-11T00:00:00Z,11,4,2020,88,1,Croatia,HR,HRV,4089400,Europe,21,1495,18
2020-04-12T00:00:00Z,12,4,2020,39,0,Croatia,HR,HRV,4089400,Europe,21,1534,19
2020-04-13T00:00:00Z,13,4,2020,66,2,Croatia,HR,HRV,4089400,Europe,23,1600,20
2020-04-14T00:00:00Z,14,4,2020,50,2,Croatia,HR,HRV,4089400,Europe,25,1650,21
2020-04-15T00:00:00Z,15,4,2020,54,6,Croatia,HR,HRV,4089400,Europe,31,1704,22
2020-04-16T00:00:00Z,16,4,2020,37,3,Croatia,HR,HRV,4089400,Europe,34,1741,23
2020-04-17T00:00:00Z,17,4,2020,50,1,Croatia,HR,HRV,4089400,Europe,35,1791,24
2020-04-18T00:00:00Z,18,4,2020,23,1,Croatia,HR,HRV,4089400,Europe,36,1814,25
2020-04-19T00:00:00Z,19,4,2020,18,3,Croatia,HR,HRV,4089400,Europe,39,1832,26
2020-04-20T00:00:00Z,20,4,2020,39,8,Croatia,HR,HRV,4089400,Europe,47,1871,27
2020-04-21T00:00:00Z,21,4,2020,10,0,Croatia,HR,HRV,4089400,Europe,47,1881,28
2020-04-22T00:00:00Z,22,4,2020,27,1,Croatia,HR,HRV,4089400,Europe,48,1908,29
2020-04-23T00:00:00Z,23,4,2020,42,0,Croatia,HR,HRV,4089400,Europe,48,1950,30
2020-04-24T00:00:00Z,24,4,2020,31,2,Croatia,HR,HRV,4089400,Europe,50,1981,31
2020-04-25T00:00:00Z,25,4,2020,28,1,Croatia,HR,HRV,4089400,Europe,51,2009,32
2020-04-26T00:00:00Z,26,4,2020,7,3,Croatia,HR,HRV,4089400,Europe,54,2016,33
2020-04-27T00:00:00Z,27,4,2020,14,1,Croatia,HR,HRV,4089400,Europe,55,2030,34
2020-04-28T00:00:00Z,28,4,2020,9,4,Croatia,HR,HRV,4089400,Europe,59,2039,35
2020-04-29T00:00:00Z,29,4,2020,8,4,Croatia,HR,HRV,4089400,Europe,63,2047,36
2020-04-30T00:00:00Z,30,4,2020,15,4,Croatia,HR,HRV,4089400,Europe,67,2062,37
2020-05-01T00:00:00Z,1,5,2020,14,2,Croatia,HR,HRV,4089400,Europe,69,2076,38
2020-05-02T00:00:00Z,2,5,2020,9,6,Croatia,HR,HRV,4089400,Europe,75,2085,39
2020-05-03T00:00:00Z,3,5,2020,3,2,Croatia,HR,HRV,4089400,Europe,77,2088,40
2020-05-04T00:00:00Z,4,5,2020,8,2,Croatia,HR,HRV,4089400,Europe,79,2096,41
2020-05-05T00:00:00Z,5,5,2020,5,1,Croatia,HR,HRV,4089400,Europe,80,2101,42
2020-05-06T00:00:00Z,6,5,2020,11,3,Croatia,HR,HRV,4089400,Europe,83,2112,43
2020-05-07T00:00:00Z,7,5,2020,7,2,Croatia,HR,HRV,4089400,Europe,85,2119,44
2020-05-08T00:00:00Z,8,5,2020,6,1,Croatia,HR,HRV,4089400,Europe,86,2125,45
2020-05-09T00:00:00Z,9,5,2020,36,0,Croatia,HR,HRV,4089400,Europe,86,2161,46
2020-05-10T00:00:00Z,10,5,2020,15,1,Croatia,HR,HRV,4089400,Europe,87,2176,47
2020-05-11T00:00:00Z,11,5,2020,11,3,Croatia,HR,HRV,4089400,Europe,90,2187,48
2020-05-12T00:00:00Z,12,5,2020,9,1,Croatia,HR,HRV,4089400,Europe,91,2196,49
2020-05-13T00:00:00Z,13,5,2020,11,0,Croatia,HR,HRV,4089400,Europe,91,2207,50
2020-05-14T00:00:00Z,14,5,2020,6,3,Croatia,HR,HRV,4089400,Europe,94,2213,51
2020-05-15T00:00:00Z,15,5,2020,8,0,Croatia,HR,HRV,4089400,Europe,94,2221,52
2020-05-16T00:00:00Z,16,5,2020,1,1,Croatia,HR,HRV,4089400,Europe,95,2222,53
2020-05-17T00:00:00Z,17,5,2020,2,0,Croatia,HR,HRV,4089400,Europe,95,2224,54
2020-05-18T00:00:00Z,18,5,2020,2,0,Croatia,HR,HRV,4089400,Europe,95,2226,55
2020-05-19T00:00:00Z,19,5,2020,2,0,Croatia,HR,HRV,4089400,Europe,95,2228,56
2020-05-20T00:00:00Z,20,5,2020,4,1,Croatia,HR,HRV,4089400,Europe,96,2232,57
2020-05-21T00:00:00Z,21,5,2020,2,0,Croatia,HR,HRV,4089400,Europe,96,2234,58
2020-05-22T00:00:00Z,22,5,2020,3,1,Croatia,HR,HRV,4089400,Europe,97,2237,59
2020-05-23T00:00:00Z,23,5,2020,6,2,Croatia,HR,HRV,4089400,Europe,99,2243,60
2020-05-24T00:00:00Z,24,5,2020,0,0,Croatia,HR,HRV,4089400,Europe,99,2243,61
2020-05-25T00:00:00Z,25,5,2020,1,0,Croatia,HR,HRV,4089400,Europe,99,2244,62
2020-05-26T00:00:00Z,26,5,2020,0,1,Croatia,HR,HRV,4089400,Europe,100,2244,63
2020-05-27T00:00:00Z,27,5,2020,0,1,Croatia,HR,HRV,4089400,Europe,101,2244,64
2020-03-19T00:00:00Z,19,3,2020,4,1,Cuba,CU,CUB,11338138,America,1,11,1
2020-03-20T00:00:00Z,20,3,2020,5,0,Cuba,CU,CUB,11338138,America,1,16,2
2020-03-21T00:00:00Z,21,3,2020,5,0,Cuba,CU,CUB,11338138,America,1,21,3
2020-03-22T00:00:00Z,22,3,2020,4,0,Cuba,CU,CUB,11338138,America,1,25,4
2020-03-23T00:00:00Z,23,3,2020,10,0,Cuba,CU,CUB,11338138,America,1,35,5
2020-03-24T00:00:00Z,24,3,2020,5,0,Cuba,CU,CUB,11338138,America,1,40,6
2020-03-25T00:00:00Z,25,3,2020,8,0,Cuba,CU,CUB,11338138,America,1,48,7
2020-03-26T00:00:00Z,26,3,2020,9,0,Cuba,CU,CUB,11338138,America,1,57,8
2020-03-27T00:00:00Z,27,3,2020,10,1,Cuba,CU,CUB,11338138,America,2,67,9
2020-03-28T00:00:00Z,28,3,2020,13,0,Cuba,CU,CUB,11338138,America,2,80,10
2020-03-29T00:00:00Z,29,3,2020,39,1,Cuba,CU,CUB,11338138,America,3,119,11
2020-03-30T00:00:00Z,30,3,2020,20,0,Cuba,CU,CUB,11338138,America,3,139,12
2020-03-31T00:00:00Z,31,3,2020,31,1,Cuba,CU,CUB,11338138,America,4,170,13
2020-04-01T00:00:00Z,1,4,2020,16,2,Cuba,CU,CUB,11338138,America,6,186,14
2020-04-02T00:00:00Z,2,4,2020,26,0,Cuba,CU,CUB,11338138,America,6,212,15
2020-04-03T00:00:00Z,3,4,2020,21,0,Cuba,CU,CUB,11338138,America,6,233,16
2020-04-04T00:00:00Z,4,4,2020,36,0,Cuba,CU,CUB,11338138,America,6,269,17
2020-04-05T00:00:00Z,5,4,2020,19,0,Cuba,CU,CUB,11338138,America,6,288,18
2020-04-06T00:00:00Z,6,4,2020,32,2,Cuba,CU,CUB,11338138,America,8,320,19
2020-04-07T00:00:00Z,7,4,2020,30,1,Cuba,CU,CUB,11338138,America,9,350,20
2020-04-08T00:00:00Z,8,4,2020,46,2,Cuba,CU,CUB,11338138,America,11,396,21
2020-04-09T00:00:00Z,9,4,2020,61,1,Cuba,CU,CUB,11338138,America,12,457,22
2020-04-10T00:00:00Z,10,4,2020,58,3,Cuba,CU,CUB,11338138,America,15,515,23
2020-04-11T00:00:00Z,11,4,2020,49,0,Cuba,CU,CUB,11338138,America,15,564,24
2020-04-12T00:00:00Z,12,4,2020,56,1,Cuba,CU,CUB,11338138,America,16,620,25
2020-04-13T00:00:00Z,13,4,2020,49,2,Cuba,CU,CUB,11338138,America,18,669,26
2020-04-14T00:00:00Z,14,4,2020,57,3,Cuba,CU,CUB,11338138,America,21,726,27
2020-04-15T00:00:00Z,15,4,2020,40,0,Cuba,CU,CUB,11338138,America,21,766,28
2020-04-16T00:00:00Z,16,4,2020,48,3,Cuba,CU,CUB,11338138,America,24,814,29
2020-04-17T00:00:00Z,17,4,2020,48,3,Cuba,CU,CUB,11338138,America,27,862,30
2020-04-18T00:00:00Z,18,4,2020,61,4,Cuba,CU,CUB,11338138,America,31,923,31
2020-04-19T00:00:00Z,19,4,2020,63,1,Cuba,CU,CUB,11338138,America,32,986,32
2020-04-20T00:00:00Z,20,4,2020,49,2,Cuba,CU,CUB,11338138,America,34,1035,33
2020-04-21T00:00:00Z,21,4,2020,52,2,Cuba,CU,CUB,11338138,America,36,1087,34
2020-04-22T00:00:00Z,22,4,2020,50,2,Cuba,CU,CUB,11338138,America,38,1137,35
2020-04-23T00:00:00Z,23,4,2020,52,2,Cuba,CU,CUB,11338138,America,40,1189,36
2020-04-24T00:00:00Z,24,4,2020,46,3,Cuba,CU,CUB,11338138,America,43,1235,37
2020-04-25T00:00:00Z,25,4,2020,50,6,Cuba,CU,CUB,11338138,America,49,1285,38
2020-04-26T00:00:00Z,26,4,2020,52,2,Cuba,CU,CUB,11338138,America,51,1337,39
2020-04-27T00:00:00Z,27,4,2020,32,3,Cuba,CU,CUB,11338138,America,54,1369,40
2020-04-28T00:00:00Z,28,4,2020,20,2,Cuba,CU,CUB,11338138,America,56,1389,41
2020-04-29T00:00:00Z,29,4,2020,48,2,Cuba,CU,CUB,11338138,America,58,1437,42
2020-04-30T00:00:00Z,30,4,2020,30,0,Cuba,CU,CUB,11338138,America,58,1467,43
2020-05-01T00:00:00Z,1,5,2020,34,3,Cuba,CU,CUB,11338138,America,61,1501,44
2020-05-02T00:00:00Z,2,5,2020,36,3,Cuba,CU,CUB,11338138,America,64,1537,45
2020-05-03T00:00:00Z,3,5,2020,74,2,Cuba,CU,CUB,11338138,America,66,1611,46
2020-05-04T00:00:00Z,4,5,2020,38,1,Cuba,CU,CUB,11338138,America,67,1649,47
2020-05-05T00:00:00Z,5,5,2020,19,2,Cuba,CU,CUB,11338138,America,69,1668,48
2020-05-06T00:00:00Z,6,5,2020,17,0,Cuba,CU,CUB,11338138,America,69,1685,49
2020-05-07T00:00:00Z,7,5,2020,18,0,Cuba,CU,CUB,11338138,America,69,1703,50
2020-05-08T00:00:00Z,8,5,2020,26,4,Cuba,CU,CUB,11338138,America,73,1729,51
2020-05-09T00:00:00Z,9,5,2020,12,1,Cuba,CU,CUB,11338138,America,74,1741,52
2020-05-10T00:00:00Z,10,5,2020,13,0,Cuba,CU,CUB,11338138,America,74,1754,53
2020-05-11T00:00:00Z,11,5,2020,12,3,Cuba,CU,CUB,11338138,America,77,1766,54
2020-05-12T00:00:00Z,12,5,2020,17,0,Cuba,CU,CUB,11338138,America,77,1783,55
2020-05-13T00:00:00Z,13,5,2020,21,1,Cuba,CU,CUB,11338138,America,78,1804,56
2020-05-14T00:00:00Z,14,5,2020,6,1,Cuba,CU,CUB,11338138,America,79,1810,57
2020-05-15T00:00:00Z,15,5,2020,20,0,Cuba,CU,CUB,11338138,America,79,1830,58
2020-05-16T00:00:00Z,16,5,2020,10,0,Cuba,CU,CUB,11338138,America,79,1840,59
2020-05-17T00:00:00Z,17,5,2020,22,0,Cuba,CU,CUB,11338138,America,79,1862,60
2020-05-18T00:00:00Z,18,5,2020,10,0,Cuba,CU,CUB,11338138,America,79,1872,61
2020-05-19T00:00:00Z,19,5,2020,9,0,Cuba,CU,CUB,11338138,America,79,1881,62
2020-05-20T00:00:00Z,20,5,2020,6,0,Cuba,CU,CUB,11338138,America,79,1887,63
2020-05-21T00:00:00Z,21,5,2020,13,0,Cuba,CU,CUB,11338138,America,79,1900,64
2020-05-22T00:00:00Z,22,5,2020,8,1,Cuba,CU,CUB,11338138,America,80,1908,65
2020-05-23T00:00:00Z,23,5,2020,8,1,Cuba,CU,CUB,11338138,America,81,1916,66
2020-05-24T00:00:00Z,24,5,2020,15,0,Cuba,CU,CUB,11338138,America,81,1931,67
2020-05-25T00:00:00Z,25,5,2020,10,1,Cuba,CU,CUB,11338138,America,82,1941,68
2020-05-26T00:00:00Z,26,5,2020,6,0,Cuba,CU,CUB,11338138,America,82,1947,69
2020-05-27T00:00:00Z,27,5,2020,16,0,Cuba,CU,CUB,11338138,America,82,1963,70
2020-03-26T00:00:00Z,26,3,2020,0,1,CuraÃ§ao,CW,CUW,159849,America,1,6,1
2020-03-27T00:00:00Z,27,3,2020,1,0,CuraÃ§ao,CW,CUW,159849,America,1,7,2
2020-03-28T00:00:00Z,28,3,2020,1,0,CuraÃ§ao,CW,CUW,159849,America,1,8,3
2020-03-29T00:00:00Z,29,3,2020,0,0,CuraÃ§ao,CW,CUW,159849,America,1,8,4
2020-03-30T00:00:00Z,30,3,2020,1,0,CuraÃ§ao,CW,CUW,159849,America,1,9,5
2020-04-01T00:00:00Z,1,4,2020,2,0,CuraÃ§ao,CW,CUW,159849,America,1,11,6
2020-04-02T00:00:00Z,2,4,2020,0,0,CuraÃ§ao,CW,CUW,159849,America,1,11,7
2020-04-03T00:00:00Z,3,4,2020,0,0,CuraÃ§ao,CW,CUW,159849,America,1,11,8
2020-04-04T00:00:00Z,4,4,2020,0,0,CuraÃ§ao,CW,CUW,159849,America,1,11,9
2020-04-05T00:00:00Z,5,4,2020,0,0,CuraÃ§ao,CW,CUW,159849,America,1,11,10
2020-04-06T00:00:00Z,6,4,2020,0,0,CuraÃ§ao,CW,CUW,159849,America,1,11,11
2020-04-07T00:00:00Z,7,4,2020,2,0,CuraÃ§ao,CW,CUW,159849,America,1,13,12
2020-04-08T00:00:00Z,8,4,2020,0,0,CuraÃ§ao,CW,CUW,159849,America,1,13,13
2020-04-09T00:00:00Z,9,4,2020,1,0,CuraÃ§ao,CW,CUW,159849,America,1,14,14
2020-04-10T00:00:00Z,10,4,2020,0,0,CuraÃ§ao,CW,CUW,159849,America,1,14,15
2020-04-11T00:00:00Z,11,4,2020,0,0,CuraÃ§ao,CW,CUW,159849,America,1,14,16
2020-04-12T00:00:00Z,12,4,2020,0,0,CuraÃ§ao,CW,CUW,159849,America,1,14,17
2020-04-13T00:00:00Z,13,4,2020,0,0,CuraÃ§ao,CW,CUW,159849,America,1,14,18
2020-04-14T00:00:00Z,14,4,2020,0,0,CuraÃ§ao,CW,CUW,159849,America,1,14,19
2020-04-15T00:00:00Z,15,4,2020,0,0,CuraÃ§ao,CW,CUW,159849,America,1,14,20
2020-04-16T00:00:00Z,16,4,2020,0,0,CuraÃ§ao,CW,CUW,159849,America,1,14,21
2020-04-17T00:00:00Z,17,4,2020,0,0,CuraÃ§ao,CW,CUW,159849,America,1,14,22
2020-04-18T00:00:00Z,18,4,2020,0,0,CuraÃ§ao,CW,CUW,159849,America,1,14,23
2020-04-19T00:00:00Z,19,4,2020,0,0,CuraÃ§ao,CW,CUW,159849,America,1,14,24
2020-04-20T00:00:00Z,20,4,2020,0,0,CuraÃ§ao,CW,CUW,159849,America,1,14,25
2020-04-21T00:00:00Z,21,4,2020,0,0,CuraÃ§ao,CW,CUW,159849,America,1,14,26
2020-04-22T00:00:00Z,22,4,2020,0,0,CuraÃ§ao,CW,CUW,159849,America,1,14,27
2020-04-23T00:00:00Z,23,4,2020,0,0,CuraÃ§ao,CW,CUW,159849,America,1,14,28
2020-04-24T00:00:00Z,24,4,2020,0,0,CuraÃ§ao,CW,CUW,159849,America,1,14,29
2020-04-25T00:00:00Z,25,4,2020,2,0,CuraÃ§ao,CW,CUW,159849,America,1,16,30
2020-04-26T00:00:00Z,26,4,2020,0,0,CuraÃ§ao,CW,CUW,159849,America,1,16,31
2020-04-27T00:00:00Z,27,4,2020,0,0,CuraÃ§ao,CW,CUW,159849,America,1,16,32
2020-04-28T00:00:00Z,28,4,2020,0,0,CuraÃ§ao,CW,CUW,159849,America,1,16,33
2020-04-29T00:00:00Z,29,4,2020,0,0,CuraÃ§ao,CW,CUW,159849,America,1,16,34
2020-04-30T00:00:00Z,30,4,2020,0,0,CuraÃ§ao,CW,CUW,159849,America,1,16,35
2020-05-01T00:00:00Z,1,5,2020,0,0,CuraÃ§ao,CW,CUW,159849,America,1,16,36
2020-05-02T00:00:00Z,2,5,2020,0,0,CuraÃ§ao,CW,CUW,159849,America,1,16,37
2020-05-03T00:00:00Z,3,5,2020,0,0,CuraÃ§ao,CW,CUW,159849,America,1,16,38
2020-05-04T00:00:00Z,4,5,2020,0,0,CuraÃ§ao,CW,CUW,159849,America,1,16,39
2020-05-05T00:00:00Z,5,5,2020,0,0,CuraÃ§ao,CW,CUW,159849,America,1,16,40
2020-05-06T00:00:00Z,6,5,2020,0,0,CuraÃ§ao,CW,CUW,159849,America,1,16,41
2020-05-07T00:00:00Z,7,5,2020,0,0,CuraÃ§ao,CW,CUW,159849,America,1,16,42
2020-05-08T00:00:00Z,8,5,2020,0,0,CuraÃ§ao,CW,CUW,159849,America,1,16,43
2020-05-09T00:00:00Z,9,5,2020,0,0,CuraÃ§ao,CW,CUW,159849,America,1,16,44
2020-05-10T00:00:00Z,10,5,2020,0,0,CuraÃ§ao,CW,CUW,159849,America,1,16,45
2020-05-11T00:00:00Z,11,5,2020,0,0,CuraÃ§ao,CW,CUW,159849,America,1,16,46
2020-05-12T00:00:00Z,12,5,2020,0,0,CuraÃ§ao,CW,CUW,159849,America,1,16,47
2020-05-13T00:00:00Z,13,5,2020,0,0,CuraÃ§ao,CW,CUW,159849,America,1,16,48
2020-05-14T00:00:00Z,14,5,2020,0,0,CuraÃ§ao,CW,CUW,159849,America,1,16,49
2020-05-15T00:00:00Z,15,5,2020,0,0,CuraÃ§ao,CW,CUW,159849,America,1,16,50
2020-05-16T00:00:00Z,16,5,2020,0,0,CuraÃ§ao,CW,CUW,159849,America,1,16,51
2020-05-17T00:00:00Z,17,5,2020,0,0,CuraÃ§ao,CW,CUW,159849,America,1,16,52
2020-05-18T00:00:00Z,18,5,2020,0,0,CuraÃ§ao,CW,CUW,159849,America,1,16,53
2020-05-19T00:00:00Z,19,5,2020,0,0,CuraÃ§ao,CW,CUW,159849,America,1,16,54
2020-05-20T00:00:00Z,20,5,2020,0,0,CuraÃ§ao,CW,CUW,159849,America,1,16,55
2020-05-21T00:00:00Z,21,5,2020,0,0,CuraÃ§ao,CW,CUW,159849,America,1,16,56
2020-05-22T00:00:00Z,22,5,2020,0,0,CuraÃ§ao,CW,CUW,159849,America,1,16,57
2020-05-23T00:00:00Z,23,5,2020,0,0,CuraÃ§ao,CW,CUW,159849,America,1,16,58
2020-05-24T00:00:00Z,24,5,2020,0,0,CuraÃ§ao,CW,CUW,159849,America,1,16,59
2020-05-25T00:00:00Z,25,5,2020,1,0,CuraÃ§ao,CW,CUW,159849,America,1,17,60
2020-05-26T00:00:00Z,26,5,2020,1,0,CuraÃ§ao,CW,CUW,159849,America,1,18,61
2020-05-27T00:00:00Z,27,5,2020,0,0,CuraÃ§ao,CW,CUW,159849,America,1,18,62
2020-03-25T00:00:00Z,25,3,2020,8,3,Cyprus,CY,CYP,1189265,Europe,3,124,1
2020-03-26T00:00:00Z,26,3,2020,8,0,Cyprus,CY,CYP,1189265,Europe,3,132,2
2020-03-27T00:00:00Z,27,3,2020,14,0,Cyprus,CY,CYP,1189265,Europe,3,146,3
2020-03-28T00:00:00Z,28,3,2020,16,2,Cyprus,CY,CYP,1189265,Europe,5,162,4
2020-03-29T00:00:00Z,29,3,2020,17,0,Cyprus,CY,CYP,1189265,Europe,5,179,5
2020-03-30T00:00:00Z,30,3,2020,35,1,Cyprus,CY,CYP,1189265,Europe,6,214,6
2020-03-31T00:00:00Z,31,3,2020,16,1,Cyprus,CY,CYP,1189265,Europe,7,230,7
2020-04-01T00:00:00Z,1,4,2020,32,1,Cyprus,CY,CYP,1189265,Europe,8,262,8
2020-04-02T00:00:00Z,2,4,2020,58,1,Cyprus,CY,CYP,1189265,Europe,9,320,9
2020-04-03T00:00:00Z,3,4,2020,36,0,Cyprus,CY,CYP,1189265,Europe,9,356,10
2020-04-04T00:00:00Z,4,4,2020,40,0,Cyprus,CY,CYP,1189265,Europe,9,396,11
2020-04-05T00:00:00Z,5,4,2020,30,0,Cyprus,CY,CYP,1189265,Europe,9,426,12
2020-04-06T00:00:00Z,6,4,2020,20,0,Cyprus,CY,CYP,1189265,Europe,9,446,13
2020-04-07T00:00:00Z,7,4,2020,19,0,Cyprus,CY,CYP,1189265,Europe,9,465,14
2020-04-08T00:00:00Z,8,4,2020,29,0,Cyprus,CY,CYP,1189265,Europe,9,494,15
2020-04-09T00:00:00Z,9,4,2020,32,0,Cyprus,CY,CYP,1189265,Europe,9,526,16
2020-04-10T00:00:00Z,10,4,2020,38,1,Cyprus,CY,CYP,1189265,Europe,10,564,17
2020-04-11T00:00:00Z,11,4,2020,31,0,Cyprus,CY,CYP,1189265,Europe,10,595,18
2020-04-12T00:00:00Z,12,4,2020,21,0,Cyprus,CY,CYP,1189265,Europe,10,616,19
2020-04-13T00:00:00Z,13,4,2020,17,1,Cyprus,CY,CYP,1189265,Europe,11,633,20
2020-04-14T00:00:00Z,14,4,2020,29,1,Cyprus,CY,CYP,1189265,Europe,12,662,21
2020-04-15T00:00:00Z,15,4,2020,33,0,Cyprus,CY,CYP,1189265,Europe,12,695,22
2020-04-16T00:00:00Z,16,4,2020,20,0,Cyprus,CY,CYP,1189265,Europe,12,715,23
2020-04-17T00:00:00Z,17,4,2020,20,0,Cyprus,CY,CYP,1189265,Europe,12,735,24
2020-04-18T00:00:00Z,18,4,2020,0,0,Cyprus,CY,CYP,1189265,Europe,12,735,25
2020-04-19T00:00:00Z,19,4,2020,26,0,Cyprus,CY,CYP,1189265,Europe,12,761,26
2020-04-20T00:00:00Z,20,4,2020,6,0,Cyprus,CY,CYP,1189265,Europe,12,767,27
2020-04-21T00:00:00Z,21,4,2020,5,0,Cyprus,CY,CYP,1189265,Europe,12,772,28
2020-04-22T00:00:00Z,22,4,2020,12,0,Cyprus,CY,CYP,1189265,Europe,12,784,29
2020-04-23T00:00:00Z,23,4,2020,6,2,Cyprus,CY,CYP,1189265,Europe,14,790,30
2020-04-24T00:00:00Z,24,4,2020,5,0,Cyprus,CY,CYP,1189265,Europe,14,795,31
2020-04-25T00:00:00Z,25,4,2020,9,0,Cyprus,CY,CYP,1189265,Europe,14,804,32
2020-04-26T00:00:00Z,26,4,2020,6,0,Cyprus,CY,CYP,1189265,Europe,14,810,33
2020-04-27T00:00:00Z,27,4,2020,7,0,Cyprus,CY,CYP,1189265,Europe,14,817,34
2020-04-28T00:00:00Z,28,4,2020,5,1,Cyprus,CY,CYP,1189265,Europe,15,822,35
2020-04-29T00:00:00Z,29,4,2020,15,0,Cyprus,CY,CYP,1189265,Europe,15,837,36
2020-04-30T00:00:00Z,30,4,2020,6,0,Cyprus,CY,CYP,1189265,Europe,15,843,37
2020-05-01T00:00:00Z,1,5,2020,7,0,Cyprus,CY,CYP,1189265,Europe,15,850,38
2020-05-02T00:00:00Z,2,5,2020,7,0,Cyprus,CY,CYP,1189265,Europe,15,857,39
2020-05-03T00:00:00Z,3,5,2020,7,0,Cyprus,CY,CYP,1189265,Europe,15,864,40
2020-05-04T00:00:00Z,4,5,2020,8,0,Cyprus,CY,CYP,1189265,Europe,15,872,41
2020-05-05T00:00:00Z,5,5,2020,2,0,Cyprus,CY,CYP,1189265,Europe,15,874,42
2020-05-06T00:00:00Z,6,5,2020,4,0,Cyprus,CY,CYP,1189265,Europe,15,878,43
2020-05-07T00:00:00Z,7,5,2020,5,0,Cyprus,CY,CYP,1189265,Europe,15,883,44
2020-05-08T00:00:00Z,8,5,2020,6,0,Cyprus,CY,CYP,1189265,Europe,15,889,45
2020-05-09T00:00:00Z,9,5,2020,2,0,Cyprus,CY,CYP,1189265,Europe,15,891,46
2020-05-10T00:00:00Z,10,5,2020,1,0,Cyprus,CY,CYP,1189265,Europe,15,892,47
2020-05-11T00:00:00Z,11,5,2020,6,1,Cyprus,CY,CYP,1189265,Europe,16,898,48
2020-05-12T00:00:00Z,12,5,2020,3,0,Cyprus,CY,CYP,1189265,Europe,16,901,49
2020-05-13T00:00:00Z,13,5,2020,2,0,Cyprus,CY,CYP,1189265,Europe,16,903,50
2020-05-14T00:00:00Z,14,5,2020,2,1,Cyprus,CY,CYP,1189265,Europe,17,905,51
2020-05-15T00:00:00Z,15,5,2020,2,0,Cyprus,CY,CYP,1189265,Europe,17,907,52
2020-05-16T00:00:00Z,16,5,2020,3,0,Cyprus,CY,CYP,1189265,Europe,17,910,53
2020-05-17T00:00:00Z,17,5,2020,4,0,Cyprus,CY,CYP,1189265,Europe,17,914,54
2020-05-18T00:00:00Z,18,5,2020,2,0,Cyprus,CY,CYP,1189265,Europe,17,916,55
2020-05-19T00:00:00Z,19,5,2020,1,0,Cyprus,CY,CYP,1189265,Europe,17,917,56
2020-05-20T00:00:00Z,20,5,2020,1,0,Cyprus,CY,CYP,1189265,Europe,17,918,57
2020-05-21T00:00:00Z,21,5,2020,4,0,Cyprus,CY,CYP,1189265,Europe,17,922,58
2020-05-22T00:00:00Z,22,5,2020,1,0,Cyprus,CY,CYP,1189265,Europe,17,923,59
2020-05-23T00:00:00Z,23,5,2020,4,0,Cyprus,CY,CYP,1189265,Europe,17,927,60
2020-05-24T00:00:00Z,24,5,2020,0,0,Cyprus,CY,CYP,1189265,Europe,17,927,61
2020-05-25T00:00:00Z,25,5,2020,8,0,Cyprus,CY,CYP,1189265,Europe,17,935,62
2020-05-26T00:00:00Z,26,5,2020,2,0,Cyprus,CY,CYP,1189265,Europe,17,937,63
2020-05-27T00:00:00Z,27,5,2020,2,0,Cyprus,CY,CYP,1189265,Europe,17,939,64
2020-03-23T00:00:00Z,23,3,2020,170,1,Czechia,CZ,CZE,10625695,Europe,1,1165,1
2020-03-24T00:00:00Z,24,3,2020,71,0,Czechia,CZ,CZE,10625695,Europe,1,1236,2
2020-03-25T00:00:00Z,25,3,2020,158,2,Czechia,CZ,CZE,10625695,Europe,3,1394,3
2020-03-26T00:00:00Z,26,3,2020,260,3,Czechia,CZ,CZE,10625695,Europe,6,1654,4
2020-03-27T00:00:00Z,27,3,2020,408,3,Czechia,CZ,CZE,10625695,Europe,9,2062,5
2020-03-28T00:00:00Z,28,3,2020,217,0,Czechia,CZ,CZE,10625695,Europe,9,2279,6
2020-03-29T00:00:00Z,29,3,2020,384,2,Czechia,CZ,CZE,10625695,Europe,11,2663,7
2020-03-30T00:00:00Z,30,3,2020,166,5,Czechia,CZ,CZE,10625695,Europe,16,2829,8
2020-03-31T00:00:00Z,31,3,2020,173,8,Czechia,CZ,CZE,10625695,Europe,24,3002,9
2020-04-01T00:00:00Z,1,4,2020,306,7,Czechia,CZ,CZE,10625695,Europe,31,3308,10
2020-04-02T00:00:00Z,2,4,2020,281,8,Czechia,CZ,CZE,10625695,Europe,39,3589,11
2020-04-03T00:00:00Z,3,4,2020,269,5,Czechia,CZ,CZE,10625695,Europe,44,3858,12
2020-04-04T00:00:00Z,4,4,2020,332,9,Czechia,CZ,CZE,10625695,Europe,53,4190,13
2020-04-05T00:00:00Z,5,4,2020,282,6,Czechia,CZ,CZE,10625695,Europe,59,4472,14
2020-04-06T00:00:00Z,6,4,2020,115,8,Czechia,CZ,CZE,10625695,Europe,67,4587,15
2020-04-07T00:00:00Z,7,4,2020,235,11,Czechia,CZ,CZE,10625695,Europe,78,4822,16
2020-04-08T00:00:00Z,8,4,2020,195,10,Czechia,CZ,CZE,10625695,Europe,88,5017,17
2020-04-09T00:00:00Z,9,4,2020,295,11,Czechia,CZ,CZE,10625695,Europe,99,5312,18
2020-04-10T00:00:00Z,10,4,2020,257,13,Czechia,CZ,CZE,10625695,Europe,112,5569,19
2020-04-11T00:00:00Z,11,4,2020,163,7,Czechia,CZ,CZE,10625695,Europe,119,5732,20
2020-04-12T00:00:00Z,12,4,2020,170,10,Czechia,CZ,CZE,10625695,Europe,129,5902,21
2020-04-13T00:00:00Z,13,4,2020,89,9,Czechia,CZ,CZE,10625695,Europe,138,5991,22
2020-04-14T00:00:00Z,14,4,2020,68,5,Czechia,CZ,CZE,10625695,Europe,143,6059,23
2020-04-15T00:00:00Z,15,4,2020,82,18,Czechia,CZ,CZE,10625695,Europe,161,6141,24
2020-04-16T00:00:00Z,16,4,2020,162,5,Czechia,CZ,CZE,10625695,Europe,166,6303,25
2020-04-17T00:00:00Z,17,4,2020,130,3,Czechia,CZ,CZE,10625695,Europe,169,6433,26
2020-04-18T00:00:00Z,18,4,2020,116,4,Czechia,CZ,CZE,10625695,Europe,173,6549,27
2020-04-19T00:00:00Z,19,4,2020,105,8,Czechia,CZ,CZE,10625695,Europe,181,6654,28
2020-04-20T00:00:00Z,20,4,2020,133,7,Czechia,CZ,CZE,10625695,Europe,188,6787,29
2020-04-21T00:00:00Z,21,4,2020,127,8,Czechia,CZ,CZE,10625695,Europe,196,6914,30
2020-04-22T00:00:00Z,22,4,2020,127,5,Czechia,CZ,CZE,10625695,Europe,201,7041,31
2020-04-23T00:00:00Z,23,4,2020,95,9,Czechia,CZ,CZE,10625695,Europe,210,7136,32
2020-04-24T00:00:00Z,24,4,2020,52,3,Czechia,CZ,CZE,10625695,Europe,213,7188,33
2020-04-25T00:00:00Z,25,4,2020,85,2,Czechia,CZ,CZE,10625695,Europe,215,7273,34
2020-04-26T00:00:00Z,26,4,2020,79,3,Czechia,CZ,CZE,10625695,Europe,218,7352,35
2020-04-27T00:00:00Z,27,4,2020,52,3,Czechia,CZ,CZE,10625695,Europe,221,7404,36
2020-04-28T00:00:00Z,28,4,2020,45,2,Czechia,CZ,CZE,10625695,Europe,223,7449,37
2020-04-29T00:00:00Z,29,4,2020,55,4,Czechia,CZ,CZE,10625695,Europe,227,7504,38
2020-04-30T00:00:00Z,30,4,2020,75,0,Czechia,CZ,CZE,10625695,Europe,227,7579,39
2020-05-01T00:00:00Z,1,5,2020,103,9,Czechia,CZ,CZE,10625695,Europe,236,7682,40
2020-05-02T00:00:00Z,2,5,2020,55,4,Czechia,CZ,CZE,10625695,Europe,240,7737,41
2020-05-03T00:00:00Z,3,5,2020,18,5,Czechia,CZ,CZE,10625695,Europe,245,7755,42
2020-05-04T00:00:00Z,4,5,2020,26,3,Czechia,CZ,CZE,10625695,Europe,248,7781,43
2020-05-05T00:00:00Z,5,5,2020,38,4,Czechia,CZ,CZE,10625695,Europe,252,7819,44
2020-05-06T00:00:00Z,6,5,2020,77,5,Czechia,CZ,CZE,10625695,Europe,257,7896,45
2020-05-07T00:00:00Z,7,5,2020,78,5,Czechia,CZ,CZE,10625695,Europe,262,7974,46
2020-05-08T00:00:00Z,8,5,2020,57,8,Czechia,CZ,CZE,10625695,Europe,270,8031,47
2020-05-09T00:00:00Z,9,5,2020,46,3,Czechia,CZ,CZE,10625695,Europe,273,8077,48
2020-05-10T00:00:00Z,10,5,2020,18,3,Czechia,CZ,CZE,10625695,Europe,276,8095,49
2020-05-11T00:00:00Z,11,5,2020,28,4,Czechia,CZ,CZE,10625695,Europe,280,8123,50
2020-05-12T00:00:00Z,12,5,2020,53,2,Czechia,CZ,CZE,10625695,Europe,282,8176,51
2020-05-13T00:00:00Z,13,5,2020,45,1,Czechia,CZ,CZE,10625695,Europe,283,8221,52
2020-05-14T00:00:00Z,14,5,2020,48,7,Czechia,CZ,CZE,10625695,Europe,290,8269,53
2020-05-15T00:00:00Z,15,5,2020,82,3,Czechia,CZ,CZE,10625695,Europe,293,8351,54
2020-05-16T00:00:00Z,16,5,2020,55,2,Czechia,CZ,CZE,10625695,Europe,295,8406,55
2020-05-17T00:00:00Z,17,5,2020,49,1,Czechia,CZ,CZE,10625695,Europe,296,8455,56
2020-05-18T00:00:00Z,18,5,2020,20,1,Czechia,CZ,CZE,10625695,Europe,297,8475,57
2020-05-19T00:00:00Z,19,5,2020,111,0,Czechia,CZ,CZE,10625695,Europe,297,8586,58
2020-05-20T00:00:00Z,20,5,2020,61,5,Czechia,CZ,CZE,10625695,Europe,302,8647,59
2020-05-21T00:00:00Z,21,5,2020,74,2,Czechia,CZ,CZE,10625695,Europe,304,8721,60
2020-05-22T00:00:00Z,22,5,2020,33,2,Czechia,CZ,CZE,10625695,Europe,306,8754,61
2020-05-23T00:00:00Z,23,5,2020,59,6,Czechia,CZ,CZE,10625695,Europe,312,8813,62
2020-05-24T00:00:00Z,24,5,2020,77,2,Czechia,CZ,CZE,10625695,Europe,314,8890,63
2020-05-25T00:00:00Z,25,5,2020,67,1,Czechia,CZ,CZE,10625695,Europe,315,8957,64
2020-05-26T00:00:00Z,26,5,2020,47,2,Czechia,CZ,CZE,10625695,Europe,317,9004,65
2020-05-27T00:00:00Z,27,5,2020,46,0,Czechia,CZ,CZE,10625695,Europe,317,9050,66
2020-03-22T00:00:00Z,22,3,2020,9,1,Democratic_Republic_of_the_Congo,CD,COD,84068091,Africa,1,23,1
2020-03-23T00:00:00Z,23,3,2020,3,1,Democratic_Republic_of_the_Congo,CD,COD,84068091,Africa,2,26,2
2020-03-24T00:00:00Z,24,3,2020,0,0,Democratic_Republic_of_the_Congo,CD,COD,84068091,Africa,2,26,3
2020-03-25T00:00:00Z,25,3,2020,19,1,Democratic_Republic_of_the_Congo,CD,COD,84068091,Africa,3,45,4
2020-03-26T00:00:00Z,26,3,2020,0,0,Democratic_Republic_of_the_Congo,CD,COD,84068091,Africa,3,45,5
2020-03-27T00:00:00Z,27,3,2020,9,1,Democratic_Republic_of_the_Congo,CD,COD,84068091,Africa,4,54,6
2020-03-28T00:00:00Z,28,3,2020,4,0,Democratic_Republic_of_the_Congo,CD,COD,84068091,Africa,4,58,7
2020-03-29T00:00:00Z,29,3,2020,0,2,Democratic_Republic_of_the_Congo,CD,COD,84068091,Africa,6,58,8
2020-03-30T00:00:00Z,30,3,2020,23,2,Democratic_Republic_of_the_Congo,CD,COD,84068091,Africa,8,81,9
2020-03-31T00:00:00Z,31,3,2020,17,0,Democratic_Republic_of_the_Congo,CD,COD,84068091,Africa,8,98,10
2020-04-01T00:00:00Z,1,4,2020,0,0,Democratic_Republic_of_the_Congo,CD,COD,84068091,Africa,8,98,11
2020-04-02T00:00:00Z,2,4,2020,25,3,Democratic_Republic_of_the_Congo,CD,COD,84068091,Africa,11,123,12
2020-04-03T00:00:00Z,3,4,2020,0,0,Democratic_Republic_of_the_Congo,CD,COD,84068091,Africa,11,123,13
2020-04-04T00:00:00Z,4,4,2020,11,2,Democratic_Republic_of_the_Congo,CD,COD,84068091,Africa,13,134,14
2020-04-05T00:00:00Z,5,4,2020,20,5,Democratic_Republic_of_the_Congo,CD,COD,84068091,Africa,18,154,15
2020-04-06T00:00:00Z,6,4,2020,0,0,Democratic_Republic_of_the_Congo,CD,COD,84068091,Africa,18,154,16
2020-04-07T00:00:00Z,7,4,2020,7,0,Democratic_Republic_of_the_Congo,CD,COD,84068091,Africa,18,161,17
2020-04-08T00:00:00Z,8,4,2020,19,0,Democratic_Republic_of_the_Congo,CD,COD,84068091,Africa,18,180,18
2020-04-09T00:00:00Z,9,4,2020,3,2,Democratic_Republic_of_the_Congo,CD,COD,84068091,Africa,20,183,19
2020-04-10T00:00:00Z,10,4,2020,32,0,Democratic_Republic_of_the_Congo,CD,COD,84068091,Africa,20,215,20
2020-04-11T00:00:00Z,11,4,2020,8,0,Democratic_Republic_of_the_Congo,CD,COD,84068091,Africa,20,223,21
2020-04-12T00:00:00Z,12,4,2020,11,0,Democratic_Republic_of_the_Congo,CD,COD,84068091,Africa,20,234,22
2020-04-13T00:00:00Z,13,4,2020,0,0,Democratic_Republic_of_the_Congo,CD,COD,84068091,Africa,20,234,23
2020-04-14T00:00:00Z,14,4,2020,1,0,Democratic_Republic_of_the_Congo,CD,COD,84068091,Africa,20,235,24
2020-04-15T00:00:00Z,15,4,2020,19,1,Democratic_Republic_of_the_Congo,CD,COD,84068091,Africa,21,254,25
2020-04-16T00:00:00Z,16,4,2020,13,1,Democratic_Republic_of_the_Congo,CD,COD,84068091,Africa,22,267,26
2020-04-17T00:00:00Z,17,4,2020,20,1,Democratic_Republic_of_the_Congo,CD,COD,84068091,Africa,23,287,27
2020-04-18T00:00:00Z,18,4,2020,20,2,Democratic_Republic_of_the_Congo,CD,COD,84068091,Africa,25,307,28
2020-04-19T00:00:00Z,19,4,2020,20,0,Democratic_Republic_of_the_Congo,CD,COD,84068091,Africa,25,327,29
2020-04-20T00:00:00Z,20,4,2020,5,0,Democratic_Republic_of_the_Congo,CD,COD,84068091,Africa,25,332,30
2020-04-21T00:00:00Z,21,4,2020,18,0,Democratic_Republic_of_the_Congo,CD,COD,84068091,Africa,25,350,31
2020-04-22T00:00:00Z,22,4,2020,9,0,Democratic_Republic_of_the_Congo,CD,COD,84068091,Africa,25,359,32
2020-04-23T00:00:00Z,23,4,2020,18,0,Democratic_Republic_of_the_Congo,CD,COD,84068091,Africa,25,377,33
2020-04-24T00:00:00Z,24,4,2020,17,0,Democratic_Republic_of_the_Congo,CD,COD,84068091,Africa,25,394,34
2020-04-25T00:00:00Z,25,4,2020,22,3,Democratic_Republic_of_the_Congo,CD,COD,84068091,Africa,28,416,35
2020-04-26T00:00:00Z,26,4,2020,26,0,Democratic_Republic_of_the_Congo,CD,COD,84068091,Africa,28,442,36
2020-04-27T00:00:00Z,27,4,2020,17,0,Democratic_Republic_of_the_Congo,CD,COD,84068091,Africa,28,459,37
2020-04-28T00:00:00Z,28,4,2020,12,2,Democratic_Republic_of_the_Congo,CD,COD,84068091,Africa,30,471,38
2020-04-29T00:00:00Z,29,4,2020,20,0,Democratic_Republic_of_the_Congo,CD,COD,84068091,Africa,30,491,39
2020-04-30T00:00:00Z,30,4,2020,9,1,Democratic_Republic_of_the_Congo,CD,COD,84068091,Africa,31,500,40
2020-05-01T00:00:00Z,1,5,2020,72,0,Democratic_Republic_of_the_Congo,CD,COD,84068091,Africa,31,572,41
2020-05-02T00:00:00Z,2,5,2020,32,1,Democratic_Republic_of_the_Congo,CD,COD,84068091,Africa,32,604,42
2020-05-03T00:00:00Z,3,5,2020,70,1,Democratic_Republic_of_the_Congo,CD,COD,84068091,Africa,33,674,43
2020-05-04T00:00:00Z,4,5,2020,10,1,Democratic_Republic_of_the_Congo,CD,COD,84068091,Africa,34,684,44
2020-05-05T00:00:00Z,5,5,2020,0,0,Democratic_Republic_of_the_Congo,CD,COD,84068091,Africa,34,684,45
2020-05-06T00:00:00Z,6,5,2020,21,0,Democratic_Republic_of_the_Congo,CD,COD,84068091,Africa,34,705,46
2020-05-07T00:00:00Z,7,5,2020,158,2,Democratic_Republic_of_the_Congo,CD,COD,84068091,Africa,36,863,47
2020-05-08T00:00:00Z,8,5,2020,34,0,Democratic_Republic_of_the_Congo,CD,COD,84068091,Africa,36,897,48
2020-05-09T00:00:00Z,9,5,2020,40,3,Democratic_Republic_of_the_Congo,CD,COD,84068091,Africa,39,937,49
2020-05-10T00:00:00Z,10,5,2020,54,2,Democratic_Republic_of_the_Congo,CD,COD,84068091,Africa,41,991,50
2020-05-11T00:00:00Z,11,5,2020,33,0,Democratic_Republic_of_the_Congo,CD,COD,84068091,Africa,41,1024,51
2020-05-12T00:00:00Z,12,5,2020,78,3,Democratic_Republic_of_the_Congo,CD,COD,84068091,Africa,44,1102,52
2020-05-13T00:00:00Z,13,5,2020,67,6,Democratic_Republic_of_the_Congo,CD,COD,84068091,Africa,50,1169,53
2020-05-14T00:00:00Z,14,5,2020,73,0,Democratic_Republic_of_the_Congo,CD,COD,84068091,Africa,50,1242,54
2020-05-15T00:00:00Z,15,5,2020,56,0,Democratic_Republic_of_the_Congo,CD,COD,84068091,Africa,50,1298,55
2020-05-16T00:00:00Z,16,5,2020,71,10,Democratic_Republic_of_the_Congo,CD,COD,84068091,Africa,60,1369,56
2020-05-17T00:00:00Z,17,5,2020,85,0,Democratic_Republic_of_the_Congo,CD,COD,84068091,Africa,60,1454,57
2020-05-18T00:00:00Z,18,5,2020,0,0,Democratic_Republic_of_the_Congo,CD,COD,84068091,Africa,60,1454,58
2020-05-19T00:00:00Z,19,5,2020,175,1,Democratic_Republic_of_the_Congo,CD,COD,84068091,Africa,61,1629,59
2020-05-20T00:00:00Z,20,5,2020,102,0,Democratic_Republic_of_the_Congo,CD,COD,84068091,Africa,61,1731,60
2020-05-21T00:00:00Z,21,5,2020,104,0,Democratic_Republic_of_the_Congo,CD,COD,84068091,Africa,61,1835,61
2020-05-22T00:00:00Z,22,5,2020,110,2,Democratic_Republic_of_the_Congo,CD,COD,84068091,Africa,63,1945,62
2020-05-23T00:00:00Z,23,5,2020,80,0,Democratic_Republic_of_the_Congo,CD,COD,84068091,Africa,63,2025,63
2020-05-24T00:00:00Z,24,5,2020,116,0,Democratic_Republic_of_the_Congo,CD,COD,84068091,Africa,63,2141,64
2020-05-25T00:00:00Z,25,5,2020,156,4,Democratic_Republic_of_the_Congo,CD,COD,84068091,Africa,67,2297,65
2020-05-26T00:00:00Z,26,5,2020,0,0,Democratic_Republic_of_the_Congo,CD,COD,84068091,Africa,67,2297,66
2020-05-27T00:00:00Z,27,5,2020,248,0,Democratic_Republic_of_the_Congo,CD,COD,84068091,Africa,67,2545,67
2020-03-16T00:00:00Z,16,3,2020,48,1,Denmark,DK,DNK,5797446,Europe,1,875,1
2020-03-17T00:00:00Z,17,3,2020,57,0,Denmark,DK,DNK,5797446,Europe,1,932,2
2020-03-18T00:00:00Z,18,3,2020,92,3,Denmark,DK,DNK,5797446,Europe,4,1024,3
2020-03-19T00:00:00Z,19,3,2020,91,0,Denmark,DK,DNK,5797446,Europe,4,1115,4
2020-03-20T00:00:00Z,20,3,2020,36,2,Denmark,DK,DNK,5797446,Europe,6,1151,5
2020-03-21T00:00:00Z,21,3,2020,104,3,Denmark,DK,DNK,5797446,Europe,9,1255,6
2020-03-22T00:00:00Z,22,3,2020,71,4,Denmark,DK,DNK,5797446,Europe,13,1326,7
2020-03-23T00:00:00Z,23,3,2020,69,0,Denmark,DK,DNK,5797446,Europe,13,1395,8
2020-03-24T00:00:00Z,24,3,2020,65,11,Denmark,DK,DNK,5797446,Europe,24,1460,9
2020-03-25T00:00:00Z,25,3,2020,131,8,Denmark,DK,DNK,5797446,Europe,32,1591,10
2020-03-26T00:00:00Z,26,3,2020,133,2,Denmark,DK,DNK,5797446,Europe,34,1724,11
2020-03-27T00:00:00Z,27,3,2020,153,7,Denmark,DK,DNK,5797446,Europe,41,1877,12
2020-03-28T00:00:00Z,28,3,2020,169,11,Denmark,DK,DNK,5797446,Europe,52,2046,13
2020-03-29T00:00:00Z,29,3,2020,155,13,Denmark,DK,DNK,5797446,Europe,65,2201,14
2020-03-30T00:00:00Z,30,3,2020,194,7,Denmark,DK,DNK,5797446,Europe,72,2395,15
2020-03-31T00:00:00Z,31,3,2020,182,5,Denmark,DK,DNK,5797446,Europe,77,2577,16
2020-04-01T00:00:00Z,1,4,2020,283,13,Denmark,DK,DNK,5797446,Europe,90,2860,17
2020-04-02T00:00:00Z,2,4,2020,247,14,Denmark,DK,DNK,5797446,Europe,104,3107,18
2020-04-03T00:00:00Z,3,4,2020,279,19,Denmark,DK,DNK,5797446,Europe,123,3386,19
2020-04-04T00:00:00Z,4,4,2020,371,16,Denmark,DK,DNK,5797446,Europe,139,3757,20
2020-04-05T00:00:00Z,5,4,2020,320,22,Denmark,DK,DNK,5797446,Europe,161,4077,21
2020-04-06T00:00:00Z,6,4,2020,292,18,Denmark,DK,DNK,5797446,Europe,179,4369,22
2020-04-07T00:00:00Z,7,4,2020,312,8,Denmark,DK,DNK,5797446,Europe,187,4681,23
2020-04-08T00:00:00Z,8,4,2020,390,16,Denmark,DK,DNK,5797446,Europe,203,5071,24
2020-04-09T00:00:00Z,9,4,2020,331,15,Denmark,DK,DNK,5797446,Europe,218,5402,25
2020-04-10T00:00:00Z,10,4,2020,233,19,Denmark,DK,DNK,5797446,Europe,237,5635,26
2020-04-11T00:00:00Z,11,4,2020,184,10,Denmark,DK,DNK,5797446,Europe,247,5819,27
2020-04-12T00:00:00Z,12,4,2020,177,13,Denmark,DK,DNK,5797446,Europe,260,5996,28
2020-04-13T00:00:00Z,13,4,2020,178,13,Denmark,DK,DNK,5797446,Europe,273,6174,29
2020-04-14T00:00:00Z,14,4,2020,144,12,Denmark,DK,DNK,5797446,Europe,285,6318,30
2020-04-15T00:00:00Z,15,4,2020,193,14,Denmark,DK,DNK,5797446,Europe,299,6511,31
2020-04-16T00:00:00Z,16,4,2020,170,10,Denmark,DK,DNK,5797446,Europe,309,6681,32
2020-04-17T00:00:00Z,17,4,2020,198,12,Denmark,DK,DNK,5797446,Europe,321,6879,33
2020-04-18T00:00:00Z,18,4,2020,194,15,Denmark,DK,DNK,5797446,Europe,336,7073,34
2020-04-19T00:00:00Z,19,4,2020,169,10,Denmark,DK,DNK,5797446,Europe,346,7242,35
2020-04-20T00:00:00Z,20,4,2020,142,9,Denmark,DK,DNK,5797446,Europe,355,7384,36
2020-04-21T00:00:00Z,21,4,2020,131,9,Denmark,DK,DNK,5797446,Europe,364,7515,37
2020-04-22T00:00:00Z,22,4,2020,180,6,Denmark,DK,DNK,5797446,Europe,370,7695,38
2020-04-23T00:00:00Z,23,4,2020,217,14,Denmark,DK,DNK,5797446,Europe,384,7912,39
2020-04-24T00:00:00Z,24,4,2020,161,10,Denmark,DK,DNK,5797446,Europe,394,8073,40
2020-04-25T00:00:00Z,25,4,2020,137,9,Denmark,DK,DNK,5797446,Europe,403,8210,41
2020-04-26T00:00:00Z,26,4,2020,235,15,Denmark,DK,DNK,5797446,Europe,418,8445,42
2020-04-27T00:00:00Z,27,4,2020,130,4,Denmark,DK,DNK,5797446,Europe,422,8575,43
2020-04-28T00:00:00Z,28,4,2020,123,5,Denmark,DK,DNK,5797446,Europe,427,8698,44
2020-04-29T00:00:00Z,29,4,2020,153,7,Denmark,DK,DNK,5797446,Europe,434,8851,45
2020-04-30T00:00:00Z,30,4,2020,157,9,Denmark,DK,DNK,5797446,Europe,443,9008,46
2020-05-01T00:00:00Z,1,5,2020,150,9,Denmark,DK,DNK,5797446,Europe,452,9158,47
2020-05-02T00:00:00Z,2,5,2020,153,10,Denmark,DK,DNK,5797446,Europe,462,9311,48
2020-05-03T00:00:00Z,3,5,2020,96,11,Denmark,DK,DNK,5797446,Europe,473,9407,49
2020-05-04T00:00:00Z,4,5,2020,116,8,Denmark,DK,DNK,5797446,Europe,481,9523,50
2020-05-05T00:00:00Z,5,5,2020,147,9,Denmark,DK,DNK,5797446,Europe,490,9670,51
2020-05-06T00:00:00Z,6,5,2020,151,7,Denmark,DK,DNK,5797446,Europe,497,9821,52
2020-05-07T00:00:00Z,7,5,2020,162,3,Denmark,DK,DNK,5797446,Europe,500,9983,53
2020-05-08T00:00:00Z,8,5,2020,100,6,Denmark,DK,DNK,5797446,Europe,506,10083,54
2020-05-09T00:00:00Z,9,5,2020,135,6,Denmark,DK,DNK,5797446,Europe,512,10218,55
2020-05-10T00:00:00Z,10,5,2020,101,4,Denmark,DK,DNK,5797446,Europe,516,10319,56
2020-05-11T00:00:00Z,11,5,2020,110,3,Denmark,DK,DNK,5797446,Europe,519,10429,57
2020-05-12T00:00:00Z,12,5,2020,84,5,Denmark,DK,DNK,5797446,Europe,524,10513,58
2020-05-13T00:00:00Z,13,5,2020,78,4,Denmark,DK,DNK,5797446,Europe,528,10591,59
2020-05-14T00:00:00Z,14,5,2020,76,6,Denmark,DK,DNK,5797446,Europe,534,10667,60
2020-05-15T00:00:00Z,15,5,2020,46,4,Denmark,DK,DNK,5797446,Europe,538,10713,61
2020-05-16T00:00:00Z,16,5,2020,78,0,Denmark,DK,DNK,5797446,Europe,538,10791,62
2020-05-17T00:00:00Z,17,5,2020,67,5,Denmark,DK,DNK,5797446,Europe,543,10858,63
2020-05-18T00:00:00Z,18,5,2020,69,4,Denmark,DK,DNK,5797446,Europe,547,10927,64
2020-05-19T00:00:00Z,19,5,2020,41,1,Denmark,DK,DNK,5797446,Europe,548,10968,65
2020-05-20T00:00:00Z,20,5,2020,76,3,Denmark,DK,DNK,5797446,Europe,551,11044,66
2020-05-21T00:00:00Z,21,5,2020,73,3,Denmark,DK,DNK,5797446,Europe,554,11117,67
2020-05-22T00:00:00Z,22,5,2020,65,7,Denmark,DK,DNK,5797446,Europe,561,11182,68
2020-05-23T00:00:00Z,23,5,2020,48,0,Denmark,DK,DNK,5797446,Europe,561,11230,69
2020-05-24T00:00:00Z,24,5,2020,59,0,Denmark,DK,DNK,5797446,Europe,561,11289,70
2020-05-25T00:00:00Z,25,5,2020,71,1,Denmark,DK,DNK,5797446,Europe,562,11360,71
2020-05-26T00:00:00Z,26,5,2020,27,1,Denmark,DK,DNK,5797446,Europe,563,11387,72
2020-05-27T00:00:00Z,27,5,2020,41,0,Denmark,DK,DNK,5797446,Europe,563,11428,73
2020-04-10T00:00:00Z,10,4,2020,5,1,Djibouti,DJ,DJI,958920,Africa,1,140,1
2020-04-11T00:00:00Z,11,4,2020,10,0,Djibouti,DJ,DJI,958920,Africa,1,150,2
2020-04-12T00:00:00Z,12,4,2020,37,1,Djibouti,DJ,DJI,958920,Africa,2,187,3
2020-04-13T00:00:00Z,13,4,2020,27,0,Djibouti,DJ,DJI,958920,Africa,2,214,4
2020-04-14T00:00:00Z,14,4,2020,84,0,Djibouti,DJ,DJI,958920,Africa,2,298,5
2020-04-15T00:00:00Z,15,4,2020,65,0,Djibouti,DJ,DJI,958920,Africa,2,363,6
2020-04-16T00:00:00Z,16,4,2020,72,0,Djibouti,DJ,DJI,958920,Africa,2,435,7
2020-04-17T00:00:00Z,17,4,2020,156,0,Djibouti,DJ,DJI,958920,Africa,2,591,8
2020-04-18T00:00:00Z,18,4,2020,141,0,Djibouti,DJ,DJI,958920,Africa,2,732,9
2020-04-19T00:00:00Z,19,4,2020,0,0,Djibouti,DJ,DJI,958920,Africa,2,732,10
2020-04-20T00:00:00Z,20,4,2020,114,0,Djibouti,DJ,DJI,958920,Africa,2,846,11
2020-04-21T00:00:00Z,21,4,2020,0,0,Djibouti,DJ,DJI,958920,Africa,2,846,12
2020-04-22T00:00:00Z,22,4,2020,99,0,Djibouti,DJ,DJI,958920,Africa,2,945,13
2020-04-23T00:00:00Z,23,4,2020,29,0,Djibouti,DJ,DJI,958920,Africa,2,974,14
2020-04-24T00:00:00Z,24,4,2020,12,0,Djibouti,DJ,DJI,958920,Africa,2,986,15
2020-04-25T00:00:00Z,25,4,2020,13,0,Djibouti,DJ,DJI,958920,Africa,2,999,16
2020-04-26T00:00:00Z,26,4,2020,9,0,Djibouti,DJ,DJI,958920,Africa,2,1008,17
2020-04-27T00:00:00Z,27,4,2020,15,0,Djibouti,DJ,DJI,958920,Africa,2,1023,18
2020-04-28T00:00:00Z,28,4,2020,12,0,Djibouti,DJ,DJI,958920,Africa,2,1035,19
2020-04-29T00:00:00Z,29,4,2020,37,0,Djibouti,DJ,DJI,958920,Africa,2,1072,20
2020-04-30T00:00:00Z,30,4,2020,5,0,Djibouti,DJ,DJI,958920,Africa,2,1077,21
2020-05-01T00:00:00Z,1,5,2020,12,0,Djibouti,DJ,DJI,958920,Africa,2,1089,22
2020-05-02T00:00:00Z,2,5,2020,8,0,Djibouti,DJ,DJI,958920,Africa,2,1097,23
2020-05-03T00:00:00Z,3,5,2020,15,0,Djibouti,DJ,DJI,958920,Africa,2,1112,24
2020-05-04T00:00:00Z,4,5,2020,0,0,Djibouti,DJ,DJI,958920,Africa,2,1112,25
2020-05-05T00:00:00Z,5,5,2020,4,0,Djibouti,DJ,DJI,958920,Africa,2,1116,26
2020-05-06T00:00:00Z,6,5,2020,4,0,Djibouti,DJ,DJI,958920,Africa,2,1120,27
2020-05-07T00:00:00Z,7,5,2020,0,1,Djibouti,DJ,DJI,958920,Africa,3,1120,28
2020-05-08T00:00:00Z,8,5,2020,13,0,Djibouti,DJ,DJI,958920,Africa,3,1133,29
2020-05-09T00:00:00Z,9,5,2020,2,0,Djibouti,DJ,DJI,958920,Africa,3,1135,30
2020-05-10T00:00:00Z,10,5,2020,54,0,Djibouti,DJ,DJI,958920,Africa,3,1189,31
2020-05-11T00:00:00Z,11,5,2020,21,0,Djibouti,DJ,DJI,958920,Africa,3,1210,32
2020-05-12T00:00:00Z,12,5,2020,17,0,Djibouti,DJ,DJI,958920,Africa,3,1227,33
2020-05-13T00:00:00Z,13,5,2020,29,0,Djibouti,DJ,DJI,958920,Africa,3,1256,34
2020-05-14T00:00:00Z,14,5,2020,12,0,Djibouti,DJ,DJI,958920,Africa,3,1268,35
2020-05-15T00:00:00Z,15,5,2020,16,0,Djibouti,DJ,DJI,958920,Africa,3,1284,36
2020-05-16T00:00:00Z,16,5,2020,25,1,Djibouti,DJ,DJI,958920,Africa,4,1309,37
2020-05-17T00:00:00Z,17,5,2020,22,0,Djibouti,DJ,DJI,958920,Africa,4,1331,38
2020-05-18T00:00:00Z,18,5,2020,70,0,Djibouti,DJ,DJI,958920,Africa,4,1401,39
2020-05-19T00:00:00Z,19,5,2020,117,3,Djibouti,DJ,DJI,958920,Africa,7,1518,40
2020-05-20T00:00:00Z,20,5,2020,0,0,Djibouti,DJ,DJI,958920,Africa,7,1518,41
2020-05-21T00:00:00Z,21,5,2020,310,2,Djibouti,DJ,DJI,958920,Africa,9,1828,42
2020-05-22T00:00:00Z,22,5,2020,219,1,Djibouti,DJ,DJI,958920,Africa,10,2047,43
2020-05-23T00:00:00Z,23,5,2020,223,0,Djibouti,DJ,DJI,958920,Africa,10,2270,44
2020-05-24T00:00:00Z,24,5,2020,0,0,Djibouti,DJ,DJI,958920,Africa,10,2270,45
2020-05-25T00:00:00Z,25,5,2020,0,0,Djibouti,DJ,DJI,958920,Africa,10,2270,46
2020-05-26T00:00:00Z,26,5,2020,198,4,Djibouti,DJ,DJI,958920,Africa,14,2468,47
2020-05-27T00:00:00Z,27,5,2020,0,0,Djibouti,DJ,DJI,958920,Africa,14,2468,48
2020-03-21T00:00:00Z,21,3,2020,13,2,Dominican_Republic,DO,DOM,10627165,America,2,34,1
2020-03-22T00:00:00Z,22,3,2020,78,1,Dominican_Republic,DO,DOM,10627165,America,3,112,2
2020-03-23T00:00:00Z,23,3,2020,90,0,Dominican_Republic,DO,DOM,10627165,America,3,202,3
2020-03-24T00:00:00Z,24,3,2020,43,0,Dominican_Republic,DO,DOM,10627165,America,3,245,4
2020-03-25T00:00:00Z,25,3,2020,67,3,Dominican_Republic,DO,DOM,10627165,America,6,312,5
2020-03-26T00:00:00Z,26,3,2020,80,4,Dominican_Republic,DO,DOM,10627165,America,10,392,6
2020-03-27T00:00:00Z,27,3,2020,96,0,Dominican_Republic,DO,DOM,10627165,America,10,488,7
2020-03-28T00:00:00Z,28,3,2020,93,10,Dominican_Republic,DO,DOM,10627165,America,20,581,8
2020-03-29T00:00:00Z,29,3,2020,138,8,Dominican_Republic,DO,DOM,10627165,America,28,719,9
2020-03-30T00:00:00Z,30,3,2020,140,11,Dominican_Republic,DO,DOM,10627165,America,39,859,10
2020-03-31T00:00:00Z,31,3,2020,42,3,Dominican_Republic,DO,DOM,10627165,America,42,901,11
2020-04-01T00:00:00Z,1,4,2020,208,9,Dominican_Republic,DO,DOM,10627165,America,51,1109,12
2020-04-02T00:00:00Z,2,4,2020,175,6,Dominican_Republic,DO,DOM,10627165,America,57,1284,13
2020-04-03T00:00:00Z,3,4,2020,96,3,Dominican_Republic,DO,DOM,10627165,America,60,1380,14
2020-04-04T00:00:00Z,4,4,2020,108,8,Dominican_Republic,DO,DOM,10627165,America,68,1488,15
2020-04-05T00:00:00Z,5,4,2020,90,9,Dominican_Republic,DO,DOM,10627165,America,77,1578,16
2020-04-06T00:00:00Z,6,4,2020,167,5,Dominican_Republic,DO,DOM,10627165,America,82,1745,17
2020-04-07T00:00:00Z,7,4,2020,83,4,Dominican_Republic,DO,DOM,10627165,America,86,1828,18
2020-04-08T00:00:00Z,8,4,2020,128,12,Dominican_Republic,DO,DOM,10627165,America,98,1956,19
2020-04-09T00:00:00Z,9,4,2020,155,10,Dominican_Republic,DO,DOM,10627165,America,108,2111,20
2020-04-10T00:00:00Z,10,4,2020,238,10,Dominican_Republic,DO,DOM,10627165,America,118,2349,21
2020-04-11T00:00:00Z,11,4,2020,271,8,Dominican_Republic,DO,DOM,10627165,America,126,2620,22
2020-04-12T00:00:00Z,12,4,2020,139,9,Dominican_Republic,DO,DOM,10627165,America,135,2759,23
2020-04-13T00:00:00Z,13,4,2020,208,38,Dominican_Republic,DO,DOM,10627165,America,173,2967,24
2020-04-14T00:00:00Z,14,4,2020,200,4,Dominican_Republic,DO,DOM,10627165,America,177,3167,25
2020-04-15T00:00:00Z,15,4,2020,119,6,Dominican_Republic,DO,DOM,10627165,America,183,3286,26
2020-04-16T00:00:00Z,16,4,2020,328,6,Dominican_Republic,DO,DOM,10627165,America,189,3614,27
2020-04-17T00:00:00Z,17,4,2020,141,7,Dominican_Republic,DO,DOM,10627165,America,196,3755,28
2020-04-18T00:00:00Z,18,4,2020,371,4,Dominican_Republic,DO,DOM,10627165,America,200,4126,29
2020-04-19T00:00:00Z,19,4,2020,209,17,Dominican_Republic,DO,DOM,10627165,America,217,4335,30
2020-04-20T00:00:00Z,20,4,2020,345,9,Dominican_Republic,DO,DOM,10627165,America,226,4680,31
2020-04-21T00:00:00Z,21,4,2020,284,9,Dominican_Republic,DO,DOM,10627165,America,235,4964,32
2020-04-22T00:00:00Z,22,4,2020,80,10,Dominican_Republic,DO,DOM,10627165,America,245,5044,33
2020-04-23T00:00:00Z,23,4,2020,256,15,Dominican_Republic,DO,DOM,10627165,America,260,5300,34
2020-04-24T00:00:00Z,24,4,2020,243,5,Dominican_Republic,DO,DOM,10627165,America,265,5543,35
2020-04-25T00:00:00Z,25,4,2020,206,2,Dominican_Republic,DO,DOM,10627165,America,267,5749,36
2020-04-26T00:00:00Z,26,4,2020,177,6,Dominican_Republic,DO,DOM,10627165,America,273,5926,37
2020-04-27T00:00:00Z,27,4,2020,209,5,Dominican_Republic,DO,DOM,10627165,America,278,6135,38
2020-04-28T00:00:00Z,28,4,2020,0,0,Dominican_Republic,DO,DOM,10627165,America,278,6135,39
2020-04-29T00:00:00Z,29,4,2020,281,8,Dominican_Republic,DO,DOM,10627165,America,286,6416,40
2020-04-30T00:00:00Z,30,4,2020,236,7,Dominican_Republic,DO,DOM,10627165,America,293,6652,41
2020-05-01T00:00:00Z,1,5,2020,320,8,Dominican_Republic,DO,DOM,10627165,America,301,6972,42
2020-05-02T00:00:00Z,2,5,2020,316,12,Dominican_Republic,DO,DOM,10627165,America,313,7288,43
2020-05-03T00:00:00Z,3,5,2020,290,13,Dominican_Republic,DO,DOM,10627165,America,326,7578,44
2020-05-04T00:00:00Z,4,5,2020,376,7,Dominican_Republic,DO,DOM,10627165,America,333,7954,45
2020-05-05T00:00:00Z,5,5,2020,281,13,Dominican_Republic,DO,DOM,10627165,America,346,8235,46
2020-05-06T00:00:00Z,6,5,2020,245,8,Dominican_Republic,DO,DOM,10627165,America,354,8480,47
2020-05-07T00:00:00Z,7,5,2020,327,8,Dominican_Republic,DO,DOM,10627165,America,362,8807,48
2020-05-08T00:00:00Z,8,5,2020,288,11,Dominican_Republic,DO,DOM,10627165,America,373,9095,49
2020-05-09T00:00:00Z,9,5,2020,281,7,Dominican_Republic,DO,DOM,10627165,America,380,9376,50
2020-05-10T00:00:00Z,10,5,2020,506,5,Dominican_Republic,DO,DOM,10627165,America,385,9882,51
2020-05-11T00:00:00Z,11,5,2020,465,3,Dominican_Republic,DO,DOM,10627165,America,388,10347,52
2020-05-12T00:00:00Z,12,5,2020,287,5,Dominican_Republic,DO,DOM,10627165,America,393,10634,53
2020-05-13T00:00:00Z,13,5,2020,266,9,Dominican_Republic,DO,DOM,10627165,America,402,10900,54
2020-05-14T00:00:00Z,14,5,2020,296,7,Dominican_Republic,DO,DOM,10627165,America,409,11196,55
2020-05-15T00:00:00Z,15,5,2020,124,13,Dominican_Republic,DO,DOM,10627165,America,422,11320,56
2020-05-16T00:00:00Z,16,5,2020,419,2,Dominican_Republic,DO,DOM,10627165,America,424,11739,57
2020-05-17T00:00:00Z,17,5,2020,154,0,Dominican_Republic,DO,DOM,10627165,America,424,11893,58
2020-05-18T00:00:00Z,18,5,2020,421,4,Dominican_Republic,DO,DOM,10627165,America,428,12314,59
2020-05-19T00:00:00Z,19,5,2020,411,6,Dominican_Republic,DO,DOM,10627165,America,434,12725,60
2020-05-20T00:00:00Z,20,5,2020,498,7,Dominican_Republic,DO,DOM,10627165,America,441,13223,61
2020-05-21T00:00:00Z,21,5,2020,254,5,Dominican_Republic,DO,DOM,10627165,America,446,13477,62
2020-05-22T00:00:00Z,22,5,2020,180,2,Dominican_Republic,DO,DOM,10627165,America,448,13657,63
2020-05-23T00:00:00Z,23,5,2020,332,8,Dominican_Republic,DO,DOM,10627165,America,456,13989,64
2020-05-24T00:00:00Z,24,5,2020,433,2,Dominican_Republic,DO,DOM,10627165,America,458,14422,65
2020-05-25T00:00:00Z,25,5,2020,0,0,Dominican_Republic,DO,DOM,10627165,America,458,14422,66
2020-05-26T00:00:00Z,26,5,2020,651,2,Dominican_Republic,DO,DOM,10627165,America,460,15073,67
2020-05-27T00:00:00Z,27,5,2020,191,8,Dominican_Republic,DO,DOM,10627165,America,468,15264,68
2020-03-14T00:00:00Z,14,3,2020,6,1,Ecuador,EC,ECU,17084357,America,1,23,1
2020-03-15T00:00:00Z,15,3,2020,5,1,Ecuador,EC,ECU,17084357,America,2,28,2
2020-03-16T00:00:00Z,16,3,2020,9,0,Ecuador,EC,ECU,17084357,America,2,37,3
2020-03-17T00:00:00Z,17,3,2020,21,0,Ecuador,EC,ECU,17084357,America,2,58,4
2020-03-18T00:00:00Z,18,3,2020,53,0,Ecuador,EC,ECU,17084357,America,2,111,5
2020-03-19T00:00:00Z,19,3,2020,57,1,Ecuador,EC,ECU,17084357,America,3,168,6
2020-03-20T00:00:00Z,20,3,2020,31,0,Ecuador,EC,ECU,17084357,America,3,199,7
2020-03-21T00:00:00Z,21,3,2020,227,4,Ecuador,EC,ECU,17084357,America,7,426,8
2020-03-22T00:00:00Z,22,3,2020,106,0,Ecuador,EC,ECU,17084357,America,7,532,9
2020-03-23T00:00:00Z,23,3,2020,257,7,Ecuador,EC,ECU,17084357,America,14,789,10
2020-03-24T00:00:00Z,24,3,2020,192,4,Ecuador,EC,ECU,17084357,America,18,981,11
2020-03-25T00:00:00Z,25,3,2020,101,9,Ecuador,EC,ECU,17084357,America,27,1082,12
2020-03-26T00:00:00Z,26,3,2020,129,2,Ecuador,EC,ECU,17084357,America,29,1211,13
2020-03-27T00:00:00Z,27,3,2020,192,5,Ecuador,EC,ECU,17084357,America,34,1403,14
2020-03-28T00:00:00Z,28,3,2020,224,7,Ecuador,EC,ECU,17084357,America,41,1627,15
2020-03-29T00:00:00Z,29,3,2020,208,7,Ecuador,EC,ECU,17084357,America,48,1835,16
2020-03-30T00:00:00Z,30,3,2020,55,10,Ecuador,EC,ECU,17084357,America,58,1890,17
2020-03-31T00:00:00Z,31,3,2020,76,4,Ecuador,EC,ECU,17084357,America,62,1966,18
2020-04-01T00:00:00Z,1,4,2020,336,17,Ecuador,EC,ECU,17084357,America,79,2302,19
2020-04-02T00:00:00Z,2,4,2020,456,41,Ecuador,EC,ECU,17084357,America,120,2758,20
2020-04-03T00:00:00Z,3,4,2020,405,0,Ecuador,EC,ECU,17084357,America,120,3163,21
2020-04-04T00:00:00Z,4,4,2020,205,25,Ecuador,EC,ECU,17084357,America,145,3368,22
2020-04-05T00:00:00Z,5,4,2020,97,27,Ecuador,EC,ECU,17084357,America,172,3465,23
2020-04-06T00:00:00Z,6,4,2020,181,8,Ecuador,EC,ECU,17084357,America,180,3646,24
2020-04-07T00:00:00Z,7,4,2020,101,11,Ecuador,EC,ECU,17084357,America,191,3747,25
2020-04-08T00:00:00Z,8,4,2020,248,29,Ecuador,EC,ECU,17084357,America,220,3995,26
2020-04-09T00:00:00Z,9,4,2020,455,22,Ecuador,EC,ECU,17084357,America,242,4450,27
2020-04-10T00:00:00Z,10,4,2020,515,30,Ecuador,EC,ECU,17084357,America,272,4965,28
2020-04-11T00:00:00Z,11,4,2020,2196,25,Ecuador,EC,ECU,17084357,America,297,7161,29
2020-04-12T00:00:00Z,12,4,2020,96,18,Ecuador,EC,ECU,17084357,America,315,7257,30
2020-04-13T00:00:00Z,13,4,2020,209,18,Ecuador,EC,ECU,17084357,America,333,7466,31
2020-04-14T00:00:00Z,14,4,2020,63,22,Ecuador,EC,ECU,17084357,America,355,7529,32
2020-04-15T00:00:00Z,15,4,2020,74,0,Ecuador,EC,ECU,17084357,America,355,7603,33
2020-04-16T00:00:00Z,16,4,2020,255,33,Ecuador,EC,ECU,17084357,America,388,7858,34
2020-04-17T00:00:00Z,17,4,2020,367,15,Ecuador,EC,ECU,17084357,America,403,8225,35
2020-04-18T00:00:00Z,18,4,2020,225,18,Ecuador,EC,ECU,17084357,America,421,8450,36
2020-04-19T00:00:00Z,19,4,2020,572,35,Ecuador,EC,ECU,17084357,America,456,9022,37
2020-04-20T00:00:00Z,20,4,2020,446,18,Ecuador,EC,ECU,17084357,America,474,9468,38
2020-04-21T00:00:00Z,21,4,2020,660,33,Ecuador,EC,ECU,17084357,America,507,10128,39
2020-04-22T00:00:00Z,22,4,2020,270,13,Ecuador,EC,ECU,17084357,America,520,10398,40
2020-04-23T00:00:00Z,23,4,2020,452,17,Ecuador,EC,ECU,17084357,America,537,10850,41
2020-04-24T00:00:00Z,24,4,2020,333,23,Ecuador,EC,ECU,17084357,America,560,11183,42
2020-04-25T00:00:00Z,25,4,2020,0,16,Ecuador,EC,ECU,17084357,America,576,11183,43
2020-04-26T00:00:00Z,26,4,2020,0,0,Ecuador,EC,ECU,17084357,America,576,11183,44
2020-04-27T00:00:00Z,27,4,2020,11536,0,Ecuador,EC,ECU,17084357,America,576,22719,45
2020-04-28T00:00:00Z,28,4,2020,521,87,Ecuador,EC,ECU,17084357,America,663,23240,46
2020-04-29T00:00:00Z,29,4,2020,1018,208,Ecuador,EC,ECU,17084357,America,871,24258,47
2020-04-30T00:00:00Z,30,4,2020,417,12,Ecuador,EC,ECU,17084357,America,883,24675,48
2020-05-01T00:00:00Z,1,5,2020,259,17,Ecuador,EC,ECU,17084357,America,900,24934,49
2020-05-02T00:00:00Z,2,5,2020,1402,163,Ecuador,EC,ECU,17084357,America,1063,26336,50
2020-05-03T00:00:00Z,3,5,2020,1128,308,Ecuador,EC,ECU,17084357,America,1371,27464,51
2020-05-04T00:00:00Z,4,5,2020,2074,193,Ecuador,EC,ECU,17084357,America,1564,29538,52
2020-05-05T00:00:00Z,5,5,2020,2343,5,Ecuador,EC,ECU,17084357,America,1569,31881,53
2020-05-06T00:00:00Z,6,5,2020,0,0,Ecuador,EC,ECU,17084357,America,1569,31881,54
2020-05-07T00:00:00Z,7,5,2020,-2461,49,Ecuador,EC,ECU,17084357,America,1618,29420,55
2020-05-08T00:00:00Z,8,5,2020,878,36,Ecuador,EC,ECU,17084357,America,1654,30298,56
2020-05-09T00:00:00Z,9,5,2020,-1480,50,Ecuador,EC,ECU,17084357,America,1704,28818,57
2020-05-10T00:00:00Z,10,5,2020,253,13,Ecuador,EC,ECU,17084357,America,1717,29071,58
2020-05-11T00:00:00Z,11,5,2020,488,410,Ecuador,EC,ECU,17084357,America,2127,29559,59
2020-05-12T00:00:00Z,12,5,2020,-50,18,Ecuador,EC,ECU,17084357,America,2145,29509,60
2020-05-13T00:00:00Z,13,5,2020,910,182,Ecuador,EC,ECU,17084357,America,2327,30419,61
2020-05-14T00:00:00Z,14,5,2020,67,7,Ecuador,EC,ECU,17084357,America,2334,30486,62
2020-05-15T00:00:00Z,15,5,2020,16,4,Ecuador,EC,ECU,17084357,America,2338,30502,63
2020-05-16T00:00:00Z,16,5,2020,965,256,Ecuador,EC,ECU,17084357,America,2594,31467,64
2020-05-17T00:00:00Z,17,5,2020,1296,94,Ecuador,EC,ECU,17084357,America,2688,32763,65
2020-05-18T00:00:00Z,18,5,2020,419,48,Ecuador,EC,ECU,17084357,America,2736,33182,66
2020-05-19T00:00:00Z,19,5,2020,400,63,Ecuador,EC,ECU,17084357,America,2799,33582,67
2020-05-20T00:00:00Z,20,5,2020,569,40,Ecuador,EC,ECU,17084357,America,2839,34151,68
2020-05-21T00:00:00Z,21,5,2020,703,49,Ecuador,EC,ECU,17084357,America,2888,34854,69
2020-05-22T00:00:00Z,22,5,2020,452,51,Ecuador,EC,ECU,17084357,America,2939,35306,70
2020-05-23T00:00:00Z,23,5,2020,522,117,Ecuador,EC,ECU,17084357,America,3056,35828,71
2020-05-24T00:00:00Z,24,5,2020,430,40,Ecuador,EC,ECU,17084357,America,3096,36258,72
2020-05-25T00:00:00Z,25,5,2020,498,12,Ecuador,EC,ECU,17084357,America,3108,36756,73
2020-05-26T00:00:00Z,26,5,2020,599,95,Ecuador,EC,ECU,17084357,America,3203,37355,74
2020-05-27T00:00:00Z,27,5,2020,0,0,Ecuador,EC,ECU,17084357,America,3203,37355,75
2020-03-09T00:00:00Z,9,3,2020,34,1,Egypt,EG,EGY,98423595,Africa,1,49,1
2020-03-10T00:00:00Z,10,3,2020,6,0,Egypt,EG,EGY,98423595,Africa,1,55,2
2020-03-11T00:00:00Z,11,3,2020,4,0,Egypt,EG,EGY,98423595,Africa,1,59,3
2020-03-12T00:00:00Z,12,3,2020,1,0,Egypt,EG,EGY,98423595,Africa,1,60,4
2020-03-13T00:00:00Z,13,3,2020,20,1,Egypt,EG,EGY,98423595,Africa,2,80,5
2020-03-14T00:00:00Z,14,3,2020,13,0,Egypt,EG,EGY,98423595,Africa,2,93,6
2020-03-15T00:00:00Z,15,3,2020,0,0,Egypt,EG,EGY,98423595,Africa,2,93,7
2020-03-16T00:00:00Z,16,3,2020,17,0,Egypt,EG,EGY,98423595,Africa,2,110,8
2020-03-17T00:00:00Z,17,3,2020,16,0,Egypt,EG,EGY,98423595,Africa,2,126,9
2020-03-18T00:00:00Z,18,3,2020,40,2,Egypt,EG,EGY,98423595,Africa,4,166,10
2020-03-19T00:00:00Z,19,3,2020,30,2,Egypt,EG,EGY,98423595,Africa,6,196,11
2020-03-20T00:00:00Z,20,3,2020,14,0,Egypt,EG,EGY,98423595,Africa,6,210,12
2020-03-21T00:00:00Z,21,3,2020,46,1,Egypt,EG,EGY,98423595,Africa,7,256,13
2020-03-22T00:00:00Z,22,3,2020,29,1,Egypt,EG,EGY,98423595,Africa,8,285,14
2020-03-23T00:00:00Z,23,3,2020,9,2,Egypt,EG,EGY,98423595,Africa,10,294,15
2020-03-24T00:00:00Z,24,3,2020,33,4,Egypt,EG,EGY,98423595,Africa,14,327,16
2020-03-25T00:00:00Z,25,3,2020,39,5,Egypt,EG,EGY,98423595,Africa,19,366,17
2020-03-26T00:00:00Z,26,3,2020,76,2,Egypt,EG,EGY,98423595,Africa,21,442,18
2020-03-27T00:00:00Z,27,3,2020,14,0,Egypt,EG,EGY,98423595,Africa,21,456,19
2020-03-28T00:00:00Z,28,3,2020,39,3,Egypt,EG,EGY,98423595,Africa,24,495,20
2020-03-29T00:00:00Z,29,3,2020,41,6,Egypt,EG,EGY,98423595,Africa,30,536,21
2020-03-30T00:00:00Z,30,3,2020,40,6,Egypt,EG,EGY,98423595,Africa,36,576,22
2020-03-31T00:00:00Z,31,3,2020,33,4,Egypt,EG,EGY,98423595,Africa,40,609,23
2020-04-01T00:00:00Z,1,4,2020,47,1,Egypt,EG,EGY,98423595,Africa,41,656,24
2020-04-02T00:00:00Z,2,4,2020,54,5,Egypt,EG,EGY,98423595,Africa,46,710,25
2020-04-03T00:00:00Z,3,4,2020,69,6,Egypt,EG,EGY,98423595,Africa,52,779,26
2020-04-04T00:00:00Z,4,4,2020,0,0,Egypt,EG,EGY,98423595,Africa,52,779,27
2020-04-05T00:00:00Z,5,4,2020,206,14,Egypt,EG,EGY,98423595,Africa,66,985,28
2020-04-06T00:00:00Z,6,4,2020,85,5,Egypt,EG,EGY,98423595,Africa,71,1070,29
2020-04-07T00:00:00Z,7,4,2020,3,7,Egypt,EG,EGY,98423595,Africa,78,1073,30
2020-04-08T00:00:00Z,8,4,2020,249,7,Egypt,EG,EGY,98423595,Africa,85,1322,31
2020-04-09T00:00:00Z,9,4,2020,238,18,Egypt,EG,EGY,98423595,Africa,103,1560,32
2020-04-10T00:00:00Z,10,4,2020,139,15,Egypt,EG,EGY,98423595,Africa,118,1699,33
2020-04-11T00:00:00Z,11,4,2020,95,17,Egypt,EG,EGY,98423595,Africa,135,1794,34
2020-04-12T00:00:00Z,12,4,2020,145,11,Egypt,EG,EGY,98423595,Africa,146,1939,35
2020-04-13T00:00:00Z,13,4,2020,126,13,Egypt,EG,EGY,98423595,Africa,159,2065,36
2020-04-14T00:00:00Z,14,4,2020,125,5,Egypt,EG,EGY,98423595,Africa,164,2190,37
2020-04-15T00:00:00Z,15,4,2020,160,14,Egypt,EG,EGY,98423595,Africa,178,2350,38
2020-04-16T00:00:00Z,16,4,2020,155,5,Egypt,EG,EGY,98423595,Africa,183,2505,39
2020-04-17T00:00:00Z,17,4,2020,168,13,Egypt,EG,EGY,98423595,Africa,196,2673,40
2020-04-18T00:00:00Z,18,4,2020,171,9,Egypt,EG,EGY,98423595,Africa,205,2844,41
2020-04-19T00:00:00Z,19,4,2020,188,19,Egypt,EG,EGY,98423595,Africa,224,3032,42
2020-04-20T00:00:00Z,20,4,2020,112,15,Egypt,EG,EGY,98423595,Africa,239,3144,43
2020-04-21T00:00:00Z,21,4,2020,189,11,Egypt,EG,EGY,98423595,Africa,250,3333,44
2020-04-22T00:00:00Z,22,4,2020,157,14,Egypt,EG,EGY,98423595,Africa,264,3490,45
2020-04-23T00:00:00Z,23,4,2020,0,0,Egypt,EG,EGY,98423595,Africa,264,3490,46
2020-04-24T00:00:00Z,24,4,2020,169,12,Egypt,EG,EGY,98423595,Africa,276,3659,47
2020-04-25T00:00:00Z,25,4,2020,433,18,Egypt,EG,EGY,98423595,Africa,294,4092,48
2020-04-26T00:00:00Z,26,4,2020,227,13,Egypt,EG,EGY,98423595,Africa,307,4319,49
2020-04-27T00:00:00Z,27,4,2020,0,0,Egypt,EG,EGY,98423595,Africa,307,4319,50
2020-04-28T00:00:00Z,28,4,2020,463,30,Egypt,EG,EGY,98423595,Africa,337,4782,51
2020-04-29T00:00:00Z,29,4,2020,260,22,Egypt,EG,EGY,98423595,Africa,359,5042,52
2020-04-30T00:00:00Z,30,4,2020,226,21,Egypt,EG,EGY,98423595,Africa,380,5268,53
2020-05-01T00:00:00Z,1,5,2020,269,12,Egypt,EG,EGY,98423595,Africa,392,5537,54
2020-05-02T00:00:00Z,2,5,2020,358,14,Egypt,EG,EGY,98423595,Africa,406,5895,55
2020-05-03T00:00:00Z,3,5,2020,298,9,Egypt,EG,EGY,98423595,Africa,415,6193,56
2020-05-04T00:00:00Z,4,5,2020,272,14,Egypt,EG,EGY,98423595,Africa,429,6465,57
2020-05-05T00:00:00Z,5,5,2020,348,7,Egypt,EG,EGY,98423595,Africa,436,6813,58
2020-05-06T00:00:00Z,6,5,2020,388,16,Egypt,EG,EGY,98423595,Africa,452,7201,59
2020-05-07T00:00:00Z,7,5,2020,387,17,Egypt,EG,EGY,98423595,Africa,469,7588,60
2020-05-08T00:00:00Z,8,5,2020,393,13,Egypt,EG,EGY,98423595,Africa,482,7981,61
2020-05-09T00:00:00Z,9,5,2020,495,21,Egypt,EG,EGY,98423595,Africa,503,8476,62
2020-05-10T00:00:00Z,10,5,2020,488,11,Egypt,EG,EGY,98423595,Africa,514,8964,63
2020-05-11T00:00:00Z,11,5,2020,436,11,Egypt,EG,EGY,98423595,Africa,525,9400,64
2020-05-12T00:00:00Z,12,5,2020,346,8,Egypt,EG,EGY,98423595,Africa,533,9746,65
2020-05-13T00:00:00Z,13,5,2020,347,11,Egypt,EG,EGY,98423595,Africa,544,10093,66
2020-05-14T00:00:00Z,14,5,2020,338,12,Egypt,EG,EGY,98423595,Africa,556,10431,67
2020-05-15T00:00:00Z,15,5,2020,398,15,Egypt,EG,EGY,98423595,Africa,571,10829,68
2020-05-16T00:00:00Z,16,5,2020,399,21,Egypt,EG,EGY,98423595,Africa,592,11228,69
2020-05-17T00:00:00Z,17,5,2020,491,20,Egypt,EG,EGY,98423595,Africa,612,11719,70
2020-05-18T00:00:00Z,18,5,2020,510,18,Egypt,EG,EGY,98423595,Africa,630,12229,71
2020-05-19T00:00:00Z,19,5,2020,535,15,Egypt,EG,EGY,98423595,Africa,645,12764,72
2020-05-20T00:00:00Z,20,5,2020,720,14,Egypt,EG,EGY,98423595,Africa,659,13484,73
2020-05-21T00:00:00Z,21,5,2020,745,21,Egypt,EG,EGY,98423595,Africa,680,14229,74
2020-05-22T00:00:00Z,22,5,2020,774,16,Egypt,EG,EGY,98423595,Africa,696,15003,75
2020-05-23T00:00:00Z,23,5,2020,783,11,Egypt,EG,EGY,98423595,Africa,707,15786,76
2020-05-24T00:00:00Z,24,5,2020,827,28,Egypt,EG,EGY,98423595,Africa,735,16613,77
2020-05-25T00:00:00Z,25,5,2020,652,29,Egypt,EG,EGY,98423595,Africa,764,17265,78
2020-05-26T00:00:00Z,26,5,2020,702,19,Egypt,EG,EGY,98423595,Africa,783,17967,79
2020-05-27T00:00:00Z,27,5,2020,789,14,Egypt,EG,EGY,98423595,Africa,797,18756,80
2020-04-01T00:00:00Z,1,4,2020,0,1,El_Salvador,SV,SLV,6420744,America,1,32,1
2020-04-02T00:00:00Z,2,4,2020,9,1,El_Salvador,SV,SLV,6420744,America,2,41,2
2020-04-03T00:00:00Z,3,4,2020,5,0,El_Salvador,SV,SLV,6420744,America,2,46,3
2020-04-04T00:00:00Z,4,4,2020,10,1,El_Salvador,SV,SLV,6420744,America,3,56,4
2020-04-05T00:00:00Z,5,4,2020,6,0,El_Salvador,SV,SLV,6420744,America,3,62,5
2020-04-06T00:00:00Z,6,4,2020,7,0,El_Salvador,SV,SLV,6420744,America,3,69,6
2020-04-07T00:00:00Z,7,4,2020,9,1,El_Salvador,SV,SLV,6420744,America,4,78,7
2020-04-08T00:00:00Z,8,4,2020,0,0,El_Salvador,SV,SLV,6420744,America,4,78,8
2020-04-09T00:00:00Z,9,4,2020,25,1,El_Salvador,SV,SLV,6420744,America,5,103,9
2020-04-10T00:00:00Z,10,4,2020,14,1,El_Salvador,SV,SLV,6420744,America,6,117,10
2020-04-11T00:00:00Z,11,4,2020,1,0,El_Salvador,SV,SLV,6420744,America,6,118,11
2020-04-12T00:00:00Z,12,4,2020,0,0,El_Salvador,SV,SLV,6420744,America,6,118,12
2020-04-13T00:00:00Z,13,4,2020,7,0,El_Salvador,SV,SLV,6420744,America,6,125,13
2020-04-14T00:00:00Z,14,4,2020,24,0,El_Salvador,SV,SLV,6420744,America,6,149,14
2020-04-15T00:00:00Z,15,4,2020,10,0,El_Salvador,SV,SLV,6420744,America,6,159,15
2020-04-16T00:00:00Z,16,4,2020,0,0,El_Salvador,SV,SLV,6420744,America,6,159,16
2020-04-17T00:00:00Z,17,4,2020,5,0,El_Salvador,SV,SLV,6420744,America,6,164,17
2020-04-18T00:00:00Z,18,4,2020,13,1,El_Salvador,SV,SLV,6420744,America,7,177,18
2020-04-19T00:00:00Z,19,4,2020,13,0,El_Salvador,SV,SLV,6420744,America,7,190,19
2020-04-20T00:00:00Z,20,4,2020,11,0,El_Salvador,SV,SLV,6420744,America,7,201,20
2020-04-21T00:00:00Z,21,4,2020,17,0,El_Salvador,SV,SLV,6420744,America,7,218,21
2020-04-22T00:00:00Z,22,4,2020,7,0,El_Salvador,SV,SLV,6420744,America,7,225,22
2020-04-23T00:00:00Z,23,4,2020,12,1,El_Salvador,SV,SLV,6420744,America,8,237,23
2020-04-24T00:00:00Z,24,4,2020,13,0,El_Salvador,SV,SLV,6420744,America,8,250,24
2020-04-25T00:00:00Z,25,4,2020,11,0,El_Salvador,SV,SLV,6420744,America,8,261,25
2020-04-26T00:00:00Z,26,4,2020,37,0,El_Salvador,SV,SLV,6420744,America,8,298,26
2020-04-27T00:00:00Z,27,4,2020,0,0,El_Salvador,SV,SLV,6420744,America,8,298,27
2020-04-28T00:00:00Z,28,4,2020,25,0,El_Salvador,SV,SLV,6420744,America,8,323,28
2020-04-29T00:00:00Z,29,4,2020,22,1,El_Salvador,SV,SLV,6420744,America,9,345,29
2020-04-30T00:00:00Z,30,4,2020,32,0,El_Salvador,SV,SLV,6420744,America,9,377,30
2020-05-01T00:00:00Z,1,5,2020,47,1,El_Salvador,SV,SLV,6420744,America,10,424,31
2020-05-02T00:00:00Z,2,5,2020,22,0,El_Salvador,SV,SLV,6420744,America,10,446,32
2020-05-03T00:00:00Z,3,5,2020,0,1,El_Salvador,SV,SLV,6420744,America,11,446,33
2020-05-04T00:00:00Z,4,5,2020,109,1,El_Salvador,SV,SLV,6420744,America,12,555,34
2020-05-05T00:00:00Z,5,5,2020,32,1,El_Salvador,SV,SLV,6420744,America,13,587,35
2020-05-06T00:00:00Z,6,5,2020,0,1,El_Salvador,SV,SLV,6420744,America,14,587,36
2020-05-07T00:00:00Z,7,5,2020,108,1,El_Salvador,SV,SLV,6420744,America,15,695,37
2020-05-08T00:00:00Z,8,5,2020,0,0,El_Salvador,SV,SLV,6420744,America,15,695,38
2020-05-09T00:00:00Z,9,5,2020,89,1,El_Salvador,SV,SLV,6420744,America,16,784,39
2020-05-10T00:00:00Z,10,5,2020,105,1,El_Salvador,SV,SLV,6420744,America,17,889,40
2020-05-11T00:00:00Z,11,5,2020,69,0,El_Salvador,SV,SLV,6420744,America,17,958,41
2020-05-12T00:00:00Z,12,5,2020,40,1,El_Salvador,SV,SLV,6420744,America,18,998,42
2020-05-13T00:00:00Z,13,5,2020,39,2,El_Salvador,SV,SLV,6420744,America,20,1037,43
2020-05-14T00:00:00Z,14,5,2020,75,0,El_Salvador,SV,SLV,6420744,America,20,1112,44
2020-05-15T00:00:00Z,15,5,2020,98,3,El_Salvador,SV,SLV,6420744,America,23,1210,45
2020-05-16T00:00:00Z,16,5,2020,55,2,El_Salvador,SV,SLV,6420744,America,25,1265,46
2020-05-17T00:00:00Z,17,5,2020,0,1,El_Salvador,SV,SLV,6420744,America,26,1265,47
2020-05-18T00:00:00Z,18,5,2020,73,4,El_Salvador,SV,SLV,6420744,America,30,1338,48
2020-05-19T00:00:00Z,19,5,2020,75,0,El_Salvador,SV,SLV,6420744,America,30,1413,49
2020-05-20T00:00:00Z,20,5,2020,85,1,El_Salvador,SV,SLV,6420744,America,31,1498,50
2020-05-21T00:00:00Z,21,5,2020,73,1,El_Salvador,SV,SLV,6420744,America,32,1571,51
2020-05-22T00:00:00Z,22,5,2020,69,1,El_Salvador,SV,SLV,6420744,America,33,1640,52
2020-05-23T00:00:00Z,23,5,2020,85,0,El_Salvador,SV,SLV,6420744,America,33,1725,53
2020-05-24T00:00:00Z,24,5,2020,94,2,El_Salvador,SV,SLV,6420744,America,35,1819,54
2020-05-25T00:00:00Z,25,5,2020,96,0,El_Salvador,SV,SLV,6420744,America,35,1915,55
2020-05-26T00:00:00Z,26,5,2020,68,1,El_Salvador,SV,SLV,6420744,America,36,1983,56
2020-05-27T00:00:00Z,27,5,2020,59,0,El_Salvador,SV,SLV,6420744,America,36,2042,57
2020-04-24T00:00:00Z,24,4,2020,1,1,Equatorial_Guinea,GQ,GNQ,1308974,Africa,1,84,1
2020-04-25T00:00:00Z,25,4,2020,128,0,Equatorial_Guinea,GQ,GNQ,1308974,Africa,1,212,2
2020-04-26T00:00:00Z,26,4,2020,2,0,Equatorial_Guinea,GQ,GNQ,1308974,Africa,1,214,3
2020-04-27T00:00:00Z,27,4,2020,44,0,Equatorial_Guinea,GQ,GNQ,1308974,Africa,1,258,4
2020-04-28T00:00:00Z,28,4,2020,0,0,Equatorial_Guinea,GQ,GNQ,1308974,Africa,1,258,5
2020-04-29T00:00:00Z,29,4,2020,57,0,Equatorial_Guinea,GQ,GNQ,1308974,Africa,1,315,6
2020-04-30T00:00:00Z,30,4,2020,0,0,Equatorial_Guinea,GQ,GNQ,1308974,Africa,1,315,7
2020-05-01T00:00:00Z,1,5,2020,0,0,Equatorial_Guinea,GQ,GNQ,1308974,Africa,1,315,8
2020-05-02T00:00:00Z,2,5,2020,0,0,Equatorial_Guinea,GQ,GNQ,1308974,Africa,1,315,9
2020-05-03T00:00:00Z,3,5,2020,0,0,Equatorial_Guinea,GQ,GNQ,1308974,Africa,1,315,10
2020-05-04T00:00:00Z,4,5,2020,0,0,Equatorial_Guinea,GQ,GNQ,1308974,Africa,1,315,11
2020-05-05T00:00:00Z,5,5,2020,0,1,Equatorial_Guinea,GQ,GNQ,1308974,Africa,2,315,12
2020-05-06T00:00:00Z,6,5,2020,124,2,Equatorial_Guinea,GQ,GNQ,1308974,Africa,4,439,13
2020-05-07T00:00:00Z,7,5,2020,0,0,Equatorial_Guinea,GQ,GNQ,1308974,Africa,4,439,14
2020-05-08T00:00:00Z,8,5,2020,0,0,Equatorial_Guinea,GQ,GNQ,1308974,Africa,4,439,15
2020-05-09T00:00:00Z,9,5,2020,0,0,Equatorial_Guinea,GQ,GNQ,1308974,Africa,4,439,16
2020-05-10T00:00:00Z,10,5,2020,0,0,Equatorial_Guinea,GQ,GNQ,1308974,Africa,4,439,17
2020-05-11T00:00:00Z,11,5,2020,0,0,Equatorial_Guinea,GQ,GNQ,1308974,Africa,4,439,18
2020-05-12T00:00:00Z,12,5,2020,0,0,Equatorial_Guinea,GQ,GNQ,1308974,Africa,4,439,19
2020-05-13T00:00:00Z,13,5,2020,0,0,Equatorial_Guinea,GQ,GNQ,1308974,Africa,4,439,20
2020-05-14T00:00:00Z,14,5,2020,83,2,Equatorial_Guinea,GQ,GNQ,1308974,Africa,6,522,21
2020-05-15T00:00:00Z,15,5,2020,72,1,Equatorial_Guinea,GQ,GNQ,1308974,Africa,7,594,22
2020-05-16T00:00:00Z,16,5,2020,0,0,Equatorial_Guinea,GQ,GNQ,1308974,Africa,7,594,23
2020-05-17T00:00:00Z,17,5,2020,0,0,Equatorial_Guinea,GQ,GNQ,1308974,Africa,7,594,24
2020-05-18T00:00:00Z,18,5,2020,0,0,Equatorial_Guinea,GQ,GNQ,1308974,Africa,7,594,25
2020-05-19T00:00:00Z,19,5,2020,125,0,Equatorial_Guinea,GQ,GNQ,1308974,Africa,7,719,26
2020-05-20T00:00:00Z,20,5,2020,171,0,Equatorial_Guinea,GQ,GNQ,1308974,Africa,7,890,27
2020-05-21T00:00:00Z,21,5,2020,0,0,Equatorial_Guinea,GQ,GNQ,1308974,Africa,7,890,28
2020-05-22T00:00:00Z,22,5,2020,13,3,Equatorial_Guinea,GQ,GNQ,1308974,Africa,10,903,29
2020-05-23T00:00:00Z,23,5,2020,0,0,Equatorial_Guinea,GQ,GNQ,1308974,Africa,10,903,30
2020-05-24T00:00:00Z,24,5,2020,140,2,Equatorial_Guinea,GQ,GNQ,1308974,Africa,12,1043,31
2020-05-25T00:00:00Z,25,5,2020,0,0,Equatorial_Guinea,GQ,GNQ,1308974,Africa,12,1043,32
2020-05-26T00:00:00Z,26,5,2020,0,0,Equatorial_Guinea,GQ,GNQ,1308974,Africa,12,1043,33
2020-05-27T00:00:00Z,27,5,2020,0,0,Equatorial_Guinea,GQ,GNQ,1308974,Africa,12,1043,34
2020-03-26T00:00:00Z,26,3,2020,35,1,Estonia,EE,EST,1320884,Europe,1,404,1
2020-03-27T00:00:00Z,27,3,2020,134,0,Estonia,EE,EST,1320884,Europe,1,538,2
2020-03-28T00:00:00Z,28,3,2020,37,0,Estonia,EE,EST,1320884,Europe,1,575,3
2020-03-29T00:00:00Z,29,3,2020,65,0,Estonia,EE,EST,1320884,Europe,1,640,4
2020-03-30T00:00:00Z,30,3,2020,39,2,Estonia,EE,EST,1320884,Europe,3,679,5
2020-03-31T00:00:00Z,31,3,2020,36,0,Estonia,EE,EST,1320884,Europe,3,715,6
2020-04-01T00:00:00Z,1,4,2020,30,1,Estonia,EE,EST,1320884,Europe,4,745,7
2020-04-02T00:00:00Z,2,4,2020,34,1,Estonia,EE,EST,1320884,Europe,5,779,8
2020-04-03T00:00:00Z,3,4,2020,79,6,Estonia,EE,EST,1320884,Europe,11,858,9
2020-04-04T00:00:00Z,4,4,2020,103,1,Estonia,EE,EST,1320884,Europe,12,961,10
2020-04-05T00:00:00Z,5,4,2020,57,1,Estonia,EE,EST,1320884,Europe,13,1018,11
2020-04-06T00:00:00Z,6,4,2020,79,2,Estonia,EE,EST,1320884,Europe,15,1097,12
2020-04-07T00:00:00Z,7,4,2020,11,4,Estonia,EE,EST,1320884,Europe,19,1108,13
2020-04-08T00:00:00Z,8,4,2020,41,2,Estonia,EE,EST,1320884,Europe,21,1149,14
2020-04-09T00:00:00Z,9,4,2020,36,3,Estonia,EE,EST,1320884,Europe,24,1185,15
2020-04-10T00:00:00Z,10,4,2020,22,0,Estonia,EE,EST,1320884,Europe,24,1207,16
2020-04-11T00:00:00Z,11,4,2020,51,0,Estonia,EE,EST,1320884,Europe,24,1258,17
2020-04-12T00:00:00Z,12,4,2020,46,0,Estonia,EE,EST,1320884,Europe,24,1304,18
2020-04-13T00:00:00Z,13,4,2020,5,1,Estonia,EE,EST,1320884,Europe,25,1309,19
2020-04-14T00:00:00Z,14,4,2020,23,3,Estonia,EE,EST,1320884,Europe,28,1332,20
2020-04-15T00:00:00Z,15,4,2020,41,3,Estonia,EE,EST,1320884,Europe,31,1373,21
2020-04-16T00:00:00Z,16,4,2020,29,4,Estonia,EE,EST,1320884,Europe,35,1402,22
2020-04-17T00:00:00Z,17,4,2020,32,1,Estonia,EE,EST,1320884,Europe,36,1434,23
2020-04-18T00:00:00Z,18,4,2020,25,2,Estonia,EE,EST,1320884,Europe,38,1459,24
2020-04-19T00:00:00Z,19,4,2020,53,0,Estonia,EE,EST,1320884,Europe,38,1512,25
2020-04-20T00:00:00Z,20,4,2020,16,2,Estonia,EE,EST,1320884,Europe,40,1528,26
2020-04-21T00:00:00Z,21,4,2020,7,0,Estonia,EE,EST,1320884,Europe,40,1535,27
2020-04-22T00:00:00Z,22,4,2020,17,3,Estonia,EE,EST,1320884,Europe,43,1552,28
2020-04-23T00:00:00Z,23,4,2020,7,1,Estonia,EE,EST,1320884,Europe,44,1559,29
2020-04-24T00:00:00Z,24,4,2020,33,1,Estonia,EE,EST,1320884,Europe,45,1592,30
2020-04-25T00:00:00Z,25,4,2020,13,1,Estonia,EE,EST,1320884,Europe,46,1605,31
2020-04-26T00:00:00Z,26,4,2020,30,0,Estonia,EE,EST,1320884,Europe,46,1635,32
2020-04-27T00:00:00Z,27,4,2020,8,3,Estonia,EE,EST,1320884,Europe,49,1643,33
2020-04-28T00:00:00Z,28,4,2020,4,1,Estonia,EE,EST,1320884,Europe,50,1647,34
2020-04-29T00:00:00Z,29,4,2020,13,0,Estonia,EE,EST,1320884,Europe,50,1660,35
2020-04-30T00:00:00Z,30,4,2020,6,0,Estonia,EE,EST,1320884,Europe,50,1666,36
2020-05-01T00:00:00Z,1,5,2020,23,2,Estonia,EE,EST,1320884,Europe,52,1689,37
2020-05-02T00:00:00Z,2,5,2020,5,0,Estonia,EE,EST,1320884,Europe,52,1694,38
2020-05-03T00:00:00Z,3,5,2020,5,1,Estonia,EE,EST,1320884,Europe,53,1699,39
2020-05-04T00:00:00Z,4,5,2020,1,2,Estonia,EE,EST,1320884,Europe,55,1700,40
2020-05-05T00:00:00Z,5,5,2020,3,0,Estonia,EE,EST,1320884,Europe,55,1703,41
2020-05-06T00:00:00Z,6,5,2020,8,0,Estonia,EE,EST,1320884,Europe,55,1711,42
2020-05-07T00:00:00Z,7,5,2020,2,0,Estonia,EE,EST,1320884,Europe,55,1713,43
2020-05-08T00:00:00Z,8,5,2020,7,1,Estonia,EE,EST,1320884,Europe,56,1720,44
2020-05-09T00:00:00Z,9,5,2020,5,0,Estonia,EE,EST,1320884,Europe,56,1725,45
2020-05-10T00:00:00Z,10,5,2020,8,4,Estonia,EE,EST,1320884,Europe,60,1733,46
2020-05-11T00:00:00Z,11,5,2020,6,0,Estonia,EE,EST,1320884,Europe,60,1739,47
2020-05-12T00:00:00Z,12,5,2020,2,1,Estonia,EE,EST,1320884,Europe,61,1741,48
2020-05-13T00:00:00Z,13,5,2020,5,0,Estonia,EE,EST,1320884,Europe,61,1746,49
2020-05-14T00:00:00Z,14,5,2020,5,0,Estonia,EE,EST,1320884,Europe,61,1751,50
2020-05-15T00:00:00Z,15,5,2020,7,1,Estonia,EE,EST,1320884,Europe,62,1758,51
2020-05-16T00:00:00Z,16,5,2020,8,1,Estonia,EE,EST,1320884,Europe,63,1766,52
2020-05-17T00:00:00Z,17,5,2020,4,0,Estonia,EE,EST,1320884,Europe,63,1770,53
2020-05-18T00:00:00Z,18,5,2020,4,0,Estonia,EE,EST,1320884,Europe,63,1774,54
2020-05-19T00:00:00Z,19,5,2020,10,1,Estonia,EE,EST,1320884,Europe,64,1784,55
2020-05-20T00:00:00Z,20,5,2020,7,0,Estonia,EE,EST,1320884,Europe,64,1791,56
2020-05-21T00:00:00Z,21,5,2020,3,0,Estonia,EE,EST,1320884,Europe,64,1794,57
2020-05-22T00:00:00Z,22,5,2020,6,0,Estonia,EE,EST,1320884,Europe,64,1800,58
2020-05-23T00:00:00Z,23,5,2020,7,0,Estonia,EE,EST,1320884,Europe,64,1807,59
2020-05-24T00:00:00Z,24,5,2020,14,0,Estonia,EE,EST,1320884,Europe,64,1821,60
2020-05-25T00:00:00Z,25,5,2020,2,0,Estonia,EE,EST,1320884,Europe,64,1823,61
2020-05-26T00:00:00Z,26,5,2020,1,1,Estonia,EE,EST,1320884,Europe,65,1824,62
2020-05-27T00:00:00Z,27,5,2020,10,0,Estonia,EE,EST,1320884,Europe,65,1834,63
2020-04-18T00:00:00Z,18,4,2020,3,1,Eswatini,SZ,SWZ,1367000,Africa,1,19,1
2020-04-19T00:00:00Z,19,4,2020,0,0,Eswatini,SZ,SWZ,1367000,Africa,1,19,2
2020-04-20T00:00:00Z,20,4,2020,3,0,Eswatini,SZ,SWZ,1367000,Africa,1,22,3
2020-04-21T00:00:00Z,21,4,2020,2,0,Eswatini,SZ,SWZ,1367000,Africa,1,24,4
2020-04-22T00:00:00Z,22,4,2020,0,0,Eswatini,SZ,SWZ,1367000,Africa,1,24,5
2020-04-23T00:00:00Z,23,4,2020,7,0,Eswatini,SZ,SWZ,1367000,Africa,1,31,6
2020-04-24T00:00:00Z,24,4,2020,1,0,Eswatini,SZ,SWZ,1367000,Africa,1,32,7
2020-04-25T00:00:00Z,25,4,2020,8,0,Eswatini,SZ,SWZ,1367000,Africa,1,40,8
2020-04-26T00:00:00Z,26,4,2020,0,0,Eswatini,SZ,SWZ,1367000,Africa,1,40,9
2020-04-27T00:00:00Z,27,4,2020,19,0,Eswatini,SZ,SWZ,1367000,Africa,1,59,10
2020-04-28T00:00:00Z,28,4,2020,6,0,Eswatini,SZ,SWZ,1367000,Africa,1,65,11
2020-04-29T00:00:00Z,29,4,2020,6,0,Eswatini,SZ,SWZ,1367000,Africa,1,71,12
2020-04-30T00:00:00Z,30,4,2020,20,0,Eswatini,SZ,SWZ,1367000,Africa,1,91,13
2020-05-01T00:00:00Z,1,5,2020,9,0,Eswatini,SZ,SWZ,1367000,Africa,1,100,14
2020-05-02T00:00:00Z,2,5,2020,6,0,Eswatini,SZ,SWZ,1367000,Africa,1,106,15
2020-05-03T00:00:00Z,3,5,2020,2,0,Eswatini,SZ,SWZ,1367000,Africa,1,108,16
2020-05-04T00:00:00Z,4,5,2020,4,0,Eswatini,SZ,SWZ,1367000,Africa,1,112,17
2020-05-05T00:00:00Z,5,5,2020,4,0,Eswatini,SZ,SWZ,1367000,Africa,1,116,18
2020-05-06T00:00:00Z,6,5,2020,0,0,Eswatini,SZ,SWZ,1367000,Africa,1,116,19
2020-05-07T00:00:00Z,7,5,2020,7,1,Eswatini,SZ,SWZ,1367000,Africa,2,123,20
2020-05-08T00:00:00Z,8,5,2020,30,0,Eswatini,SZ,SWZ,1367000,Africa,2,153,21
2020-05-09T00:00:00Z,9,5,2020,6,0,Eswatini,SZ,SWZ,1367000,Africa,2,159,22
2020-05-10T00:00:00Z,10,5,2020,4,0,Eswatini,SZ,SWZ,1367000,Africa,2,163,23
2020-05-11T00:00:00Z,11,5,2020,9,0,Eswatini,SZ,SWZ,1367000,Africa,2,172,24
2020-05-12T00:00:00Z,12,5,2020,3,0,Eswatini,SZ,SWZ,1367000,Africa,2,175,25
2020-05-13T00:00:00Z,13,5,2020,9,0,Eswatini,SZ,SWZ,1367000,Africa,2,184,26
2020-05-14T00:00:00Z,14,5,2020,3,0,Eswatini,SZ,SWZ,1367000,Africa,2,187,27
2020-05-15T00:00:00Z,15,5,2020,0,0,Eswatini,SZ,SWZ,1367000,Africa,2,187,28
2020-05-16T00:00:00Z,16,5,2020,3,0,Eswatini,SZ,SWZ,1367000,Africa,2,190,29
2020-05-17T00:00:00Z,17,5,2020,12,0,Eswatini,SZ,SWZ,1367000,Africa,2,202,30
2020-05-18T00:00:00Z,18,5,2020,1,0,Eswatini,SZ,SWZ,1367000,Africa,2,203,31
2020-05-19T00:00:00Z,19,5,2020,0,0,Eswatini,SZ,SWZ,1367000,Africa,2,203,32
2020-05-20T00:00:00Z,20,5,2020,5,0,Eswatini,SZ,SWZ,1367000,Africa,2,208,33
2020-05-21T00:00:00Z,21,5,2020,9,0,Eswatini,SZ,SWZ,1367000,Africa,2,217,34
2020-05-22T00:00:00Z,22,5,2020,3,0,Eswatini,SZ,SWZ,1367000,Africa,2,220,35
2020-05-23T00:00:00Z,23,5,2020,0,0,Eswatini,SZ,SWZ,1367000,Africa,2,220,36
2020-05-24T00:00:00Z,24,5,2020,18,0,Eswatini,SZ,SWZ,1367000,Africa,2,238,37
2020-05-25T00:00:00Z,25,5,2020,12,0,Eswatini,SZ,SWZ,1367000,Africa,2,250,38
2020-05-26T00:00:00Z,26,5,2020,6,0,Eswatini,SZ,SWZ,1367000,Africa,2,256,39
2020-05-27T00:00:00Z,27,5,2020,5,0,Eswatini,SZ,SWZ,1367000,Africa,2,261,40
2020-04-06T00:00:00Z,6,4,2020,5,2,Ethiopia,ET,ETH,109224559,Africa,2,43,1
2020-04-07T00:00:00Z,7,4,2020,1,0,Ethiopia,ET,ETH,109224559,Africa,2,44,2
2020-04-08T00:00:00Z,8,4,2020,8,0,Ethiopia,ET,ETH,109224559,Africa,2,52,3
2020-04-09T00:00:00Z,9,4,2020,3,0,Ethiopia,ET,ETH,109224559,Africa,2,55,4
2020-04-10T00:00:00Z,10,4,2020,1,0,Ethiopia,ET,ETH,109224559,Africa,2,56,5
2020-04-11T00:00:00Z,11,4,2020,9,0,Ethiopia,ET,ETH,109224559,Africa,2,65,6
2020-04-12T00:00:00Z,12,4,2020,4,1,Ethiopia,ET,ETH,109224559,Africa,3,69,7
2020-04-13T00:00:00Z,13,4,2020,2,0,Ethiopia,ET,ETH,109224559,Africa,3,71,8
2020-04-14T00:00:00Z,14,4,2020,3,0,Ethiopia,ET,ETH,109224559,Africa,3,74,9
2020-04-15T00:00:00Z,15,4,2020,8,0,Ethiopia,ET,ETH,109224559,Africa,3,82,10
2020-04-16T00:00:00Z,16,4,2020,3,0,Ethiopia,ET,ETH,109224559,Africa,3,85,11
2020-04-17T00:00:00Z,17,4,2020,7,0,Ethiopia,ET,ETH,109224559,Africa,3,92,12
2020-04-18T00:00:00Z,18,4,2020,4,0,Ethiopia,ET,ETH,109224559,Africa,3,96,13
2020-04-19T00:00:00Z,19,4,2020,9,0,Ethiopia,ET,ETH,109224559,Africa,3,105,14
2020-04-20T00:00:00Z,20,4,2020,3,0,Ethiopia,ET,ETH,109224559,Africa,3,108,15
2020-04-21T00:00:00Z,21,4,2020,3,0,Ethiopia,ET,ETH,109224559,Africa,3,111,16
2020-04-22T00:00:00Z,22,4,2020,3,0,Ethiopia,ET,ETH,109224559,Africa,3,114,17
2020-04-23T00:00:00Z,23,4,2020,2,0,Ethiopia,ET,ETH,109224559,Africa,3,116,18
2020-04-24T00:00:00Z,24,4,2020,0,0,Ethiopia,ET,ETH,109224559,Africa,3,116,19
2020-04-25T00:00:00Z,25,4,2020,1,0,Ethiopia,ET,ETH,109224559,Africa,3,117,20
2020-04-26T00:00:00Z,26,4,2020,5,0,Ethiopia,ET,ETH,109224559,Africa,3,122,21
2020-04-27T00:00:00Z,27,4,2020,1,0,Ethiopia,ET,ETH,109224559,Africa,3,123,22
2020-04-28T00:00:00Z,28,4,2020,1,0,Ethiopia,ET,ETH,109224559,Africa,3,124,23
2020-04-29T00:00:00Z,29,4,2020,2,0,Ethiopia,ET,ETH,109224559,Africa,3,126,24
2020-04-30T00:00:00Z,30,4,2020,4,0,Ethiopia,ET,ETH,109224559,Africa,3,130,25
2020-05-01T00:00:00Z,1,5,2020,1,0,Ethiopia,ET,ETH,109224559,Africa,3,131,26
2020-05-02T00:00:00Z,2,5,2020,2,0,Ethiopia,ET,ETH,109224559,Africa,3,133,27
2020-05-03T00:00:00Z,3,5,2020,0,0,Ethiopia,ET,ETH,109224559,Africa,3,133,28
2020-05-04T00:00:00Z,4,5,2020,2,0,Ethiopia,ET,ETH,109224559,Africa,3,135,29
2020-05-05T00:00:00Z,5,5,2020,5,0,Ethiopia,ET,ETH,109224559,Africa,3,140,30
2020-05-06T00:00:00Z,6,5,2020,5,1,Ethiopia,ET,ETH,109224559,Africa,4,145,31
2020-05-07T00:00:00Z,7,5,2020,17,0,Ethiopia,ET,ETH,109224559,Africa,4,162,32
2020-05-08T00:00:00Z,8,5,2020,29,0,Ethiopia,ET,ETH,109224559,Africa,4,191,33
2020-05-09T00:00:00Z,9,5,2020,3,0,Ethiopia,ET,ETH,109224559,Africa,4,194,34
2020-05-10T00:00:00Z,10,5,2020,16,1,Ethiopia,ET,ETH,109224559,Africa,5,210,35
2020-05-11T00:00:00Z,11,5,2020,29,0,Ethiopia,ET,ETH,109224559,Africa,5,239,36
2020-05-12T00:00:00Z,12,5,2020,11,0,Ethiopia,ET,ETH,109224559,Africa,5,250,37
2020-05-13T00:00:00Z,13,5,2020,11,0,Ethiopia,ET,ETH,109224559,Africa,5,261,38
2020-05-14T00:00:00Z,14,5,2020,2,0,Ethiopia,ET,ETH,109224559,Africa,5,263,39
2020-05-15T00:00:00Z,15,5,2020,9,0,Ethiopia,ET,ETH,109224559,Africa,5,272,40
2020-05-16T00:00:00Z,16,5,2020,15,0,Ethiopia,ET,ETH,109224559,Africa,5,287,41
2020-05-17T00:00:00Z,17,5,2020,19,0,Ethiopia,ET,ETH,109224559,Africa,5,306,42
2020-05-18T00:00:00Z,18,5,2020,11,0,Ethiopia,ET,ETH,109224559,Africa,5,317,43
2020-05-19T00:00:00Z,19,5,2020,35,0,Ethiopia,ET,ETH,109224559,Africa,5,352,44
2020-05-20T00:00:00Z,20,5,2020,13,0,Ethiopia,ET,ETH,109224559,Africa,5,365,45
2020-05-21T00:00:00Z,21,5,2020,24,0,Ethiopia,ET,ETH,109224559,Africa,5,389,46
2020-05-22T00:00:00Z,22,5,2020,10,0,Ethiopia,ET,ETH,109224559,Africa,5,399,47
2020-05-23T00:00:00Z,23,5,2020,34,0,Ethiopia,ET,ETH,109224559,Africa,5,433,48
2020-05-24T00:00:00Z,24,5,2020,61,0,Ethiopia,ET,ETH,109224559,Africa,5,494,49
2020-05-25T00:00:00Z,25,5,2020,88,0,Ethiopia,ET,ETH,109224559,Africa,5,582,50
2020-05-26T00:00:00Z,26,5,2020,73,0,Ethiopia,ET,ETH,109224559,Africa,5,655,51
2020-05-27T00:00:00Z,27,5,2020,46,1,Ethiopia,ET,ETH,109224559,Africa,6,701,52
2020-03-22T00:00:00Z,22,3,2020,71,1,Finland,FI,FIN,5518050,Europe,1,521,1
2020-03-23T00:00:00Z,23,3,2020,105,0,Finland,FI,FIN,5518050,Europe,1,626,2
2020-03-24T00:00:00Z,24,3,2020,74,0,Finland,FI,FIN,5518050,Europe,1,700,3
2020-03-25T00:00:00Z,25,3,2020,92,0,Finland,FI,FIN,5518050,Europe,1,792,4
2020-03-26T00:00:00Z,26,3,2020,88,2,Finland,FI,FIN,5518050,Europe,3,880,5
2020-03-27T00:00:00Z,27,3,2020,78,1,Finland,FI,FIN,5518050,Europe,4,958,6
2020-03-28T00:00:00Z,28,3,2020,67,3,Finland,FI,FIN,5518050,Europe,7,1025,7
2020-03-29T00:00:00Z,29,3,2020,193,2,Finland,FI,FIN,5518050,Europe,9,1218,8
2020-03-30T00:00:00Z,30,3,2020,0,2,Finland,FI,FIN,5518050,Europe,11,1218,9
2020-03-31T00:00:00Z,31,3,2020,95,2,Finland,FI,FIN,5518050,Europe,13,1313,10
2020-04-01T00:00:00Z,1,4,2020,71,4,Finland,FI,FIN,5518050,Europe,17,1384,11
2020-04-02T00:00:00Z,2,4,2020,62,0,Finland,FI,FIN,5518050,Europe,17,1446,12
2020-04-03T00:00:00Z,3,4,2020,72,2,Finland,FI,FIN,5518050,Europe,19,1518,13
2020-04-04T00:00:00Z,4,4,2020,97,1,Finland,FI,FIN,5518050,Europe,20,1615,14
2020-04-05T00:00:00Z,5,4,2020,267,5,Finland,FI,FIN,5518050,Europe,25,1882,15
2020-04-06T00:00:00Z,6,4,2020,45,2,Finland,FI,FIN,5518050,Europe,27,1927,16
2020-04-07T00:00:00Z,7,4,2020,249,0,Finland,FI,FIN,5518050,Europe,27,2176,17
2020-04-08T00:00:00Z,8,4,2020,132,7,Finland,FI,FIN,5518050,Europe,34,2308,18
2020-04-09T00:00:00Z,9,4,2020,179,6,Finland,FI,FIN,5518050,Europe,40,2487,19
2020-04-10T00:00:00Z,10,4,2020,118,2,Finland,FI,FIN,5518050,Europe,42,2605,20
2020-04-11T00:00:00Z,11,4,2020,164,6,Finland,FI,FIN,5518050,Europe,48,2769,21
2020-04-12T00:00:00Z,12,4,2020,136,1,Finland,FI,FIN,5518050,Europe,49,2905,22
2020-04-13T00:00:00Z,13,4,2020,69,7,Finland,FI,FIN,5518050,Europe,56,2974,23
2020-04-14T00:00:00Z,14,4,2020,90,3,Finland,FI,FIN,5518050,Europe,59,3064,24
2020-04-15T00:00:00Z,15,4,2020,97,5,Finland,FI,FIN,5518050,Europe,64,3161,25
2020-04-16T00:00:00Z,16,4,2020,76,8,Finland,FI,FIN,5518050,Europe,72,3237,26
2020-04-17T00:00:00Z,17,4,2020,132,3,Finland,FI,FIN,5518050,Europe,75,3369,27
2020-04-18T00:00:00Z,18,4,2020,120,7,Finland,FI,FIN,5518050,Europe,82,3489,28
2020-04-19T00:00:00Z,19,4,2020,192,8,Finland,FI,FIN,5518050,Europe,90,3681,29
2020-04-20T00:00:00Z,20,4,2020,102,4,Finland,FI,FIN,5518050,Europe,94,3783,30
2020-04-21T00:00:00Z,21,4,2020,85,4,Finland,FI,FIN,5518050,Europe,98,3868,31
2020-04-22T00:00:00Z,22,4,2020,146,43,Finland,FI,FIN,5518050,Europe,141,4014,32
2020-04-23T00:00:00Z,23,4,2020,115,8,Finland,FI,FIN,5518050,Europe,149,4129,33
2020-04-24T00:00:00Z,24,4,2020,155,23,Finland,FI,FIN,5518050,Europe,172,4284,34
2020-04-25T00:00:00Z,25,4,2020,111,5,Finland,FI,FIN,5518050,Europe,177,4395,35
2020-04-26T00:00:00Z,26,4,2020,80,9,Finland,FI,FIN,5518050,Europe,186,4475,36
2020-04-27T00:00:00Z,27,4,2020,101,4,Finland,FI,FIN,5518050,Europe,190,4576,37
2020-04-28T00:00:00Z,28,4,2020,119,3,Finland,FI,FIN,5518050,Europe,193,4695,38
2020-04-29T00:00:00Z,29,4,2020,45,6,Finland,FI,FIN,5518050,Europe,199,4740,39
2020-04-30T00:00:00Z,30,4,2020,166,7,Finland,FI,FIN,5518050,Europe,206,4906,40
2020-05-01T00:00:00Z,1,5,2020,89,5,Finland,FI,FIN,5518050,Europe,211,4995,41
2020-05-02T00:00:00Z,2,5,2020,56,7,Finland,FI,FIN,5518050,Europe,218,5051,42
2020-05-03T00:00:00Z,3,5,2020,128,2,Finland,FI,FIN,5518050,Europe,220,5179,43
2020-05-04T00:00:00Z,4,5,2020,75,10,Finland,FI,FIN,5518050,Europe,230,5254,44
2020-05-05T00:00:00Z,5,5,2020,73,10,Finland,FI,FIN,5518050,Europe,240,5327,45
2020-05-06T00:00:00Z,6,5,2020,85,6,Finland,FI,FIN,5518050,Europe,246,5412,46
2020-05-07T00:00:00Z,7,5,2020,161,6,Finland,FI,FIN,5518050,Europe,252,5573,47
2020-05-08T00:00:00Z,8,5,2020,100,3,Finland,FI,FIN,5518050,Europe,255,5673,48
2020-05-09T00:00:00Z,9,5,2020,65,5,Finland,FI,FIN,5518050,Europe,260,5738,49
2020-05-10T00:00:00Z,10,5,2020,142,5,Finland,FI,FIN,5518050,Europe,265,5880,50
2020-05-11T00:00:00Z,11,5,2020,82,2,Finland,FI,FIN,5518050,Europe,267,5962,51
2020-05-12T00:00:00Z,12,5,2020,22,4,Finland,FI,FIN,5518050,Europe,271,5984,52
2020-05-13T00:00:00Z,13,5,2020,19,4,Finland,FI,FIN,5518050,Europe,275,6003,53
2020-05-14T00:00:00Z,14,5,2020,51,9,Finland,FI,FIN,5518050,Europe,284,6054,54
2020-05-15T00:00:00Z,15,5,2020,91,3,Finland,FI,FIN,5518050,Europe,287,6145,55
2020-05-16T00:00:00Z,16,5,2020,83,6,Finland,FI,FIN,5518050,Europe,293,6228,56
2020-05-17T00:00:00Z,17,5,2020,58,4,Finland,FI,FIN,5518050,Europe,297,6286,57
2020-05-18T00:00:00Z,18,5,2020,61,1,Finland,FI,FIN,5518050,Europe,298,6347,58
2020-05-19T00:00:00Z,19,5,2020,33,2,Finland,FI,FIN,5518050,Europe,300,6380,59
2020-05-20T00:00:00Z,20,5,2020,19,1,Finland,FI,FIN,5518050,Europe,301,6399,60
2020-05-21T00:00:00Z,21,5,2020,44,3,Finland,FI,FIN,5518050,Europe,304,6443,61
2020-05-22T00:00:00Z,22,5,2020,50,2,Finland,FI,FIN,5518050,Europe,306,6493,62
2020-05-23T00:00:00Z,23,5,2020,44,0,Finland,FI,FIN,5518050,Europe,306,6537,63
2020-05-24T00:00:00Z,24,5,2020,31,0,Finland,FI,FIN,5518050,Europe,306,6568,64
2020-05-25T00:00:00Z,25,5,2020,11,1,Finland,FI,FIN,5518050,Europe,307,6579,65
2020-05-26T00:00:00Z,26,5,2020,20,1,Finland,FI,FIN,5518050,Europe,308,6599,66
2020-05-27T00:00:00Z,27,5,2020,29,4,Finland,FI,FIN,5518050,Europe,312,6628,67
2020-02-15T00:00:00Z,15,2,2020,0,1,France,FR,FRA,66987244,Europe,1,11,1
2020-02-16T00:00:00Z,16,2,2020,0,0,France,FR,FRA,66987244,Europe,1,11,2
2020-02-17T00:00:00Z,17,2,2020,1,0,France,FR,FRA,66987244,Europe,1,12,3
2020-02-18T00:00:00Z,18,2,2020,0,0,France,FR,FRA,66987244,Europe,1,12,4
2020-02-19T00:00:00Z,19,2,2020,0,0,France,FR,FRA,66987244,Europe,1,12,5
2020-02-20T00:00:00Z,20,2,2020,0,0,France,FR,FRA,66987244,Europe,1,12,6
2020-02-21T00:00:00Z,21,2,2020,0,0,France,FR,FRA,66987244,Europe,1,12,7
2020-02-22T00:00:00Z,22,2,2020,0,0,France,FR,FRA,66987244,Europe,1,12,8
2020-02-23T00:00:00Z,23,2,2020,0,0,France,FR,FRA,66987244,Europe,1,12,9
2020-02-24T00:00:00Z,24,2,2020,0,0,France,FR,FRA,66987244,Europe,1,12,10
2020-02-25T00:00:00Z,25,2,2020,0,0,France,FR,FRA,66987244,Europe,1,12,11
2020-02-26T00:00:00Z,26,2,2020,2,0,France,FR,FRA,66987244,Europe,1,14,12
2020-02-27T00:00:00Z,27,2,2020,3,1,France,FR,FRA,66987244,Europe,2,17,13
2020-02-28T00:00:00Z,28,2,2020,21,0,France,FR,FRA,66987244,Europe,2,38,14
2020-02-29T00:00:00Z,29,2,2020,19,0,France,FR,FRA,66987244,Europe,2,57,15
2020-03-01T00:00:00Z,1,3,2020,43,0,France,FR,FRA,66987244,Europe,2,100,16
2020-03-02T00:00:00Z,2,3,2020,30,0,France,FR,FRA,66987244,Europe,2,130,17
2020-03-03T00:00:00Z,3,3,2020,48,1,France,FR,FRA,66987244,Europe,3,178,18
2020-03-04T00:00:00Z,4,3,2020,34,1,France,FR,FRA,66987244,Europe,4,212,19
2020-03-05T00:00:00Z,5,3,2020,73,0,France,FR,FRA,66987244,Europe,4,285,20
2020-03-06T00:00:00Z,6,3,2020,138,3,France,FR,FRA,66987244,Europe,7,423,21
2020-03-07T00:00:00Z,7,3,2020,190,2,France,FR,FRA,66987244,Europe,9,613,22
2020-03-08T00:00:00Z,8,3,2020,103,1,France,FR,FRA,66987244,Europe,10,716,23
2020-03-09T00:00:00Z,9,3,2020,410,9,France,FR,FRA,66987244,Europe,19,1126,24
2020-03-10T00:00:00Z,10,3,2020,286,11,France,FR,FRA,66987244,Europe,30,1412,25
2020-03-11T00:00:00Z,11,3,2020,372,3,France,FR,FRA,66987244,Europe,33,1784,26
2020-03-12T00:00:00Z,12,3,2020,497,15,France,FR,FRA,66987244,Europe,48,2281,27
2020-03-13T00:00:00Z,13,3,2020,595,13,France,FR,FRA,66987244,Europe,61,2876,28
2020-03-14T00:00:00Z,14,3,2020,785,18,France,FR,FRA,66987244,Europe,79,3661,29
2020-03-15T00:00:00Z,15,3,2020,838,12,France,FR,FRA,66987244,Europe,91,4499,30
2020-03-16T00:00:00Z,16,3,2020,924,36,France,FR,FRA,66987244,Europe,127,5423,31
2020-03-17T00:00:00Z,17,3,2020,1210,21,France,FR,FRA,66987244,Europe,148,6633,32
2020-03-18T00:00:00Z,18,3,2020,1097,27,France,FR,FRA,66987244,Europe,175,7730,33
2020-03-19T00:00:00Z,19,3,2020,1404,69,France,FR,FRA,66987244,Europe,244,9134,34
2020-03-20T00:00:00Z,20,3,2020,1861,128,France,FR,FRA,66987244,Europe,372,10995,35
2020-03-21T00:00:00Z,21,3,2020,1617,78,France,FR,FRA,66987244,Europe,450,12612,36
2020-03-22T00:00:00Z,22,3,2020,1847,112,France,FR,FRA,66987244,Europe,562,14459,37
2020-03-23T00:00:00Z,23,3,2020,1559,112,France,FR,FRA,66987244,Europe,674,16018,38
2020-03-24T00:00:00Z,24,3,2020,3838,186,France,FR,FRA,66987244,Europe,860,19856,39
2020-03-25T00:00:00Z,25,3,2020,2446,240,France,FR,FRA,66987244,Europe,1100,22302,40
2020-03-26T00:00:00Z,26,3,2020,2931,231,France,FR,FRA,66987244,Europe,1331,25233,41
2020-03-27T00:00:00Z,27,3,2020,3922,365,France,FR,FRA,66987244,Europe,1696,29155,42
2020-03-28T00:00:00Z,28,3,2020,3809,299,France,FR,FRA,66987244,Europe,1995,32964,43
2020-03-29T00:00:00Z,29,3,2020,4611,319,France,FR,FRA,66987244,Europe,2314,37575,44
2020-03-30T00:00:00Z,30,3,2020,2599,292,France,FR,FRA,66987244,Europe,2606,40174,45
2020-03-31T00:00:00Z,31,3,2020,4376,418,France,FR,FRA,66987244,Europe,3024,44550,46
2020-04-01T00:00:00Z,1,4,2020,7578,499,France,FR,FRA,66987244,Europe,3523,52128,47
2020-04-02T00:00:00Z,2,4,2020,4861,509,France,FR,FRA,66987244,Europe,4032,56989,48
2020-04-03T00:00:00Z,3,4,2020,2116,471,France,FR,FRA,66987244,Europe,4503,59105,49
2020-04-04T00:00:00Z,4,4,2020,5233,2004,France,FR,FRA,66987244,Europe,6507,64338,50
2020-04-05T00:00:00Z,5,4,2020,4267,1053,France,FR,FRA,66987244,Europe,7560,68605,51
2020-04-06T00:00:00Z,6,4,2020,1873,518,France,FR,FRA,66987244,Europe,8078,70478,52
2020-04-07T00:00:00Z,7,4,2020,3912,833,France,FR,FRA,66987244,Europe,8911,74390,53
2020-04-08T00:00:00Z,8,4,2020,3777,1417,France,FR,FRA,66987244,Europe,10328,78167,54
2020-04-09T00:00:00Z,9,4,2020,3881,541,France,FR,FRA,66987244,Europe,10869,82048,55
2020-04-10T00:00:00Z,10,4,2020,4286,1341,France,FR,FRA,66987244,Europe,12210,86334,56
2020-04-11T00:00:00Z,11,4,2020,4342,987,France,FR,FRA,66987244,Europe,13197,90676,57
2020-04-12T00:00:00Z,12,4,2020,3114,635,France,FR,FRA,66987244,Europe,13832,93790,58
2020-04-13T00:00:00Z,13,4,2020,1613,561,France,FR,FRA,66987244,Europe,14393,95403,59
2020-04-14T00:00:00Z,14,4,2020,2673,574,France,FR,FRA,66987244,Europe,14967,98076,60
2020-04-15T00:00:00Z,15,4,2020,5497,762,France,FR,FRA,66987244,Europe,15729,103573,61
2020-04-16T00:00:00Z,16,4,2020,2633,1438,France,FR,FRA,66987244,Europe,17167,106206,62
2020-04-17T00:00:00Z,17,4,2020,2641,753,France,FR,FRA,66987244,Europe,17920,108847,63
2020-04-18T00:00:00Z,18,4,2020,405,761,France,FR,FRA,66987244,Europe,18681,109252,64
2020-04-19T00:00:00Z,19,4,2020,2569,642,France,FR,FRA,66987244,Europe,19323,111821,65
2020-04-20T00:00:00Z,20,4,2020,785,395,France,FR,FRA,66987244,Europe,19718,112606,66
2020-04-21T00:00:00Z,21,4,2020,2051,547,France,FR,FRA,66987244,Europe,20265,114657,67
2020-04-22T00:00:00Z,22,4,2020,2667,531,France,FR,FRA,66987244,Europe,20796,117324,68
2020-04-23T00:00:00Z,23,4,2020,1827,544,France,FR,FRA,66987244,Europe,21340,119151,69
2020-04-24T00:00:00Z,24,4,2020,1653,516,France,FR,FRA,66987244,Europe,21856,120804,70
2020-04-25T00:00:00Z,25,4,2020,1773,389,France,FR,FRA,66987244,Europe,22245,122577,71
2020-04-26T00:00:00Z,26,4,2020,1537,369,France,FR,FRA,66987244,Europe,22614,124114,72
2020-04-27T00:00:00Z,27,4,2020,461,242,France,FR,FRA,66987244,Europe,22856,124575,73
2020-04-28T00:00:00Z,28,4,2020,1195,437,France,FR,FRA,66987244,Europe,23293,125770,74
2020-04-29T00:00:00Z,29,4,2020,1065,367,France,FR,FRA,66987244,Europe,23660,126835,75
2020-04-30T00:00:00Z,30,4,2020,1607,427,France,FR,FRA,66987244,Europe,24087,128442,76
2020-05-01T00:00:00Z,1,5,2020,1139,289,France,FR,FRA,66987244,Europe,24376,129581,77
2020-05-02T00:00:00Z,2,5,2020,604,218,France,FR,FRA,66987244,Europe,24594,130185,78
2020-05-03T00:00:00Z,3,5,2020,794,166,France,FR,FRA,66987244,Europe,24760,130979,79
2020-05-04T00:00:00Z,4,5,2020,308,135,France,FR,FRA,66987244,Europe,24895,131287,80
2020-05-05T00:00:00Z,5,5,2020,576,306,France,FR,FRA,66987244,Europe,25201,131863,81
2020-05-06T00:00:00Z,6,5,2020,1104,330,France,FR,FRA,66987244,Europe,25531,132967,82
2020-05-07T00:00:00Z,7,5,2020,4183,278,France,FR,FRA,66987244,Europe,25809,137150,83
2020-05-08T00:00:00Z,8,5,2020,629,178,France,FR,FRA,66987244,Europe,25987,137779,84
2020-05-09T00:00:00Z,9,5,2020,642,243,France,FR,FRA,66987244,Europe,26230,138421,85
2020-05-10T00:00:00Z,10,5,2020,433,80,France,FR,FRA,66987244,Europe,26310,138854,86
2020-05-11T00:00:00Z,11,5,2020,209,70,France,FR,FRA,66987244,Europe,26380,139063,87
2020-05-12T00:00:00Z,12,5,2020,456,263,France,FR,FRA,66987244,Europe,26643,139519,88
2020-05-13T00:00:00Z,13,5,2020,708,348,France,FR,FRA,66987244,Europe,26991,140227,89
2020-05-14T00:00:00Z,14,5,2020,507,83,France,FR,FRA,66987244,Europe,27074,140734,90
2020-05-15T00:00:00Z,15,5,2020,622,351,France,FR,FRA,66987244,Europe,27425,141356,91
2020-05-16T00:00:00Z,16,5,2020,563,130,France,FR,FRA,66987244,Europe,27555,141919,92
2020-05-17T00:00:00Z,17,5,2020,372,88,France,FR,FRA,66987244,Europe,27643,142291,93
2020-05-18T00:00:00Z,18,5,2020,120,68,France,FR,FRA,66987244,Europe,27711,142411,94
2020-05-19T00:00:00Z,19,5,2020,492,186,France,FR,FRA,66987244,Europe,27897,142903,95
2020-05-20T00:00:00Z,20,5,2020,524,125,France,FR,FRA,66987244,Europe,28022,143427,96
2020-05-21T00:00:00Z,21,5,2020,418,110,France,FR,FRA,66987244,Europe,28132,143845,97
2020-05-22T00:00:00Z,22,5,2020,318,83,France,FR,FRA,66987244,Europe,28215,144163,98
2020-05-23T00:00:00Z,23,5,2020,403,74,France,FR,FRA,66987244,Europe,28289,144566,99
2020-05-24T00:00:00Z,24,5,2020,240,43,France,FR,FRA,66987244,Europe,28332,144806,100
2020-05-25T00:00:00Z,25,5,2020,115,35,France,FR,FRA,66987244,Europe,28367,144921,101
2020-05-26T00:00:00Z,26,5,2020,358,65,France,FR,FRA,66987244,Europe,28432,145279,102
2020-05-27T00:00:00Z,27,5,2020,276,98,France,FR,FRA,66987244,Europe,28530,145555,103
2020-03-21T00:00:00Z,21,3,2020,0,1,Gabon,GA,GAB,2119275,Africa,1,3,1
2020-03-22T00:00:00Z,22,3,2020,0,0,Gabon,GA,GAB,2119275,Africa,1,3,2
2020-03-23T00:00:00Z,23,3,2020,3,0,Gabon,GA,GAB,2119275,Africa,1,6,3
2020-03-24T00:00:00Z,24,3,2020,0,0,Gabon,GA,GAB,2119275,Africa,1,6,4
2020-03-25T00:00:00Z,25,3,2020,0,0,Gabon,GA,GAB,2119275,Africa,1,6,5
2020-03-26T00:00:00Z,26,3,2020,0,0,Gabon,GA,GAB,2119275,Africa,1,6,6
2020-03-27T00:00:00Z,27,3,2020,1,0,Gabon,GA,GAB,2119275,Africa,1,7,7
2020-03-28T00:00:00Z,28,3,2020,0,0,Gabon,GA,GAB,2119275,Africa,1,7,8
2020-03-29T00:00:00Z,29,3,2020,0,0,Gabon,GA,GAB,2119275,Africa,1,7,9
2020-03-30T00:00:00Z,30,3,2020,0,0,Gabon,GA,GAB,2119275,Africa,1,7,10
2020-03-31T00:00:00Z,31,3,2020,0,0,Gabon,GA,GAB,2119275,Africa,1,7,11
2020-04-01T00:00:00Z,1,4,2020,9,0,Gabon,GA,GAB,2119275,Africa,1,16,12
2020-04-02T00:00:00Z,2,4,2020,2,0,Gabon,GA,GAB,2119275,Africa,1,18,13
2020-04-03T00:00:00Z,3,4,2020,0,0,Gabon,GA,GAB,2119275,Africa,1,18,14
2020-04-04T00:00:00Z,4,4,2020,3,0,Gabon,GA,GAB,2119275,Africa,1,21,15
2020-04-05T00:00:00Z,5,4,2020,0,0,Gabon,GA,GAB,2119275,Africa,1,21,16
2020-04-06T00:00:00Z,6,4,2020,0,0,Gabon,GA,GAB,2119275,Africa,1,21,17
2020-04-07T00:00:00Z,7,4,2020,0,0,Gabon,GA,GAB,2119275,Africa,1,21,18
2020-04-08T00:00:00Z,8,4,2020,9,0,Gabon,GA,GAB,2119275,Africa,1,30,19
2020-04-09T00:00:00Z,9,4,2020,3,0,Gabon,GA,GAB,2119275,Africa,1,33,20
2020-04-10T00:00:00Z,10,4,2020,11,0,Gabon,GA,GAB,2119275,Africa,1,44,21
2020-04-11T00:00:00Z,11,4,2020,2,0,Gabon,GA,GAB,2119275,Africa,1,46,22
2020-04-12T00:00:00Z,12,4,2020,3,0,Gabon,GA,GAB,2119275,Africa,1,49,23
2020-04-13T00:00:00Z,13,4,2020,8,0,Gabon,GA,GAB,2119275,Africa,1,57,24
2020-04-14T00:00:00Z,14,4,2020,0,0,Gabon,GA,GAB,2119275,Africa,1,57,25
2020-04-15T00:00:00Z,15,4,2020,18,0,Gabon,GA,GAB,2119275,Africa,1,75,26
2020-04-16T00:00:00Z,16,4,2020,12,0,Gabon,GA,GAB,2119275,Africa,1,87,27
2020-04-17T00:00:00Z,17,4,2020,8,0,Gabon,GA,GAB,2119275,Africa,1,95,28
2020-04-18T00:00:00Z,18,4,2020,13,0,Gabon,GA,GAB,2119275,Africa,1,108,29
2020-04-19T00:00:00Z,19,4,2020,1,0,Gabon,GA,GAB,2119275,Africa,1,109,30
2020-04-20T00:00:00Z,20,4,2020,0,0,Gabon,GA,GAB,2119275,Africa,1,109,31
2020-04-21T00:00:00Z,21,4,2020,11,0,Gabon,GA,GAB,2119275,Africa,1,120,32
2020-04-22T00:00:00Z,22,4,2020,36,0,Gabon,GA,GAB,2119275,Africa,1,156,33
2020-04-23T00:00:00Z,23,4,2020,10,0,Gabon,GA,GAB,2119275,Africa,1,166,34
2020-04-24T00:00:00Z,24,4,2020,1,1,Gabon,GA,GAB,2119275,Africa,2,167,35
2020-04-25T00:00:00Z,25,4,2020,5,1,Gabon,GA,GAB,2119275,Africa,3,172,36
2020-04-26T00:00:00Z,26,4,2020,4,0,Gabon,GA,GAB,2119275,Africa,3,176,37
2020-04-27T00:00:00Z,27,4,2020,0,0,Gabon,GA,GAB,2119275,Africa,3,176,38
2020-04-28T00:00:00Z,28,4,2020,35,0,Gabon,GA,GAB,2119275,Africa,3,211,39
2020-04-29T00:00:00Z,29,4,2020,27,0,Gabon,GA,GAB,2119275,Africa,3,238,40
2020-04-30T00:00:00Z,30,4,2020,38,0,Gabon,GA,GAB,2119275,Africa,3,276,41
2020-05-01T00:00:00Z,1,5,2020,0,0,Gabon,GA,GAB,2119275,Africa,3,276,42
2020-05-02T00:00:00Z,2,5,2020,32,1,Gabon,GA,GAB,2119275,Africa,4,308,43
2020-05-03T00:00:00Z,3,5,2020,27,1,Gabon,GA,GAB,2119275,Africa,5,335,44
2020-05-04T00:00:00Z,4,5,2020,0,0,Gabon,GA,GAB,2119275,Africa,5,335,45
2020-05-05T00:00:00Z,5,5,2020,32,1,Gabon,GA,GAB,2119275,Africa,6,367,46
2020-05-06T00:00:00Z,6,5,2020,30,0,Gabon,GA,GAB,2119275,Africa,6,397,47
2020-05-07T00:00:00Z,7,5,2020,42,2,Gabon,GA,GAB,2119275,Africa,8,439,48
2020-05-08T00:00:00Z,8,5,2020,65,0,Gabon,GA,GAB,2119275,Africa,8,504,49
2020-05-09T00:00:00Z,9,5,2020,116,0,Gabon,GA,GAB,2119275,Africa,8,620,50
2020-05-10T00:00:00Z,10,5,2020,41,0,Gabon,GA,GAB,2119275,Africa,8,661,51
2020-05-11T00:00:00Z,11,5,2020,0,0,Gabon,GA,GAB,2119275,Africa,8,661,52
2020-05-12T00:00:00Z,12,5,2020,141,1,Gabon,GA,GAB,2119275,Africa,9,802,53
2020-05-13T00:00:00Z,13,5,2020,61,0,Gabon,GA,GAB,2119275,Africa,9,863,54
2020-05-14T00:00:00Z,14,5,2020,141,0,Gabon,GA,GAB,2119275,Africa,9,1004,55
2020-05-15T00:00:00Z,15,5,2020,100,1,Gabon,GA,GAB,2119275,Africa,10,1104,56
2020-05-16T00:00:00Z,16,5,2020,105,0,Gabon,GA,GAB,2119275,Africa,10,1209,57
2020-05-17T00:00:00Z,17,5,2020,111,1,Gabon,GA,GAB,2119275,Africa,11,1320,58
2020-05-18T00:00:00Z,18,5,2020,0,0,Gabon,GA,GAB,2119275,Africa,11,1320,59
2020-05-19T00:00:00Z,19,5,2020,112,0,Gabon,GA,GAB,2119275,Africa,11,1432,60
2020-05-20T00:00:00Z,20,5,2020,70,1,Gabon,GA,GAB,2119275,Africa,12,1502,61
2020-05-21T00:00:00Z,21,5,2020,65,0,Gabon,GA,GAB,2119275,Africa,12,1567,62
2020-05-22T00:00:00Z,22,5,2020,0,0,Gabon,GA,GAB,2119275,Africa,12,1567,63
2020-05-23T00:00:00Z,23,5,2020,161,0,Gabon,GA,GAB,2119275,Africa,12,1728,64
2020-05-24T00:00:00Z,24,5,2020,206,0,Gabon,GA,GAB,2119275,Africa,12,1934,65
2020-05-25T00:00:00Z,25,5,2020,0,0,Gabon,GA,GAB,2119275,Africa,12,1934,66
2020-05-26T00:00:00Z,26,5,2020,201,2,Gabon,GA,GAB,2119275,Africa,14,2135,67
2020-05-27T00:00:00Z,27,5,2020,103,0,Gabon,GA,GAB,2119275,Africa,14,2238,68
2020-03-24T00:00:00Z,24,3,2020,1,1,Gambia,GM,GMB,2280102,Africa,1,2,1
2020-03-25T00:00:00Z,25,3,2020,1,0,Gambia,GM,GMB,2280102,Africa,1,3,2
2020-03-26T00:00:00Z,26,3,2020,0,0,Gambia,GM,GMB,2280102,Africa,1,3,3
2020-03-27T00:00:00Z,27,3,2020,0,0,Gambia,GM,GMB,2280102,Africa,1,3,4
2020-03-28T00:00:00Z,28,3,2020,0,0,Gambia,GM,GMB,2280102,Africa,1,3,5
2020-03-29T00:00:00Z,29,3,2020,0,0,Gambia,GM,GMB,2280102,Africa,1,3,6
2020-03-30T00:00:00Z,30,3,2020,0,0,Gambia,GM,GMB,2280102,Africa,1,3,7
2020-03-31T00:00:00Z,31,3,2020,1,0,Gambia,GM,GMB,2280102,Africa,1,4,8
2020-04-01T00:00:00Z,1,4,2020,0,0,Gambia,GM,GMB,2280102,Africa,1,4,9
2020-04-02T00:00:00Z,2,4,2020,0,0,Gambia,GM,GMB,2280102,Africa,1,4,10
2020-04-03T00:00:00Z,3,4,2020,0,0,Gambia,GM,GMB,2280102,Africa,1,4,11
2020-04-04T00:00:00Z,4,4,2020,0,0,Gambia,GM,GMB,2280102,Africa,1,4,12
2020-04-05T00:00:00Z,5,4,2020,0,0,Gambia,GM,GMB,2280102,Africa,1,4,13
2020-04-06T00:00:00Z,6,4,2020,0,0,Gambia,GM,GMB,2280102,Africa,1,4,14
2020-04-07T00:00:00Z,7,4,2020,0,0,Gambia,GM,GMB,2280102,Africa,1,4,15
2020-04-08T00:00:00Z,8,4,2020,0,0,Gambia,GM,GMB,2280102,Africa,1,4,16
2020-04-09T00:00:00Z,9,4,2020,0,0,Gambia,GM,GMB,2280102,Africa,1,4,17
2020-04-10T00:00:00Z,10,4,2020,0,0,Gambia,GM,GMB,2280102,Africa,1,4,18
2020-04-11T00:00:00Z,11,4,2020,0,0,Gambia,GM,GMB,2280102,Africa,1,4,19
2020-04-12T00:00:00Z,12,4,2020,5,0,Gambia,GM,GMB,2280102,Africa,1,9,20
2020-04-13T00:00:00Z,13,4,2020,0,0,Gambia,GM,GMB,2280102,Africa,1,9,21
2020-04-14T00:00:00Z,14,4,2020,0,0,Gambia,GM,GMB,2280102,Africa,1,9,22
2020-04-15T00:00:00Z,15,4,2020,0,0,Gambia,GM,GMB,2280102,Africa,1,9,23
2020-04-16T00:00:00Z,16,4,2020,0,0,Gambia,GM,GMB,2280102,Africa,1,9,24
2020-04-17T00:00:00Z,17,4,2020,0,0,Gambia,GM,GMB,2280102,Africa,1,9,25
2020-04-18T00:00:00Z,18,4,2020,0,0,Gambia,GM,GMB,2280102,Africa,1,9,26
2020-04-19T00:00:00Z,19,4,2020,0,0,Gambia,GM,GMB,2280102,Africa,1,9,27
2020-04-20T00:00:00Z,20,4,2020,1,0,Gambia,GM,GMB,2280102,Africa,1,10,28
2020-04-21T00:00:00Z,21,4,2020,0,0,Gambia,GM,GMB,2280102,Africa,1,10,29
2020-04-22T00:00:00Z,22,4,2020,0,0,Gambia,GM,GMB,2280102,Africa,1,10,30
2020-04-23T00:00:00Z,23,4,2020,0,0,Gambia,GM,GMB,2280102,Africa,1,10,31
2020-04-24T00:00:00Z,24,4,2020,0,0,Gambia,GM,GMB,2280102,Africa,1,10,32
2020-04-25T00:00:00Z,25,4,2020,0,0,Gambia,GM,GMB,2280102,Africa,1,10,33
2020-04-26T00:00:00Z,26,4,2020,0,0,Gambia,GM,GMB,2280102,Africa,1,10,34
2020-04-27T00:00:00Z,27,4,2020,0,0,Gambia,GM,GMB,2280102,Africa,1,10,35
2020-04-28T00:00:00Z,28,4,2020,0,0,Gambia,GM,GMB,2280102,Africa,1,10,36
2020-04-29T00:00:00Z,29,4,2020,0,0,Gambia,GM,GMB,2280102,Africa,1,10,37
2020-04-30T00:00:00Z,30,4,2020,1,0,Gambia,GM,GMB,2280102,Africa,1,11,38
2020-05-01T00:00:00Z,1,5,2020,1,0,Gambia,GM,GMB,2280102,Africa,1,12,39
2020-05-02T00:00:00Z,2,5,2020,0,0,Gambia,GM,GMB,2280102,Africa,1,12,40
2020-05-03T00:00:00Z,3,5,2020,5,0,Gambia,GM,GMB,2280102,Africa,1,17,41
2020-05-04T00:00:00Z,4,5,2020,0,0,Gambia,GM,GMB,2280102,Africa,1,17,42
2020-05-05T00:00:00Z,5,5,2020,0,0,Gambia,GM,GMB,2280102,Africa,1,17,43
2020-05-06T00:00:00Z,6,5,2020,0,0,Gambia,GM,GMB,2280102,Africa,1,17,44
2020-05-07T00:00:00Z,7,5,2020,0,0,Gambia,GM,GMB,2280102,Africa,1,17,45
2020-05-08T00:00:00Z,8,5,2020,1,0,Gambia,GM,GMB,2280102,Africa,1,18,46
2020-05-09T00:00:00Z,9,5,2020,2,0,Gambia,GM,GMB,2280102,Africa,1,20,47
2020-05-10T00:00:00Z,10,5,2020,0,0,Gambia,GM,GMB,2280102,Africa,1,20,48
2020-05-11T00:00:00Z,11,5,2020,0,0,Gambia,GM,GMB,2280102,Africa,1,20,49
2020-05-12T00:00:00Z,12,5,2020,2,0,Gambia,GM,GMB,2280102,Africa,1,22,50
2020-05-13T00:00:00Z,13,5,2020,1,0,Gambia,GM,GMB,2280102,Africa,1,23,51
2020-05-14T00:00:00Z,14,5,2020,0,0,Gambia,GM,GMB,2280102,Africa,1,23,52
2020-05-15T00:00:00Z,15,5,2020,0,0,Gambia,GM,GMB,2280102,Africa,1,23,53
2020-05-16T00:00:00Z,16,5,2020,0,0,Gambia,GM,GMB,2280102,Africa,1,23,54
2020-05-17T00:00:00Z,17,5,2020,0,0,Gambia,GM,GMB,2280102,Africa,1,23,55
2020-05-18T00:00:00Z,18,5,2020,0,0,Gambia,GM,GMB,2280102,Africa,1,23,56
2020-05-19T00:00:00Z,19,5,2020,1,0,Gambia,GM,GMB,2280102,Africa,1,24,57
2020-05-20T00:00:00Z,20,5,2020,0,0,Gambia,GM,GMB,2280102,Africa,1,24,58
2020-05-21T00:00:00Z,21,5,2020,0,0,Gambia,GM,GMB,2280102,Africa,1,24,59
2020-05-22T00:00:00Z,22,5,2020,0,0,Gambia,GM,GMB,2280102,Africa,1,24,60
2020-05-23T00:00:00Z,23,5,2020,1,0,Gambia,GM,GMB,2280102,Africa,1,25,61
2020-05-24T00:00:00Z,24,5,2020,0,0,Gambia,GM,GMB,2280102,Africa,1,25,62
2020-05-25T00:00:00Z,25,5,2020,0,0,Gambia,GM,GMB,2280102,Africa,1,25,63
2020-05-26T00:00:00Z,26,5,2020,0,0,Gambia,GM,GMB,2280102,Africa,1,25,64
2020-05-27T00:00:00Z,27,5,2020,0,0,Gambia,GM,GMB,2280102,Africa,1,25,65
2020-04-06T00:00:00Z,6,4,2020,17,2,Georgia,GE,GEO,3731000,Europe,2,174,1
2020-04-07T00:00:00Z,7,4,2020,14,0,Georgia,GE,GEO,3731000,Europe,2,188,2
2020-04-08T00:00:00Z,8,4,2020,8,1,Georgia,GE,GEO,3731000,Europe,3,196,3
2020-04-09T00:00:00Z,9,4,2020,15,0,Georgia,GE,GEO,3731000,Europe,3,211,4
2020-04-10T00:00:00Z,10,4,2020,7,0,Georgia,GE,GEO,3731000,Europe,3,218,5
2020-04-11T00:00:00Z,11,4,2020,16,0,Georgia,GE,GEO,3731000,Europe,3,234,6
2020-04-12T00:00:00Z,12,4,2020,8,0,Georgia,GE,GEO,3731000,Europe,3,242,7
2020-04-13T00:00:00Z,13,4,2020,15,0,Georgia,GE,GEO,3731000,Europe,3,257,8
2020-04-14T00:00:00Z,14,4,2020,15,0,Georgia,GE,GEO,3731000,Europe,3,272,9
2020-04-15T00:00:00Z,15,4,2020,28,0,Georgia,GE,GEO,3731000,Europe,3,300,10
2020-04-16T00:00:00Z,16,4,2020,6,0,Georgia,GE,GEO,3731000,Europe,3,306,11
2020-04-17T00:00:00Z,17,4,2020,42,0,Georgia,GE,GEO,3731000,Europe,3,348,12
2020-04-18T00:00:00Z,18,4,2020,22,0,Georgia,GE,GEO,3731000,Europe,3,370,13
2020-04-19T00:00:00Z,19,4,2020,18,1,Georgia,GE,GEO,3731000,Europe,4,388,14
2020-04-20T00:00:00Z,20,4,2020,6,0,Georgia,GE,GEO,3731000,Europe,4,394,15
2020-04-21T00:00:00Z,21,4,2020,8,0,Georgia,GE,GEO,3731000,Europe,4,402,16
2020-04-22T00:00:00Z,22,4,2020,6,0,Georgia,GE,GEO,3731000,Europe,4,408,17
2020-04-23T00:00:00Z,23,4,2020,8,1,Georgia,GE,GEO,3731000,Europe,5,416,18
2020-04-24T00:00:00Z,24,4,2020,9,0,Georgia,GE,GEO,3731000,Europe,5,425,19
2020-04-25T00:00:00Z,25,4,2020,19,0,Georgia,GE,GEO,3731000,Europe,5,444,20
2020-04-26T00:00:00Z,26,4,2020,12,0,Georgia,GE,GEO,3731000,Europe,5,456,21
2020-04-27T00:00:00Z,27,4,2020,30,1,Georgia,GE,GEO,3731000,Europe,6,486,22
2020-04-28T00:00:00Z,28,4,2020,11,0,Georgia,GE,GEO,3731000,Europe,6,497,23
2020-04-29T00:00:00Z,29,4,2020,14,0,Georgia,GE,GEO,3731000,Europe,6,511,24
2020-04-30T00:00:00Z,30,4,2020,6,0,Georgia,GE,GEO,3731000,Europe,6,517,25
2020-05-01T00:00:00Z,1,5,2020,22,0,Georgia,GE,GEO,3731000,Europe,6,539,26
2020-05-02T00:00:00Z,2,5,2020,43,2,Georgia,GE,GEO,3731000,Europe,8,582,27
2020-05-03T00:00:00Z,3,5,2020,0,0,Georgia,GE,GEO,3731000,Europe,8,582,28
2020-05-04T00:00:00Z,4,5,2020,7,1,Georgia,GE,GEO,3731000,Europe,9,589,29
2020-05-05T00:00:00Z,5,5,2020,4,0,Georgia,GE,GEO,3731000,Europe,9,593,30
2020-05-06T00:00:00Z,6,5,2020,11,0,Georgia,GE,GEO,3731000,Europe,9,604,31
2020-05-07T00:00:00Z,7,5,2020,6,0,Georgia,GE,GEO,3731000,Europe,9,610,32
2020-05-08T00:00:00Z,8,5,2020,5,0,Georgia,GE,GEO,3731000,Europe,9,615,33
2020-05-09T00:00:00Z,9,5,2020,8,1,Georgia,GE,GEO,3731000,Europe,10,623,34
2020-05-10T00:00:00Z,10,5,2020,3,0,Georgia,GE,GEO,3731000,Europe,10,626,35
2020-05-11T00:00:00Z,11,5,2020,9,0,Georgia,GE,GEO,3731000,Europe,10,635,36
2020-05-12T00:00:00Z,12,5,2020,3,1,Georgia,GE,GEO,3731000,Europe,11,638,37
2020-05-13T00:00:00Z,13,5,2020,4,0,Georgia,GE,GEO,3731000,Europe,11,642,38
2020-05-14T00:00:00Z,14,5,2020,5,0,Georgia,GE,GEO,3731000,Europe,11,647,39
2020-05-15T00:00:00Z,15,5,2020,20,1,Georgia,GE,GEO,3731000,Europe,12,667,40
2020-05-16T00:00:00Z,16,5,2020,4,0,Georgia,GE,GEO,3731000,Europe,12,671,41
2020-05-17T00:00:00Z,17,5,2020,24,0,Georgia,GE,GEO,3731000,Europe,12,695,42
2020-05-18T00:00:00Z,18,5,2020,6,0,Georgia,GE,GEO,3731000,Europe,12,701,43
2020-05-19T00:00:00Z,19,5,2020,1,0,Georgia,GE,GEO,3731000,Europe,12,702,44
2020-05-20T00:00:00Z,20,5,2020,5,0,Georgia,GE,GEO,3731000,Europe,12,707,45
2020-05-21T00:00:00Z,21,5,2020,6,0,Georgia,GE,GEO,3731000,Europe,12,713,46
2020-05-22T00:00:00Z,22,5,2020,8,0,Georgia,GE,GEO,3731000,Europe,12,721,47
2020-05-23T00:00:00Z,23,5,2020,2,0,Georgia,GE,GEO,3731000,Europe,12,723,48
2020-05-24T00:00:00Z,24,5,2020,5,0,Georgia,GE,GEO,3731000,Europe,12,728,49
2020-05-25T00:00:00Z,25,5,2020,2,0,Georgia,GE,GEO,3731000,Europe,12,730,50
2020-05-26T00:00:00Z,26,5,2020,1,0,Georgia,GE,GEO,3731000,Europe,12,731,51
2020-05-27T00:00:00Z,27,5,2020,1,0,Georgia,GE,GEO,3731000,Europe,12,732,52
2020-03-10T00:00:00Z,10,3,2020,237,2,Germany,DE,DEU,82927922,Europe,2,1139,1
2020-03-11T00:00:00Z,11,3,2020,157,0,Germany,DE,DEU,82927922,Europe,2,1296,2
2020-03-12T00:00:00Z,12,3,2020,271,1,Germany,DE,DEU,82927922,Europe,3,1567,3
2020-03-13T00:00:00Z,13,3,2020,802,2,Germany,DE,DEU,82927922,Europe,5,2369,4
2020-03-14T00:00:00Z,14,3,2020,693,0,Germany,DE,DEU,82927922,Europe,5,3062,5
2020-03-15T00:00:00Z,15,3,2020,733,3,Germany,DE,DEU,82927922,Europe,8,3795,6
2020-03-16T00:00:00Z,16,3,2020,1043,4,Germany,DE,DEU,82927922,Europe,12,4838,7
2020-03-17T00:00:00Z,17,3,2020,1174,1,Germany,DE,DEU,82927922,Europe,13,6012,8
2020-03-18T00:00:00Z,18,3,2020,1144,0,Germany,DE,DEU,82927922,Europe,13,7156,9
2020-03-19T00:00:00Z,19,3,2020,1042,0,Germany,DE,DEU,82927922,Europe,13,8198,10
2020-03-20T00:00:00Z,20,3,2020,5940,30,Germany,DE,DEU,82927922,Europe,43,14138,11
2020-03-21T00:00:00Z,21,3,2020,4049,2,Germany,DE,DEU,82927922,Europe,45,18187,12
2020-03-22T00:00:00Z,22,3,2020,3276,22,Germany,DE,DEU,82927922,Europe,67,21463,13
2020-03-23T00:00:00Z,23,3,2020,3311,27,Germany,DE,DEU,82927922,Europe,94,24774,14
2020-03-24T00:00:00Z,24,3,2020,4438,32,Germany,DE,DEU,82927922,Europe,126,29212,15
2020-03-25T00:00:00Z,25,3,2020,2342,23,Germany,DE,DEU,82927922,Europe,149,31554,16
2020-03-26T00:00:00Z,26,3,2020,4954,49,Germany,DE,DEU,82927922,Europe,198,36508,17
2020-03-27T00:00:00Z,27,3,2020,5780,55,Germany,DE,DEU,82927922,Europe,253,42288,18
2020-03-28T00:00:00Z,28,3,2020,6294,72,Germany,DE,DEU,82927922,Europe,325,48582,19
2020-03-29T00:00:00Z,29,3,2020,3965,64,Germany,DE,DEU,82927922,Europe,389,52547,20
2020-03-30T00:00:00Z,30,3,2020,4751,66,Germany,DE,DEU,82927922,Europe,455,57298,21
2020-03-31T00:00:00Z,31,3,2020,4615,128,Germany,DE,DEU,82927922,Europe,583,61913,22
2020-04-01T00:00:00Z,1,4,2020,5453,149,Germany,DE,DEU,82927922,Europe,732,67366,23
2020-04-02T00:00:00Z,2,4,2020,6156,140,Germany,DE,DEU,82927922,Europe,872,73522,24
2020-04-03T00:00:00Z,3,4,2020,6174,145,Germany,DE,DEU,82927922,Europe,1017,79696,25
2020-04-04T00:00:00Z,4,4,2020,6082,141,Germany,DE,DEU,82927922,Europe,1158,85778,26
2020-04-05T00:00:00Z,5,4,2020,5936,184,Germany,DE,DEU,82927922,Europe,1342,91714,27
2020-04-06T00:00:00Z,6,4,2020,3677,92,Germany,DE,DEU,82927922,Europe,1434,95391,28
2020-04-07T00:00:00Z,7,4,2020,3834,173,Germany,DE,DEU,82927922,Europe,1607,99225,29
2020-04-08T00:00:00Z,8,4,2020,4003,254,Germany,DE,DEU,82927922,Europe,1861,103228,30
2020-04-09T00:00:00Z,9,4,2020,4974,246,Germany,DE,DEU,82927922,Europe,2107,108202,31
2020-04-10T00:00:00Z,10,4,2020,5323,266,Germany,DE,DEU,82927922,Europe,2373,113525,32
2020-04-11T00:00:00Z,11,4,2020,4133,171,Germany,DE,DEU,82927922,Europe,2544,117658,33
2020-04-12T00:00:00Z,12,4,2020,2821,129,Germany,DE,DEU,82927922,Europe,2673,120479,34
2020-04-13T00:00:00Z,13,4,2020,2537,126,Germany,DE,DEU,82927922,Europe,2799,123016,35
2020-04-14T00:00:00Z,14,4,2020,2082,170,Germany,DE,DEU,82927922,Europe,2969,125098,36
2020-04-15T00:00:00Z,15,4,2020,2486,285,Germany,DE,DEU,82927922,Europe,3254,127584,37
2020-04-16T00:00:00Z,16,4,2020,2866,315,Germany,DE,DEU,82927922,Europe,3569,130450,38
2020-04-17T00:00:00Z,17,4,2020,3380,299,Germany,DE,DEU,82927922,Europe,3868,133830,39
2020-04-18T00:00:00Z,18,4,2020,3609,242,Germany,DE,DEU,82927922,Europe,4110,137439,40
2020-04-19T00:00:00Z,19,4,2020,2458,184,Germany,DE,DEU,82927922,Europe,4294,139897,41
2020-04-20T00:00:00Z,20,4,2020,1775,110,Germany,DE,DEU,82927922,Europe,4404,141672,42
2020-04-21T00:00:00Z,21,4,2020,1785,194,Germany,DE,DEU,82927922,Europe,4598,143457,43
2020-04-22T00:00:00Z,22,4,2020,2237,281,Germany,DE,DEU,82927922,Europe,4879,145694,44
2020-04-23T00:00:00Z,23,4,2020,2352,215,Germany,DE,DEU,82927922,Europe,5094,148046,45
2020-04-24T00:00:00Z,24,4,2020,2337,227,Germany,DE,DEU,82927922,Europe,5321,150383,46
2020-04-25T00:00:00Z,25,4,2020,2055,179,Germany,DE,DEU,82927922,Europe,5500,152438,47
2020-04-26T00:00:00Z,26,4,2020,1737,140,Germany,DE,DEU,82927922,Europe,5640,154175,48
2020-04-27T00:00:00Z,27,4,2020,1018,110,Germany,DE,DEU,82927922,Europe,5750,155193,49
2020-04-28T00:00:00Z,28,4,2020,1144,163,Germany,DE,DEU,82927922,Europe,5913,156337,50
2020-04-29T00:00:00Z,29,4,2020,1304,202,Germany,DE,DEU,82927922,Europe,6115,157641,51
2020-04-30T00:00:00Z,30,4,2020,1478,173,Germany,DE,DEU,82927922,Europe,6288,159119,52
2020-05-01T00:00:00Z,1,5,2020,0,0,Germany,DE,DEU,82927922,Europe,6288,159119,53
2020-05-02T00:00:00Z,2,5,2020,2584,287,Germany,DE,DEU,82927922,Europe,6575,161703,54
2020-05-03T00:00:00Z,3,5,2020,793,74,Germany,DE,DEU,82927922,Europe,6649,162496,55
2020-05-04T00:00:00Z,4,5,2020,679,43,Germany,DE,DEU,82927922,Europe,6692,163175,56
2020-05-05T00:00:00Z,5,5,2020,685,139,Germany,DE,DEU,82927922,Europe,6831,163860,57
2020-05-06T00:00:00Z,6,5,2020,1037,165,Germany,DE,DEU,82927922,Europe,6996,164897,58
2020-05-07T00:00:00Z,7,5,2020,1194,123,Germany,DE,DEU,82927922,Europe,7119,166091,59
2020-05-08T00:00:00Z,8,5,2020,1209,147,Germany,DE,DEU,82927922,Europe,7266,167300,60
2020-05-09T00:00:00Z,9,5,2020,1251,103,Germany,DE,DEU,82927922,Europe,7369,168551,61
2020-05-10T00:00:00Z,10,5,2020,667,26,Germany,DE,DEU,82927922,Europe,7395,169218,62
2020-05-11T00:00:00Z,11,5,2020,357,22,Germany,DE,DEU,82927922,Europe,7417,169575,63
2020-05-12T00:00:00Z,12,5,2020,933,116,Germany,DE,DEU,82927922,Europe,7533,170508,64
2020-05-13T00:00:00Z,13,5,2020,798,101,Germany,DE,DEU,82927922,Europe,7634,171306,65
2020-05-14T00:00:00Z,14,5,2020,933,89,Germany,DE,DEU,82927922,Europe,7723,172239,66
2020-05-15T00:00:00Z,15,5,2020,913,101,Germany,DE,DEU,82927922,Europe,7824,173152,67
2020-05-16T00:00:00Z,16,5,2020,620,57,Germany,DE,DEU,82927922,Europe,7881,173772,68
2020-05-17T00:00:00Z,17,5,2020,583,33,Germany,DE,DEU,82927922,Europe,7914,174355,69
2020-05-18T00:00:00Z,18,5,2020,342,21,Germany,DE,DEU,82927922,Europe,7935,174697,70
2020-05-19T00:00:00Z,19,5,2020,513,72,Germany,DE,DEU,82927922,Europe,8007,175210,71
2020-05-20T00:00:00Z,20,5,2020,797,83,Germany,DE,DEU,82927922,Europe,8090,176007,72
2020-05-21T00:00:00Z,21,5,2020,745,57,Germany,DE,DEU,82927922,Europe,8147,176752,73
2020-05-22T00:00:00Z,22,5,2020,460,27,Germany,DE,DEU,82927922,Europe,8174,177212,74
2020-05-23T00:00:00Z,23,5,2020,638,42,Germany,DE,DEU,82927922,Europe,8216,177850,75
2020-05-24T00:00:00Z,24,5,2020,431,31,Germany,DE,DEU,82927922,Europe,8247,178281,76
2020-05-25T00:00:00Z,25,5,2020,289,10,Germany,DE,DEU,82927922,Europe,8257,178570,77
2020-05-26T00:00:00Z,26,5,2020,432,45,Germany,DE,DEU,82927922,Europe,8302,179002,78
2020-05-27T00:00:00Z,27,5,2020,362,47,Germany,DE,DEU,82927922,Europe,8349,179364,79
2020-03-22T00:00:00Z,22,3,2020,5,1,Ghana,GH,GHA,29767108,Africa,1,21,1
2020-03-23T00:00:00Z,23,3,2020,3,0,Ghana,GH,GHA,29767108,Africa,1,24,2
2020-03-24T00:00:00Z,24,3,2020,3,1,Ghana,GH,GHA,29767108,Africa,2,27,3
2020-03-25T00:00:00Z,25,3,2020,26,0,Ghana,GH,GHA,29767108,Africa,2,53,4
2020-03-26T00:00:00Z,26,3,2020,15,1,Ghana,GH,GHA,29767108,Africa,3,68,5
2020-03-27T00:00:00Z,27,3,2020,64,0,Ghana,GH,GHA,29767108,Africa,3,132,6
2020-03-28T00:00:00Z,28,3,2020,5,0,Ghana,GH,GHA,29767108,Africa,3,137,7
2020-03-29T00:00:00Z,29,3,2020,4,2,Ghana,GH,GHA,29767108,Africa,5,141,8
2020-03-30T00:00:00Z,30,3,2020,11,0,Ghana,GH,GHA,29767108,Africa,5,152,9
2020-03-31T00:00:00Z,31,3,2020,0,0,Ghana,GH,GHA,29767108,Africa,5,152,10
2020-04-01T00:00:00Z,1,4,2020,0,0,Ghana,GH,GHA,29767108,Africa,5,152,11
2020-04-02T00:00:00Z,2,4,2020,43,0,Ghana,GH,GHA,29767108,Africa,5,195,12
2020-04-03T00:00:00Z,3,4,2020,9,0,Ghana,GH,GHA,29767108,Africa,5,204,13
2020-04-04T00:00:00Z,4,4,2020,1,0,Ghana,GH,GHA,29767108,Africa,5,205,14
2020-04-05T00:00:00Z,5,4,2020,9,0,Ghana,GH,GHA,29767108,Africa,5,214,15
2020-04-06T00:00:00Z,6,4,2020,0,0,Ghana,GH,GHA,29767108,Africa,5,214,16
2020-04-07T00:00:00Z,7,4,2020,73,0,Ghana,GH,GHA,29767108,Africa,5,287,17
2020-04-08T00:00:00Z,8,4,2020,0,0,Ghana,GH,GHA,29767108,Africa,5,287,18
2020-04-09T00:00:00Z,9,4,2020,26,1,Ghana,GH,GHA,29767108,Africa,6,313,19
2020-04-10T00:00:00Z,10,4,2020,65,0,Ghana,GH,GHA,29767108,Africa,6,378,20
2020-04-11T00:00:00Z,11,4,2020,0,0,Ghana,GH,GHA,29767108,Africa,6,378,21
2020-04-12T00:00:00Z,12,4,2020,30,2,Ghana,GH,GHA,29767108,Africa,8,408,22
2020-04-13T00:00:00Z,13,4,2020,158,0,Ghana,GH,GHA,29767108,Africa,8,566,23
2020-04-14T00:00:00Z,14,4,2020,0,0,Ghana,GH,GHA,29767108,Africa,8,566,24
2020-04-15T00:00:00Z,15,4,2020,70,0,Ghana,GH,GHA,29767108,Africa,8,636,25
2020-04-16T00:00:00Z,16,4,2020,5,0,Ghana,GH,GHA,29767108,Africa,8,641,26
2020-04-17T00:00:00Z,17,4,2020,0,0,Ghana,GH,GHA,29767108,Africa,8,641,27
2020-04-18T00:00:00Z,18,4,2020,0,0,Ghana,GH,GHA,29767108,Africa,8,641,28
2020-04-19T00:00:00Z,19,4,2020,193,1,Ghana,GH,GHA,29767108,Africa,9,834,29
2020-04-20T00:00:00Z,20,4,2020,208,0,Ghana,GH,GHA,29767108,Africa,9,1042,30
2020-04-21T00:00:00Z,21,4,2020,0,0,Ghana,GH,GHA,29767108,Africa,9,1042,31
2020-04-22T00:00:00Z,22,4,2020,0,0,Ghana,GH,GHA,29767108,Africa,9,1042,32
2020-04-23T00:00:00Z,23,4,2020,112,0,Ghana,GH,GHA,29767108,Africa,9,1154,33
2020-04-24T00:00:00Z,24,4,2020,0,0,Ghana,GH,GHA,29767108,Africa,9,1154,34
2020-04-25T00:00:00Z,25,4,2020,125,1,Ghana,GH,GHA,29767108,Africa,10,1279,35
2020-04-26T00:00:00Z,26,4,2020,0,0,Ghana,GH,GHA,29767108,Africa,10,1279,36
2020-04-27T00:00:00Z,27,4,2020,271,1,Ghana,GH,GHA,29767108,Africa,11,1550,37
2020-04-28T00:00:00Z,28,4,2020,0,0,Ghana,GH,GHA,29767108,Africa,11,1550,38
2020-04-29T00:00:00Z,29,4,2020,121,5,Ghana,GH,GHA,29767108,Africa,16,1671,39
2020-04-30T00:00:00Z,30,4,2020,0,0,Ghana,GH,GHA,29767108,Africa,16,1671,40
2020-05-01T00:00:00Z,1,5,2020,403,1,Ghana,GH,GHA,29767108,Africa,17,2074,41
2020-05-02T00:00:00Z,2,5,2020,0,0,Ghana,GH,GHA,29767108,Africa,17,2074,42
2020-05-03T00:00:00Z,3,5,2020,95,1,Ghana,GH,GHA,29767108,Africa,18,2169,43
2020-05-04T00:00:00Z,4,5,2020,0,0,Ghana,GH,GHA,29767108,Africa,18,2169,44
2020-05-05T00:00:00Z,5,5,2020,550,0,Ghana,GH,GHA,29767108,Africa,18,2719,45
2020-05-06T00:00:00Z,6,5,2020,0,0,Ghana,GH,GHA,29767108,Africa,18,2719,46
2020-05-07T00:00:00Z,7,5,2020,372,0,Ghana,GH,GHA,29767108,Africa,18,3091,47
2020-05-08T00:00:00Z,8,5,2020,0,0,Ghana,GH,GHA,29767108,Africa,18,3091,48
2020-05-09T00:00:00Z,9,5,2020,921,0,Ghana,GH,GHA,29767108,Africa,18,4012,49
2020-05-10T00:00:00Z,10,5,2020,251,4,Ghana,GH,GHA,29767108,Africa,22,4263,50
2020-05-11T00:00:00Z,11,5,2020,0,0,Ghana,GH,GHA,29767108,Africa,22,4263,51
2020-05-12T00:00:00Z,12,5,2020,437,0,Ghana,GH,GHA,29767108,Africa,22,4700,52
2020-05-13T00:00:00Z,13,5,2020,427,0,Ghana,GH,GHA,29767108,Africa,22,5127,53
2020-05-14T00:00:00Z,14,5,2020,281,2,Ghana,GH,GHA,29767108,Africa,24,5408,54
2020-05-15T00:00:00Z,15,5,2020,122,0,Ghana,GH,GHA,29767108,Africa,24,5530,55
2020-05-16T00:00:00Z,16,5,2020,108,4,Ghana,GH,GHA,29767108,Africa,28,5638,56
2020-05-17T00:00:00Z,17,5,2020,97,1,Ghana,GH,GHA,29767108,Africa,29,5735,57
2020-05-18T00:00:00Z,18,5,2020,0,0,Ghana,GH,GHA,29767108,Africa,29,5735,58
2020-05-19T00:00:00Z,19,5,2020,0,0,Ghana,GH,GHA,29767108,Africa,29,5735,59
2020-05-20T00:00:00Z,20,5,2020,361,2,Ghana,GH,GHA,29767108,Africa,31,6096,60
2020-05-21T00:00:00Z,21,5,2020,173,0,Ghana,GH,GHA,29767108,Africa,31,6269,61
2020-05-22T00:00:00Z,22,5,2020,217,0,Ghana,GH,GHA,29767108,Africa,31,6486,62
2020-05-23T00:00:00Z,23,5,2020,131,0,Ghana,GH,GHA,29767108,Africa,31,6617,63
2020-05-24T00:00:00Z,24,5,2020,0,0,Ghana,GH,GHA,29767108,Africa,31,6617,64
2020-05-25T00:00:00Z,25,5,2020,66,1,Ghana,GH,GHA,29767108,Africa,32,6683,65
2020-05-26T00:00:00Z,26,5,2020,125,0,Ghana,GH,GHA,29767108,Africa,32,6808,66
2020-05-27T00:00:00Z,27,5,2020,309,2,Ghana,GH,GHA,29767108,Africa,34,7117,67
2020-03-12T00:00:00Z,12,3,2020,9,1,Greece,EL,GRC,10727668,Europe,1,99,1
2020-03-13T00:00:00Z,13,3,2020,34,0,Greece,EL,GRC,10727668,Europe,1,133,2
2020-03-14T00:00:00Z,14,3,2020,57,0,Greece,EL,GRC,10727668,Europe,1,190,3
2020-03-15T00:00:00Z,15,3,2020,38,2,Greece,EL,GRC,10727668,Europe,3,228,4
2020-03-16T00:00:00Z,16,3,2020,103,1,Greece,EL,GRC,10727668,Europe,4,331,5
2020-03-17T00:00:00Z,17,3,2020,21,0,Greece,EL,GRC,10727668,Europe,4,352,6
2020-03-18T00:00:00Z,18,3,2020,35,1,Greece,EL,GRC,10727668,Europe,5,387,7
2020-03-19T00:00:00Z,19,3,2020,31,0,Greece,EL,GRC,10727668,Europe,5,418,8
2020-03-20T00:00:00Z,20,3,2020,46,0,Greece,EL,GRC,10727668,Europe,5,464,9
2020-03-21T00:00:00Z,21,3,2020,31,3,Greece,EL,GRC,10727668,Europe,8,495,10
2020-03-22T00:00:00Z,22,3,2020,35,5,Greece,EL,GRC,10727668,Europe,13,530,11
2020-03-23T00:00:00Z,23,3,2020,94,2,Greece,EL,GRC,10727668,Europe,15,624,12
2020-03-24T00:00:00Z,24,3,2020,71,2,Greece,EL,GRC,10727668,Europe,17,695,13
2020-03-25T00:00:00Z,25,3,2020,48,3,Greece,EL,GRC,10727668,Europe,20,743,14
2020-03-26T00:00:00Z,26,3,2020,78,2,Greece,EL,GRC,10727668,Europe,22,821,15
2020-03-27T00:00:00Z,27,3,2020,71,4,Greece,EL,GRC,10727668,Europe,26,892,16
2020-03-28T00:00:00Z,28,3,2020,74,2,Greece,EL,GRC,10727668,Europe,28,966,17
2020-03-29T00:00:00Z,29,3,2020,95,4,Greece,EL,GRC,10727668,Europe,32,1061,18
2020-03-30T00:00:00Z,30,3,2020,95,6,Greece,EL,GRC,10727668,Europe,38,1156,19
2020-03-31T00:00:00Z,31,3,2020,56,5,Greece,EL,GRC,10727668,Europe,43,1212,20
2020-04-01T00:00:00Z,1,4,2020,102,6,Greece,EL,GRC,10727668,Europe,49,1314,21
2020-04-02T00:00:00Z,2,4,2020,61,1,Greece,EL,GRC,10727668,Europe,50,1375,22
2020-04-03T00:00:00Z,3,4,2020,139,3,Greece,EL,GRC,10727668,Europe,53,1514,23
2020-04-04T00:00:00Z,4,4,2020,99,6,Greece,EL,GRC,10727668,Europe,59,1613,24
2020-04-05T00:00:00Z,5,4,2020,60,9,Greece,EL,GRC,10727668,Europe,68,1673,25
2020-04-06T00:00:00Z,6,4,2020,62,5,Greece,EL,GRC,10727668,Europe,73,1735,26
2020-04-07T00:00:00Z,7,4,2020,20,6,Greece,EL,GRC,10727668,Europe,79,1755,27
2020-04-08T00:00:00Z,8,4,2020,77,2,Greece,EL,GRC,10727668,Europe,81,1832,28
2020-04-09T00:00:00Z,9,4,2020,52,2,Greece,EL,GRC,10727668,Europe,83,1884,29
2020-04-10T00:00:00Z,10,4,2020,71,3,Greece,EL,GRC,10727668,Europe,86,1955,30
2020-04-11T00:00:00Z,11,4,2020,56,4,Greece,EL,GRC,10727668,Europe,90,2011,31
2020-04-12T00:00:00Z,12,4,2020,70,3,Greece,EL,GRC,10727668,Europe,93,2081,32
2020-04-13T00:00:00Z,13,4,2020,33,5,Greece,EL,GRC,10727668,Europe,98,2114,33
2020-04-14T00:00:00Z,14,4,2020,31,1,Greece,EL,GRC,10727668,Europe,99,2145,34
2020-04-15T00:00:00Z,15,4,2020,25,2,Greece,EL,GRC,10727668,Europe,101,2170,35
2020-04-16T00:00:00Z,16,4,2020,22,1,Greece,EL,GRC,10727668,Europe,102,2192,36
2020-04-17T00:00:00Z,17,4,2020,15,3,Greece,EL,GRC,10727668,Europe,105,2207,37
2020-04-18T00:00:00Z,18,4,2020,0,0,Greece,EL,GRC,10727668,Europe,105,2207,38
2020-04-19T00:00:00Z,19,4,2020,0,0,Greece,EL,GRC,10727668,Europe,105,2207,39
2020-04-20T00:00:00Z,20,4,2020,28,5,Greece,EL,GRC,10727668,Europe,110,2235,40
2020-04-21T00:00:00Z,21,4,2020,10,6,Greece,EL,GRC,10727668,Europe,116,2245,41
2020-04-22T00:00:00Z,22,4,2020,156,5,Greece,EL,GRC,10727668,Europe,121,2401,42
2020-04-23T00:00:00Z,23,4,2020,7,0,Greece,EL,GRC,10727668,Europe,121,2408,43
2020-04-24T00:00:00Z,24,4,2020,55,4,Greece,EL,GRC,10727668,Europe,125,2463,44
2020-04-25T00:00:00Z,25,4,2020,27,5,Greece,EL,GRC,10727668,Europe,130,2490,45
2020-04-26T00:00:00Z,26,4,2020,16,0,Greece,EL,GRC,10727668,Europe,130,2506,46
2020-04-27T00:00:00Z,27,4,2020,0,0,Greece,EL,GRC,10727668,Europe,130,2506,47
2020-04-28T00:00:00Z,28,4,2020,28,6,Greece,EL,GRC,10727668,Europe,136,2534,48
2020-04-29T00:00:00Z,29,4,2020,0,0,Greece,EL,GRC,10727668,Europe,136,2534,49
2020-04-30T00:00:00Z,30,4,2020,42,3,Greece,EL,GRC,10727668,Europe,139,2576,50
2020-05-01T00:00:00Z,1,5,2020,15,1,Greece,EL,GRC,10727668,Europe,140,2591,51
2020-05-02T00:00:00Z,2,5,2020,0,0,Greece,EL,GRC,10727668,Europe,140,2591,52
2020-05-03T00:00:00Z,3,5,2020,29,3,Greece,EL,GRC,10727668,Europe,143,2620,53
2020-05-04T00:00:00Z,4,5,2020,6,1,Greece,EL,GRC,10727668,Europe,144,2626,54
2020-05-05T00:00:00Z,5,5,2020,6,2,Greece,EL,GRC,10727668,Europe,146,2632,55
2020-05-06T00:00:00Z,6,5,2020,10,0,Greece,EL,GRC,10727668,Europe,146,2642,56
2020-05-07T00:00:00Z,7,5,2020,21,1,Greece,EL,GRC,10727668,Europe,147,2663,57
2020-05-08T00:00:00Z,8,5,2020,15,1,Greece,EL,GRC,10727668,Europe,148,2678,58
2020-05-09T00:00:00Z,9,5,2020,13,2,Greece,EL,GRC,10727668,Europe,150,2691,59
2020-05-10T00:00:00Z,10,5,2020,19,1,Greece,EL,GRC,10727668,Europe,151,2710,60
2020-05-11T00:00:00Z,11,5,2020,6,0,Greece,EL,GRC,10727668,Europe,151,2716,61
2020-05-12T00:00:00Z,12,5,2020,10,0,Greece,EL,GRC,10727668,Europe,151,2726,62
2020-05-13T00:00:00Z,13,5,2020,18,1,Greece,EL,GRC,10727668,Europe,152,2744,63
2020-05-14T00:00:00Z,14,5,2020,16,3,Greece,EL,GRC,10727668,Europe,155,2760,64
2020-05-15T00:00:00Z,15,5,2020,10,1,Greece,EL,GRC,10727668,Europe,156,2770,65
2020-05-16T00:00:00Z,16,5,2020,40,4,Greece,EL,GRC,10727668,Europe,160,2810,66
2020-05-17T00:00:00Z,17,5,2020,9,2,Greece,EL,GRC,10727668,Europe,162,2819,67
2020-05-18T00:00:00Z,18,5,2020,15,1,Greece,EL,GRC,10727668,Europe,163,2834,68
2020-05-19T00:00:00Z,19,5,2020,2,2,Greece,EL,GRC,10727668,Europe,165,2836,69
2020-05-20T00:00:00Z,20,5,2020,4,0,Greece,EL,GRC,10727668,Europe,165,2840,70
2020-05-21T00:00:00Z,21,5,2020,10,1,Greece,EL,GRC,10727668,Europe,166,2850,71
2020-05-22T00:00:00Z,22,5,2020,3,2,Greece,EL,GRC,10727668,Europe,168,2853,72
2020-05-23T00:00:00Z,23,5,2020,20,1,Greece,EL,GRC,10727668,Europe,169,2873,73
2020-05-24T00:00:00Z,24,5,2020,3,2,Greece,EL,GRC,10727668,Europe,171,2876,74
2020-05-25T00:00:00Z,25,5,2020,2,0,Greece,EL,GRC,10727668,Europe,171,2878,75
2020-05-26T00:00:00Z,26,5,2020,4,1,Greece,EL,GRC,10727668,Europe,172,2882,76
2020-05-27T00:00:00Z,27,5,2020,10,1,Greece,EL,GRC,10727668,Europe,173,2892,77
2020-03-22T00:00:00Z,22,3,2020,1,1,Guam,GU,GUM,165768,Oceania,1,15,1
2020-03-23T00:00:00Z,23,3,2020,12,0,Guam,GU,GUM,165768,Oceania,1,27,2
2020-03-24T00:00:00Z,24,3,2020,2,0,Guam,GU,GUM,165768,Oceania,1,29,3
2020-03-25T00:00:00Z,25,3,2020,3,0,Guam,GU,GUM,165768,Oceania,1,32,4
2020-03-26T00:00:00Z,26,3,2020,5,0,Guam,GU,GUM,165768,Oceania,1,37,5
2020-03-27T00:00:00Z,27,3,2020,12,0,Guam,GU,GUM,165768,Oceania,1,49,6
2020-03-28T00:00:00Z,28,3,2020,2,0,Guam,GU,GUM,165768,Oceania,1,51,7
2020-03-29T00:00:00Z,29,3,2020,4,0,Guam,GU,GUM,165768,Oceania,1,55,8
2020-03-30T00:00:00Z,30,3,2020,1,0,Guam,GU,GUM,165768,Oceania,1,56,9
2020-03-31T00:00:00Z,31,3,2020,4,0,Guam,GU,GUM,165768,Oceania,1,60,10
2020-04-01T00:00:00Z,1,4,2020,9,2,Guam,GU,GUM,165768,Oceania,3,69,11
2020-04-02T00:00:00Z,2,4,2020,8,0,Guam,GU,GUM,165768,Oceania,3,77,12
2020-04-03T00:00:00Z,3,4,2020,5,0,Guam,GU,GUM,165768,Oceania,3,82,13
2020-04-04T00:00:00Z,4,4,2020,5,1,Guam,GU,GUM,165768,Oceania,4,87,14
2020-04-05T00:00:00Z,5,4,2020,6,0,Guam,GU,GUM,165768,Oceania,4,93,15
2020-04-06T00:00:00Z,6,4,2020,17,0,Guam,GU,GUM,165768,Oceania,4,110,16
2020-04-07T00:00:00Z,7,4,2020,2,0,Guam,GU,GUM,165768,Oceania,4,112,17
2020-04-08T00:00:00Z,8,4,2020,9,0,Guam,GU,GUM,165768,Oceania,4,121,18
2020-04-09T00:00:00Z,9,4,2020,4,0,Guam,GU,GUM,165768,Oceania,4,125,19
2020-04-10T00:00:00Z,10,4,2020,3,0,Guam,GU,GUM,165768,Oceania,4,128,20
2020-04-11T00:00:00Z,11,4,2020,2,0,Guam,GU,GUM,165768,Oceania,4,130,21
2020-04-12T00:00:00Z,12,4,2020,3,1,Guam,GU,GUM,165768,Oceania,5,133,22
2020-04-13T00:00:00Z,13,4,2020,0,0,Guam,GU,GUM,165768,Oceania,5,133,23
2020-04-14T00:00:00Z,14,4,2020,1,0,Guam,GU,GUM,165768,Oceania,5,134,24
2020-04-15T00:00:00Z,15,4,2020,1,0,Guam,GU,GUM,165768,Oceania,5,135,25
2020-04-16T00:00:00Z,16,4,2020,0,0,Guam,GU,GUM,165768,Oceania,5,135,26
2020-04-17T00:00:00Z,17,4,2020,0,0,Guam,GU,GUM,165768,Oceania,5,135,27
2020-04-18T00:00:00Z,18,4,2020,1,0,Guam,GU,GUM,165768,Oceania,5,136,28
2020-04-19T00:00:00Z,19,4,2020,0,0,Guam,GU,GUM,165768,Oceania,5,136,29
2020-04-20T00:00:00Z,20,4,2020,0,0,Guam,GU,GUM,165768,Oceania,5,136,30
2020-04-21T00:00:00Z,21,4,2020,0,0,Guam,GU,GUM,165768,Oceania,5,136,31
2020-04-22T00:00:00Z,22,4,2020,0,0,Guam,GU,GUM,165768,Oceania,5,136,32
2020-04-23T00:00:00Z,23,4,2020,1,0,Guam,GU,GUM,165768,Oceania,5,137,33
2020-04-24T00:00:00Z,24,4,2020,3,0,Guam,GU,GUM,165768,Oceania,5,140,34
2020-04-25T00:00:00Z,25,4,2020,1,0,Guam,GU,GUM,165768,Oceania,5,141,35
2020-04-26T00:00:00Z,26,4,2020,0,0,Guam,GU,GUM,165768,Oceania,5,141,36
2020-04-27T00:00:00Z,27,4,2020,1,0,Guam,GU,GUM,165768,Oceania,5,142,37
2020-04-28T00:00:00Z,28,4,2020,2,0,Guam,GU,GUM,165768,Oceania,5,144,38
2020-04-29T00:00:00Z,29,4,2020,1,0,Guam,GU,GUM,165768,Oceania,5,145,39
2020-04-30T00:00:00Z,30,4,2020,0,0,Guam,GU,GUM,165768,Oceania,5,145,40
2020-05-01T00:00:00Z,1,5,2020,1,0,Guam,GU,GUM,165768,Oceania,5,146,41
2020-05-02T00:00:00Z,2,5,2020,0,0,Guam,GU,GUM,165768,Oceania,5,146,42
2020-05-03T00:00:00Z,3,5,2020,2,0,Guam,GU,GUM,165768,Oceania,5,148,43
2020-05-04T00:00:00Z,4,5,2020,1,0,Guam,GU,GUM,165768,Oceania,5,149,44
2020-05-05T00:00:00Z,5,5,2020,0,0,Guam,GU,GUM,165768,Oceania,5,149,45
2020-05-06T00:00:00Z,6,5,2020,0,0,Guam,GU,GUM,165768,Oceania,5,149,46
2020-05-07T00:00:00Z,7,5,2020,2,0,Guam,GU,GUM,165768,Oceania,5,151,47
2020-05-08T00:00:00Z,8,5,2020,0,0,Guam,GU,GUM,165768,Oceania,5,151,48
2020-05-09T00:00:00Z,9,5,2020,0,0,Guam,GU,GUM,165768,Oceania,5,151,49
2020-05-10T00:00:00Z,10,5,2020,0,0,Guam,GU,GUM,165768,Oceania,5,151,50
2020-05-11T00:00:00Z,11,5,2020,0,0,Guam,GU,GUM,165768,Oceania,5,151,51
2020-05-12T00:00:00Z,12,5,2020,1,0,Guam,GU,GUM,165768,Oceania,5,152,52
2020-05-13T00:00:00Z,13,5,2020,0,0,Guam,GU,GUM,165768,Oceania,5,152,53
2020-05-14T00:00:00Z,14,5,2020,0,0,Guam,GU,GUM,165768,Oceania,5,152,54
2020-05-15T00:00:00Z,15,5,2020,2,0,Guam,GU,GUM,165768,Oceania,5,154,55
2020-05-16T00:00:00Z,16,5,2020,0,0,Guam,GU,GUM,165768,Oceania,5,154,56
2020-05-17T00:00:00Z,17,5,2020,0,0,Guam,GU,GUM,165768,Oceania,5,154,57
2020-05-18T00:00:00Z,18,5,2020,0,0,Guam,GU,GUM,165768,Oceania,5,154,58
2020-05-19T00:00:00Z,19,5,2020,0,0,Guam,GU,GUM,165768,Oceania,5,154,59
2020-05-20T00:00:00Z,20,5,2020,0,0,Guam,GU,GUM,165768,Oceania,5,154,60
2020-05-21T00:00:00Z,21,5,2020,11,0,Guam,GU,GUM,165768,Oceania,5,165,61
2020-05-22T00:00:00Z,22,5,2020,0,0,Guam,GU,GUM,165768,Oceania,5,165,62
2020-05-23T00:00:00Z,23,5,2020,0,0,Guam,GU,GUM,165768,Oceania,5,165,63
2020-05-24T00:00:00Z,24,5,2020,1,0,Guam,GU,GUM,165768,Oceania,5,166,64
2020-05-25T00:00:00Z,25,5,2020,0,0,Guam,GU,GUM,165768,Oceania,5,166,65
2020-05-26T00:00:00Z,26,5,2020,0,0,Guam,GU,GUM,165768,Oceania,5,166,66
2020-05-27T00:00:00Z,27,5,2020,3,0,Guam,GU,GUM,165768,Oceania,5,169,67
2020-03-16T00:00:00Z,16,3,2020,0,1,Guatemala,GT,GTM,17247807,America,1,1,1
2020-03-17T00:00:00Z,17,3,2020,5,0,Guatemala,GT,GTM,17247807,America,1,6,2
2020-03-18T00:00:00Z,18,3,2020,0,0,Guatemala,GT,GTM,17247807,America,1,6,3
2020-03-19T00:00:00Z,19,3,2020,2,0,Guatemala,GT,GTM,17247807,America,1,8,4
2020-03-20T00:00:00Z,20,3,2020,1,0,Guatemala,GT,GTM,17247807,America,1,9,5
2020-03-21T00:00:00Z,21,3,2020,4,0,Guatemala,GT,GTM,17247807,America,1,13,6
2020-03-22T00:00:00Z,22,3,2020,4,0,Guatemala,GT,GTM,17247807,America,1,17,7
2020-03-23T00:00:00Z,23,3,2020,2,0,Guatemala,GT,GTM,17247807,America,1,19,8
2020-03-24T00:00:00Z,24,3,2020,1,0,Guatemala,GT,GTM,17247807,America,1,20,9
2020-03-25T00:00:00Z,25,3,2020,1,0,Guatemala,GT,GTM,17247807,America,1,21,10
2020-03-26T00:00:00Z,26,3,2020,3,0,Guatemala,GT,GTM,17247807,America,1,24,11
2020-03-27T00:00:00Z,27,3,2020,1,0,Guatemala,GT,GTM,17247807,America,1,25,12
2020-03-28T00:00:00Z,28,3,2020,7,0,Guatemala,GT,GTM,17247807,America,1,32,13
2020-03-29T00:00:00Z,29,3,2020,2,0,Guatemala,GT,GTM,17247807,America,1,34,14
2020-03-30T00:00:00Z,30,3,2020,2,0,Guatemala,GT,GTM,17247807,America,1,36,15
2020-03-31T00:00:00Z,31,3,2020,0,0,Guatemala,GT,GTM,17247807,America,1,36,16
2020-04-01T00:00:00Z,1,4,2020,2,0,Guatemala,GT,GTM,17247807,America,1,38,17
2020-04-02T00:00:00Z,2,4,2020,8,0,Guatemala,GT,GTM,17247807,America,1,46,18
2020-04-03T00:00:00Z,3,4,2020,1,0,Guatemala,GT,GTM,17247807,America,1,47,19
2020-04-04T00:00:00Z,4,4,2020,3,0,Guatemala,GT,GTM,17247807,America,1,50,20
2020-04-05T00:00:00Z,5,4,2020,11,1,Guatemala,GT,GTM,17247807,America,2,61,21
2020-04-06T00:00:00Z,6,4,2020,9,1,Guatemala,GT,GTM,17247807,America,3,70,22
2020-04-07T00:00:00Z,7,4,2020,4,0,Guatemala,GT,GTM,17247807,America,3,74,23
2020-04-08T00:00:00Z,8,4,2020,6,0,Guatemala,GT,GTM,17247807,America,3,80,24
2020-04-09T00:00:00Z,9,4,2020,7,0,Guatemala,GT,GTM,17247807,America,3,87,25
2020-04-10T00:00:00Z,10,4,2020,39,0,Guatemala,GT,GTM,17247807,America,3,126,26
2020-04-11T00:00:00Z,11,4,2020,11,0,Guatemala,GT,GTM,17247807,America,3,137,27
2020-04-12T00:00:00Z,12,4,2020,16,0,Guatemala,GT,GTM,17247807,America,3,153,28
2020-04-13T00:00:00Z,13,4,2020,3,2,Guatemala,GT,GTM,17247807,America,5,156,29
2020-04-14T00:00:00Z,14,4,2020,11,0,Guatemala,GT,GTM,17247807,America,5,167,30
2020-04-15T00:00:00Z,15,4,2020,13,0,Guatemala,GT,GTM,17247807,America,5,180,31
2020-04-16T00:00:00Z,16,4,2020,16,0,Guatemala,GT,GTM,17247807,America,5,196,32
2020-04-17T00:00:00Z,17,4,2020,18,2,Guatemala,GT,GTM,17247807,America,7,214,33
2020-04-18T00:00:00Z,18,4,2020,21,0,Guatemala,GT,GTM,17247807,America,7,235,34
2020-04-19T00:00:00Z,19,4,2020,22,0,Guatemala,GT,GTM,17247807,America,7,257,35
2020-04-20T00:00:00Z,20,4,2020,32,0,Guatemala,GT,GTM,17247807,America,7,289,36
2020-04-21T00:00:00Z,21,4,2020,5,0,Guatemala,GT,GTM,17247807,America,7,294,37
2020-04-22T00:00:00Z,22,4,2020,22,1,Guatemala,GT,GTM,17247807,America,8,316,38
2020-04-23T00:00:00Z,23,4,2020,26,2,Guatemala,GT,GTM,17247807,America,10,342,39
2020-04-24T00:00:00Z,24,4,2020,42,1,Guatemala,GT,GTM,17247807,America,11,384,40
2020-04-25T00:00:00Z,25,4,2020,46,0,Guatemala,GT,GTM,17247807,America,11,430,41
2020-04-26T00:00:00Z,26,4,2020,43,2,Guatemala,GT,GTM,17247807,America,13,473,42
2020-04-27T00:00:00Z,27,4,2020,27,2,Guatemala,GT,GTM,17247807,America,15,500,43
2020-04-28T00:00:00Z,28,4,2020,30,0,Guatemala,GT,GTM,17247807,America,15,530,44
2020-04-29T00:00:00Z,29,4,2020,27,1,Guatemala,GT,GTM,17247807,America,16,557,45
2020-04-30T00:00:00Z,30,4,2020,28,0,Guatemala,GT,GTM,17247807,America,16,585,46
2020-05-01T00:00:00Z,1,5,2020,14,0,Guatemala,GT,GTM,17247807,America,16,599,47
2020-05-02T00:00:00Z,2,5,2020,45,0,Guatemala,GT,GTM,17247807,America,16,644,48
2020-05-03T00:00:00Z,3,5,2020,44,1,Guatemala,GT,GTM,17247807,America,17,688,49
2020-05-04T00:00:00Z,4,5,2020,15,0,Guatemala,GT,GTM,17247807,America,17,703,50
2020-05-05T00:00:00Z,5,5,2020,27,2,Guatemala,GT,GTM,17247807,America,19,730,51
2020-05-06T00:00:00Z,6,5,2020,33,0,Guatemala,GT,GTM,17247807,America,19,763,52
2020-05-07T00:00:00Z,7,5,2020,35,2,Guatemala,GT,GTM,17247807,America,21,798,53
2020-05-08T00:00:00Z,8,5,2020,34,2,Guatemala,GT,GTM,17247807,America,23,832,54
2020-05-09T00:00:00Z,9,5,2020,68,1,Guatemala,GT,GTM,17247807,America,24,900,55
2020-05-10T00:00:00Z,10,5,2020,67,0,Guatemala,GT,GTM,17247807,America,24,967,56
2020-05-11T00:00:00Z,11,5,2020,85,2,Guatemala,GT,GTM,17247807,America,26,1052,57
2020-05-12T00:00:00Z,12,5,2020,62,0,Guatemala,GT,GTM,17247807,America,26,1114,58
2020-05-13T00:00:00Z,13,5,2020,85,1,Guatemala,GT,GTM,17247807,America,27,1199,59
2020-05-14T00:00:00Z,14,5,2020,143,2,Guatemala,GT,GTM,17247807,America,29,1342,60
2020-05-15T00:00:00Z,15,5,2020,176,0,Guatemala,GT,GTM,17247807,America,29,1518,61
2020-05-16T00:00:00Z,16,5,2020,125,1,Guatemala,GT,GTM,17247807,America,30,1643,62
2020-05-17T00:00:00Z,17,5,2020,120,3,Guatemala,GT,GTM,17247807,America,33,1763,63
2020-05-18T00:00:00Z,18,5,2020,149,2,Guatemala,GT,GTM,17247807,America,35,1912,64
2020-05-19T00:00:00Z,19,5,2020,89,3,Guatemala,GT,GTM,17247807,America,38,2001,65
2020-05-20T00:00:00Z,20,5,2020,132,5,Guatemala,GT,GTM,17247807,America,43,2133,66
2020-05-21T00:00:00Z,21,5,2020,132,2,Guatemala,GT,GTM,17247807,America,45,2265,67
2020-05-22T00:00:00Z,22,5,2020,247,3,Guatemala,GT,GTM,17247807,America,48,2512,68
2020-05-23T00:00:00Z,23,5,2020,231,3,Guatemala,GT,GTM,17247807,America,51,2743,69
2020-05-24T00:00:00Z,24,5,2020,311,4,Guatemala,GT,GTM,17247807,America,55,3054,70
2020-05-25T00:00:00Z,25,5,2020,370,3,Guatemala,GT,GTM,17247807,America,58,3424,71
2020-05-26T00:00:00Z,26,5,2020,336,1,Guatemala,GT,GTM,17247807,America,59,3760,72
2020-05-27T00:00:00Z,27,5,2020,194,4,Guatemala,GT,GTM,17247807,America,63,3954,73
2020-04-04T00:00:00Z,4,4,2020,23,2,Guernsey,GG,GGY,63026,Europe,2,114,1
2020-04-05T00:00:00Z,5,4,2020,22,0,Guernsey,GG,GGY,63026,Europe,2,136,2
2020-04-06T00:00:00Z,6,4,2020,18,1,Guernsey,GG,GGY,63026,Europe,3,154,3
2020-04-07T00:00:00Z,7,4,2020,11,1,Guernsey,GG,GGY,63026,Europe,4,165,4
2020-04-08T00:00:00Z,8,4,2020,1,0,Guernsey,GG,GGY,63026,Europe,4,166,5
2020-04-09T00:00:00Z,9,4,2020,15,1,Guernsey,GG,GGY,63026,Europe,5,181,6
2020-04-10T00:00:00Z,10,4,2020,10,0,Guernsey,GG,GGY,63026,Europe,5,191,7
2020-04-11T00:00:00Z,11,4,2020,9,1,Guernsey,GG,GGY,63026,Europe,6,200,8
2020-04-12T00:00:00Z,12,4,2020,9,0,Guernsey,GG,GGY,63026,Europe,6,209,9
2020-04-13T00:00:00Z,13,4,2020,9,0,Guernsey,GG,GGY,63026,Europe,6,218,10
2020-04-14T00:00:00Z,14,4,2020,1,0,Guernsey,GG,GGY,63026,Europe,6,219,11
2020-04-15T00:00:00Z,15,4,2020,4,1,Guernsey,GG,GGY,63026,Europe,7,223,12
2020-04-16T00:00:00Z,16,4,2020,0,0,Guernsey,GG,GGY,63026,Europe,7,223,13
2020-04-17T00:00:00Z,17,4,2020,11,2,Guernsey,GG,GGY,63026,Europe,9,234,14
2020-04-18T00:00:00Z,18,4,2020,0,0,Guernsey,GG,GGY,63026,Europe,9,234,15
2020-04-19T00:00:00Z,19,4,2020,5,0,Guernsey,GG,GGY,63026,Europe,9,239,16
2020-04-20T00:00:00Z,20,4,2020,0,0,Guernsey,GG,GGY,63026,Europe,9,239,17
2020-04-21T00:00:00Z,21,4,2020,0,1,Guernsey,GG,GGY,63026,Europe,10,239,18
2020-04-22T00:00:00Z,22,4,2020,0,0,Guernsey,GG,GGY,63026,Europe,10,239,19
2020-04-23T00:00:00Z,23,4,2020,4,0,Guernsey,GG,GGY,63026,Europe,10,243,20
2020-04-24T00:00:00Z,24,4,2020,2,0,Guernsey,GG,GGY,63026,Europe,10,245,21
2020-04-25T00:00:00Z,25,4,2020,0,1,Guernsey,GG,GGY,63026,Europe,11,245,22
2020-04-26T00:00:00Z,26,4,2020,0,1,Guernsey,GG,GGY,63026,Europe,12,245,23
2020-04-27T00:00:00Z,27,4,2020,2,1,Guernsey,GG,GGY,63026,Europe,13,247,24
2020-04-28T00:00:00Z,28,4,2020,0,0,Guernsey,GG,GGY,63026,Europe,13,247,25
2020-04-29T00:00:00Z,29,4,2020,0,0,Guernsey,GG,GGY,63026,Europe,13,247,26
2020-04-30T00:00:00Z,30,4,2020,4,0,Guernsey,GG,GGY,63026,Europe,13,251,27
2020-05-01T00:00:00Z,1,5,2020,0,0,Guernsey,GG,GGY,63026,Europe,13,251,28
2020-05-02T00:00:00Z,2,5,2020,1,0,Guernsey,GG,GGY,63026,Europe,13,252,29
2020-05-03T00:00:00Z,3,5,2020,0,0,Guernsey,GG,GGY,63026,Europe,13,252,30
2020-05-04T00:00:00Z,4,5,2020,0,0,Guernsey,GG,GGY,63026,Europe,13,252,31
2020-05-05T00:00:00Z,5,5,2020,0,0,Guernsey,GG,GGY,63026,Europe,13,252,32
2020-05-06T00:00:00Z,6,5,2020,0,0,Guernsey,GG,GGY,63026,Europe,13,252,33
2020-05-07T00:00:00Z,7,5,2020,0,0,Guernsey,GG,GGY,63026,Europe,13,252,34
2020-05-08T00:00:00Z,8,5,2020,0,0,Guernsey,GG,GGY,63026,Europe,13,252,35
2020-05-09T00:00:00Z,9,5,2020,0,0,Guernsey,GG,GGY,63026,Europe,13,252,36
2020-05-10T00:00:00Z,10,5,2020,0,0,Guernsey,GG,GGY,63026,Europe,13,252,37
2020-05-11T00:00:00Z,11,5,2020,0,0,Guernsey,GG,GGY,63026,Europe,13,252,38
2020-05-12T00:00:00Z,12,5,2020,0,0,Guernsey,GG,GGY,63026,Europe,13,252,39
2020-05-13T00:00:00Z,13,5,2020,0,0,Guernsey,GG,GGY,63026,Europe,13,252,40
2020-05-14T00:00:00Z,14,5,2020,0,0,Guernsey,GG,GGY,63026,Europe,13,252,41
2020-05-15T00:00:00Z,15,5,2020,0,0,Guernsey,GG,GGY,63026,Europe,13,252,42
2020-05-16T00:00:00Z,16,5,2020,0,0,Guernsey,GG,GGY,63026,Europe,13,252,43
2020-05-17T00:00:00Z,17,5,2020,0,0,Guernsey,GG,GGY,63026,Europe,13,252,44
2020-05-18T00:00:00Z,18,5,2020,0,0,Guernsey,GG,GGY,63026,Europe,13,252,45
2020-05-19T00:00:00Z,19,5,2020,0,0,Guernsey,GG,GGY,63026,Europe,13,252,46
2020-05-20T00:00:00Z,20,5,2020,0,0,Guernsey,GG,GGY,63026,Europe,13,252,47
2020-05-21T00:00:00Z,21,5,2020,0,0,Guernsey,GG,GGY,63026,Europe,13,252,48
2020-05-22T00:00:00Z,22,5,2020,0,0,Guernsey,GG,GGY,63026,Europe,13,252,49
2020-05-23T00:00:00Z,23,5,2020,0,0,Guernsey,GG,GGY,63026,Europe,13,252,50
2020-05-24T00:00:00Z,24,5,2020,0,0,Guernsey,GG,GGY,63026,Europe,13,252,51
2020-05-25T00:00:00Z,25,5,2020,0,0,Guernsey,GG,GGY,63026,Europe,13,252,52
2020-05-26T00:00:00Z,26,5,2020,0,0,Guernsey,GG,GGY,63026,Europe,13,252,53
2020-05-27T00:00:00Z,27,5,2020,0,0,Guernsey,GG,GGY,63026,Europe,13,252,54
2020-04-16T00:00:00Z,16,4,2020,41,1,Guinea,GN,GIN,12414318,Africa,1,404,1
2020-04-17T00:00:00Z,17,4,2020,34,0,Guinea,GN,GIN,12414318,Africa,1,438,2
2020-04-18T00:00:00Z,18,4,2020,39,2,Guinea,GN,GIN,12414318,Africa,3,477,3
2020-04-19T00:00:00Z,19,4,2020,0,0,Guinea,GN,GIN,12414318,Africa,3,477,4
2020-04-20T00:00:00Z,20,4,2020,102,2,Guinea,GN,GIN,12414318,Africa,5,579,5
2020-04-21T00:00:00Z,21,4,2020,43,0,Guinea,GN,GIN,12414318,Africa,5,622,6
2020-04-22T00:00:00Z,22,4,2020,66,1,Guinea,GN,GIN,12414318,Africa,6,688,7
2020-04-23T00:00:00Z,23,4,2020,73,0,Guinea,GN,GIN,12414318,Africa,6,761,8
2020-04-24T00:00:00Z,24,4,2020,101,0,Guinea,GN,GIN,12414318,Africa,6,862,9
2020-04-25T00:00:00Z,25,4,2020,92,0,Guinea,GN,GIN,12414318,Africa,6,954,10
2020-04-26T00:00:00Z,26,4,2020,42,1,Guinea,GN,GIN,12414318,Africa,7,996,11
2020-04-27T00:00:00Z,27,4,2020,98,0,Guinea,GN,GIN,12414318,Africa,7,1094,12
2020-04-28T00:00:00Z,28,4,2020,69,0,Guinea,GN,GIN,12414318,Africa,7,1163,13
2020-04-29T00:00:00Z,29,4,2020,77,0,Guinea,GN,GIN,12414318,Africa,7,1240,14
2020-04-30T00:00:00Z,30,4,2020,111,0,Guinea,GN,GIN,12414318,Africa,7,1351,15
2020-05-01T00:00:00Z,1,5,2020,144,0,Guinea,GN,GIN,12414318,Africa,7,1495,16
2020-05-02T00:00:00Z,2,5,2020,42,0,Guinea,GN,GIN,12414318,Africa,7,1537,17
2020-05-03T00:00:00Z,3,5,2020,49,0,Guinea,GN,GIN,12414318,Africa,7,1586,18
2020-05-04T00:00:00Z,4,5,2020,0,0,Guinea,GN,GIN,12414318,Africa,7,1586,19
2020-05-05T00:00:00Z,5,5,2020,124,2,Guinea,GN,GIN,12414318,Africa,9,1710,20
2020-05-06T00:00:00Z,6,5,2020,101,1,Guinea,GN,GIN,12414318,Africa,10,1811,21
2020-05-07T00:00:00Z,7,5,2020,45,1,Guinea,GN,GIN,12414318,Africa,11,1856,22
2020-05-08T00:00:00Z,8,5,2020,71,0,Guinea,GN,GIN,12414318,Africa,11,1927,23
2020-05-09T00:00:00Z,9,5,2020,82,0,Guinea,GN,GIN,12414318,Africa,11,2009,24
2020-05-10T00:00:00Z,10,5,2020,33,0,Guinea,GN,GIN,12414318,Africa,11,2042,25
2020-05-11T00:00:00Z,11,5,2020,104,0,Guinea,GN,GIN,12414318,Africa,11,2146,26
2020-05-12T00:00:00Z,12,5,2020,67,0,Guinea,GN,GIN,12414318,Africa,11,2213,27
2020-05-13T00:00:00Z,13,5,2020,0,0,Guinea,GN,GIN,12414318,Africa,11,2213,28
2020-05-14T00:00:00Z,14,5,2020,161,3,Guinea,GN,GIN,12414318,Africa,14,2374,29
2020-05-15T00:00:00Z,15,5,2020,99,0,Guinea,GN,GIN,12414318,Africa,14,2473,30
2020-05-16T00:00:00Z,16,5,2020,58,1,Guinea,GN,GIN,12414318,Africa,15,2531,31
2020-05-17T00:00:00Z,17,5,2020,127,1,Guinea,GN,GIN,12414318,Africa,16,2658,32
2020-05-18T00:00:00Z,18,5,2020,0,0,Guinea,GN,GIN,12414318,Africa,16,2658,33
2020-05-19T00:00:00Z,19,5,2020,138,0,Guinea,GN,GIN,12414318,Africa,16,2796,34
2020-05-20T00:00:00Z,20,5,2020,67,2,Guinea,GN,GIN,12414318,Africa,18,2863,35
2020-05-21T00:00:00Z,21,5,2020,0,0,Guinea,GN,GIN,12414318,Africa,18,2863,36
2020-05-22T00:00:00Z,22,5,2020,204,1,Guinea,GN,GIN,12414318,Africa,19,3067,37
2020-05-23T00:00:00Z,23,5,2020,0,0,Guinea,GN,GIN,12414318,Africa,19,3067,38
2020-05-24T00:00:00Z,24,5,2020,109,1,Guinea,GN,GIN,12414318,Africa,20,3176,39
2020-05-25T00:00:00Z,25,5,2020,99,0,Guinea,GN,GIN,12414318,Africa,20,3275,40
2020-05-26T00:00:00Z,26,5,2020,0,0,Guinea,GN,GIN,12414318,Africa,20,3275,41
2020-05-27T00:00:00Z,27,5,2020,83,0,Guinea,GN,GIN,12414318,Africa,20,3358,42
2020-04-27T00:00:00Z,27,4,2020,1,1,Guinea_Bissau,GW,GNB,1874309,Africa,1,53,1
2020-04-28T00:00:00Z,28,4,2020,20,0,Guinea_Bissau,GW,GNB,1874309,Africa,1,73,2
2020-04-29T00:00:00Z,29,4,2020,0,0,Guinea_Bissau,GW,GNB,1874309,Africa,1,73,3
2020-04-30T00:00:00Z,30,4,2020,4,0,Guinea_Bissau,GW,GNB,1874309,Africa,1,77,4
2020-05-01T00:00:00Z,1,5,2020,128,0,Guinea_Bissau,GW,GNB,1874309,Africa,1,205,5
2020-05-02T00:00:00Z,2,5,2020,52,0,Guinea_Bissau,GW,GNB,1874309,Africa,1,257,6
2020-05-03T00:00:00Z,3,5,2020,0,0,Guinea_Bissau,GW,GNB,1874309,Africa,1,257,7
2020-05-04T00:00:00Z,4,5,2020,35,1,Guinea_Bissau,GW,GNB,1874309,Africa,2,292,8
2020-05-05T00:00:00Z,5,5,2020,121,0,Guinea_Bissau,GW,GNB,1874309,Africa,2,413,9
2020-05-06T00:00:00Z,6,5,2020,62,0,Guinea_Bissau,GW,GNB,1874309,Africa,2,475,10
2020-05-07T00:00:00Z,7,5,2020,0,0,Guinea_Bissau,GW,GNB,1874309,Africa,2,475,11
2020-05-08T00:00:00Z,8,5,2020,89,0,Guinea_Bissau,GW,GNB,1874309,Africa,2,564,12
2020-05-09T00:00:00Z,9,5,2020,30,0,Guinea_Bissau,GW,GNB,1874309,Africa,2,594,13
2020-05-10T00:00:00Z,10,5,2020,47,1,Guinea_Bissau,GW,GNB,1874309,Africa,3,641,14
2020-05-11T00:00:00Z,11,5,2020,85,0,Guinea_Bissau,GW,GNB,1874309,Africa,3,726,15
2020-05-12T00:00:00Z,12,5,2020,35,0,Guinea_Bissau,GW,GNB,1874309,Africa,3,761,16
2020-05-13T00:00:00Z,13,5,2020,59,0,Guinea_Bissau,GW,GNB,1874309,Africa,3,820,17
2020-05-14T00:00:00Z,14,5,2020,0,0,Guinea_Bissau,GW,GNB,1874309,Africa,3,820,18
2020-05-15T00:00:00Z,15,5,2020,93,0,Guinea_Bissau,GW,GNB,1874309,Africa,3,913,19
2020-05-16T00:00:00Z,16,5,2020,0,0,Guinea_Bissau,GW,GNB,1874309,Africa,3,913,20
2020-05-17T00:00:00Z,17,5,2020,0,0,Guinea_Bissau,GW,GNB,1874309,Africa,3,913,21
2020-05-18T00:00:00Z,18,5,2020,77,1,Guinea_Bissau,GW,GNB,1874309,Africa,4,990,22
2020-05-19T00:00:00Z,19,5,2020,0,0,Guinea_Bissau,GW,GNB,1874309,Africa,4,990,23
2020-05-20T00:00:00Z,20,5,2020,48,2,Guinea_Bissau,GW,GNB,1874309,Africa,6,1038,24
2020-05-21T00:00:00Z,21,5,2020,0,0,Guinea_Bissau,GW,GNB,1874309,Africa,6,1038,25
2020-05-22T00:00:00Z,22,5,2020,51,0,Guinea_Bissau,GW,GNB,1874309,Africa,6,1089,26
2020-05-23T00:00:00Z,23,5,2020,0,0,Guinea_Bissau,GW,GNB,1874309,Africa,6,1089,27
2020-05-24T00:00:00Z,24,5,2020,25,0,Guinea_Bissau,GW,GNB,1874309,Africa,6,1114,28
2020-05-25T00:00:00Z,25,5,2020,59,0,Guinea_Bissau,GW,GNB,1874309,Africa,6,1173,29
2020-05-26T00:00:00Z,26,5,2020,0,0,Guinea_Bissau,GW,GNB,1874309,Africa,6,1173,30
2020-05-27T00:00:00Z,27,5,2020,0,0,Guinea_Bissau,GW,GNB,1874309,Africa,6,1173,31
2020-03-13T00:00:00Z,13,3,2020,1,1,Guyana,GY,GUY,779004,America,1,1,1
2020-03-16T00:00:00Z,16,3,2020,3,0,Guyana,GY,GUY,779004,America,1,4,2
2020-03-17T00:00:00Z,17,3,2020,0,0,Guyana,GY,GUY,779004,America,1,4,3
2020-03-18T00:00:00Z,18,3,2020,0,0,Guyana,GY,GUY,779004,America,1,4,4
2020-03-19T00:00:00Z,19,3,2020,1,0,Guyana,GY,GUY,779004,America,1,5,5
2020-03-20T00:00:00Z,20,3,2020,0,0,Guyana,GY,GUY,779004,America,1,5,6
2020-03-21T00:00:00Z,21,3,2020,0,0,Guyana,GY,GUY,779004,America,1,5,7
2020-03-22T00:00:00Z,22,3,2020,0,0,Guyana,GY,GUY,779004,America,1,5,8
2020-03-23T00:00:00Z,23,3,2020,0,0,Guyana,GY,GUY,779004,America,1,5,9
2020-03-24T00:00:00Z,24,3,2020,0,0,Guyana,GY,GUY,779004,America,1,5,10
2020-03-25T00:00:00Z,25,3,2020,0,0,Guyana,GY,GUY,779004,America,1,5,11
2020-03-26T00:00:00Z,26,3,2020,0,0,Guyana,GY,GUY,779004,America,1,5,12
2020-03-27T00:00:00Z,27,3,2020,0,0,Guyana,GY,GUY,779004,America,1,5,13
2020-03-28T00:00:00Z,28,3,2020,0,0,Guyana,GY,GUY,779004,America,1,5,14
2020-03-29T00:00:00Z,29,3,2020,3,0,Guyana,GY,GUY,779004,America,1,8,15
2020-03-30T00:00:00Z,30,3,2020,0,0,Guyana,GY,GUY,779004,America,1,8,16
2020-03-31T00:00:00Z,31,3,2020,0,0,Guyana,GY,GUY,779004,America,1,8,17
2020-04-01T00:00:00Z,1,4,2020,4,1,Guyana,GY,GUY,779004,America,2,12,18
2020-04-02T00:00:00Z,2,4,2020,7,2,Guyana,GY,GUY,779004,America,4,19,19
2020-04-03T00:00:00Z,3,4,2020,0,0,Guyana,GY,GUY,779004,America,4,19,20
2020-04-04T00:00:00Z,4,4,2020,4,0,Guyana,GY,GUY,779004,America,4,23,21
2020-04-05T00:00:00Z,5,4,2020,1,0,Guyana,GY,GUY,779004,America,4,24,22
2020-04-06T00:00:00Z,6,4,2020,5,0,Guyana,GY,GUY,779004,America,4,29,23
2020-04-07T00:00:00Z,7,4,2020,2,1,Guyana,GY,GUY,779004,America,5,31,24
2020-04-08T00:00:00Z,8,4,2020,2,0,Guyana,GY,GUY,779004,America,5,33,25
2020-04-09T00:00:00Z,9,4,2020,4,1,Guyana,GY,GUY,779004,America,6,37,26
2020-04-10T00:00:00Z,10,4,2020,0,0,Guyana,GY,GUY,779004,America,6,37,27
2020-04-11T00:00:00Z,11,4,2020,3,0,Guyana,GY,GUY,779004,America,6,40,28
2020-04-12T00:00:00Z,12,4,2020,5,0,Guyana,GY,GUY,779004,America,6,45,29
2020-04-13T00:00:00Z,13,4,2020,0,0,Guyana,GY,GUY,779004,America,6,45,30
2020-04-14T00:00:00Z,14,4,2020,2,0,Guyana,GY,GUY,779004,America,6,47,31
2020-04-15T00:00:00Z,15,4,2020,1,0,Guyana,GY,GUY,779004,America,6,48,32
2020-04-16T00:00:00Z,16,4,2020,7,0,Guyana,GY,GUY,779004,America,6,55,33
2020-04-17T00:00:00Z,17,4,2020,2,0,Guyana,GY,GUY,779004,America,6,57,34
2020-04-18T00:00:00Z,18,4,2020,6,0,Guyana,GY,GUY,779004,America,6,63,35
2020-04-19T00:00:00Z,19,4,2020,0,1,Guyana,GY,GUY,779004,America,7,63,36
2020-04-20T00:00:00Z,20,4,2020,2,0,Guyana,GY,GUY,779004,America,7,65,37
2020-04-21T00:00:00Z,21,4,2020,1,0,Guyana,GY,GUY,779004,America,7,66,38
2020-04-22T00:00:00Z,22,4,2020,1,0,Guyana,GY,GUY,779004,America,7,67,39
2020-04-23T00:00:00Z,23,4,2020,0,0,Guyana,GY,GUY,779004,America,7,67,40
2020-04-24T00:00:00Z,24,4,2020,3,0,Guyana,GY,GUY,779004,America,7,70,41
2020-04-25T00:00:00Z,25,4,2020,3,1,Guyana,GY,GUY,779004,America,8,73,42
2020-04-26T00:00:00Z,26,4,2020,1,0,Guyana,GY,GUY,779004,America,8,74,43
2020-04-27T00:00:00Z,27,4,2020,0,0,Guyana,GY,GUY,779004,America,8,74,44
2020-04-28T00:00:00Z,28,4,2020,0,0,Guyana,GY,GUY,779004,America,8,74,45
2020-04-29T00:00:00Z,29,4,2020,1,0,Guyana,GY,GUY,779004,America,8,75,46
2020-04-30T00:00:00Z,30,4,2020,3,0,Guyana,GY,GUY,779004,America,8,78,47
2020-05-01T00:00:00Z,1,5,2020,4,1,Guyana,GY,GUY,779004,America,9,82,48
2020-05-02T00:00:00Z,2,5,2020,0,0,Guyana,GY,GUY,779004,America,9,82,49
2020-05-03T00:00:00Z,3,5,2020,0,0,Guyana,GY,GUY,779004,America,9,82,50
2020-05-04T00:00:00Z,4,5,2020,0,0,Guyana,GY,GUY,779004,America,9,82,51
2020-05-05T00:00:00Z,5,5,2020,10,0,Guyana,GY,GUY,779004,America,9,92,52
2020-05-06T00:00:00Z,6,5,2020,1,1,Guyana,GY,GUY,779004,America,10,93,53
2020-05-07T00:00:00Z,7,5,2020,0,0,Guyana,GY,GUY,779004,America,10,93,54
2020-05-08T00:00:00Z,8,5,2020,0,0,Guyana,GY,GUY,779004,America,10,93,55
2020-05-09T00:00:00Z,9,5,2020,1,0,Guyana,GY,GUY,779004,America,10,94,56
2020-05-10T00:00:00Z,10,5,2020,3,0,Guyana,GY,GUY,779004,America,10,97,57
2020-05-11T00:00:00Z,11,5,2020,7,0,Guyana,GY,GUY,779004,America,10,104,58
2020-05-12T00:00:00Z,12,5,2020,5,0,Guyana,GY,GUY,779004,America,10,109,59
2020-05-13T00:00:00Z,13,5,2020,4,0,Guyana,GY,GUY,779004,America,10,113,60
2020-05-14T00:00:00Z,14,5,2020,0,0,Guyana,GY,GUY,779004,America,10,113,61
2020-05-15T00:00:00Z,15,5,2020,0,0,Guyana,GY,GUY,779004,America,10,113,62
2020-05-16T00:00:00Z,16,5,2020,3,0,Guyana,GY,GUY,779004,America,10,116,63
2020-05-17T00:00:00Z,17,5,2020,1,0,Guyana,GY,GUY,779004,America,10,117,64
2020-05-18T00:00:00Z,18,5,2020,0,0,Guyana,GY,GUY,779004,America,10,117,65
2020-05-19T00:00:00Z,19,5,2020,7,0,Guyana,GY,GUY,779004,America,10,124,66
2020-05-20T00:00:00Z,20,5,2020,1,0,Guyana,GY,GUY,779004,America,10,125,67
2020-05-21T00:00:00Z,21,5,2020,0,0,Guyana,GY,GUY,779004,America,10,125,68
2020-05-22T00:00:00Z,22,5,2020,2,0,Guyana,GY,GUY,779004,America,10,127,69
2020-05-23T00:00:00Z,23,5,2020,0,0,Guyana,GY,GUY,779004,America,10,127,70
2020-05-24T00:00:00Z,24,5,2020,0,0,Guyana,GY,GUY,779004,America,10,127,71
2020-05-25T00:00:00Z,25,5,2020,8,0,Guyana,GY,GUY,779004,America,10,135,72
2020-05-26T00:00:00Z,26,5,2020,2,1,Guyana,GY,GUY,779004,America,11,137,73
2020-05-27T00:00:00Z,27,5,2020,2,0,Guyana,GY,GUY,779004,America,11,139,74
2020-04-07T00:00:00Z,7,4,2020,3,1,Haiti,HT,HTI,11123176,America,1,24,1
2020-04-08T00:00:00Z,8,4,2020,1,0,Haiti,HT,HTI,11123176,America,1,25,2
2020-04-09T00:00:00Z,9,4,2020,2,0,Haiti,HT,HTI,11123176,America,1,27,3
2020-04-10T00:00:00Z,10,4,2020,3,1,Haiti,HT,HTI,11123176,America,2,30,4
2020-04-11T00:00:00Z,11,4,2020,1,0,Haiti,HT,HTI,11123176,America,2,31,5
2020-04-12T00:00:00Z,12,4,2020,2,0,Haiti,HT,HTI,11123176,America,2,33,6
2020-04-13T00:00:00Z,13,4,2020,0,1,Haiti,HT,HTI,11123176,America,3,33,7
2020-04-14T00:00:00Z,14,4,2020,7,0,Haiti,HT,HTI,11123176,America,3,40,8
2020-04-15T00:00:00Z,15,4,2020,0,0,Haiti,HT,HTI,11123176,America,3,40,9
2020-04-16T00:00:00Z,16,4,2020,1,0,Haiti,HT,HTI,11123176,America,3,41,10
2020-04-17T00:00:00Z,17,4,2020,2,0,Haiti,HT,HTI,11123176,America,3,43,11
2020-04-18T00:00:00Z,18,4,2020,1,0,Haiti,HT,HTI,11123176,America,3,44,12
2020-04-19T00:00:00Z,19,4,2020,0,0,Haiti,HT,HTI,11123176,America,3,44,13
2020-04-20T00:00:00Z,20,4,2020,3,0,Haiti,HT,HTI,11123176,America,3,47,14
2020-04-21T00:00:00Z,21,4,2020,10,0,Haiti,HT,HTI,11123176,America,3,57,15
2020-04-22T00:00:00Z,22,4,2020,1,1,Haiti,HT,HTI,11123176,America,4,58,16
2020-04-23T00:00:00Z,23,4,2020,4,0,Haiti,HT,HTI,11123176,America,4,62,17
2020-04-24T00:00:00Z,24,4,2020,10,1,Haiti,HT,HTI,11123176,America,5,72,18
2020-04-25T00:00:00Z,25,4,2020,0,0,Haiti,HT,HTI,11123176,America,5,72,19
2020-04-26T00:00:00Z,26,4,2020,0,1,Haiti,HT,HTI,11123176,America,6,72,20
2020-04-27T00:00:00Z,27,4,2020,0,0,Haiti,HT,HTI,11123176,America,6,72,21
2020-04-28T00:00:00Z,28,4,2020,4,0,Haiti,HT,HTI,11123176,America,6,76,22
2020-04-29T00:00:00Z,29,4,2020,0,0,Haiti,HT,HTI,11123176,America,6,76,23
2020-04-30T00:00:00Z,30,4,2020,0,0,Haiti,HT,HTI,11123176,America,6,76,24
2020-05-01T00:00:00Z,1,5,2020,5,2,Haiti,HT,HTI,11123176,America,8,81,25
2020-05-02T00:00:00Z,2,5,2020,4,0,Haiti,HT,HTI,11123176,America,8,85,26
2020-05-03T00:00:00Z,3,5,2020,0,0,Haiti,HT,HTI,11123176,America,8,85,27
2020-05-04T00:00:00Z,4,5,2020,0,0,Haiti,HT,HTI,11123176,America,8,85,28
2020-05-05T00:00:00Z,5,5,2020,15,3,Haiti,HT,HTI,11123176,America,11,100,29
2020-05-06T00:00:00Z,6,5,2020,1,1,Haiti,HT,HTI,11123176,America,12,101,30
2020-05-07T00:00:00Z,7,5,2020,7,0,Haiti,HT,HTI,11123176,America,12,108,31
2020-05-08T00:00:00Z,8,5,2020,21,0,Haiti,HT,HTI,11123176,America,12,129,32
2020-05-09T00:00:00Z,9,5,2020,17,0,Haiti,HT,HTI,11123176,America,12,146,33
2020-05-10T00:00:00Z,10,5,2020,5,0,Haiti,HT,HTI,11123176,America,12,151,34
2020-05-11T00:00:00Z,11,5,2020,31,3,Haiti,HT,HTI,11123176,America,15,182,35
2020-05-12T00:00:00Z,12,5,2020,27,1,Haiti,HT,HTI,11123176,America,16,209,36
2020-05-13T00:00:00Z,13,5,2020,10,2,Haiti,HT,HTI,11123176,America,18,219,37
2020-05-14T00:00:00Z,14,5,2020,15,0,Haiti,HT,HTI,11123176,America,18,234,38
2020-05-15T00:00:00Z,15,5,2020,39,2,Haiti,HT,HTI,11123176,America,20,273,39
2020-05-16T00:00:00Z,16,5,2020,37,0,Haiti,HT,HTI,11123176,America,20,310,40
2020-05-17T00:00:00Z,17,5,2020,48,0,Haiti,HT,HTI,11123176,America,20,358,41
2020-05-18T00:00:00Z,18,5,2020,98,0,Haiti,HT,HTI,11123176,America,20,456,42
2020-05-19T00:00:00Z,19,5,2020,77,1,Haiti,HT,HTI,11123176,America,21,533,43
2020-05-20T00:00:00Z,20,5,2020,63,1,Haiti,HT,HTI,11123176,America,22,596,44
2020-05-21T00:00:00Z,21,5,2020,0,0,Haiti,HT,HTI,11123176,America,22,596,45
2020-05-22T00:00:00Z,22,5,2020,138,3,Haiti,HT,HTI,11123176,America,25,734,46
2020-05-23T00:00:00Z,23,5,2020,78,0,Haiti,HT,HTI,11123176,America,25,812,47
2020-05-24T00:00:00Z,24,5,2020,53,1,Haiti,HT,HTI,11123176,America,26,865,48
2020-05-25T00:00:00Z,25,5,2020,93,1,Haiti,HT,HTI,11123176,America,27,958,49
2020-05-26T00:00:00Z,26,5,2020,105,4,Haiti,HT,HTI,11123176,America,31,1063,50
2020-05-27T00:00:00Z,27,5,2020,111,2,Haiti,HT,HTI,11123176,America,33,1174,51
2020-03-27T00:00:00Z,27,3,2020,15,1,Honduras,HN,HND,9587522,America,1,67,1
2020-03-28T00:00:00Z,28,3,2020,28,0,Honduras,HN,HND,9587522,America,1,95,2
2020-03-29T00:00:00Z,29,3,2020,15,1,Honduras,HN,HND,9587522,America,2,110,3
2020-03-30T00:00:00Z,30,3,2020,29,1,Honduras,HN,HND,9587522,America,3,139,4
2020-03-31T00:00:00Z,31,3,2020,2,4,Honduras,HN,HND,9587522,America,7,141,5
2020-04-01T00:00:00Z,1,4,2020,31,3,Honduras,HN,HND,9587522,America,10,172,6
2020-04-02T00:00:00Z,2,4,2020,47,4,Honduras,HN,HND,9587522,America,14,219,7
2020-04-03T00:00:00Z,3,4,2020,3,1,Honduras,HN,HND,9587522,America,15,222,8
2020-04-04T00:00:00Z,4,4,2020,42,0,Honduras,HN,HND,9587522,America,15,264,9
2020-04-05T00:00:00Z,5,4,2020,4,7,Honduras,HN,HND,9587522,America,22,268,10
2020-04-06T00:00:00Z,6,4,2020,30,0,Honduras,HN,HND,9587522,America,22,298,11
2020-04-07T00:00:00Z,7,4,2020,7,0,Honduras,HN,HND,9587522,America,22,305,12
2020-04-08T00:00:00Z,8,4,2020,7,0,Honduras,HN,HND,9587522,America,22,312,13
2020-04-09T00:00:00Z,9,4,2020,31,1,Honduras,HN,HND,9587522,America,23,343,14
2020-04-10T00:00:00Z,10,4,2020,39,0,Honduras,HN,HND,9587522,America,23,382,15
2020-04-11T00:00:00Z,11,4,2020,10,1,Honduras,HN,HND,9587522,America,24,392,16
2020-04-12T00:00:00Z,12,4,2020,1,1,Honduras,HN,HND,9587522,America,25,393,17
2020-04-13T00:00:00Z,13,4,2020,4,0,Honduras,HN,HND,9587522,America,25,397,18
2020-04-14T00:00:00Z,14,4,2020,10,1,Honduras,HN,HND,9587522,America,26,407,19
2020-04-15T00:00:00Z,15,4,2020,12,5,Honduras,HN,HND,9587522,America,31,419,20
2020-04-16T00:00:00Z,16,4,2020,7,4,Honduras,HN,HND,9587522,America,35,426,21
2020-04-17T00:00:00Z,17,4,2020,16,6,Honduras,HN,HND,9587522,America,41,442,22
2020-04-18T00:00:00Z,18,4,2020,15,5,Honduras,HN,HND,9587522,America,46,457,23
2020-04-19T00:00:00Z,19,4,2020,15,0,Honduras,HN,HND,9587522,America,46,472,24
2020-04-20T00:00:00Z,20,4,2020,5,0,Honduras,HN,HND,9587522,America,46,477,25
2020-04-21T00:00:00Z,21,4,2020,17,0,Honduras,HN,HND,9587522,America,46,494,26
2020-04-22T00:00:00Z,22,4,2020,16,0,Honduras,HN,HND,9587522,America,46,510,27
2020-04-23T00:00:00Z,23,4,2020,9,1,Honduras,HN,HND,9587522,America,47,519,28
2020-04-24T00:00:00Z,24,4,2020,0,0,Honduras,HN,HND,9587522,America,47,519,29
2020-04-25T00:00:00Z,25,4,2020,72,0,Honduras,HN,HND,9587522,America,47,591,30
2020-04-26T00:00:00Z,26,4,2020,36,12,Honduras,HN,HND,9587522,America,59,627,31
2020-04-27T00:00:00Z,27,4,2020,34,2,Honduras,HN,HND,9587522,America,61,661,32
2020-04-28T00:00:00Z,28,4,2020,32,0,Honduras,HN,HND,9587522,America,61,693,33
2020-04-29T00:00:00Z,29,4,2020,45,5,Honduras,HN,HND,9587522,America,66,738,34
2020-04-30T00:00:00Z,30,4,2020,33,5,Honduras,HN,HND,9587522,America,71,771,35
2020-05-01T00:00:00Z,1,5,2020,33,4,Honduras,HN,HND,9587522,America,75,804,36
2020-05-02T00:00:00Z,2,5,2020,95,0,Honduras,HN,HND,9587522,America,75,899,37
2020-05-03T00:00:00Z,3,5,2020,111,1,Honduras,HN,HND,9587522,America,76,1010,38
2020-05-04T00:00:00Z,4,5,2020,45,6,Honduras,HN,HND,9587522,America,82,1055,39
2020-05-05T00:00:00Z,5,5,2020,123,0,Honduras,HN,HND,9587522,America,82,1178,40
2020-05-06T00:00:00Z,6,5,2020,92,11,Honduras,HN,HND,9587522,America,93,1270,41
2020-05-07T00:00:00Z,7,5,2020,191,6,Honduras,HN,HND,9587522,America,99,1461,42
2020-05-08T00:00:00Z,8,5,2020,224,6,Honduras,HN,HND,9587522,America,105,1685,43
2020-05-09T00:00:00Z,9,5,2020,86,2,Honduras,HN,HND,9587522,America,107,1771,44
2020-05-10T00:00:00Z,10,5,2020,59,1,Honduras,HN,HND,9587522,America,108,1830,45
2020-05-11T00:00:00Z,11,5,2020,142,0,Honduras,HN,HND,9587522,America,108,1972,46
2020-05-12T00:00:00Z,12,5,2020,34,8,Honduras,HN,HND,9587522,America,116,2006,47
2020-05-13T00:00:00Z,13,5,2020,74,5,Honduras,HN,HND,9587522,America,121,2080,48
2020-05-14T00:00:00Z,14,5,2020,175,2,Honduras,HN,HND,9587522,America,123,2255,49
2020-05-15T00:00:00Z,15,5,2020,63,10,Honduras,HN,HND,9587522,America,133,2318,50
2020-05-16T00:00:00Z,16,5,2020,142,1,Honduras,HN,HND,9587522,America,134,2460,51
2020-05-17T00:00:00Z,17,5,2020,105,4,Honduras,HN,HND,9587522,America,138,2565,52
2020-05-18T00:00:00Z,18,5,2020,81,4,Honduras,HN,HND,9587522,America,142,2646,53
2020-05-19T00:00:00Z,19,5,2020,152,4,Honduras,HN,HND,9587522,America,146,2798,54
2020-05-20T00:00:00Z,20,5,2020,157,1,Honduras,HN,HND,9587522,America,147,2955,55
2020-05-21T00:00:00Z,21,5,2020,145,4,Honduras,HN,HND,9587522,America,151,3100,56
2020-05-22T00:00:00Z,22,5,2020,104,5,Honduras,HN,HND,9587522,America,156,3204,57
2020-05-23T00:00:00Z,23,5,2020,273,11,Honduras,HN,HND,9587522,America,167,3477,58
2020-05-24T00:00:00Z,24,5,2020,266,7,Honduras,HN,HND,9587522,America,174,3743,59
2020-05-25T00:00:00Z,25,5,2020,207,6,Honduras,HN,HND,9587522,America,180,3950,60
2020-05-26T00:00:00Z,26,5,2020,239,2,Honduras,HN,HND,9587522,America,182,4189,61
2020-05-27T00:00:00Z,27,5,2020,212,6,Honduras,HN,HND,9587522,America,188,4401,62
2020-03-16T00:00:00Z,16,3,2020,8,1,Hungary,HU,HUN,9768785,Europe,1,39,1
2020-03-17T00:00:00Z,17,3,2020,11,0,Hungary,HU,HUN,9768785,Europe,1,50,2
2020-03-18T00:00:00Z,18,3,2020,0,0,Hungary,HU,HUN,9768785,Europe,1,50,3
2020-03-19T00:00:00Z,19,3,2020,23,0,Hungary,HU,HUN,9768785,Europe,1,73,4
2020-03-20T00:00:00Z,20,3,2020,12,0,Hungary,HU,HUN,9768785,Europe,1,85,5
2020-03-21T00:00:00Z,21,3,2020,18,3,Hungary,HU,HUN,9768785,Europe,4,103,6
2020-03-22T00:00:00Z,22,3,2020,28,0,Hungary,HU,HUN,9768785,Europe,4,131,7
2020-03-23T00:00:00Z,23,3,2020,36,3,Hungary,HU,HUN,9768785,Europe,7,167,8
2020-03-24T00:00:00Z,24,3,2020,20,1,Hungary,HU,HUN,9768785,Europe,8,187,9
2020-03-25T00:00:00Z,25,3,2020,39,2,Hungary,HU,HUN,9768785,Europe,10,226,10
2020-03-26T00:00:00Z,26,3,2020,35,0,Hungary,HU,HUN,9768785,Europe,10,261,11
2020-03-27T00:00:00Z,27,3,2020,39,0,Hungary,HU,HUN,9768785,Europe,10,300,12
2020-03-28T00:00:00Z,28,3,2020,43,1,Hungary,HU,HUN,9768785,Europe,11,343,13
2020-03-29T00:00:00Z,29,3,2020,65,2,Hungary,HU,HUN,9768785,Europe,13,408,14
2020-03-30T00:00:00Z,30,3,2020,39,2,Hungary,HU,HUN,9768785,Europe,15,447,15
2020-03-31T00:00:00Z,31,3,2020,45,1,Hungary,HU,HUN,9768785,Europe,16,492,16
2020-04-01T00:00:00Z,1,4,2020,33,4,Hungary,HU,HUN,9768785,Europe,20,525,17
2020-04-02T00:00:00Z,2,4,2020,60,1,Hungary,HU,HUN,9768785,Europe,21,585,18
2020-04-03T00:00:00Z,3,4,2020,38,5,Hungary,HU,HUN,9768785,Europe,26,623,19
2020-04-04T00:00:00Z,4,4,2020,55,6,Hungary,HU,HUN,9768785,Europe,32,678,20
2020-04-05T00:00:00Z,5,4,2020,55,2,Hungary,HU,HUN,9768785,Europe,34,733,21
2020-04-06T00:00:00Z,6,4,2020,11,4,Hungary,HU,HUN,9768785,Europe,38,744,22
2020-04-07T00:00:00Z,7,4,2020,73,9,Hungary,HU,HUN,9768785,Europe,47,817,23
2020-04-08T00:00:00Z,8,4,2020,78,11,Hungary,HU,HUN,9768785,Europe,58,895,24
2020-04-09T00:00:00Z,9,4,2020,85,8,Hungary,HU,HUN,9768785,Europe,66,980,25
2020-04-10T00:00:00Z,10,4,2020,210,11,Hungary,HU,HUN,9768785,Europe,77,1190,26
2020-04-11T00:00:00Z,11,4,2020,120,8,Hungary,HU,HUN,9768785,Europe,85,1310,27
2020-04-12T00:00:00Z,12,4,2020,100,14,Hungary,HU,HUN,9768785,Europe,99,1410,28
2020-04-13T00:00:00Z,13,4,2020,48,10,Hungary,HU,HUN,9768785,Europe,109,1458,29
2020-04-14T00:00:00Z,14,4,2020,54,13,Hungary,HU,HUN,9768785,Europe,122,1512,30
2020-04-15T00:00:00Z,15,4,2020,67,12,Hungary,HU,HUN,9768785,Europe,134,1579,31
2020-04-16T00:00:00Z,16,4,2020,73,8,Hungary,HU,HUN,9768785,Europe,142,1652,32
2020-04-17T00:00:00Z,17,4,2020,111,14,Hungary,HU,HUN,9768785,Europe,156,1763,33
2020-04-18T00:00:00Z,18,4,2020,71,16,Hungary,HU,HUN,9768785,Europe,172,1834,34
2020-04-19T00:00:00Z,19,4,2020,82,17,Hungary,HU,HUN,9768785,Europe,189,1916,35
2020-04-20T00:00:00Z,20,4,2020,68,10,Hungary,HU,HUN,9768785,Europe,199,1984,36
2020-04-21T00:00:00Z,21,4,2020,114,14,Hungary,HU,HUN,9768785,Europe,213,2098,37
2020-04-22T00:00:00Z,22,4,2020,70,12,Hungary,HU,HUN,9768785,Europe,225,2168,38
2020-04-23T00:00:00Z,23,4,2020,116,0,Hungary,HU,HUN,9768785,Europe,225,2284,39
2020-04-24T00:00:00Z,24,4,2020,99,25,Hungary,HU,HUN,9768785,Europe,250,2383,40
2020-04-25T00:00:00Z,25,4,2020,60,12,Hungary,HU,HUN,9768785,Europe,262,2443,41
2020-04-26T00:00:00Z,26,4,2020,57,10,Hungary,HU,HUN,9768785,Europe,272,2500,42
2020-04-27T00:00:00Z,27,4,2020,83,8,Hungary,HU,HUN,9768785,Europe,280,2583,43
2020-04-28T00:00:00Z,28,4,2020,66,11,Hungary,HU,HUN,9768785,Europe,291,2649,44
2020-04-29T00:00:00Z,29,4,2020,78,9,Hungary,HU,HUN,9768785,Europe,300,2727,45
2020-04-30T00:00:00Z,30,4,2020,48,12,Hungary,HU,HUN,9768785,Europe,312,2775,46
2020-05-01T00:00:00Z,1,5,2020,88,11,Hungary,HU,HUN,9768785,Europe,323,2863,47
2020-05-02T00:00:00Z,2,5,2020,79,12,Hungary,HU,HUN,9768785,Europe,335,2942,48
2020-05-03T00:00:00Z,3,5,2020,56,5,Hungary,HU,HUN,9768785,Europe,340,2998,49
2020-05-04T00:00:00Z,4,5,2020,37,11,Hungary,HU,HUN,9768785,Europe,351,3035,50
2020-05-05T00:00:00Z,5,5,2020,30,12,Hungary,HU,HUN,9768785,Europe,363,3065,51
2020-05-06T00:00:00Z,6,5,2020,46,10,Hungary,HU,HUN,9768785,Europe,373,3111,52
2020-05-07T00:00:00Z,7,5,2020,39,10,Hungary,HU,HUN,9768785,Europe,383,3150,53
2020-05-08T00:00:00Z,8,5,2020,28,9,Hungary,HU,HUN,9768785,Europe,392,3178,54
2020-05-09T00:00:00Z,9,5,2020,35,13,Hungary,HU,HUN,9768785,Europe,405,3213,55
2020-05-10T00:00:00Z,10,5,2020,50,8,Hungary,HU,HUN,9768785,Europe,413,3263,56
2020-05-11T00:00:00Z,11,5,2020,21,8,Hungary,HU,HUN,9768785,Europe,421,3284,57
2020-05-12T00:00:00Z,12,5,2020,29,4,Hungary,HU,HUN,9768785,Europe,425,3313,58
2020-05-13T00:00:00Z,13,5,2020,28,5,Hungary,HU,HUN,9768785,Europe,430,3341,59
2020-05-14T00:00:00Z,14,5,2020,39,6,Hungary,HU,HUN,9768785,Europe,436,3380,60
2020-05-15T00:00:00Z,15,5,2020,37,6,Hungary,HU,HUN,9768785,Europe,442,3417,61
2020-05-16T00:00:00Z,16,5,2020,56,6,Hungary,HU,HUN,9768785,Europe,448,3473,62
2020-05-17T00:00:00Z,17,5,2020,36,3,Hungary,HU,HUN,9768785,Europe,451,3509,63
2020-05-18T00:00:00Z,18,5,2020,26,11,Hungary,HU,HUN,9768785,Europe,462,3535,64
2020-05-19T00:00:00Z,19,5,2020,21,5,Hungary,HU,HUN,9768785,Europe,467,3556,65
2020-05-20T00:00:00Z,20,5,2020,42,3,Hungary,HU,HUN,9768785,Europe,470,3598,66
2020-05-21T00:00:00Z,21,5,2020,43,3,Hungary,HU,HUN,9768785,Europe,473,3641,67
2020-05-22T00:00:00Z,22,5,2020,37,3,Hungary,HU,HUN,9768785,Europe,476,3678,68
2020-05-23T00:00:00Z,23,5,2020,35,6,Hungary,HU,HUN,9768785,Europe,482,3713,69
2020-05-24T00:00:00Z,24,5,2020,28,4,Hungary,HU,HUN,9768785,Europe,486,3741,70
2020-05-25T00:00:00Z,25,5,2020,15,5,Hungary,HU,HUN,9768785,Europe,491,3756,71
2020-05-26T00:00:00Z,26,5,2020,15,8,Hungary,HU,HUN,9768785,Europe,499,3771,72
2020-05-27T00:00:00Z,27,5,2020,22,6,Hungary,HU,HUN,9768785,Europe,505,3793,73
2020-03-20T00:00:00Z,20,3,2020,80,1,Iceland,IS,ISL,353574,Europe,1,330,1
2020-03-21T00:00:00Z,21,3,2020,79,0,Iceland,IS,ISL,353574,Europe,1,409,2
2020-03-22T00:00:00Z,22,3,2020,64,0,Iceland,IS,ISL,353574,Europe,1,473,3
2020-03-23T00:00:00Z,23,3,2020,95,0,Iceland,IS,ISL,353574,Europe,1,568,4
2020-03-24T00:00:00Z,24,3,2020,20,1,Iceland,IS,ISL,353574,Europe,2,588,5
2020-03-25T00:00:00Z,25,3,2020,60,0,Iceland,IS,ISL,353574,Europe,2,648,6
2020-03-26T00:00:00Z,26,3,2020,89,0,Iceland,IS,ISL,353574,Europe,2,737,7
2020-03-27T00:00:00Z,27,3,2020,65,0,Iceland,IS,ISL,353574,Europe,2,802,8
2020-03-28T00:00:00Z,28,3,2020,88,0,Iceland,IS,ISL,353574,Europe,2,890,9
2020-03-29T00:00:00Z,29,3,2020,73,0,Iceland,IS,ISL,353574,Europe,2,963,10
2020-03-30T00:00:00Z,30,3,2020,57,0,Iceland,IS,ISL,353574,Europe,2,1020,11
2020-03-31T00:00:00Z,31,3,2020,66,0,Iceland,IS,ISL,353574,Europe,2,1086,12
2020-04-01T00:00:00Z,1,4,2020,49,0,Iceland,IS,ISL,353574,Europe,2,1135,13
2020-04-02T00:00:00Z,2,4,2020,85,0,Iceland,IS,ISL,353574,Europe,2,1220,14
2020-04-03T00:00:00Z,3,4,2020,99,2,Iceland,IS,ISL,353574,Europe,4,1319,15
2020-04-04T00:00:00Z,4,4,2020,45,0,Iceland,IS,ISL,353574,Europe,4,1364,16
2020-04-05T00:00:00Z,5,4,2020,53,0,Iceland,IS,ISL,353574,Europe,4,1417,17
2020-04-06T00:00:00Z,6,4,2020,69,0,Iceland,IS,ISL,353574,Europe,4,1486,18
2020-04-07T00:00:00Z,7,4,2020,76,2,Iceland,IS,ISL,353574,Europe,6,1562,19
2020-04-08T00:00:00Z,8,4,2020,24,0,Iceland,IS,ISL,353574,Europe,6,1586,20
2020-04-09T00:00:00Z,9,4,2020,30,0,Iceland,IS,ISL,353574,Europe,6,1616,21
2020-04-10T00:00:00Z,10,4,2020,32,0,Iceland,IS,ISL,353574,Europe,6,1648,22
2020-04-11T00:00:00Z,11,4,2020,27,1,Iceland,IS,ISL,353574,Europe,7,1675,23
2020-04-12T00:00:00Z,12,4,2020,14,1,Iceland,IS,ISL,353574,Europe,8,1689,24
2020-04-13T00:00:00Z,13,4,2020,12,0,Iceland,IS,ISL,353574,Europe,8,1701,25
2020-04-14T00:00:00Z,14,4,2020,10,0,Iceland,IS,ISL,353574,Europe,8,1711,26
2020-04-15T00:00:00Z,15,4,2020,9,0,Iceland,IS,ISL,353574,Europe,8,1720,27
2020-04-16T00:00:00Z,16,4,2020,7,0,Iceland,IS,ISL,353574,Europe,8,1727,28
2020-04-17T00:00:00Z,17,4,2020,12,0,Iceland,IS,ISL,353574,Europe,8,1739,29
2020-04-18T00:00:00Z,18,4,2020,15,0,Iceland,IS,ISL,353574,Europe,8,1754,30
2020-04-19T00:00:00Z,19,4,2020,6,1,Iceland,IS,ISL,353574,Europe,9,1760,31
2020-04-20T00:00:00Z,20,4,2020,11,0,Iceland,IS,ISL,353574,Europe,9,1771,32
2020-04-21T00:00:00Z,21,4,2020,2,1,Iceland,IS,ISL,353574,Europe,10,1773,33
2020-04-22T00:00:00Z,22,4,2020,5,0,Iceland,IS,ISL,353574,Europe,10,1778,34
2020-04-23T00:00:00Z,23,4,2020,7,0,Iceland,IS,ISL,353574,Europe,10,1785,35
2020-04-24T00:00:00Z,24,4,2020,4,0,Iceland,IS,ISL,353574,Europe,10,1789,36
2020-04-25T00:00:00Z,25,4,2020,0,0,Iceland,IS,ISL,353574,Europe,10,1789,37
2020-04-26T00:00:00Z,26,4,2020,1,0,Iceland,IS,ISL,353574,Europe,10,1790,38
2020-04-27T00:00:00Z,27,4,2020,2,0,Iceland,IS,ISL,353574,Europe,10,1792,39
2020-04-28T00:00:00Z,28,4,2020,0,0,Iceland,IS,ISL,353574,Europe,10,1792,40
2020-04-29T00:00:00Z,29,4,2020,3,0,Iceland,IS,ISL,353574,Europe,10,1795,41
2020-04-30T00:00:00Z,30,4,2020,2,0,Iceland,IS,ISL,353574,Europe,10,1797,42
2020-05-01T00:00:00Z,1,5,2020,0,0,Iceland,IS,ISL,353574,Europe,10,1797,43
2020-05-02T00:00:00Z,2,5,2020,1,0,Iceland,IS,ISL,353574,Europe,10,1798,44
2020-05-03T00:00:00Z,3,5,2020,0,0,Iceland,IS,ISL,353574,Europe,10,1798,45
2020-05-04T00:00:00Z,4,5,2020,1,0,Iceland,IS,ISL,353574,Europe,10,1799,46
2020-05-05T00:00:00Z,5,5,2020,0,0,Iceland,IS,ISL,353574,Europe,10,1799,47
2020-05-06T00:00:00Z,6,5,2020,0,0,Iceland,IS,ISL,353574,Europe,10,1799,48
2020-05-07T00:00:00Z,7,5,2020,0,0,Iceland,IS,ISL,353574,Europe,10,1799,49
2020-05-08T00:00:00Z,8,5,2020,2,0,Iceland,IS,ISL,353574,Europe,10,1801,50
2020-05-09T00:00:00Z,9,5,2020,0,0,Iceland,IS,ISL,353574,Europe,10,1801,51
2020-05-10T00:00:00Z,10,5,2020,0,0,Iceland,IS,ISL,353574,Europe,10,1801,52
2020-05-11T00:00:00Z,11,5,2020,0,0,Iceland,IS,ISL,353574,Europe,10,1801,53
2020-05-12T00:00:00Z,12,5,2020,0,0,Iceland,IS,ISL,353574,Europe,10,1801,54
2020-05-13T00:00:00Z,13,5,2020,0,0,Iceland,IS,ISL,353574,Europe,10,1801,55
2020-05-14T00:00:00Z,14,5,2020,1,0,Iceland,IS,ISL,353574,Europe,10,1802,56
2020-05-15T00:00:00Z,15,5,2020,0,0,Iceland,IS,ISL,353574,Europe,10,1802,57
2020-05-16T00:00:00Z,16,5,2020,0,0,Iceland,IS,ISL,353574,Europe,10,1802,58
2020-05-17T00:00:00Z,17,5,2020,0,0,Iceland,IS,ISL,353574,Europe,10,1802,59
2020-05-18T00:00:00Z,18,5,2020,0,0,Iceland,IS,ISL,353574,Europe,10,1802,60
2020-05-19T00:00:00Z,19,5,2020,0,0,Iceland,IS,ISL,353574,Europe,10,1802,61
2020-05-20T00:00:00Z,20,5,2020,0,0,Iceland,IS,ISL,353574,Europe,10,1802,62
2020-05-21T00:00:00Z,21,5,2020,1,0,Iceland,IS,ISL,353574,Europe,10,1803,63
2020-05-22T00:00:00Z,22,5,2020,0,0,Iceland,IS,ISL,353574,Europe,10,1803,64
2020-05-23T00:00:00Z,23,5,2020,0,0,Iceland,IS,ISL,353574,Europe,10,1803,65
2020-05-24T00:00:00Z,24,5,2020,1,0,Iceland,IS,ISL,353574,Europe,10,1804,66
2020-05-25T00:00:00Z,25,5,2020,0,0,Iceland,IS,ISL,353574,Europe,10,1804,67
2020-05-26T00:00:00Z,26,5,2020,0,0,Iceland,IS,ISL,353574,Europe,10,1804,68
2020-05-27T00:00:00Z,27,5,2020,0,0,Iceland,IS,ISL,353574,Europe,10,1804,69
2020-03-13T00:00:00Z,13,3,2020,2,1,India,IN,IND,1352617328,Asia,1,75,1
2020-03-14T00:00:00Z,14,3,2020,8,1,India,IN,IND,1352617328,Asia,2,83,2
2020-03-15T00:00:00Z,15,3,2020,7,0,India,IN,IND,1352617328,Asia,2,90,3
2020-03-16T00:00:00Z,16,3,2020,3,0,India,IN,IND,1352617328,Asia,2,93,4
2020-03-17T00:00:00Z,17,3,2020,32,1,India,IN,IND,1352617328,Asia,3,125,5
2020-03-18T00:00:00Z,18,3,2020,12,0,India,IN,IND,1352617328,Asia,3,137,6
2020-03-19T00:00:00Z,19,3,2020,28,0,India,IN,IND,1352617328,Asia,3,165,7
2020-03-20T00:00:00Z,20,3,2020,26,1,India,IN,IND,1352617328,Asia,4,191,8
2020-03-21T00:00:00Z,21,3,2020,40,0,India,IN,IND,1352617328,Asia,4,231,9
2020-03-22T00:00:00Z,22,3,2020,89,0,India,IN,IND,1352617328,Asia,4,320,10
2020-03-23T00:00:00Z,23,3,2020,119,3,India,IN,IND,1352617328,Asia,7,439,11
2020-03-24T00:00:00Z,24,3,2020,53,2,India,IN,IND,1352617328,Asia,9,492,12
2020-03-25T00:00:00Z,25,3,2020,70,0,India,IN,IND,1352617328,Asia,9,562,13
2020-03-26T00:00:00Z,26,3,2020,87,4,India,IN,IND,1352617328,Asia,13,649,14
2020-03-27T00:00:00Z,27,3,2020,75,4,India,IN,IND,1352617328,Asia,17,724,15
2020-03-28T00:00:00Z,28,3,2020,149,2,India,IN,IND,1352617328,Asia,19,873,16
2020-03-29T00:00:00Z,29,3,2020,106,6,India,IN,IND,1352617328,Asia,25,979,17
2020-03-30T00:00:00Z,30,3,2020,92,4,India,IN,IND,1352617328,Asia,29,1071,18
2020-03-31T00:00:00Z,31,3,2020,180,3,India,IN,IND,1352617328,Asia,32,1251,19
2020-04-01T00:00:00Z,1,4,2020,146,3,India,IN,IND,1352617328,Asia,35,1397,20
2020-04-02T00:00:00Z,2,4,2020,568,15,India,IN,IND,1352617328,Asia,50,1965,21
2020-04-03T00:00:00Z,3,4,2020,336,6,India,IN,IND,1352617328,Asia,56,2301,22
2020-04-04T00:00:00Z,4,4,2020,601,12,India,IN,IND,1352617328,Asia,68,2902,23
2020-04-05T00:00:00Z,5,4,2020,472,9,India,IN,IND,1352617328,Asia,77,3374,24
2020-04-06T00:00:00Z,6,4,2020,693,32,India,IN,IND,1352617328,Asia,109,4067,25
2020-04-07T00:00:00Z,7,4,2020,354,5,India,IN,IND,1352617328,Asia,114,4421,26
2020-04-08T00:00:00Z,8,4,2020,773,35,India,IN,IND,1352617328,Asia,149,5194,27
2020-04-09T00:00:00Z,9,4,2020,540,17,India,IN,IND,1352617328,Asia,166,5734,28
2020-04-10T00:00:00Z,10,4,2020,678,33,India,IN,IND,1352617328,Asia,199,6412,29
2020-04-11T00:00:00Z,11,4,2020,1035,40,India,IN,IND,1352617328,Asia,239,7447,30
2020-04-12T00:00:00Z,12,4,2020,909,34,India,IN,IND,1352617328,Asia,273,8356,31
2020-04-13T00:00:00Z,13,4,2020,796,35,India,IN,IND,1352617328,Asia,308,9152,32
2020-04-14T00:00:00Z,14,4,2020,1211,31,India,IN,IND,1352617328,Asia,339,10363,33
2020-04-15T00:00:00Z,15,4,2020,1075,38,India,IN,IND,1352617328,Asia,377,11438,34
2020-04-16T00:00:00Z,16,4,2020,942,37,India,IN,IND,1352617328,Asia,414,12380,35
2020-04-17T00:00:00Z,17,4,2020,1007,23,India,IN,IND,1352617328,Asia,437,13387,36
2020-04-18T00:00:00Z,18,4,2020,991,43,India,IN,IND,1352617328,Asia,480,14378,37
2020-04-19T00:00:00Z,19,4,2020,1334,27,India,IN,IND,1352617328,Asia,507,15712,38
2020-04-20T00:00:00Z,20,4,2020,1553,36,India,IN,IND,1352617328,Asia,543,17265,39
2020-04-21T00:00:00Z,21,4,2020,1335,47,India,IN,IND,1352617328,Asia,590,18600,40
2020-04-22T00:00:00Z,22,4,2020,1384,50,India,IN,IND,1352617328,Asia,640,19984,41
2020-04-23T00:00:00Z,23,4,2020,1409,41,India,IN,IND,1352617328,Asia,681,21393,42
2020-04-24T00:00:00Z,24,4,2020,1684,37,India,IN,IND,1352617328,Asia,718,23077,43
2020-04-25T00:00:00Z,25,4,2020,1429,57,India,IN,IND,1352617328,Asia,775,24506,44
2020-04-26T00:00:00Z,26,4,2020,1990,49,India,IN,IND,1352617328,Asia,824,26496,45
2020-04-27T00:00:00Z,27,4,2020,1396,48,India,IN,IND,1352617328,Asia,872,27892,46
2020-04-28T00:00:00Z,28,4,2020,1543,62,India,IN,IND,1352617328,Asia,934,29435,47
2020-04-29T00:00:00Z,29,4,2020,1897,73,India,IN,IND,1352617328,Asia,1007,31332,48
2020-04-30T00:00:00Z,30,4,2020,1718,67,India,IN,IND,1352617328,Asia,1074,33050,49
2020-05-01T00:00:00Z,1,5,2020,1993,73,India,IN,IND,1352617328,Asia,1147,35043,50
2020-05-02T00:00:00Z,2,5,2020,2293,71,India,IN,IND,1352617328,Asia,1218,37336,51
2020-05-03T00:00:00Z,3,5,2020,2644,83,India,IN,IND,1352617328,Asia,1301,39980,52
2020-05-04T00:00:00Z,4,5,2020,2553,72,India,IN,IND,1352617328,Asia,1373,42533,53
2020-05-05T00:00:00Z,5,5,2020,3900,195,India,IN,IND,1352617328,Asia,1568,46433,54
2020-05-06T00:00:00Z,6,5,2020,2958,126,India,IN,IND,1352617328,Asia,1694,49391,55
2020-05-07T00:00:00Z,7,5,2020,3561,89,India,IN,IND,1352617328,Asia,1783,52952,56
2020-05-08T00:00:00Z,8,5,2020,3390,103,India,IN,IND,1352617328,Asia,1886,56342,57
2020-05-09T00:00:00Z,9,5,2020,3320,95,India,IN,IND,1352617328,Asia,1981,59662,58
2020-05-10T00:00:00Z,10,5,2020,3277,128,India,IN,IND,1352617328,Asia,2109,62939,59
2020-05-11T00:00:00Z,11,5,2020,4213,97,India,IN,IND,1352617328,Asia,2206,67152,60
2020-05-12T00:00:00Z,12,5,2020,3604,87,India,IN,IND,1352617328,Asia,2293,70756,61
2020-05-13T00:00:00Z,13,5,2020,3525,122,India,IN,IND,1352617328,Asia,2415,74281,62
2020-05-14T00:00:00Z,14,5,2020,3722,134,India,IN,IND,1352617328,Asia,2549,78003,63
2020-05-15T00:00:00Z,15,5,2020,3967,100,India,IN,IND,1352617328,Asia,2649,81970,64
2020-05-16T00:00:00Z,16,5,2020,3970,103,India,IN,IND,1352617328,Asia,2752,85940,65
2020-05-17T00:00:00Z,17,5,2020,4987,120,India,IN,IND,1352617328,Asia,2872,90927,66
2020-05-18T00:00:00Z,18,5,2020,5242,157,India,IN,IND,1352617328,Asia,3029,96169,67
2020-05-19T00:00:00Z,19,5,2020,4970,134,India,IN,IND,1352617328,Asia,3163,101139,68
2020-05-20T00:00:00Z,20,5,2020,5611,140,India,IN,IND,1352617328,Asia,3303,106750,69
2020-05-21T00:00:00Z,21,5,2020,5609,132,India,IN,IND,1352617328,Asia,3435,112359,70
2020-05-22T00:00:00Z,22,5,2020,6088,148,India,IN,IND,1352617328,Asia,3583,118447,71
2020-05-23T00:00:00Z,23,5,2020,6654,137,India,IN,IND,1352617328,Asia,3720,125101,72
2020-05-24T00:00:00Z,24,5,2020,6767,147,India,IN,IND,1352617328,Asia,3867,131868,73
2020-05-25T00:00:00Z,25,5,2020,6977,154,India,IN,IND,1352617328,Asia,4021,138845,74
2020-05-26T00:00:00Z,26,5,2020,6535,146,India,IN,IND,1352617328,Asia,4167,145380,75
2020-05-27T00:00:00Z,27,5,2020,6387,170,India,IN,IND,1352617328,Asia,4337,151767,76
2020-03-12T00:00:00Z,12,3,2020,15,1,Indonesia,ID,IDN,267663435,Asia,1,34,1
2020-03-14T00:00:00Z,14,3,2020,35,3,Indonesia,ID,IDN,267663435,Asia,4,69,2
2020-03-15T00:00:00Z,15,3,2020,27,0,Indonesia,ID,IDN,267663435,Asia,4,96,3
2020-03-16T00:00:00Z,16,3,2020,21,1,Indonesia,ID,IDN,267663435,Asia,5,117,4
2020-03-17T00:00:00Z,17,3,2020,17,0,Indonesia,ID,IDN,267663435,Asia,5,134,5
2020-03-18T00:00:00Z,18,3,2020,38,0,Indonesia,ID,IDN,267663435,Asia,5,172,6
2020-03-19T00:00:00Z,19,3,2020,0,0,Indonesia,ID,IDN,267663435,Asia,5,172,7
2020-03-20T00:00:00Z,20,3,2020,55,14,Indonesia,ID,IDN,267663435,Asia,19,227,8
2020-03-21T00:00:00Z,21,3,2020,82,6,Indonesia,ID,IDN,267663435,Asia,25,309,9
2020-03-22T00:00:00Z,22,3,2020,141,13,Indonesia,ID,IDN,267663435,Asia,38,450,10
2020-03-23T00:00:00Z,23,3,2020,64,10,Indonesia,ID,IDN,267663435,Asia,48,514,11
2020-03-24T00:00:00Z,24,3,2020,65,1,Indonesia,ID,IDN,267663435,Asia,49,579,12
2020-03-25T00:00:00Z,25,3,2020,107,6,Indonesia,ID,IDN,267663435,Asia,55,686,13
2020-03-26T00:00:00Z,26,3,2020,104,3,Indonesia,ID,IDN,267663435,Asia,58,790,14
2020-03-27T00:00:00Z,27,3,2020,103,20,Indonesia,ID,IDN,267663435,Asia,78,893,15
2020-03-28T00:00:00Z,28,3,2020,153,9,Indonesia,ID,IDN,267663435,Asia,87,1046,16
2020-03-29T00:00:00Z,29,3,2020,109,15,Indonesia,ID,IDN,267663435,Asia,102,1155,17
2020-03-30T00:00:00Z,30,3,2020,130,12,Indonesia,ID,IDN,267663435,Asia,114,1285,18
2020-03-31T00:00:00Z,31,3,2020,129,8,Indonesia,ID,IDN,267663435,Asia,122,1414,19
2020-04-01T00:00:00Z,1,4,2020,114,14,Indonesia,ID,IDN,267663435,Asia,136,1528,20
2020-04-02T00:00:00Z,2,4,2020,149,21,Indonesia,ID,IDN,267663435,Asia,157,1677,21
2020-04-03T00:00:00Z,3,4,2020,113,13,Indonesia,ID,IDN,267663435,Asia,170,1790,22
2020-04-04T00:00:00Z,4,4,2020,196,11,Indonesia,ID,IDN,267663435,Asia,181,1986,23
2020-04-05T00:00:00Z,5,4,2020,106,10,Indonesia,ID,IDN,267663435,Asia,191,2092,24
2020-04-06T00:00:00Z,6,4,2020,181,7,Indonesia,ID,IDN,267663435,Asia,198,2273,25
2020-04-07T00:00:00Z,7,4,2020,218,11,Indonesia,ID,IDN,267663435,Asia,209,2491,26
2020-04-08T00:00:00Z,8,4,2020,247,12,Indonesia,ID,IDN,267663435,Asia,221,2738,27
2020-04-09T00:00:00Z,9,4,2020,218,19,Indonesia,ID,IDN,267663435,Asia,240,2956,28
2020-04-10T00:00:00Z,10,4,2020,337,40,Indonesia,ID,IDN,267663435,Asia,280,3293,29
2020-04-11T00:00:00Z,11,4,2020,219,26,Indonesia,ID,IDN,267663435,Asia,306,3512,30
2020-04-12T00:00:00Z,12,4,2020,330,21,Indonesia,ID,IDN,267663435,Asia,327,3842,31
2020-04-13T00:00:00Z,13,4,2020,399,46,Indonesia,ID,IDN,267663435,Asia,373,4241,32
2020-04-14T00:00:00Z,14,4,2020,316,26,Indonesia,ID,IDN,267663435,Asia,399,4557,33
2020-04-15T00:00:00Z,15,4,2020,282,60,Indonesia,ID,IDN,267663435,Asia,459,4839,34
2020-04-16T00:00:00Z,16,4,2020,297,10,Indonesia,ID,IDN,267663435,Asia,469,5136,35
2020-04-17T00:00:00Z,17,4,2020,380,27,Indonesia,ID,IDN,267663435,Asia,496,5516,36
2020-04-18T00:00:00Z,18,4,2020,407,24,Indonesia,ID,IDN,267663435,Asia,520,5923,37
2020-04-19T00:00:00Z,19,4,2020,325,15,Indonesia,ID,IDN,267663435,Asia,535,6248,38
2020-04-20T00:00:00Z,20,4,2020,327,47,Indonesia,ID,IDN,267663435,Asia,582,6575,39
2020-04-21T00:00:00Z,21,4,2020,185,8,Indonesia,ID,IDN,267663435,Asia,590,6760,40
2020-04-22T00:00:00Z,22,4,2020,375,26,Indonesia,ID,IDN,267663435,Asia,616,7135,41
2020-04-23T00:00:00Z,23,4,2020,283,19,Indonesia,ID,IDN,267663435,Asia,635,7418,42
2020-04-24T00:00:00Z,24,4,2020,357,12,Indonesia,ID,IDN,267663435,Asia,647,7775,43
2020-04-25T00:00:00Z,25,4,2020,436,42,Indonesia,ID,IDN,267663435,Asia,689,8211,44
2020-04-26T00:00:00Z,26,4,2020,396,31,Indonesia,ID,IDN,267663435,Asia,720,8607,45
2020-04-27T00:00:00Z,27,4,2020,275,23,Indonesia,ID,IDN,267663435,Asia,743,8882,46
2020-04-28T00:00:00Z,28,4,2020,214,22,Indonesia,ID,IDN,267663435,Asia,765,9096,47
2020-04-29T00:00:00Z,29,4,2020,415,8,Indonesia,ID,IDN,267663435,Asia,773,9511,48
2020-04-30T00:00:00Z,30,4,2020,260,11,Indonesia,ID,IDN,267663435,Asia,784,9771,49
2020-05-01T00:00:00Z,1,5,2020,347,8,Indonesia,ID,IDN,267663435,Asia,792,10118,50
2020-05-02T00:00:00Z,2,5,2020,433,8,Indonesia,ID,IDN,267663435,Asia,800,10551,51
2020-05-03T00:00:00Z,3,5,2020,292,31,Indonesia,ID,IDN,267663435,Asia,831,10843,52
2020-05-04T00:00:00Z,4,5,2020,349,14,Indonesia,ID,IDN,267663435,Asia,845,11192,53
2020-05-05T00:00:00Z,5,5,2020,395,19,Indonesia,ID,IDN,267663435,Asia,864,11587,54
2020-05-06T00:00:00Z,6,5,2020,484,8,Indonesia,ID,IDN,267663435,Asia,872,12071,55
2020-05-07T00:00:00Z,7,5,2020,367,23,Indonesia,ID,IDN,267663435,Asia,895,12438,56
2020-05-08T00:00:00Z,8,5,2020,338,35,Indonesia,ID,IDN,267663435,Asia,930,12776,57
2020-05-09T00:00:00Z,9,5,2020,336,13,Indonesia,ID,IDN,267663435,Asia,943,13112,58
2020-05-10T00:00:00Z,10,5,2020,533,16,Indonesia,ID,IDN,267663435,Asia,959,13645,59
2020-05-11T00:00:00Z,11,5,2020,387,14,Indonesia,ID,IDN,267663435,Asia,973,14032,60
2020-05-12T00:00:00Z,12,5,2020,233,18,Indonesia,ID,IDN,267663435,Asia,991,14265,61
2020-05-13T00:00:00Z,13,5,2020,484,16,Indonesia,ID,IDN,267663435,Asia,1007,14749,62
2020-05-14T00:00:00Z,14,5,2020,689,21,Indonesia,ID,IDN,267663435,Asia,1028,15438,63
2020-05-15T00:00:00Z,15,5,2020,568,15,Indonesia,ID,IDN,267663435,Asia,1043,16006,64
2020-05-16T00:00:00Z,16,5,2020,490,33,Indonesia,ID,IDN,267663435,Asia,1076,16496,65
2020-05-17T00:00:00Z,17,5,2020,529,13,Indonesia,ID,IDN,267663435,Asia,1089,17025,66
2020-05-18T00:00:00Z,18,5,2020,489,59,Indonesia,ID,IDN,267663435,Asia,1148,17514,67
2020-05-19T00:00:00Z,19,5,2020,496,43,Indonesia,ID,IDN,267663435,Asia,1191,18010,68
2020-05-20T00:00:00Z,20,5,2020,486,30,Indonesia,ID,IDN,267663435,Asia,1221,18496,69
2020-05-21T00:00:00Z,21,5,2020,693,21,Indonesia,ID,IDN,267663435,Asia,1242,19189,70
2020-05-22T00:00:00Z,22,5,2020,973,36,Indonesia,ID,IDN,267663435,Asia,1278,20162,71
2020-05-23T00:00:00Z,23,5,2020,634,48,Indonesia,ID,IDN,267663435,Asia,1326,20796,72
2020-05-24T00:00:00Z,24,5,2020,949,25,Indonesia,ID,IDN,267663435,Asia,1351,21745,73
2020-05-25T00:00:00Z,25,5,2020,526,21,Indonesia,ID,IDN,267663435,Asia,1372,22271,74
2020-05-26T00:00:00Z,26,5,2020,479,19,Indonesia,ID,IDN,267663435,Asia,1391,22750,75
2020-05-27T00:00:00Z,27,5,2020,415,27,Indonesia,ID,IDN,267663435,Asia,1418,23165,76
2020-02-20T00:00:00Z,20,2,2020,2,2,Iran,IR,IRN,81800269,Asia,2,2,1
2020-02-21T00:00:00Z,21,2,2020,3,0,Iran,IR,IRN,81800269,Asia,2,5,2
2020-02-22T00:00:00Z,22,2,2020,13,2,Iran,IR,IRN,81800269,Asia,4,18,3
2020-02-23T00:00:00Z,23,2,2020,10,1,Iran,IR,IRN,81800269,Asia,5,28,4
2020-02-24T00:00:00Z,24,2,2020,15,3,Iran,IR,IRN,81800269,Asia,8,43,5
2020-02-25T00:00:00Z,25,2,2020,18,4,Iran,IR,IRN,81800269,Asia,12,61,6
2020-02-26T00:00:00Z,26,2,2020,34,3,Iran,IR,IRN,81800269,Asia,15,95,7
2020-02-27T00:00:00Z,27,2,2020,44,4,Iran,IR,IRN,81800269,Asia,19,139,8
2020-02-28T00:00:00Z,28,2,2020,106,7,Iran,IR,IRN,81800269,Asia,26,245,9
2020-02-29T00:00:00Z,29,2,2020,143,8,Iran,IR,IRN,81800269,Asia,34,388,10
2020-03-01T00:00:00Z,1,3,2020,205,9,Iran,IR,IRN,81800269,Asia,43,593,11
2020-03-02T00:00:00Z,2,3,2020,385,11,Iran,IR,IRN,81800269,Asia,54,978,12
2020-03-03T00:00:00Z,3,3,2020,523,12,Iran,IR,IRN,81800269,Asia,66,1501,13
2020-03-04T00:00:00Z,4,3,2020,835,11,Iran,IR,IRN,81800269,Asia,77,2336,14
2020-03-05T00:00:00Z,5,3,2020,586,15,Iran,IR,IRN,81800269,Asia,92,2922,15
2020-03-06T00:00:00Z,6,3,2020,591,15,Iran,IR,IRN,81800269,Asia,107,3513,16
2020-03-07T00:00:00Z,7,3,2020,1234,17,Iran,IR,IRN,81800269,Asia,124,4747,17
2020-03-08T00:00:00Z,8,3,2020,1076,21,Iran,IR,IRN,81800269,Asia,145,5823,18
2020-03-09T00:00:00Z,9,3,2020,743,49,Iran,IR,IRN,81800269,Asia,194,6566,19
2020-03-10T00:00:00Z,10,3,2020,595,43,Iran,IR,IRN,81800269,Asia,237,7161,20
2020-03-11T00:00:00Z,11,3,2020,881,54,Iran,IR,IRN,81800269,Asia,291,8042,21
2020-03-12T00:00:00Z,12,3,2020,958,63,Iran,IR,IRN,81800269,Asia,354,9000,22
2020-03-13T00:00:00Z,13,3,2020,1075,75,Iran,IR,IRN,81800269,Asia,429,10075,23
2020-03-14T00:00:00Z,14,3,2020,1289,85,Iran,IR,IRN,81800269,Asia,514,11364,24
2020-03-15T00:00:00Z,15,3,2020,1365,97,Iran,IR,IRN,81800269,Asia,611,12729,25
2020-03-16T00:00:00Z,16,3,2020,1209,113,Iran,IR,IRN,81800269,Asia,724,13938,26
2020-03-17T00:00:00Z,17,3,2020,1053,129,Iran,IR,IRN,81800269,Asia,853,14991,27
2020-03-18T00:00:00Z,18,3,2020,1178,135,Iran,IR,IRN,81800269,Asia,988,16169,28
2020-03-19T00:00:00Z,19,3,2020,1192,147,Iran,IR,IRN,81800269,Asia,1135,17361,29
2020-03-20T00:00:00Z,20,3,2020,1046,149,Iran,IR,IRN,81800269,Asia,1284,18407,30
2020-03-21T00:00:00Z,21,3,2020,1237,149,Iran,IR,IRN,81800269,Asia,1433,19644,31
2020-03-22T00:00:00Z,22,3,2020,966,123,Iran,IR,IRN,81800269,Asia,1556,20610,32
2020-03-23T00:00:00Z,23,3,2020,1028,129,Iran,IR,IRN,81800269,Asia,1685,21638,33
2020-03-24T00:00:00Z,24,3,2020,1411,127,Iran,IR,IRN,81800269,Asia,1812,23049,34
2020-03-25T00:00:00Z,25,3,2020,1762,122,Iran,IR,IRN,81800269,Asia,1934,24811,35
2020-03-26T00:00:00Z,26,3,2020,2206,143,Iran,IR,IRN,81800269,Asia,2077,27017,36
2020-03-27T00:00:00Z,27,3,2020,2389,157,Iran,IR,IRN,81800269,Asia,2234,29406,37
2020-03-28T00:00:00Z,28,3,2020,2926,144,Iran,IR,IRN,81800269,Asia,2378,32332,38
2020-03-29T00:00:00Z,29,3,2020,3076,139,Iran,IR,IRN,81800269,Asia,2517,35408,39
2020-03-30T00:00:00Z,30,3,2020,2901,123,Iran,IR,IRN,81800269,Asia,2640,38309,40
2020-03-31T00:00:00Z,31,3,2020,3186,117,Iran,IR,IRN,81800269,Asia,2757,41495,41
2020-04-01T00:00:00Z,1,4,2020,3111,141,Iran,IR,IRN,81800269,Asia,2898,44606,42
2020-04-02T00:00:00Z,2,4,2020,2987,138,Iran,IR,IRN,81800269,Asia,3036,47593,43
2020-04-03T00:00:00Z,3,4,2020,2875,124,Iran,IR,IRN,81800269,Asia,3160,50468,44
2020-04-04T00:00:00Z,4,4,2020,0,0,Iran,IR,IRN,81800269,Asia,3160,50468,45
2020-04-05T00:00:00Z,5,4,2020,5275,292,Iran,IR,IRN,81800269,Asia,3452,55743,46
2020-04-06T00:00:00Z,6,4,2020,2483,151,Iran,IR,IRN,81800269,Asia,3603,58226,47
2020-04-07T00:00:00Z,7,4,2020,2274,136,Iran,IR,IRN,81800269,Asia,3739,60500,48
2020-04-08T00:00:00Z,8,4,2020,2089,133,Iran,IR,IRN,81800269,Asia,3872,62589,49
2020-04-09T00:00:00Z,9,4,2020,1997,121,Iran,IR,IRN,81800269,Asia,3993,64586,50
2020-04-10T00:00:00Z,10,4,2020,1634,117,Iran,IR,IRN,81800269,Asia,4110,66220,51
2020-04-11T00:00:00Z,11,4,2020,1972,122,Iran,IR,IRN,81800269,Asia,4232,68192,52
2020-04-12T00:00:00Z,12,4,2020,1837,125,Iran,IR,IRN,81800269,Asia,4357,70029,53
2020-04-13T00:00:00Z,13,4,2020,1657,117,Iran,IR,IRN,81800269,Asia,4474,71686,54
2020-04-14T00:00:00Z,14,4,2020,1617,111,Iran,IR,IRN,81800269,Asia,4585,73303,55
2020-04-15T00:00:00Z,15,4,2020,1574,98,Iran,IR,IRN,81800269,Asia,4683,74877,56
2020-04-16T00:00:00Z,16,4,2020,1512,94,Iran,IR,IRN,81800269,Asia,4777,76389,57
2020-04-17T00:00:00Z,17,4,2020,1606,92,Iran,IR,IRN,81800269,Asia,4869,77995,58
2020-04-18T00:00:00Z,18,4,2020,1499,89,Iran,IR,IRN,81800269,Asia,4958,79494,59
2020-04-19T00:00:00Z,19,4,2020,1374,73,Iran,IR,IRN,81800269,Asia,5031,80868,60
2020-04-20T00:00:00Z,20,4,2020,1343,87,Iran,IR,IRN,81800269,Asia,5118,82211,61
2020-04-21T00:00:00Z,21,4,2020,1294,91,Iran,IR,IRN,81800269,Asia,5209,83505,62
2020-04-22T00:00:00Z,22,4,2020,1297,88,Iran,IR,IRN,81800269,Asia,5297,84802,63
2020-04-23T00:00:00Z,23,4,2020,1194,94,Iran,IR,IRN,81800269,Asia,5391,85996,64
2020-04-24T00:00:00Z,24,4,2020,1030,90,Iran,IR,IRN,81800269,Asia,5481,87026,65
2020-04-25T00:00:00Z,25,4,2020,1168,93,Iran,IR,IRN,81800269,Asia,5574,88194,66
2020-04-26T00:00:00Z,26,4,2020,1134,76,Iran,IR,IRN,81800269,Asia,5650,89328,67
2020-04-27T00:00:00Z,27,4,2020,1153,60,Iran,IR,IRN,81800269,Asia,5710,90481,68
2020-04-28T00:00:00Z,28,4,2020,991,96,Iran,IR,IRN,81800269,Asia,5806,91472,69
2020-04-29T00:00:00Z,29,4,2020,1112,71,Iran,IR,IRN,81800269,Asia,5877,92584,70
2020-04-30T00:00:00Z,30,4,2020,1073,80,Iran,IR,IRN,81800269,Asia,5957,93657,71
2020-05-01T00:00:00Z,1,5,2020,983,71,Iran,IR,IRN,81800269,Asia,6028,94640,72
2020-05-02T00:00:00Z,2,5,2020,1006,63,Iran,IR,IRN,81800269,Asia,6091,95646,73
2020-05-03T00:00:00Z,3,5,2020,802,65,Iran,IR,IRN,81800269,Asia,6156,96448,74
2020-05-04T00:00:00Z,4,5,2020,976,47,Iran,IR,IRN,81800269,Asia,6203,97424,75
2020-05-05T00:00:00Z,5,5,2020,1223,74,Iran,IR,IRN,81800269,Asia,6277,98647,76
2020-05-06T00:00:00Z,6,5,2020,1323,63,Iran,IR,IRN,81800269,Asia,6340,99970,77
2020-05-07T00:00:00Z,7,5,2020,1680,78,Iran,IR,IRN,81800269,Asia,6418,101650,78
2020-05-08T00:00:00Z,8,5,2020,1485,68,Iran,IR,IRN,81800269,Asia,6486,103135,79
2020-05-09T00:00:00Z,9,5,2020,1556,55,Iran,IR,IRN,81800269,Asia,6541,104691,80
2020-05-10T00:00:00Z,10,5,2020,1529,48,Iran,IR,IRN,81800269,Asia,6589,106220,81
2020-05-11T00:00:00Z,11,5,2020,1383,51,Iran,IR,IRN,81800269,Asia,6640,107603,82
2020-05-12T00:00:00Z,12,5,2020,1683,45,Iran,IR,IRN,81800269,Asia,6685,109286,83
2020-05-13T00:00:00Z,13,5,2020,1481,48,Iran,IR,IRN,81800269,Asia,6733,110767,84
2020-05-14T00:00:00Z,14,5,2020,1958,50,Iran,IR,IRN,81800269,Asia,6783,112725,85
2020-05-15T00:00:00Z,15,5,2020,1808,71,Iran,IR,IRN,81800269,Asia,6854,114533,86
2020-05-16T00:00:00Z,16,5,2020,2102,48,Iran,IR,IRN,81800269,Asia,6902,116635,87
2020-05-17T00:00:00Z,17,5,2020,1757,35,Iran,IR,IRN,81800269,Asia,6937,118392,88
2020-05-18T00:00:00Z,18,5,2020,1806,51,Iran,IR,IRN,81800269,Asia,6988,120198,89
2020-05-19T00:00:00Z,19,5,2020,2294,69,Iran,IR,IRN,81800269,Asia,7057,122492,90
2020-05-20T00:00:00Z,20,5,2020,2111,62,Iran,IR,IRN,81800269,Asia,7119,124603,91
2020-05-21T00:00:00Z,21,5,2020,2346,64,Iran,IR,IRN,81800269,Asia,7183,126949,92
2020-05-22T00:00:00Z,22,5,2020,2392,66,Iran,IR,IRN,81800269,Asia,7249,129341,93
2020-05-23T00:00:00Z,23,5,2020,2311,51,Iran,IR,IRN,81800269,Asia,7300,131652,94
2020-05-24T00:00:00Z,24,5,2020,1869,59,Iran,IR,IRN,81800269,Asia,7359,133521,95
2020-05-25T00:00:00Z,25,5,2020,2180,58,Iran,IR,IRN,81800269,Asia,7417,135701,96
2020-05-26T00:00:00Z,26,5,2020,2023,34,Iran,IR,IRN,81800269,Asia,7451,137724,97
2020-05-27T00:00:00Z,27,5,2020,1787,57,Iran,IR,IRN,81800269,Asia,7508,139511,98
2020-03-06T00:00:00Z,6,3,2020,7,2,Iraq,IQ,IRQ,38433600,Asia,2,38,1
2020-03-08T00:00:00Z,8,3,2020,16,0,Iraq,IQ,IRQ,38433600,Asia,2,54,2
2020-03-09T00:00:00Z,9,3,2020,7,4,Iraq,IQ,IRQ,38433600,Asia,6,61,3
2020-03-11T00:00:00Z,11,3,2020,0,0,Iraq,IQ,IRQ,38433600,Asia,6,61,4
2020-03-12T00:00:00Z,12,3,2020,9,2,Iraq,IQ,IRQ,38433600,Asia,8,70,5
2020-03-13T00:00:00Z,13,3,2020,4,0,Iraq,IQ,IRQ,38433600,Asia,8,74,6
2020-03-14T00:00:00Z,14,3,2020,11,1,Iraq,IQ,IRQ,38433600,Asia,9,85,7
2020-03-15T00:00:00Z,15,3,2020,0,0,Iraq,IQ,IRQ,38433600,Asia,9,85,8
2020-03-16T00:00:00Z,16,3,2020,39,0,Iraq,IQ,IRQ,38433600,Asia,9,124,9
2020-03-17T00:00:00Z,17,3,2020,0,0,Iraq,IQ,IRQ,38433600,Asia,9,124,10
2020-03-18T00:00:00Z,18,3,2020,30,2,Iraq,IQ,IRQ,38433600,Asia,11,154,11
2020-03-19T00:00:00Z,19,3,2020,10,1,Iraq,IQ,IRQ,38433600,Asia,12,164,12
2020-03-20T00:00:00Z,20,3,2020,13,0,Iraq,IQ,IRQ,38433600,Asia,12,177,13
2020-03-21T00:00:00Z,21,3,2020,16,2,Iraq,IQ,IRQ,38433600,Asia,14,193,14
2020-03-22T00:00:00Z,22,3,2020,21,3,Iraq,IQ,IRQ,38433600,Asia,17,214,15
2020-03-23T00:00:00Z,23,3,2020,19,3,Iraq,IQ,IRQ,38433600,Asia,20,233,16
2020-03-24T00:00:00Z,24,3,2020,33,3,Iraq,IQ,IRQ,38433600,Asia,23,266,17
2020-03-25T00:00:00Z,25,3,2020,50,4,Iraq,IQ,IRQ,38433600,Asia,27,316,18
2020-03-26T00:00:00Z,26,3,2020,30,2,Iraq,IQ,IRQ,38433600,Asia,29,346,19
2020-03-27T00:00:00Z,27,3,2020,36,7,Iraq,IQ,IRQ,38433600,Asia,36,382,20
2020-03-28T00:00:00Z,28,3,2020,76,4,Iraq,IQ,IRQ,38433600,Asia,40,458,21
2020-03-29T00:00:00Z,29,3,2020,48,2,Iraq,IQ,IRQ,38433600,Asia,42,506,22
2020-03-30T00:00:00Z,30,3,2020,41,0,Iraq,IQ,IRQ,38433600,Asia,42,547,23
2020-03-31T00:00:00Z,31,3,2020,83,4,Iraq,IQ,IRQ,38433600,Asia,46,630,24
2020-04-01T00:00:00Z,1,4,2020,64,4,Iraq,IQ,IRQ,38433600,Asia,50,694,25
2020-04-02T00:00:00Z,2,4,2020,0,0,Iraq,IQ,IRQ,38433600,Asia,50,694,26
2020-04-03T00:00:00Z,3,4,2020,78,4,Iraq,IQ,IRQ,38433600,Asia,54,772,27
2020-04-04T00:00:00Z,4,4,2020,0,0,Iraq,IQ,IRQ,38433600,Asia,54,772,28
2020-04-05T00:00:00Z,5,4,2020,106,2,Iraq,IQ,IRQ,38433600,Asia,56,878,29
2020-04-06T00:00:00Z,6,4,2020,83,5,Iraq,IQ,IRQ,38433600,Asia,61,961,30
2020-04-07T00:00:00Z,7,4,2020,70,3,Iraq,IQ,IRQ,38433600,Asia,64,1031,31
2020-04-08T00:00:00Z,8,4,2020,0,0,Iraq,IQ,IRQ,38433600,Asia,64,1031,32
2020-04-09T00:00:00Z,9,4,2020,171,5,Iraq,IQ,IRQ,38433600,Asia,69,1202,33
2020-04-10T00:00:00Z,10,4,2020,30,0,Iraq,IQ,IRQ,38433600,Asia,69,1232,34
2020-04-11T00:00:00Z,11,4,2020,47,1,Iraq,IQ,IRQ,38433600,Asia,70,1279,35
2020-04-12T00:00:00Z,12,4,2020,39,2,Iraq,IQ,IRQ,38433600,Asia,72,1318,36
2020-04-13T00:00:00Z,13,4,2020,34,4,Iraq,IQ,IRQ,38433600,Asia,76,1352,37
2020-04-14T00:00:00Z,14,4,2020,26,2,Iraq,IQ,IRQ,38433600,Asia,78,1378,38
2020-04-15T00:00:00Z,15,4,2020,22,0,Iraq,IQ,IRQ,38433600,Asia,78,1400,39
2020-04-16T00:00:00Z,16,4,2020,15,1,Iraq,IQ,IRQ,38433600,Asia,79,1415,40
2020-04-17T00:00:00Z,17,4,2020,19,1,Iraq,IQ,IRQ,38433600,Asia,80,1434,41
2020-04-18T00:00:00Z,18,4,2020,48,1,Iraq,IQ,IRQ,38433600,Asia,81,1482,42
2020-04-19T00:00:00Z,19,4,2020,0,0,Iraq,IQ,IRQ,38433600,Asia,81,1482,43
2020-04-20T00:00:00Z,20,4,2020,57,1,Iraq,IQ,IRQ,38433600,Asia,82,1539,44
2020-04-21T00:00:00Z,21,4,2020,35,0,Iraq,IQ,IRQ,38433600,Asia,82,1574,45
2020-04-22T00:00:00Z,22,4,2020,28,1,Iraq,IQ,IRQ,38433600,Asia,83,1602,46
2020-04-23T00:00:00Z,23,4,2020,0,0,Iraq,IQ,IRQ,38433600,Asia,83,1602,47
2020-04-24T00:00:00Z,24,4,2020,75,0,Iraq,IQ,IRQ,38433600,Asia,83,1677,48
2020-04-25T00:00:00Z,25,4,2020,31,3,Iraq,IQ,IRQ,38433600,Asia,86,1708,49
2020-04-26T00:00:00Z,26,4,2020,55,0,Iraq,IQ,IRQ,38433600,Asia,86,1763,50
2020-04-27T00:00:00Z,27,4,2020,57,1,Iraq,IQ,IRQ,38433600,Asia,87,1820,51
2020-04-28T00:00:00Z,28,4,2020,27,1,Iraq,IQ,IRQ,38433600,Asia,88,1847,52
2020-04-29T00:00:00Z,29,4,2020,0,0,Iraq,IQ,IRQ,38433600,Asia,88,1847,53
2020-04-30T00:00:00Z,30,4,2020,156,4,Iraq,IQ,IRQ,38433600,Asia,92,2003,54
2020-05-01T00:00:00Z,1,5,2020,82,1,Iraq,IQ,IRQ,38433600,Asia,93,2085,55
2020-05-02T00:00:00Z,2,5,2020,68,1,Iraq,IQ,IRQ,38433600,Asia,94,2153,56
2020-05-03T00:00:00Z,3,5,2020,66,1,Iraq,IQ,IRQ,38433600,Asia,95,2219,57
2020-05-04T00:00:00Z,4,5,2020,77,2,Iraq,IQ,IRQ,38433600,Asia,97,2296,58
2020-05-05T00:00:00Z,5,5,2020,50,1,Iraq,IQ,IRQ,38433600,Asia,98,2346,59
2020-05-06T00:00:00Z,6,5,2020,85,4,Iraq,IQ,IRQ,38433600,Asia,102,2431,60
2020-05-07T00:00:00Z,7,5,2020,49,0,Iraq,IQ,IRQ,38433600,Asia,102,2480,61
2020-05-08T00:00:00Z,8,5,2020,63,0,Iraq,IQ,IRQ,38433600,Asia,102,2543,62
2020-05-09T00:00:00Z,9,5,2020,60,2,Iraq,IQ,IRQ,38433600,Asia,104,2603,63
2020-05-10T00:00:00Z,10,5,2020,76,3,Iraq,IQ,IRQ,38433600,Asia,107,2679,64
2020-05-11T00:00:00Z,11,5,2020,88,2,Iraq,IQ,IRQ,38433600,Asia,109,2767,65
2020-05-12T00:00:00Z,12,5,2020,51,1,Iraq,IQ,IRQ,38433600,Asia,110,2818,66
2020-05-13T00:00:00Z,13,5,2020,95,2,Iraq,IQ,IRQ,38433600,Asia,112,2913,67
2020-05-14T00:00:00Z,14,5,2020,119,3,Iraq,IQ,IRQ,38433600,Asia,115,3032,68
2020-05-15T00:00:00Z,15,5,2020,111,0,Iraq,IQ,IRQ,38433600,Asia,115,3143,69
2020-05-16T00:00:00Z,16,5,2020,50,2,Iraq,IQ,IRQ,38433600,Asia,117,3193,70
2020-05-17T00:00:00Z,17,5,2020,67,4,Iraq,IQ,IRQ,38433600,Asia,121,3260,71
2020-05-18T00:00:00Z,18,5,2020,144,2,Iraq,IQ,IRQ,38433600,Asia,123,3404,72
2020-05-19T00:00:00Z,19,5,2020,150,4,Iraq,IQ,IRQ,38433600,Asia,127,3554,73
2020-05-20T00:00:00Z,20,5,2020,57,4,Iraq,IQ,IRQ,38433600,Asia,131,3611,74
2020-05-21T00:00:00Z,21,5,2020,113,3,Iraq,IQ,IRQ,38433600,Asia,134,3724,75
2020-05-22T00:00:00Z,22,5,2020,153,6,Iraq,IQ,IRQ,38433600,Asia,140,3877,76
2020-05-23T00:00:00Z,23,5,2020,87,7,Iraq,IQ,IRQ,38433600,Asia,147,3964,77
2020-05-24T00:00:00Z,24,5,2020,308,5,Iraq,IQ,IRQ,38433600,Asia,152,4272,78
2020-05-25T00:00:00Z,25,5,2020,197,8,Iraq,IQ,IRQ,38433600,Asia,160,4469,79
2020-05-26T00:00:00Z,26,5,2020,163,3,Iraq,IQ,IRQ,38433600,Asia,163,4632,80
2020-05-27T00:00:00Z,27,5,2020,216,6,Iraq,IQ,IRQ,38433600,Asia,169,4848,81
2020-03-12T00:00:00Z,12,3,2020,8,1,Ireland,IE,IRL,4853506,Europe,1,43,1
2020-03-13T00:00:00Z,13,3,2020,27,0,Ireland,IE,IRL,4853506,Europe,1,70,2
2020-03-14T00:00:00Z,14,3,2020,21,0,Ireland,IE,IRL,4853506,Europe,1,91,3
2020-03-15T00:00:00Z,15,3,2020,38,1,Ireland,IE,IRL,4853506,Europe,2,129,4
2020-03-16T00:00:00Z,16,3,2020,40,0,Ireland,IE,IRL,4853506,Europe,2,169,5
2020-03-17T00:00:00Z,17,3,2020,54,0,Ireland,IE,IRL,4853506,Europe,2,223,6
2020-03-18T00:00:00Z,18,3,2020,69,0,Ireland,IE,IRL,4853506,Europe,2,292,7
2020-03-19T00:00:00Z,19,3,2020,74,0,Ireland,IE,IRL,4853506,Europe,2,366,8
2020-03-20T00:00:00Z,20,3,2020,191,1,Ireland,IE,IRL,4853506,Europe,3,557,9
2020-03-21T00:00:00Z,21,3,2020,126,0,Ireland,IE,IRL,4853506,Europe,3,683,10
2020-03-22T00:00:00Z,22,3,2020,102,0,Ireland,IE,IRL,4853506,Europe,3,785,11
2020-03-23T00:00:00Z,23,3,2020,121,1,Ireland,IE,IRL,4853506,Europe,4,906,12
2020-03-24T00:00:00Z,24,3,2020,219,2,Ireland,IE,IRL,4853506,Europe,6,1125,13
2020-03-25T00:00:00Z,25,3,2020,204,1,Ireland,IE,IRL,4853506,Europe,7,1329,14
2020-03-26T00:00:00Z,26,3,2020,235,2,Ireland,IE,IRL,4853506,Europe,9,1564,15
2020-03-27T00:00:00Z,27,3,2020,255,10,Ireland,IE,IRL,4853506,Europe,19,1819,16
2020-03-28T00:00:00Z,28,3,2020,302,3,Ireland,IE,IRL,4853506,Europe,22,2121,17
2020-03-29T00:00:00Z,29,3,2020,294,14,Ireland,IE,IRL,4853506,Europe,36,2415,18
2020-03-30T00:00:00Z,30,3,2020,200,10,Ireland,IE,IRL,4853506,Europe,46,2615,19
2020-03-31T00:00:00Z,31,3,2020,295,8,Ireland,IE,IRL,4853506,Europe,54,2910,20
2020-04-01T00:00:00Z,1,4,2020,325,17,Ireland,IE,IRL,4853506,Europe,71,3235,21
2020-04-02T00:00:00Z,2,4,2020,212,14,Ireland,IE,IRL,4853506,Europe,85,3447,22
2020-04-03T00:00:00Z,3,4,2020,402,13,Ireland,IE,IRL,4853506,Europe,98,3849,23
2020-04-04T00:00:00Z,4,4,2020,424,22,Ireland,IE,IRL,4853506,Europe,120,4273,24
2020-04-05T00:00:00Z,5,4,2020,331,17,Ireland,IE,IRL,4853506,Europe,137,4604,25
2020-04-06T00:00:00Z,6,4,2020,507,21,Ireland,IE,IRL,4853506,Europe,158,5111,26
2020-04-07T00:00:00Z,7,4,2020,253,16,Ireland,IE,IRL,4853506,Europe,174,5364,27
2020-04-08T00:00:00Z,8,4,2020,345,36,Ireland,IE,IRL,4853506,Europe,210,5709,28
2020-04-09T00:00:00Z,9,4,2020,515,25,Ireland,IE,IRL,4853506,Europe,235,6224,29
2020-04-10T00:00:00Z,10,4,2020,1169,28,Ireland,IE,IRL,4853506,Europe,263,7393,30
2020-04-11T00:00:00Z,11,4,2020,696,24,Ireland,IE,IRL,4853506,Europe,287,8089,31
2020-04-12T00:00:00Z,12,4,2020,839,33,Ireland,IE,IRL,4853506,Europe,320,8928,32
2020-04-13T00:00:00Z,13,4,2020,727,14,Ireland,IE,IRL,4853506,Europe,334,9655,33
2020-04-14T00:00:00Z,14,4,2020,992,31,Ireland,IE,IRL,4853506,Europe,365,10647,34
2020-04-15T00:00:00Z,15,4,2020,832,41,Ireland,IE,IRL,4853506,Europe,406,11479,35
2020-04-16T00:00:00Z,16,4,2020,1068,38,Ireland,IE,IRL,4853506,Europe,444,12547,36
2020-04-17T00:00:00Z,17,4,2020,724,42,Ireland,IE,IRL,4853506,Europe,486,13271,37
2020-04-18T00:00:00Z,18,4,2020,709,44,Ireland,IE,IRL,4853506,Europe,530,13980,38
2020-04-19T00:00:00Z,19,4,2020,778,41,Ireland,IE,IRL,4853506,Europe,571,14758,39
2020-04-20T00:00:00Z,20,4,2020,493,39,Ireland,IE,IRL,4853506,Europe,610,15251,40
2020-04-21T00:00:00Z,21,4,2020,401,77,Ireland,IE,IRL,4853506,Europe,687,15652,41
2020-04-22T00:00:00Z,22,4,2020,388,43,Ireland,IE,IRL,4853506,Europe,730,16040,42
2020-04-23T00:00:00Z,23,4,2020,631,39,Ireland,IE,IRL,4853506,Europe,769,16671,43
2020-04-24T00:00:00Z,24,4,2020,936,25,Ireland,IE,IRL,4853506,Europe,794,17607,44
2020-04-25T00:00:00Z,25,4,2020,577,35,Ireland,IE,IRL,4853506,Europe,829,18184,45
2020-04-26T00:00:00Z,26,4,2020,377,234,Ireland,IE,IRL,4853506,Europe,1063,18561,46
2020-04-27T00:00:00Z,27,4,2020,701,24,Ireland,IE,IRL,4853506,Europe,1087,19262,47
2020-04-28T00:00:00Z,28,4,2020,386,15,Ireland,IE,IRL,4853506,Europe,1102,19648,48
2020-04-29T00:00:00Z,29,4,2020,229,57,Ireland,IE,IRL,4853506,Europe,1159,19877,49
2020-04-30T00:00:00Z,30,4,2020,376,31,Ireland,IE,IRL,4853506,Europe,1190,20253,50
2020-05-01T00:00:00Z,1,5,2020,359,42,Ireland,IE,IRL,4853506,Europe,1232,20612,51
2020-05-02T00:00:00Z,2,5,2020,221,33,Ireland,IE,IRL,4853506,Europe,1265,20833,52
2020-05-03T00:00:00Z,3,5,2020,343,0,Ireland,IE,IRL,4853506,Europe,1265,21176,53
2020-05-04T00:00:00Z,4,5,2020,330,38,Ireland,IE,IRL,4853506,Europe,1303,21506,54
2020-05-05T00:00:00Z,5,5,2020,216,16,Ireland,IE,IRL,4853506,Europe,1319,21722,55
2020-05-06T00:00:00Z,6,5,2020,261,20,Ireland,IE,IRL,4853506,Europe,1339,21983,56
2020-05-07T00:00:00Z,7,5,2020,265,36,Ireland,IE,IRL,4853506,Europe,1375,22248,57
2020-05-08T00:00:00Z,8,5,2020,137,28,Ireland,IE,IRL,4853506,Europe,1403,22385,58
2020-05-09T00:00:00Z,9,5,2020,156,26,Ireland,IE,IRL,4853506,Europe,1429,22541,59
2020-05-10T00:00:00Z,10,5,2020,219,17,Ireland,IE,IRL,4853506,Europe,1446,22760,60
2020-05-11T00:00:00Z,11,5,2020,236,12,Ireland,IE,IRL,4853506,Europe,1458,22996,61
2020-05-12T00:00:00Z,12,5,2020,139,9,Ireland,IE,IRL,4853506,Europe,1467,23135,62
2020-05-13T00:00:00Z,13,5,2020,107,21,Ireland,IE,IRL,4853506,Europe,1488,23242,63
2020-05-14T00:00:00Z,14,5,2020,159,9,Ireland,IE,IRL,4853506,Europe,1497,23401,64
2020-05-15T00:00:00Z,15,5,2020,426,9,Ireland,IE,IRL,4853506,Europe,1506,23827,65
2020-05-16T00:00:00Z,16,5,2020,129,12,Ireland,IE,IRL,4853506,Europe,1518,23956,66
2020-05-17T00:00:00Z,17,5,2020,92,15,Ireland,IE,IRL,4853506,Europe,1533,24048,67
2020-05-18T00:00:00Z,18,5,2020,64,10,Ireland,IE,IRL,4853506,Europe,1543,24112,68
2020-05-19T00:00:00Z,19,5,2020,88,4,Ireland,IE,IRL,4853506,Europe,1547,24200,69
2020-05-20T00:00:00Z,20,5,2020,51,14,Ireland,IE,IRL,4853506,Europe,1561,24251,70
2020-05-21T00:00:00Z,21,5,2020,64,10,Ireland,IE,IRL,4853506,Europe,1571,24315,71
2020-05-22T00:00:00Z,22,5,2020,76,12,Ireland,IE,IRL,4853506,Europe,1583,24391,72
2020-05-23T00:00:00Z,23,5,2020,115,9,Ireland,IE,IRL,4853506,Europe,1592,24506,73
2020-05-24T00:00:00Z,24,5,2020,76,12,Ireland,IE,IRL,4853506,Europe,1604,24582,74
2020-05-25T00:00:00Z,25,5,2020,57,2,Ireland,IE,IRL,4853506,Europe,1606,24639,75
2020-05-26T00:00:00Z,26,5,2020,59,0,Ireland,IE,IRL,4853506,Europe,1606,24698,76
2020-05-27T00:00:00Z,27,5,2020,37,9,Ireland,IE,IRL,4853506,Europe,1615,24735,77
2020-04-03T00:00:00Z,3,4,2020,6,1,Isle_of_Man,IM,IMN,84077,Europe,1,71,1
2020-04-04T00:00:00Z,4,4,2020,43,0,Isle_of_Man,IM,IMN,84077,Europe,1,114,2
2020-04-05T00:00:00Z,5,4,2020,12,0,Isle_of_Man,IM,IMN,84077,Europe,1,126,3
2020-04-06T00:00:00Z,6,4,2020,1,0,Isle_of_Man,IM,IMN,84077,Europe,1,127,4
2020-04-07T00:00:00Z,7,4,2020,12,0,Isle_of_Man,IM,IMN,84077,Europe,1,139,5
2020-04-08T00:00:00Z,8,4,2020,11,0,Isle_of_Man,IM,IMN,84077,Europe,1,150,6
2020-04-09T00:00:00Z,9,4,2020,8,0,Isle_of_Man,IM,IMN,84077,Europe,1,158,7
2020-04-10T00:00:00Z,10,4,2020,32,0,Isle_of_Man,IM,IMN,84077,Europe,1,190,8
2020-04-11T00:00:00Z,11,4,2020,11,0,Isle_of_Man,IM,IMN,84077,Europe,1,201,9
2020-04-12T00:00:00Z,12,4,2020,25,0,Isle_of_Man,IM,IMN,84077,Europe,1,226,10
2020-04-13T00:00:00Z,13,4,2020,2,1,Isle_of_Man,IM,IMN,84077,Europe,2,228,11
2020-04-14T00:00:00Z,14,4,2020,14,0,Isle_of_Man,IM,IMN,84077,Europe,2,242,12
2020-04-15T00:00:00Z,15,4,2020,0,0,Isle_of_Man,IM,IMN,84077,Europe,2,242,13
2020-04-16T00:00:00Z,16,4,2020,12,0,Isle_of_Man,IM,IMN,84077,Europe,2,254,14
2020-04-17T00:00:00Z,17,4,2020,30,2,Isle_of_Man,IM,IMN,84077,Europe,4,284,15
2020-04-18T00:00:00Z,18,4,2020,5,0,Isle_of_Man,IM,IMN,84077,Europe,4,289,16
2020-04-19T00:00:00Z,19,4,2020,8,2,Isle_of_Man,IM,IMN,84077,Europe,6,297,17
2020-04-20T00:00:00Z,20,4,2020,1,0,Isle_of_Man,IM,IMN,84077,Europe,6,298,18
2020-04-21T00:00:00Z,21,4,2020,2,3,Isle_of_Man,IM,IMN,84077,Europe,9,300,19
2020-04-22T00:00:00Z,22,4,2020,7,1,Isle_of_Man,IM,IMN,84077,Europe,10,307,20
2020-04-23T00:00:00Z,23,4,2020,0,5,Isle_of_Man,IM,IMN,84077,Europe,15,307,21
2020-04-24T00:00:00Z,24,4,2020,0,1,Isle_of_Man,IM,IMN,84077,Europe,16,307,22
2020-04-25T00:00:00Z,25,4,2020,1,2,Isle_of_Man,IM,IMN,84077,Europe,18,308,23
2020-04-26T00:00:00Z,26,4,2020,0,0,Isle_of_Man,IM,IMN,84077,Europe,18,308,24
2020-04-27T00:00:00Z,27,4,2020,0,0,Isle_of_Man,IM,IMN,84077,Europe,18,308,25
2020-04-28T00:00:00Z,28,4,2020,0,0,Isle_of_Man,IM,IMN,84077,Europe,18,308,26
2020-04-29T00:00:00Z,29,4,2020,1,3,Isle_of_Man,IM,IMN,84077,Europe,21,309,27
2020-04-30T00:00:00Z,30,4,2020,4,0,Isle_of_Man,IM,IMN,84077,Europe,21,313,28
2020-05-01T00:00:00Z,1,5,2020,2,0,Isle_of_Man,IM,IMN,84077,Europe,21,315,29
2020-05-02T00:00:00Z,2,5,2020,1,1,Isle_of_Man,IM,IMN,84077,Europe,22,316,30
2020-05-03T00:00:00Z,3,5,2020,4,0,Isle_of_Man,IM,IMN,84077,Europe,22,320,31
2020-05-04T00:00:00Z,4,5,2020,1,0,Isle_of_Man,IM,IMN,84077,Europe,22,321,32
2020-05-05T00:00:00Z,5,5,2020,4,1,Isle_of_Man,IM,IMN,84077,Europe,23,325,33
2020-05-06T00:00:00Z,6,5,2020,1,0,Isle_of_Man,IM,IMN,84077,Europe,23,326,34
2020-05-07T00:00:00Z,7,5,2020,1,0,Isle_of_Man,IM,IMN,84077,Europe,23,327,35
2020-05-08T00:00:00Z,8,5,2020,2,0,Isle_of_Man,IM,IMN,84077,Europe,23,329,36
2020-05-09T00:00:00Z,9,5,2020,0,0,Isle_of_Man,IM,IMN,84077,Europe,23,329,37
2020-05-10T00:00:00Z,10,5,2020,1,0,Isle_of_Man,IM,IMN,84077,Europe,23,330,38
2020-05-11T00:00:00Z,11,5,2020,0,0,Isle_of_Man,IM,IMN,84077,Europe,23,330,39
2020-05-12T00:00:00Z,12,5,2020,0,0,Isle_of_Man,IM,IMN,84077,Europe,23,330,40
2020-05-13T00:00:00Z,13,5,2020,1,0,Isle_of_Man,IM,IMN,84077,Europe,23,331,41
2020-05-14T00:00:00Z,14,5,2020,1,0,Isle_of_Man,IM,IMN,84077,Europe,23,332,42
2020-05-15T00:00:00Z,15,5,2020,0,0,Isle_of_Man,IM,IMN,84077,Europe,23,332,43
2020-05-16T00:00:00Z,16,5,2020,2,1,Isle_of_Man,IM,IMN,84077,Europe,24,334,44
2020-05-17T00:00:00Z,17,5,2020,1,0,Isle_of_Man,IM,IMN,84077,Europe,24,335,45
2020-05-18T00:00:00Z,18,5,2020,0,0,Isle_of_Man,IM,IMN,84077,Europe,24,335,46
2020-05-19T00:00:00Z,19,5,2020,0,0,Isle_of_Man,IM,IMN,84077,Europe,24,335,47
2020-05-20T00:00:00Z,20,5,2020,0,0,Isle_of_Man,IM,IMN,84077,Europe,24,335,48
2020-05-21T00:00:00Z,21,5,2020,1,0,Isle_of_Man,IM,IMN,84077,Europe,24,336,49
2020-05-22T00:00:00Z,22,5,2020,0,0,Isle_of_Man,IM,IMN,84077,Europe,24,336,50
2020-05-23T00:00:00Z,23,5,2020,0,0,Isle_of_Man,IM,IMN,84077,Europe,24,336,51
2020-05-24T00:00:00Z,24,5,2020,0,0,Isle_of_Man,IM,IMN,84077,Europe,24,336,52
2020-05-25T00:00:00Z,25,5,2020,0,0,Isle_of_Man,IM,IMN,84077,Europe,24,336,53
2020-05-26T00:00:00Z,26,5,2020,0,0,Isle_of_Man,IM,IMN,84077,Europe,24,336,54
2020-05-27T00:00:00Z,27,5,2020,0,0,Isle_of_Man,IM,IMN,84077,Europe,24,336,55
2020-03-21T00:00:00Z,21,3,2020,35,1,Israel,IL,ISR,8883800,Asia,1,712,1
2020-03-22T00:00:00Z,22,3,2020,171,0,Israel,IL,ISR,8883800,Asia,1,883,2
2020-03-23T00:00:00Z,23,3,2020,188,0,Israel,IL,ISR,8883800,Asia,1,1071,3
2020-03-24T00:00:00Z,24,3,2020,371,0,Israel,IL,ISR,8883800,Asia,1,1442,4
2020-03-25T00:00:00Z,25,3,2020,488,2,Israel,IL,ISR,8883800,Asia,3,1930,5
2020-03-26T00:00:00Z,26,3,2020,439,2,Israel,IL,ISR,8883800,Asia,5,2369,6
2020-03-27T00:00:00Z,27,3,2020,297,3,Israel,IL,ISR,8883800,Asia,8,2666,7
2020-03-28T00:00:00Z,28,3,2020,369,2,Israel,IL,ISR,8883800,Asia,10,3035,8
2020-03-29T00:00:00Z,29,3,2020,584,2,Israel,IL,ISR,8883800,Asia,12,3619,9
2020-03-30T00:00:00Z,30,3,2020,628,3,Israel,IL,ISR,8883800,Asia,15,4247,10
2020-03-31T00:00:00Z,31,3,2020,226,2,Israel,IL,ISR,8883800,Asia,17,4473,11
2020-04-01T00:00:00Z,1,4,2020,443,3,Israel,IL,ISR,8883800,Asia,20,4916,12
2020-04-02T00:00:00Z,2,4,2020,675,1,Israel,IL,ISR,8883800,Asia,21,5591,13
2020-04-03T00:00:00Z,3,4,2020,661,13,Israel,IL,ISR,8883800,Asia,34,6252,14
2020-04-04T00:00:00Z,4,4,2020,1176,5,Israel,IL,ISR,8883800,Asia,39,7428,15
2020-04-05T00:00:00Z,5,4,2020,590,7,Israel,IL,ISR,8883800,Asia,46,8018,16
2020-04-06T00:00:00Z,6,4,2020,412,3,Israel,IL,ISR,8883800,Asia,49,8430,17
2020-04-07T00:00:00Z,7,4,2020,474,8,Israel,IL,ISR,8883800,Asia,57,8904,18
2020-04-08T00:00:00Z,8,4,2020,344,8,Israel,IL,ISR,8883800,Asia,65,9248,19
2020-04-09T00:00:00Z,9,4,2020,156,6,Israel,IL,ISR,8883800,Asia,71,9404,20
2020-04-10T00:00:00Z,10,4,2020,564,15,Israel,IL,ISR,8883800,Asia,86,9968,21
2020-04-11T00:00:00Z,11,4,2020,440,9,Israel,IL,ISR,8883800,Asia,95,10408,22
2020-04-12T00:00:00Z,12,4,2020,335,6,Israel,IL,ISR,8883800,Asia,101,10743,23
2020-04-13T00:00:00Z,13,4,2020,402,2,Israel,IL,ISR,8883800,Asia,103,11145,24
2020-04-14T00:00:00Z,14,4,2020,441,13,Israel,IL,ISR,8883800,Asia,116,11586,25
2020-04-15T00:00:00Z,15,4,2020,460,7,Israel,IL,ISR,8883800,Asia,123,12046,26
2020-04-16T00:00:00Z,16,4,2020,455,7,Israel,IL,ISR,8883800,Asia,130,12501,27
2020-04-17T00:00:00Z,17,4,2020,257,12,Israel,IL,ISR,8883800,Asia,142,12758,28
2020-04-18T00:00:00Z,18,4,2020,224,9,Israel,IL,ISR,8883800,Asia,151,12982,29
2020-04-19T00:00:00Z,19,4,2020,283,13,Israel,IL,ISR,8883800,Asia,164,13265,30
2020-04-20T00:00:00Z,20,4,2020,226,8,Israel,IL,ISR,8883800,Asia,172,13491,31
2020-04-21T00:00:00Z,21,4,2020,222,5,Israel,IL,ISR,8883800,Asia,177,13713,32
2020-04-22T00:00:00Z,22,4,2020,229,7,Israel,IL,ISR,8883800,Asia,184,13942,33
2020-04-23T00:00:00Z,23,4,2020,650,7,Israel,IL,ISR,8883800,Asia,191,14592,34
2020-04-24T00:00:00Z,24,4,2020,290,2,Israel,IL,ISR,8883800,Asia,193,14882,35
2020-04-25T00:00:00Z,25,4,2020,176,1,Israel,IL,ISR,8883800,Asia,194,15058,36
2020-04-26T00:00:00Z,26,4,2020,240,5,Israel,IL,ISR,8883800,Asia,199,15298,37
2020-04-27T00:00:00Z,27,4,2020,100,0,Israel,IL,ISR,8883800,Asia,199,15398,38
2020-04-28T00:00:00Z,28,4,2020,68,3,Israel,IL,ISR,8883800,Asia,202,15466,39
2020-04-29T00:00:00Z,29,4,2020,123,6,Israel,IL,ISR,8883800,Asia,208,15589,40
2020-04-30T00:00:00Z,30,4,2020,245,7,Israel,IL,ISR,8883800,Asia,215,15834,41
2020-05-01T00:00:00Z,1,5,2020,112,7,Israel,IL,ISR,8883800,Asia,222,15946,42
2020-05-02T00:00:00Z,2,5,2020,155,3,Israel,IL,ISR,8883800,Asia,225,16101,43
2020-05-03T00:00:00Z,3,5,2020,84,4,Israel,IL,ISR,8883800,Asia,229,16185,44
2020-05-04T00:00:00Z,4,5,2020,23,3,Israel,IL,ISR,8883800,Asia,232,16208,45
2020-05-05T00:00:00Z,5,5,2020,38,3,Israel,IL,ISR,8883800,Asia,235,16246,46
2020-05-06T00:00:00Z,6,5,2020,43,3,Israel,IL,ISR,8883800,Asia,238,16289,47
2020-05-07T00:00:00Z,7,5,2020,21,1,Israel,IL,ISR,8883800,Asia,239,16310,48
2020-05-08T00:00:00Z,8,5,2020,71,1,Israel,IL,ISR,8883800,Asia,240,16381,49
2020-05-09T00:00:00Z,9,5,2020,55,5,Israel,IL,ISR,8883800,Asia,245,16436,50
2020-05-10T00:00:00Z,10,5,2020,18,2,Israel,IL,ISR,8883800,Asia,247,16454,51
2020-05-11T00:00:00Z,11,5,2020,23,5,Israel,IL,ISR,8883800,Asia,252,16477,52
2020-05-12T00:00:00Z,12,5,2020,29,6,Israel,IL,ISR,8883800,Asia,258,16506,53
2020-05-13T00:00:00Z,13,5,2020,23,2,Israel,IL,ISR,8883800,Asia,260,16529,54
2020-05-14T00:00:00Z,14,5,2020,19,4,Israel,IL,ISR,8883800,Asia,264,16548,55
2020-05-15T00:00:00Z,15,5,2020,31,1,Israel,IL,ISR,8883800,Asia,265,16579,56
2020-05-16T00:00:00Z,16,5,2020,10,1,Israel,IL,ISR,8883800,Asia,266,16589,57
2020-05-17T00:00:00Z,17,5,2020,19,2,Israel,IL,ISR,8883800,Asia,268,16608,58
2020-05-18T00:00:00Z,18,5,2020,9,4,Israel,IL,ISR,8883800,Asia,272,16617,59
2020-05-19T00:00:00Z,19,5,2020,4,0,Israel,IL,ISR,8883800,Asia,272,16621,60
2020-05-20T00:00:00Z,20,5,2020,29,5,Israel,IL,ISR,8883800,Asia,277,16650,61
2020-05-21T00:00:00Z,21,5,2020,20,2,Israel,IL,ISR,8883800,Asia,279,16670,62
2020-05-22T00:00:00Z,22,5,2020,20,0,Israel,IL,ISR,8883800,Asia,279,16690,63
2020-05-23T00:00:00Z,23,5,2020,0,0,Israel,IL,ISR,8883800,Asia,279,16690,64
2020-05-24T00:00:00Z,24,5,2020,0,0,Israel,IL,ISR,8883800,Asia,279,16690,65
2020-05-25T00:00:00Z,25,5,2020,30,1,Israel,IL,ISR,8883800,Asia,280,16720,66
2020-05-26T00:00:00Z,26,5,2020,14,1,Israel,IL,ISR,8883800,Asia,281,16734,67
2020-05-27T00:00:00Z,27,5,2020,23,0,Israel,IL,ISR,8883800,Asia,281,16757,68
2020-02-23T00:00:00Z,23,2,2020,62,2,Italy,IT,ITA,60431283,Europe,2,79,1
2020-02-24T00:00:00Z,24,2,2020,53,0,Italy,IT,ITA,60431283,Europe,2,132,2
2020-02-25T00:00:00Z,25,2,2020,97,4,Italy,IT,ITA,60431283,Europe,6,229,3
2020-02-26T00:00:00Z,26,2,2020,93,5,Italy,IT,ITA,60431283,Europe,11,322,4
2020-02-27T00:00:00Z,27,2,2020,78,1,Italy,IT,ITA,60431283,Europe,12,400,5
2020-02-28T00:00:00Z,28,2,2020,250,5,Italy,IT,ITA,60431283,Europe,17,650,6
2020-02-29T00:00:00Z,29,2,2020,238,4,Italy,IT,ITA,60431283,Europe,21,888,7
2020-03-01T00:00:00Z,1,3,2020,240,8,Italy,IT,ITA,60431283,Europe,29,1128,8
2020-03-02T00:00:00Z,2,3,2020,561,6,Italy,IT,ITA,60431283,Europe,35,1689,9
2020-03-03T00:00:00Z,3,3,2020,347,17,Italy,IT,ITA,60431283,Europe,52,2036,10
2020-03-04T00:00:00Z,4,3,2020,466,28,Italy,IT,ITA,60431283,Europe,80,2502,11
2020-03-05T00:00:00Z,5,3,2020,587,27,Italy,IT,ITA,60431283,Europe,107,3089,12
2020-03-06T00:00:00Z,6,3,2020,769,41,Italy,IT,ITA,60431283,Europe,148,3858,13
2020-03-07T00:00:00Z,7,3,2020,778,49,Italy,IT,ITA,60431283,Europe,197,4636,14
2020-03-08T00:00:00Z,8,3,2020,1247,36,Italy,IT,ITA,60431283,Europe,233,5883,15
2020-03-09T00:00:00Z,9,3,2020,1492,133,Italy,IT,ITA,60431283,Europe,366,7375,16
2020-03-10T00:00:00Z,10,3,2020,1797,98,Italy,IT,ITA,60431283,Europe,464,9172,17
2020-03-11T00:00:00Z,11,3,2020,977,167,Italy,IT,ITA,60431283,Europe,631,10149,18
2020-03-12T00:00:00Z,12,3,2020,2313,196,Italy,IT,ITA,60431283,Europe,827,12462,19
2020-03-13T00:00:00Z,13,3,2020,2651,189,Italy,IT,ITA,60431283,Europe,1016,15113,20
2020-03-14T00:00:00Z,14,3,2020,2547,252,Italy,IT,ITA,60431283,Europe,1268,17660,21
2020-03-15T00:00:00Z,15,3,2020,3497,173,Italy,IT,ITA,60431283,Europe,1441,21157,22
2020-03-16T00:00:00Z,16,3,2020,2823,370,Italy,IT,ITA,60431283,Europe,1811,23980,23
2020-03-17T00:00:00Z,17,3,2020,4000,347,Italy,IT,ITA,60431283,Europe,2158,27980,24
2020-03-18T00:00:00Z,18,3,2020,3526,347,Italy,IT,ITA,60431283,Europe,2505,31506,25
2020-03-19T00:00:00Z,19,3,2020,4207,473,Italy,IT,ITA,60431283,Europe,2978,35713,26
2020-03-20T00:00:00Z,20,3,2020,5322,429,Italy,IT,ITA,60431283,Europe,3407,41035,27
2020-03-21T00:00:00Z,21,3,2020,5986,625,Italy,IT,ITA,60431283,Europe,4032,47021,28
2020-03-22T00:00:00Z,22,3,2020,6557,795,Italy,IT,ITA,60431283,Europe,4827,53578,29
2020-03-23T00:00:00Z,23,3,2020,5560,649,Italy,IT,ITA,60431283,Europe,5476,59138,30
2020-03-24T00:00:00Z,24,3,2020,4789,601,Italy,IT,ITA,60431283,Europe,6077,63927,31
2020-03-25T00:00:00Z,25,3,2020,5249,743,Italy,IT,ITA,60431283,Europe,6820,69176,32
2020-03-26T00:00:00Z,26,3,2020,5210,685,Italy,IT,ITA,60431283,Europe,7505,74386,33
2020-03-27T00:00:00Z,27,3,2020,6153,660,Italy,IT,ITA,60431283,Europe,8165,80539,34
2020-03-28T00:00:00Z,28,3,2020,5959,971,Italy,IT,ITA,60431283,Europe,9136,86498,35
2020-03-29T00:00:00Z,29,3,2020,5974,887,Italy,IT,ITA,60431283,Europe,10023,92472,36
2020-03-30T00:00:00Z,30,3,2020,5217,758,Italy,IT,ITA,60431283,Europe,10781,97689,37
2020-03-31T00:00:00Z,31,3,2020,4050,810,Italy,IT,ITA,60431283,Europe,11591,101739,38
2020-04-01T00:00:00Z,1,4,2020,4053,839,Italy,IT,ITA,60431283,Europe,12430,105792,39
2020-04-02T00:00:00Z,2,4,2020,4782,727,Italy,IT,ITA,60431283,Europe,13157,110574,40
2020-04-03T00:00:00Z,3,4,2020,4668,760,Italy,IT,ITA,60431283,Europe,13917,115242,41
2020-04-04T00:00:00Z,4,4,2020,4585,764,Italy,IT,ITA,60431283,Europe,14681,119827,42
2020-04-05T00:00:00Z,5,4,2020,4805,681,Italy,IT,ITA,60431283,Europe,15362,124632,43
2020-04-06T00:00:00Z,6,4,2020,4316,527,Italy,IT,ITA,60431283,Europe,15889,128948,44
2020-04-07T00:00:00Z,7,4,2020,3599,636,Italy,IT,ITA,60431283,Europe,16525,132547,45
2020-04-08T00:00:00Z,8,4,2020,3039,604,Italy,IT,ITA,60431283,Europe,17129,135586,46
2020-04-09T00:00:00Z,9,4,2020,3836,540,Italy,IT,ITA,60431283,Europe,17669,139422,47
2020-04-10T00:00:00Z,10,4,2020,4204,612,Italy,IT,ITA,60431283,Europe,18281,143626,48
2020-04-11T00:00:00Z,11,4,2020,3951,570,Italy,IT,ITA,60431283,Europe,18851,147577,49
2020-04-12T00:00:00Z,12,4,2020,4694,619,Italy,IT,ITA,60431283,Europe,19470,152271,50
2020-04-13T00:00:00Z,13,4,2020,4092,431,Italy,IT,ITA,60431283,Europe,19901,156363,51
2020-04-14T00:00:00Z,14,4,2020,3153,564,Italy,IT,ITA,60431283,Europe,20465,159516,52
2020-04-15T00:00:00Z,15,4,2020,2972,604,Italy,IT,ITA,60431283,Europe,21069,162488,53
2020-04-16T00:00:00Z,16,4,2020,2667,578,Italy,IT,ITA,60431283,Europe,21647,165155,54
2020-04-17T00:00:00Z,17,4,2020,3786,525,Italy,IT,ITA,60431283,Europe,22172,168941,55
2020-04-18T00:00:00Z,18,4,2020,3493,575,Italy,IT,ITA,60431283,Europe,22747,172434,56
2020-04-19T00:00:00Z,19,4,2020,3491,480,Italy,IT,ITA,60431283,Europe,23227,175925,57
2020-04-20T00:00:00Z,20,4,2020,3047,433,Italy,IT,ITA,60431283,Europe,23660,178972,58
2020-04-21T00:00:00Z,21,4,2020,2256,454,Italy,IT,ITA,60431283,Europe,24114,181228,59
2020-04-22T00:00:00Z,22,4,2020,2729,534,Italy,IT,ITA,60431283,Europe,24648,183957,60
2020-04-23T00:00:00Z,23,4,2020,3370,437,Italy,IT,ITA,60431283,Europe,25085,187327,61
2020-04-24T00:00:00Z,24,4,2020,2646,464,Italy,IT,ITA,60431283,Europe,25549,189973,62
2020-04-25T00:00:00Z,25,4,2020,3021,420,Italy,IT,ITA,60431283,Europe,25969,192994,63
2020-04-26T00:00:00Z,26,4,2020,2357,415,Italy,IT,ITA,60431283,Europe,26384,195351,64
2020-04-27T00:00:00Z,27,4,2020,2324,260,Italy,IT,ITA,60431283,Europe,26644,197675,65
2020-04-28T00:00:00Z,28,4,2020,1739,333,Italy,IT,ITA,60431283,Europe,26977,199414,66
2020-04-29T00:00:00Z,29,4,2020,2091,382,Italy,IT,ITA,60431283,Europe,27359,201505,67
2020-04-30T00:00:00Z,30,4,2020,2086,323,Italy,IT,ITA,60431283,Europe,27682,203591,68
2020-05-01T00:00:00Z,1,5,2020,1872,285,Italy,IT,ITA,60431283,Europe,27967,205463,69
2020-05-02T00:00:00Z,2,5,2020,1965,269,Italy,IT,ITA,60431283,Europe,28236,207428,70
2020-05-03T00:00:00Z,3,5,2020,1900,474,Italy,IT,ITA,60431283,Europe,28710,209328,71
2020-05-04T00:00:00Z,4,5,2020,1389,174,Italy,IT,ITA,60431283,Europe,28884,210717,72
2020-05-05T00:00:00Z,5,5,2020,1221,195,Italy,IT,ITA,60431283,Europe,29079,211938,73
2020-05-06T00:00:00Z,6,5,2020,1075,236,Italy,IT,ITA,60431283,Europe,29315,213013,74
2020-05-07T00:00:00Z,7,5,2020,1444,369,Italy,IT,ITA,60431283,Europe,29684,214457,75
2020-05-08T00:00:00Z,8,5,2020,1401,274,Italy,IT,ITA,60431283,Europe,29958,215858,76
2020-05-09T00:00:00Z,9,5,2020,1327,243,Italy,IT,ITA,60431283,Europe,30201,217185,77
2020-05-10T00:00:00Z,10,5,2020,1083,194,Italy,IT,ITA,60431283,Europe,30395,218268,78
2020-05-11T00:00:00Z,11,5,2020,802,165,Italy,IT,ITA,60431283,Europe,30560,219070,79
2020-05-12T00:00:00Z,12,5,2020,744,179,Italy,IT,ITA,60431283,Europe,30739,219814,80
2020-05-13T00:00:00Z,13,5,2020,1402,172,Italy,IT,ITA,60431283,Europe,30911,221216,81
2020-05-14T00:00:00Z,14,5,2020,888,195,Italy,IT,ITA,60431283,Europe,31106,222104,82
2020-05-15T00:00:00Z,15,5,2020,992,262,Italy,IT,ITA,60431283,Europe,31368,223096,83
2020-05-16T00:00:00Z,16,5,2020,789,242,Italy,IT,ITA,60431283,Europe,31610,223885,84
2020-05-17T00:00:00Z,17,5,2020,875,153,Italy,IT,ITA,60431283,Europe,31763,224760,85
2020-05-18T00:00:00Z,18,5,2020,675,145,Italy,IT,ITA,60431283,Europe,31908,225435,86
2020-05-19T00:00:00Z,19,5,2020,451,99,Italy,IT,ITA,60431283,Europe,32007,225886,87
2020-05-20T00:00:00Z,20,5,2020,813,162,Italy,IT,ITA,60431283,Europe,32169,226699,88
2020-05-21T00:00:00Z,21,5,2020,665,161,Italy,IT,ITA,60431283,Europe,32330,227364,89
2020-05-22T00:00:00Z,22,5,2020,642,156,Italy,IT,ITA,60431283,Europe,32486,228006,90
2020-05-23T00:00:00Z,23,5,2020,652,130,Italy,IT,ITA,60431283,Europe,32616,228658,91
2020-05-24T00:00:00Z,24,5,2020,669,119,Italy,IT,ITA,60431283,Europe,32735,229327,92
2020-05-25T00:00:00Z,25,5,2020,531,50,Italy,IT,ITA,60431283,Europe,32785,229858,93
2020-05-26T00:00:00Z,26,5,2020,300,92,Italy,IT,ITA,60431283,Europe,32877,230158,94
2020-05-27T00:00:00Z,27,5,2020,397,78,Italy,IT,ITA,60431283,Europe,32955,230555,95
2020-03-25T00:00:00Z,25,3,2020,2,1,Jamaica,JM,JAM,2934855,America,1,21,1
2020-03-26T00:00:00Z,26,3,2020,4,0,Jamaica,JM,JAM,2934855,America,1,25,2
2020-03-27T00:00:00Z,27,3,2020,1,0,Jamaica,JM,JAM,2934855,America,1,26,3
2020-03-28T00:00:00Z,28,3,2020,0,0,Jamaica,JM,JAM,2934855,America,1,26,4
2020-03-29T00:00:00Z,29,3,2020,6,0,Jamaica,JM,JAM,2934855,America,1,32,5
2020-03-30T00:00:00Z,30,3,2020,2,0,Jamaica,JM,JAM,2934855,America,1,34,6
2020-03-31T00:00:00Z,31,3,2020,4,0,Jamaica,JM,JAM,2934855,America,1,38,7
2020-04-01T00:00:00Z,1,4,2020,0,0,Jamaica,JM,JAM,2934855,America,1,38,8
2020-04-02T00:00:00Z,2,4,2020,6,2,Jamaica,JM,JAM,2934855,America,3,44,9
2020-04-03T00:00:00Z,3,4,2020,3,0,Jamaica,JM,JAM,2934855,America,3,47,10
2020-04-04T00:00:00Z,4,4,2020,6,0,Jamaica,JM,JAM,2934855,America,3,53,11
2020-04-05T00:00:00Z,5,4,2020,2,0,Jamaica,JM,JAM,2934855,America,3,55,12
2020-04-06T00:00:00Z,6,4,2020,3,0,Jamaica,JM,JAM,2934855,America,3,58,13
2020-04-07T00:00:00Z,7,4,2020,1,0,Jamaica,JM,JAM,2934855,America,3,59,14
2020-04-08T00:00:00Z,8,4,2020,4,0,Jamaica,JM,JAM,2934855,America,3,63,15
2020-04-09T00:00:00Z,9,4,2020,0,1,Jamaica,JM,JAM,2934855,America,4,63,16
2020-04-10T00:00:00Z,10,4,2020,0,0,Jamaica,JM,JAM,2934855,America,4,63,17
2020-04-11T00:00:00Z,11,4,2020,2,0,Jamaica,JM,JAM,2934855,America,4,65,18
2020-04-12T00:00:00Z,12,4,2020,4,0,Jamaica,JM,JAM,2934855,America,4,69,19
2020-04-13T00:00:00Z,13,4,2020,3,0,Jamaica,JM,JAM,2934855,America,4,72,20
2020-04-14T00:00:00Z,14,4,2020,1,0,Jamaica,JM,JAM,2934855,America,4,73,21
2020-04-15T00:00:00Z,15,4,2020,32,1,Jamaica,JM,JAM,2934855,America,5,105,22
2020-04-16T00:00:00Z,16,4,2020,20,0,Jamaica,JM,JAM,2934855,America,5,125,23
2020-04-17T00:00:00Z,17,4,2020,18,0,Jamaica,JM,JAM,2934855,America,5,143,24
2020-04-18T00:00:00Z,18,4,2020,20,0,Jamaica,JM,JAM,2934855,America,5,163,25
2020-04-19T00:00:00Z,19,4,2020,10,0,Jamaica,JM,JAM,2934855,America,5,173,26
2020-04-20T00:00:00Z,20,4,2020,23,0,Jamaica,JM,JAM,2934855,America,5,196,27
2020-04-21T00:00:00Z,21,4,2020,27,1,Jamaica,JM,JAM,2934855,America,6,223,28
2020-04-22T00:00:00Z,22,4,2020,10,0,Jamaica,JM,JAM,2934855,America,6,233,29
2020-04-23T00:00:00Z,23,4,2020,19,0,Jamaica,JM,JAM,2934855,America,6,252,30
2020-04-24T00:00:00Z,24,4,2020,0,0,Jamaica,JM,JAM,2934855,America,6,252,31
2020-04-25T00:00:00Z,25,4,2020,36,1,Jamaica,JM,JAM,2934855,America,7,288,32
2020-04-26T00:00:00Z,26,4,2020,17,0,Jamaica,JM,JAM,2934855,America,7,305,33
2020-04-27T00:00:00Z,27,4,2020,45,0,Jamaica,JM,JAM,2934855,America,7,350,34
2020-04-28T00:00:00Z,28,4,2020,14,0,Jamaica,JM,JAM,2934855,America,7,364,35
2020-04-29T00:00:00Z,29,4,2020,17,0,Jamaica,JM,JAM,2934855,America,7,381,36
2020-04-30T00:00:00Z,30,4,2020,15,0,Jamaica,JM,JAM,2934855,America,7,396,37
2020-05-01T00:00:00Z,1,5,2020,26,1,Jamaica,JM,JAM,2934855,America,8,422,38
2020-05-02T00:00:00Z,2,5,2020,10,0,Jamaica,JM,JAM,2934855,America,8,432,39
2020-05-03T00:00:00Z,3,5,2020,31,0,Jamaica,JM,JAM,2934855,America,8,463,40
2020-05-04T00:00:00Z,4,5,2020,6,1,Jamaica,JM,JAM,2934855,America,9,469,41
2020-05-05T00:00:00Z,5,5,2020,2,0,Jamaica,JM,JAM,2934855,America,9,471,42
2020-05-06T00:00:00Z,6,5,2020,2,0,Jamaica,JM,JAM,2934855,America,9,473,43
2020-05-07T00:00:00Z,7,5,2020,5,0,Jamaica,JM,JAM,2934855,America,9,478,44
2020-05-08T00:00:00Z,8,5,2020,10,0,Jamaica,JM,JAM,2934855,America,9,488,45
2020-05-09T00:00:00Z,9,5,2020,2,0,Jamaica,JM,JAM,2934855,America,9,490,46
2020-05-10T00:00:00Z,10,5,2020,8,0,Jamaica,JM,JAM,2934855,America,9,498,47
2020-05-11T00:00:00Z,11,5,2020,4,0,Jamaica,JM,JAM,2934855,America,9,502,48
2020-05-12T00:00:00Z,12,5,2020,3,0,Jamaica,JM,JAM,2934855,America,9,505,49
2020-05-13T00:00:00Z,13,5,2020,2,0,Jamaica,JM,JAM,2934855,America,9,507,50
2020-05-14T00:00:00Z,14,5,2020,2,0,Jamaica,JM,JAM,2934855,America,9,509,51
2020-05-15T00:00:00Z,15,5,2020,0,0,Jamaica,JM,JAM,2934855,America,9,509,52
2020-05-16T00:00:00Z,16,5,2020,2,0,Jamaica,JM,JAM,2934855,America,9,511,53
2020-05-17T00:00:00Z,17,5,2020,6,0,Jamaica,JM,JAM,2934855,America,9,517,54
2020-05-18T00:00:00Z,18,5,2020,3,0,Jamaica,JM,JAM,2934855,America,9,520,55
2020-05-19T00:00:00Z,19,5,2020,0,0,Jamaica,JM,JAM,2934855,America,9,520,56
2020-05-20T00:00:00Z,20,5,2020,0,0,Jamaica,JM,JAM,2934855,America,9,520,57
2020-05-21T00:00:00Z,21,5,2020,9,0,Jamaica,JM,JAM,2934855,America,9,529,58
2020-05-22T00:00:00Z,22,5,2020,5,0,Jamaica,JM,JAM,2934855,America,9,534,59
2020-05-23T00:00:00Z,23,5,2020,10,0,Jamaica,JM,JAM,2934855,America,9,544,60
2020-05-24T00:00:00Z,24,5,2020,6,0,Jamaica,JM,JAM,2934855,America,9,550,61
2020-05-25T00:00:00Z,25,5,2020,2,0,Jamaica,JM,JAM,2934855,America,9,552,62
2020-05-26T00:00:00Z,26,5,2020,4,0,Jamaica,JM,JAM,2934855,America,9,556,63
2020-05-27T00:00:00Z,27,5,2020,8,0,Jamaica,JM,JAM,2934855,America,9,564,64
2020-02-13T00:00:00Z,13,2,2020,4,1,Japan,JP,JPN,126529100,Asia,1,29,1
2020-02-14T00:00:00Z,14,2,2020,1,0,Japan,JP,JPN,126529100,Asia,1,30,2
2020-02-15T00:00:00Z,15,2,2020,8,0,Japan,JP,JPN,126529100,Asia,1,38,3
2020-02-16T00:00:00Z,16,2,2020,14,0,Japan,JP,JPN,126529100,Asia,1,52,4
2020-02-17T00:00:00Z,17,2,2020,7,0,Japan,JP,JPN,126529100,Asia,1,59,5
2020-02-18T00:00:00Z,18,2,2020,0,0,Japan,JP,JPN,126529100,Asia,1,59,6
2020-02-19T00:00:00Z,19,2,2020,7,0,Japan,JP,JPN,126529100,Asia,1,66,7
2020-02-20T00:00:00Z,20,2,2020,18,0,Japan,JP,JPN,126529100,Asia,1,84,8
2020-02-21T00:00:00Z,21,2,2020,9,0,Japan,JP,JPN,126529100,Asia,1,93,9
2020-02-22T00:00:00Z,22,2,2020,12,0,Japan,JP,JPN,126529100,Asia,1,105,10
2020-02-23T00:00:00Z,23,2,2020,27,0,Japan,JP,JPN,126529100,Asia,1,132,11
2020-02-24T00:00:00Z,24,2,2020,12,0,Japan,JP,JPN,126529100,Asia,1,144,12
2020-02-25T00:00:00Z,25,2,2020,0,0,Japan,JP,JPN,126529100,Asia,1,144,13
2020-02-26T00:00:00Z,26,2,2020,20,0,Japan,JP,JPN,126529100,Asia,1,164,14
2020-02-27T00:00:00Z,27,2,2020,22,2,Japan,JP,JPN,126529100,Asia,3,186,15
2020-02-28T00:00:00Z,28,2,2020,24,0,Japan,JP,JPN,126529100,Asia,3,210,16
2020-02-29T00:00:00Z,29,2,2020,20,0,Japan,JP,JPN,126529100,Asia,3,230,17
2020-03-01T00:00:00Z,1,3,2020,9,2,Japan,JP,JPN,126529100,Asia,5,239,18
2020-03-02T00:00:00Z,2,3,2020,15,1,Japan,JP,JPN,126529100,Asia,6,254,19
2020-03-03T00:00:00Z,3,3,2020,0,0,Japan,JP,JPN,126529100,Asia,6,254,20
2020-03-04T00:00:00Z,4,3,2020,14,0,Japan,JP,JPN,126529100,Asia,6,268,21
2020-03-05T00:00:00Z,5,3,2020,49,0,Japan,JP,JPN,126529100,Asia,6,317,22
2020-03-06T00:00:00Z,6,3,2020,32,0,Japan,JP,JPN,126529100,Asia,6,349,23
2020-03-07T00:00:00Z,7,3,2020,59,0,Japan,JP,JPN,126529100,Asia,6,408,24
2020-03-08T00:00:00Z,8,3,2020,47,0,Japan,JP,JPN,126529100,Asia,6,455,25
2020-03-09T00:00:00Z,9,3,2020,33,1,Japan,JP,JPN,126529100,Asia,7,488,26
2020-03-10T00:00:00Z,10,3,2020,26,2,Japan,JP,JPN,126529100,Asia,9,514,27
2020-03-11T00:00:00Z,11,3,2020,54,3,Japan,JP,JPN,126529100,Asia,12,568,28
2020-03-12T00:00:00Z,12,3,2020,51,3,Japan,JP,JPN,126529100,Asia,15,619,29
2020-03-13T00:00:00Z,13,3,2020,56,4,Japan,JP,JPN,126529100,Asia,19,675,30
2020-03-14T00:00:00Z,14,3,2020,62,2,Japan,JP,JPN,126529100,Asia,21,737,31
2020-03-15T00:00:00Z,15,3,2020,43,1,Japan,JP,JPN,126529100,Asia,22,780,32
2020-03-16T00:00:00Z,16,3,2020,34,2,Japan,JP,JPN,126529100,Asia,24,814,33
2020-03-17T00:00:00Z,17,3,2020,10,4,Japan,JP,JPN,126529100,Asia,28,824,34
2020-03-18T00:00:00Z,18,3,2020,5,0,Japan,JP,JPN,126529100,Asia,28,829,35
2020-03-19T00:00:00Z,19,3,2020,44,1,Japan,JP,JPN,126529100,Asia,29,873,36
2020-03-20T00:00:00Z,20,3,2020,77,4,Japan,JP,JPN,126529100,Asia,33,950,37
2020-03-21T00:00:00Z,21,3,2020,57,2,Japan,JP,JPN,126529100,Asia,35,1007,38
2020-03-22T00:00:00Z,22,3,2020,39,1,Japan,JP,JPN,126529100,Asia,36,1046,39
2020-03-23T00:00:00Z,23,3,2020,43,5,Japan,JP,JPN,126529100,Asia,41,1089,40
2020-03-24T00:00:00Z,24,3,2020,39,1,Japan,JP,JPN,126529100,Asia,42,1128,41
2020-03-25T00:00:00Z,25,3,2020,65,1,Japan,JP,JPN,126529100,Asia,43,1193,42
2020-03-26T00:00:00Z,26,3,2020,75,2,Japan,JP,JPN,126529100,Asia,45,1268,43
2020-03-27T00:00:00Z,27,3,2020,96,1,Japan,JP,JPN,126529100,Asia,46,1364,44
2020-03-28T00:00:00Z,28,3,2020,135,3,Japan,JP,JPN,126529100,Asia,49,1499,45
2020-03-29T00:00:00Z,29,3,2020,194,3,Japan,JP,JPN,126529100,Asia,52,1693,46
2020-03-30T00:00:00Z,30,3,2020,173,2,Japan,JP,JPN,126529100,Asia,54,1866,47
2020-03-31T00:00:00Z,31,3,2020,87,2,Japan,JP,JPN,126529100,Asia,56,1953,48
2020-04-01T00:00:00Z,1,4,2020,0,0,Japan,JP,JPN,126529100,Asia,56,1953,49
2020-04-02T00:00:00Z,2,4,2020,225,1,Japan,JP,JPN,126529100,Asia,57,2178,50
2020-04-03T00:00:00Z,3,4,2020,439,6,Japan,JP,JPN,126529100,Asia,63,2617,51
2020-04-04T00:00:00Z,4,4,2020,318,6,Japan,JP,JPN,126529100,Asia,69,2935,52
2020-04-05T00:00:00Z,5,4,2020,336,1,Japan,JP,JPN,126529100,Asia,70,3271,53
2020-04-06T00:00:00Z,6,4,2020,383,3,Japan,JP,JPN,126529100,Asia,73,3654,54
2020-04-07T00:00:00Z,7,4,2020,163,7,Japan,JP,JPN,126529100,Asia,80,3817,55
2020-04-08T00:00:00Z,8,4,2020,89,0,Japan,JP,JPN,126529100,Asia,80,3906,56
2020-04-09T00:00:00Z,9,4,2020,351,1,Japan,JP,JPN,126529100,Asia,81,4257,57
2020-04-10T00:00:00Z,10,4,2020,410,4,Japan,JP,JPN,126529100,Asia,85,4667,58
2020-04-11T00:00:00Z,11,4,2020,680,3,Japan,JP,JPN,126529100,Asia,88,5347,59
2020-04-12T00:00:00Z,12,4,2020,1401,10,Japan,JP,JPN,126529100,Asia,98,6748,60
2020-04-13T00:00:00Z,13,4,2020,507,4,Japan,JP,JPN,126529100,Asia,102,7255,61
2020-04-14T00:00:00Z,14,4,2020,390,7,Japan,JP,JPN,126529100,Asia,109,7645,62
2020-04-15T00:00:00Z,15,4,2020,455,10,Japan,JP,JPN,126529100,Asia,119,8100,63
2020-04-16T00:00:00Z,16,4,2020,482,17,Japan,JP,JPN,126529100,Asia,136,8582,64
2020-04-17T00:00:00Z,17,4,2020,585,12,Japan,JP,JPN,126529100,Asia,148,9167,65
2020-04-18T00:00:00Z,18,4,2020,628,6,Japan,JP,JPN,126529100,Asia,154,9795,66
2020-04-19T00:00:00Z,19,4,2020,566,7,Japan,JP,JPN,126529100,Asia,161,10361,67
2020-04-20T00:00:00Z,20,4,2020,390,10,Japan,JP,JPN,126529100,Asia,171,10751,68
2020-04-21T00:00:00Z,21,4,2020,367,15,Japan,JP,JPN,126529100,Asia,186,11118,69
2020-04-22T00:00:00Z,22,4,2020,378,0,Japan,JP,JPN,126529100,Asia,186,11496,70
2020-04-23T00:00:00Z,23,4,2020,276,101,Japan,JP,JPN,126529100,Asia,287,11772,71
2020-04-24T00:00:00Z,24,4,2020,468,30,Japan,JP,JPN,126529100,Asia,317,12240,72
2020-04-25T00:00:00Z,25,4,2020,652,17,Japan,JP,JPN,126529100,Asia,334,12892,73
2020-04-26T00:00:00Z,26,4,2020,290,14,Japan,JP,JPN,126529100,Asia,348,13182,74
2020-04-27T00:00:00Z,27,4,2020,203,3,Japan,JP,JPN,126529100,Asia,351,13385,75
2020-04-28T00:00:00Z,28,4,2020,191,25,Japan,JP,JPN,126529100,Asia,376,13576,76
2020-04-29T00:00:00Z,29,4,2020,276,13,Japan,JP,JPN,126529100,Asia,389,13852,77
2020-04-30T00:00:00Z,30,4,2020,236,26,Japan,JP,JPN,126529100,Asia,415,14088,78
2020-05-01T00:00:00Z,1,5,2020,193,17,Japan,JP,JPN,126529100,Asia,432,14281,79
2020-05-02T00:00:00Z,2,5,2020,263,26,Japan,JP,JPN,126529100,Asia,458,14544,80
2020-05-03T00:00:00Z,3,5,2020,295,34,Japan,JP,JPN,126529100,Asia,492,14839,81
2020-05-04T00:00:00Z,4,5,2020,218,18,Japan,JP,JPN,126529100,Asia,510,15057,82
2020-05-05T00:00:00Z,5,5,2020,174,11,Japan,JP,JPN,126529100,Asia,521,15231,83
2020-05-06T00:00:00Z,6,5,2020,123,22,Japan,JP,JPN,126529100,Asia,543,15354,84
2020-05-07T00:00:00Z,7,5,2020,109,8,Japan,JP,JPN,126529100,Asia,551,15463,85
2020-05-08T00:00:00Z,8,5,2020,84,6,Japan,JP,JPN,126529100,Asia,557,15547,86
2020-05-09T00:00:00Z,9,5,2020,81,44,Japan,JP,JPN,126529100,Asia,601,15628,87
2020-05-10T00:00:00Z,10,5,2020,119,12,Japan,JP,JPN,126529100,Asia,613,15747,88
2020-05-11T00:00:00Z,11,5,2020,51,8,Japan,JP,JPN,126529100,Asia,621,15798,89
2020-05-12T00:00:00Z,12,5,2020,76,22,Japan,JP,JPN,126529100,Asia,643,15874,90
2020-05-13T00:00:00Z,13,5,2020,150,25,Japan,JP,JPN,126529100,Asia,668,16024,91
2020-05-14T00:00:00Z,14,5,2020,55,19,Japan,JP,JPN,126529100,Asia,687,16079,92
2020-05-15T00:00:00Z,15,5,2020,114,23,Japan,JP,JPN,126529100,Asia,710,16193,93
2020-05-16T00:00:00Z,16,5,2020,44,15,Japan,JP,JPN,126529100,Asia,725,16237,94
2020-05-17T00:00:00Z,17,5,2020,48,19,Japan,JP,JPN,126529100,Asia,744,16285,95
2020-05-18T00:00:00Z,18,5,2020,20,5,Japan,JP,JPN,126529100,Asia,749,16305,96
2020-05-19T00:00:00Z,19,5,2020,60,14,Japan,JP,JPN,126529100,Asia,763,16365,97
2020-05-20T00:00:00Z,20,5,2020,20,8,Japan,JP,JPN,126529100,Asia,771,16385,98
2020-05-21T00:00:00Z,21,5,2020,39,6,Japan,JP,JPN,126529100,Asia,777,16424,99
2020-05-22T00:00:00Z,22,5,2020,89,19,Japan,JP,JPN,126529100,Asia,796,16513,100
2020-05-23T00:00:00Z,23,5,2020,23,12,Japan,JP,JPN,126529100,Asia,808,16536,101
2020-05-24T00:00:00Z,24,5,2020,14,12,Japan,JP,JPN,126529100,Asia,820,16550,102
2020-05-25T00:00:00Z,25,5,2020,31,10,Japan,JP,JPN,126529100,Asia,830,16581,103
2020-05-26T00:00:00Z,26,5,2020,42,16,Japan,JP,JPN,126529100,Asia,846,16623,104
2020-05-27T00:00:00Z,27,5,2020,28,12,Japan,JP,JPN,126529100,Asia,858,16651,105
2020-03-27T00:00:00Z,27,3,2020,14,1,Jersey,JE,JEY,106800,Europe,1,32,1
2020-03-28T00:00:00Z,28,3,2020,20,0,Jersey,JE,JEY,106800,Europe,1,52,2
2020-03-29T00:00:00Z,29,3,2020,9,0,Jersey,JE,JEY,106800,Europe,1,61,3
2020-03-30T00:00:00Z,30,3,2020,2,1,Jersey,JE,JEY,106800,Europe,2,63,4
2020-03-31T00:00:00Z,31,3,2020,0,0,Jersey,JE,JEY,106800,Europe,2,63,5
2020-04-01T00:00:00Z,1,4,2020,18,0,Jersey,JE,JEY,106800,Europe,2,81,6
2020-04-02T00:00:00Z,2,4,2020,0,0,Jersey,JE,JEY,106800,Europe,2,81,7
2020-04-03T00:00:00Z,3,4,2020,0,0,Jersey,JE,JEY,106800,Europe,2,81,8
2020-04-04T00:00:00Z,4,4,2020,37,0,Jersey,JE,JEY,106800,Europe,2,118,9
2020-04-05T00:00:00Z,5,4,2020,5,1,Jersey,JE,JEY,106800,Europe,3,123,10
2020-04-06T00:00:00Z,6,4,2020,32,0,Jersey,JE,JEY,106800,Europe,3,155,11
2020-04-07T00:00:00Z,7,4,2020,14,0,Jersey,JE,JEY,106800,Europe,3,169,12
2020-04-08T00:00:00Z,8,4,2020,1,0,Jersey,JE,JEY,106800,Europe,3,170,13
2020-04-09T00:00:00Z,9,4,2020,0,0,Jersey,JE,JEY,106800,Europe,3,170,14
2020-04-10T00:00:00Z,10,4,2020,13,0,Jersey,JE,JEY,106800,Europe,3,183,15
2020-04-11T00:00:00Z,11,4,2020,15,1,Jersey,JE,JEY,106800,Europe,4,198,16
2020-04-12T00:00:00Z,12,4,2020,0,0,Jersey,JE,JEY,106800,Europe,4,198,17
2020-04-13T00:00:00Z,13,4,2020,15,0,Jersey,JE,JEY,106800,Europe,4,213,18
2020-04-14T00:00:00Z,14,4,2020,4,0,Jersey,JE,JEY,106800,Europe,4,217,19
2020-04-15T00:00:00Z,15,4,2020,0,0,Jersey,JE,JEY,106800,Europe,4,217,20
2020-04-16T00:00:00Z,16,4,2020,0,2,Jersey,JE,JEY,106800,Europe,6,217,21
2020-04-17T00:00:00Z,17,4,2020,6,4,Jersey,JE,JEY,106800,Europe,10,223,22
2020-04-18T00:00:00Z,18,4,2020,1,1,Jersey,JE,JEY,106800,Europe,11,224,23
2020-04-19T00:00:00Z,19,4,2020,21,1,Jersey,JE,JEY,106800,Europe,12,245,24
2020-04-20T00:00:00Z,20,4,2020,4,0,Jersey,JE,JEY,106800,Europe,12,249,25
2020-04-21T00:00:00Z,21,4,2020,0,2,Jersey,JE,JEY,106800,Europe,14,249,26
2020-04-22T00:00:00Z,22,4,2020,6,0,Jersey,JE,JEY,106800,Europe,14,255,27
2020-04-23T00:00:00Z,23,4,2020,0,4,Jersey,JE,JEY,106800,Europe,18,255,28
2020-04-24T00:00:00Z,24,4,2020,21,1,Jersey,JE,JEY,106800,Europe,19,276,29
2020-04-25T00:00:00Z,25,4,2020,2,0,Jersey,JE,JEY,106800,Europe,19,278,30
2020-04-26T00:00:00Z,26,4,2020,2,0,Jersey,JE,JEY,106800,Europe,19,280,31
2020-04-27T00:00:00Z,27,4,2020,1,0,Jersey,JE,JEY,106800,Europe,19,281,32
2020-04-28T00:00:00Z,28,4,2020,2,0,Jersey,JE,JEY,106800,Europe,19,283,33
2020-04-29T00:00:00Z,29,4,2020,1,1,Jersey,JE,JEY,106800,Europe,20,284,34
2020-04-30T00:00:00Z,30,4,2020,2,1,Jersey,JE,JEY,106800,Europe,21,286,35
2020-05-01T00:00:00Z,1,5,2020,0,2,Jersey,JE,JEY,106800,Europe,23,286,36
2020-05-02T00:00:00Z,2,5,2020,0,1,Jersey,JE,JEY,106800,Europe,24,286,37
2020-05-03T00:00:00Z,3,5,2020,5,0,Jersey,JE,JEY,106800,Europe,24,291,38
2020-05-04T00:00:00Z,4,5,2020,1,0,Jersey,JE,JEY,106800,Europe,24,292,39
2020-05-05T00:00:00Z,5,5,2020,1,0,Jersey,JE,JEY,106800,Europe,24,293,40
2020-05-06T00:00:00Z,6,5,2020,0,0,Jersey,JE,JEY,106800,Europe,24,293,41
2020-05-07T00:00:00Z,7,5,2020,0,1,Jersey,JE,JEY,106800,Europe,25,293,42
2020-05-08T00:00:00Z,8,5,2020,0,0,Jersey,JE,JEY,106800,Europe,25,293,43
2020-05-09T00:00:00Z,9,5,2020,0,0,Jersey,JE,JEY,106800,Europe,25,293,44
2020-05-10T00:00:00Z,10,5,2020,0,0,Jersey,JE,JEY,106800,Europe,25,293,45
2020-05-11T00:00:00Z,11,5,2020,1,0,Jersey,JE,JEY,106800,Europe,25,294,46
2020-05-12T00:00:00Z,12,5,2020,0,0,Jersey,JE,JEY,106800,Europe,25,294,47
2020-05-13T00:00:00Z,13,5,2020,1,1,Jersey,JE,JEY,106800,Europe,26,295,48
2020-05-14T00:00:00Z,14,5,2020,1,1,Jersey,JE,JEY,106800,Europe,27,296,49
2020-05-15T00:00:00Z,15,5,2020,1,0,Jersey,JE,JEY,106800,Europe,27,297,50
2020-05-16T00:00:00Z,16,5,2020,0,0,Jersey,JE,JEY,106800,Europe,27,297,51
2020-05-17T00:00:00Z,17,5,2020,5,0,Jersey,JE,JEY,106800,Europe,27,302,52
2020-05-18T00:00:00Z,18,5,2020,0,0,Jersey,JE,JEY,106800,Europe,27,302,53
2020-05-19T00:00:00Z,19,5,2020,1,0,Jersey,JE,JEY,106800,Europe,27,303,54
2020-05-20T00:00:00Z,20,5,2020,0,1,Jersey,JE,JEY,106800,Europe,28,303,55
2020-05-21T00:00:00Z,21,5,2020,3,1,Jersey,JE,JEY,106800,Europe,29,306,56
2020-05-22T00:00:00Z,22,5,2020,0,0,Jersey,JE,JEY,106800,Europe,29,306,57
2020-05-23T00:00:00Z,23,5,2020,0,0,Jersey,JE,JEY,106800,Europe,29,306,58
2020-05-24T00:00:00Z,24,5,2020,0,0,Jersey,JE,JEY,106800,Europe,29,306,59
2020-05-25T00:00:00Z,25,5,2020,0,0,Jersey,JE,JEY,106800,Europe,29,306,60
2020-05-26T00:00:00Z,26,5,2020,1,0,Jersey,JE,JEY,106800,Europe,29,307,61
2020-05-27T00:00:00Z,27,5,2020,0,0,Jersey,JE,JEY,106800,Europe,29,307,62
2020-03-29T00:00:00Z,29,3,2020,23,1,Jordan,JO,JOR,9956011,Asia,1,235,1
2020-03-30T00:00:00Z,30,3,2020,24,0,Jordan,JO,JOR,9956011,Asia,1,259,2
2020-03-31T00:00:00Z,31,3,2020,9,4,Jordan,JO,JOR,9956011,Asia,5,268,3
2020-04-01T00:00:00Z,1,4,2020,6,0,Jordan,JO,JOR,9956011,Asia,5,274,4
2020-04-02T00:00:00Z,2,4,2020,4,0,Jordan,JO,JOR,9956011,Asia,5,278,5
2020-04-03T00:00:00Z,3,4,2020,21,0,Jordan,JO,JOR,9956011,Asia,5,299,6
2020-04-04T00:00:00Z,4,4,2020,0,0,Jordan,JO,JOR,9956011,Asia,5,299,7
2020-04-05T00:00:00Z,5,4,2020,24,0,Jordan,JO,JOR,9956011,Asia,5,323,8
2020-04-06T00:00:00Z,6,4,2020,22,0,Jordan,JO,JOR,9956011,Asia,5,345,9
2020-04-07T00:00:00Z,7,4,2020,4,1,Jordan,JO,JOR,9956011,Asia,6,349,10
2020-04-08T00:00:00Z,8,4,2020,0,0,Jordan,JO,JOR,9956011,Asia,6,349,11
2020-04-09T00:00:00Z,9,4,2020,9,0,Jordan,JO,JOR,9956011,Asia,6,358,12
2020-04-10T00:00:00Z,10,4,2020,14,1,Jordan,JO,JOR,9956011,Asia,7,372,13
2020-04-11T00:00:00Z,11,4,2020,0,0,Jordan,JO,JOR,9956011,Asia,7,372,14
2020-04-12T00:00:00Z,12,4,2020,9,0,Jordan,JO,JOR,9956011,Asia,7,381,15
2020-04-13T00:00:00Z,13,4,2020,8,0,Jordan,JO,JOR,9956011,Asia,7,389,16
2020-04-14T00:00:00Z,14,4,2020,2,0,Jordan,JO,JOR,9956011,Asia,7,391,17
2020-04-15T00:00:00Z,15,4,2020,6,0,Jordan,JO,JOR,9956011,Asia,7,397,18
2020-04-16T00:00:00Z,16,4,2020,4,0,Jordan,JO,JOR,9956011,Asia,7,401,19
2020-04-17T00:00:00Z,17,4,2020,1,0,Jordan,JO,JOR,9956011,Asia,7,402,20
2020-04-18T00:00:00Z,18,4,2020,5,0,Jordan,JO,JOR,9956011,Asia,7,407,21
2020-04-19T00:00:00Z,19,4,2020,6,0,Jordan,JO,JOR,9956011,Asia,7,413,22
2020-04-20T00:00:00Z,20,4,2020,4,0,Jordan,JO,JOR,9956011,Asia,7,417,23
2020-04-21T00:00:00Z,21,4,2020,8,0,Jordan,JO,JOR,9956011,Asia,7,425,24
2020-04-22T00:00:00Z,22,4,2020,0,0,Jordan,JO,JOR,9956011,Asia,7,425,25
2020-04-23T00:00:00Z,23,4,2020,3,0,Jordan,JO,JOR,9956011,Asia,7,428,26
2020-04-24T00:00:00Z,24,4,2020,9,0,Jordan,JO,JOR,9956011,Asia,7,437,27
2020-04-25T00:00:00Z,25,4,2020,4,0,Jordan,JO,JOR,9956011,Asia,7,441,28
2020-04-26T00:00:00Z,26,4,2020,3,0,Jordan,JO,JOR,9956011,Asia,7,444,29
2020-04-27T00:00:00Z,27,4,2020,3,0,Jordan,JO,JOR,9956011,Asia,7,447,30
2020-04-28T00:00:00Z,28,4,2020,2,0,Jordan,JO,JOR,9956011,Asia,7,449,31
2020-04-29T00:00:00Z,29,4,2020,0,1,Jordan,JO,JOR,9956011,Asia,8,449,32
2020-04-30T00:00:00Z,30,4,2020,2,0,Jordan,JO,JOR,9956011,Asia,8,451,33
2020-05-01T00:00:00Z,1,5,2020,2,0,Jordan,JO,JOR,9956011,Asia,8,453,34
2020-05-02T00:00:00Z,2,5,2020,6,0,Jordan,JO,JOR,9956011,Asia,8,459,35
2020-05-03T00:00:00Z,3,5,2020,1,1,Jordan,JO,JOR,9956011,Asia,9,460,36
2020-05-04T00:00:00Z,4,5,2020,1,0,Jordan,JO,JOR,9956011,Asia,9,461,37
2020-05-05T00:00:00Z,5,5,2020,4,0,Jordan,JO,JOR,9956011,Asia,9,465,38
2020-05-06T00:00:00Z,6,5,2020,6,0,Jordan,JO,JOR,9956011,Asia,9,471,39
2020-05-07T00:00:00Z,7,5,2020,2,0,Jordan,JO,JOR,9956011,Asia,9,473,40
2020-05-08T00:00:00Z,8,5,2020,21,0,Jordan,JO,JOR,9956011,Asia,9,494,41
2020-05-09T00:00:00Z,9,5,2020,14,0,Jordan,JO,JOR,9956011,Asia,9,508,42
2020-05-10T00:00:00Z,10,5,2020,14,0,Jordan,JO,JOR,9956011,Asia,9,522,43
2020-05-11T00:00:00Z,11,5,2020,18,0,Jordan,JO,JOR,9956011,Asia,9,540,44
2020-05-12T00:00:00Z,12,5,2020,22,0,Jordan,JO,JOR,9956011,Asia,9,562,45
2020-05-13T00:00:00Z,13,5,2020,14,0,Jordan,JO,JOR,9956011,Asia,9,576,46
2020-05-14T00:00:00Z,14,5,2020,6,0,Jordan,JO,JOR,9956011,Asia,9,582,47
2020-05-15T00:00:00Z,15,5,2020,4,0,Jordan,JO,JOR,9956011,Asia,9,586,48
2020-05-16T00:00:00Z,16,5,2020,10,0,Jordan,JO,JOR,9956011,Asia,9,596,49
2020-05-17T00:00:00Z,17,5,2020,11,0,Jordan,JO,JOR,9956011,Asia,9,607,50
2020-05-18T00:00:00Z,18,5,2020,6,0,Jordan,JO,JOR,9956011,Asia,9,613,51
2020-05-19T00:00:00Z,19,5,2020,16,0,Jordan,JO,JOR,9956011,Asia,9,629,52
2020-05-20T00:00:00Z,20,5,2020,20,0,Jordan,JO,JOR,9956011,Asia,9,649,53
2020-05-21T00:00:00Z,21,5,2020,23,0,Jordan,JO,JOR,9956011,Asia,9,672,54
2020-05-22T00:00:00Z,22,5,2020,12,0,Jordan,JO,JOR,9956011,Asia,9,684,55
2020-05-23T00:00:00Z,23,5,2020,16,0,Jordan,JO,JOR,9956011,Asia,9,700,56
2020-05-24T00:00:00Z,24,5,2020,4,0,Jordan,JO,JOR,9956011,Asia,9,704,57
2020-05-25T00:00:00Z,25,5,2020,4,0,Jordan,JO,JOR,9956011,Asia,9,708,58
2020-05-26T00:00:00Z,26,5,2020,3,0,Jordan,JO,JOR,9956011,Asia,9,711,59
2020-05-27T00:00:00Z,27,5,2020,7,0,Jordan,JO,JOR,9956011,Asia,9,718,60
2020-03-30T00:00:00Z,30,3,2020,55,1,Kazakhstan,KZ,KAZ,18276499,Asia,1,284,1
2020-03-31T00:00:00Z,31,3,2020,41,0,Kazakhstan,KZ,KAZ,18276499,Asia,1,325,2
2020-04-01T00:00:00Z,1,4,2020,15,0,Kazakhstan,KZ,KAZ,18276499,Asia,1,340,3
2020-04-02T00:00:00Z,2,4,2020,8,1,Kazakhstan,KZ,KAZ,18276499,Asia,2,348,4
2020-04-03T00:00:00Z,3,4,2020,38,1,Kazakhstan,KZ,KAZ,18276499,Asia,3,386,5
2020-04-04T00:00:00Z,4,4,2020,74,0,Kazakhstan,KZ,KAZ,18276499,Asia,3,460,6
2020-04-05T00:00:00Z,5,4,2020,0,0,Kazakhstan,KZ,KAZ,18276499,Asia,3,460,7
2020-04-06T00:00:00Z,6,4,2020,71,2,Kazakhstan,KZ,KAZ,18276499,Asia,5,531,8
2020-04-07T00:00:00Z,7,4,2020,139,1,Kazakhstan,KZ,KAZ,18276499,Asia,6,670,9
2020-04-08T00:00:00Z,8,4,2020,34,0,Kazakhstan,KZ,KAZ,18276499,Asia,6,704,10
2020-04-09T00:00:00Z,9,4,2020,55,1,Kazakhstan,KZ,KAZ,18276499,Asia,7,759,11
2020-04-10T00:00:00Z,10,4,2020,43,2,Kazakhstan,KZ,KAZ,18276499,Asia,9,802,12
2020-04-11T00:00:00Z,11,4,2020,38,1,Kazakhstan,KZ,KAZ,18276499,Asia,10,840,13
2020-04-12T00:00:00Z,12,4,2020,40,0,Kazakhstan,KZ,KAZ,18276499,Asia,10,880,14
2020-04-13T00:00:00Z,13,4,2020,81,0,Kazakhstan,KZ,KAZ,18276499,Asia,10,961,15
2020-04-14T00:00:00Z,14,4,2020,218,4,Kazakhstan,KZ,KAZ,18276499,Asia,14,1179,16
2020-04-15T00:00:00Z,15,4,2020,88,0,Kazakhstan,KZ,KAZ,18276499,Asia,14,1267,17
2020-04-16T00:00:00Z,16,4,2020,64,2,Kazakhstan,KZ,KAZ,18276499,Asia,16,1331,18
2020-04-17T00:00:00Z,17,4,2020,139,1,Kazakhstan,KZ,KAZ,18276499,Asia,17,1470,19
2020-04-18T00:00:00Z,18,4,2020,121,0,Kazakhstan,KZ,KAZ,18276499,Asia,17,1591,20
2020-04-19T00:00:00Z,19,4,2020,63,0,Kazakhstan,KZ,KAZ,18276499,Asia,17,1654,21
2020-04-20T00:00:00Z,20,4,2020,81,2,Kazakhstan,KZ,KAZ,18276499,Asia,19,1735,22
2020-04-21T00:00:00Z,21,4,2020,214,0,Kazakhstan,KZ,KAZ,18276499,Asia,19,1949,23
2020-04-22T00:00:00Z,22,4,2020,76,0,Kazakhstan,KZ,KAZ,18276499,Asia,19,2025,24
2020-04-23T00:00:00Z,23,4,2020,166,0,Kazakhstan,KZ,KAZ,18276499,Asia,19,2191,25
2020-04-24T00:00:00Z,24,4,2020,143,3,Kazakhstan,KZ,KAZ,18276499,Asia,22,2334,26
2020-04-25T00:00:00Z,25,4,2020,148,3,Kazakhstan,KZ,KAZ,18276499,Asia,25,2482,27
2020-04-26T00:00:00Z,26,4,2020,170,0,Kazakhstan,KZ,KAZ,18276499,Asia,25,2652,28
2020-04-27T00:00:00Z,27,4,2020,65,0,Kazakhstan,KZ,KAZ,18276499,Asia,25,2717,29
2020-04-28T00:00:00Z,28,4,2020,143,0,Kazakhstan,KZ,KAZ,18276499,Asia,25,2860,30
2020-04-29T00:00:00Z,29,4,2020,203,0,Kazakhstan,KZ,KAZ,18276499,Asia,25,3063,31
2020-04-30T00:00:00Z,30,4,2020,142,0,Kazakhstan,KZ,KAZ,18276499,Asia,25,3205,32
2020-05-01T00:00:00Z,1,5,2020,299,0,Kazakhstan,KZ,KAZ,18276499,Asia,25,3504,33
2020-05-02T00:00:00Z,2,5,2020,167,0,Kazakhstan,KZ,KAZ,18276499,Asia,25,3671,34
2020-05-03T00:00:00Z,3,5,2020,206,0,Kazakhstan,KZ,KAZ,18276499,Asia,25,3877,35
2020-05-04T00:00:00Z,4,5,2020,87,2,Kazakhstan,KZ,KAZ,18276499,Asia,27,3964,36
2020-05-05T00:00:00Z,5,5,2020,157,2,Kazakhstan,KZ,KAZ,18276499,Asia,29,4121,37
2020-05-06T00:00:00Z,6,5,2020,156,0,Kazakhstan,KZ,KAZ,18276499,Asia,29,4277,38
2020-05-07T00:00:00Z,7,5,2020,225,1,Kazakhstan,KZ,KAZ,18276499,Asia,30,4502,39
2020-05-08T00:00:00Z,8,5,2020,188,1,Kazakhstan,KZ,KAZ,18276499,Asia,31,4690,40
2020-05-09T00:00:00Z,9,5,2020,144,0,Kazakhstan,KZ,KAZ,18276499,Asia,31,4834,41
2020-05-10T00:00:00Z,10,5,2020,202,0,Kazakhstan,KZ,KAZ,18276499,Asia,31,5036,42
2020-05-11T00:00:00Z,11,5,2020,90,0,Kazakhstan,KZ,KAZ,18276499,Asia,31,5126,43
2020-05-12T00:00:00Z,12,5,2020,114,1,Kazakhstan,KZ,KAZ,18276499,Asia,32,5240,44
2020-05-13T00:00:00Z,13,5,2020,177,0,Kazakhstan,KZ,KAZ,18276499,Asia,32,5417,45
2020-05-14T00:00:00Z,14,5,2020,154,0,Kazakhstan,KZ,KAZ,18276499,Asia,32,5571,46
2020-05-15T00:00:00Z,15,5,2020,0,0,Kazakhstan,KZ,KAZ,18276499,Asia,32,5571,47
2020-05-16T00:00:00Z,16,5,2020,279,2,Kazakhstan,KZ,KAZ,18276499,Asia,34,5850,48
2020-05-17T00:00:00Z,17,5,2020,307,0,Kazakhstan,KZ,KAZ,18276499,Asia,34,6157,49
2020-05-18T00:00:00Z,18,5,2020,283,0,Kazakhstan,KZ,KAZ,18276499,Asia,34,6440,50
2020-05-19T00:00:00Z,19,5,2020,311,1,Kazakhstan,KZ,KAZ,18276499,Asia,35,6751,51
2020-05-20T00:00:00Z,20,5,2020,218,0,Kazakhstan,KZ,KAZ,18276499,Asia,35,6969,52
2020-05-21T00:00:00Z,21,5,2020,265,0,Kazakhstan,KZ,KAZ,18276499,Asia,35,7234,53
2020-05-22T00:00:00Z,22,5,2020,363,0,Kazakhstan,KZ,KAZ,18276499,Asia,35,7597,54
2020-05-23T00:00:00Z,23,5,2020,322,0,Kazakhstan,KZ,KAZ,18276499,Asia,35,7919,55
2020-05-24T00:00:00Z,24,5,2020,403,0,Kazakhstan,KZ,KAZ,18276499,Asia,35,8322,56
2020-05-25T00:00:00Z,25,5,2020,209,0,Kazakhstan,KZ,KAZ,18276499,Asia,35,8531,57
2020-05-26T00:00:00Z,26,5,2020,438,0,Kazakhstan,KZ,KAZ,18276499,Asia,35,8969,58
2020-05-27T00:00:00Z,27,5,2020,335,2,Kazakhstan,KZ,KAZ,18276499,Asia,37,9304,59
2020-03-27T00:00:00Z,27,3,2020,6,1,Kenya,KE,KEN,51393010,Africa,1,31,1
2020-03-28T00:00:00Z,28,3,2020,0,0,Kenya,KE,KEN,51393010,Africa,1,31,2
2020-03-29T00:00:00Z,29,3,2020,7,0,Kenya,KE,KEN,51393010,Africa,1,38,3
2020-03-30T00:00:00Z,30,3,2020,4,0,Kenya,KE,KEN,51393010,Africa,1,42,4
2020-03-31T00:00:00Z,31,3,2020,8,0,Kenya,KE,KEN,51393010,Africa,1,50,5
2020-04-01T00:00:00Z,1,4,2020,9,0,Kenya,KE,KEN,51393010,Africa,1,59,6
2020-04-02T00:00:00Z,2,4,2020,22,0,Kenya,KE,KEN,51393010,Africa,1,81,7
2020-04-03T00:00:00Z,3,4,2020,29,2,Kenya,KE,KEN,51393010,Africa,3,110,8
2020-04-04T00:00:00Z,4,4,2020,12,1,Kenya,KE,KEN,51393010,Africa,4,122,9
2020-04-05T00:00:00Z,5,4,2020,4,0,Kenya,KE,KEN,51393010,Africa,4,126,10
2020-04-06T00:00:00Z,6,4,2020,16,0,Kenya,KE,KEN,51393010,Africa,4,142,11
2020-04-07T00:00:00Z,7,4,2020,16,0,Kenya,KE,KEN,51393010,Africa,4,158,12
2020-04-08T00:00:00Z,8,4,2020,14,2,Kenya,KE,KEN,51393010,Africa,6,172,13
2020-04-09T00:00:00Z,9,4,2020,7,0,Kenya,KE,KEN,51393010,Africa,6,179,14
2020-04-10T00:00:00Z,10,4,2020,5,1,Kenya,KE,KEN,51393010,Africa,7,184,15
2020-04-11T00:00:00Z,11,4,2020,5,0,Kenya,KE,KEN,51393010,Africa,7,189,16
2020-04-12T00:00:00Z,12,4,2020,2,0,Kenya,KE,KEN,51393010,Africa,7,191,17
2020-04-13T00:00:00Z,13,4,2020,6,1,Kenya,KE,KEN,51393010,Africa,8,197,18
2020-04-14T00:00:00Z,14,4,2020,11,1,Kenya,KE,KEN,51393010,Africa,9,208,19
2020-04-15T00:00:00Z,15,4,2020,8,0,Kenya,KE,KEN,51393010,Africa,9,216,20
2020-04-16T00:00:00Z,16,4,2020,9,1,Kenya,KE,KEN,51393010,Africa,10,225,21
2020-04-17T00:00:00Z,17,4,2020,9,1,Kenya,KE,KEN,51393010,Africa,11,234,22
2020-04-18T00:00:00Z,18,4,2020,12,0,Kenya,KE,KEN,51393010,Africa,11,246,23
2020-04-19T00:00:00Z,19,4,2020,16,1,Kenya,KE,KEN,51393010,Africa,12,262,24
2020-04-20T00:00:00Z,20,4,2020,8,2,Kenya,KE,KEN,51393010,Africa,14,270,25
2020-04-21T00:00:00Z,21,4,2020,11,0,Kenya,KE,KEN,51393010,Africa,14,281,26
2020-04-22T00:00:00Z,22,4,2020,0,0,Kenya,KE,KEN,51393010,Africa,14,281,27
2020-04-23T00:00:00Z,23,4,2020,22,0,Kenya,KE,KEN,51393010,Africa,14,303,28
2020-04-24T00:00:00Z,24,4,2020,17,0,Kenya,KE,KEN,51393010,Africa,14,320,29
2020-04-25T00:00:00Z,25,4,2020,16,0,Kenya,KE,KEN,51393010,Africa,14,336,30
2020-04-26T00:00:00Z,26,4,2020,7,0,Kenya,KE,KEN,51393010,Africa,14,343,31
2020-04-27T00:00:00Z,27,4,2020,12,0,Kenya,KE,KEN,51393010,Africa,14,355,32
2020-04-28T00:00:00Z,28,4,2020,8,0,Kenya,KE,KEN,51393010,Africa,14,363,33
2020-04-29T00:00:00Z,29,4,2020,11,0,Kenya,KE,KEN,51393010,Africa,14,374,34
2020-04-30T00:00:00Z,30,4,2020,10,1,Kenya,KE,KEN,51393010,Africa,15,384,35
2020-05-01T00:00:00Z,1,5,2020,12,2,Kenya,KE,KEN,51393010,Africa,17,396,36
2020-05-02T00:00:00Z,2,5,2020,15,4,Kenya,KE,KEN,51393010,Africa,21,411,37
2020-05-03T00:00:00Z,3,5,2020,24,1,Kenya,KE,KEN,51393010,Africa,22,435,38
2020-05-04T00:00:00Z,4,5,2020,30,2,Kenya,KE,KEN,51393010,Africa,24,465,39
2020-05-05T00:00:00Z,5,5,2020,25,0,Kenya,KE,KEN,51393010,Africa,24,490,40
2020-05-06T00:00:00Z,6,5,2020,45,0,Kenya,KE,KEN,51393010,Africa,24,535,41
2020-05-07T00:00:00Z,7,5,2020,47,2,Kenya,KE,KEN,51393010,Africa,26,582,42
2020-05-08T00:00:00Z,8,5,2020,25,3,Kenya,KE,KEN,51393010,Africa,29,607,43
2020-05-09T00:00:00Z,9,5,2020,14,0,Kenya,KE,KEN,51393010,Africa,29,621,44
2020-05-10T00:00:00Z,10,5,2020,28,1,Kenya,KE,KEN,51393010,Africa,30,649,45
2020-05-11T00:00:00Z,11,5,2020,23,2,Kenya,KE,KEN,51393010,Africa,32,672,46
2020-05-12T00:00:00Z,12,5,2020,28,1,Kenya,KE,KEN,51393010,Africa,33,700,47
2020-05-13T00:00:00Z,13,5,2020,15,3,Kenya,KE,KEN,51393010,Africa,36,715,48
2020-05-14T00:00:00Z,14,5,2020,22,4,Kenya,KE,KEN,51393010,Africa,40,737,49
2020-05-15T00:00:00Z,15,5,2020,21,2,Kenya,KE,KEN,51393010,Africa,42,758,50
2020-05-16T00:00:00Z,16,5,2020,23,3,Kenya,KE,KEN,51393010,Africa,45,781,51
2020-05-17T00:00:00Z,17,5,2020,49,5,Kenya,KE,KEN,51393010,Africa,50,830,52
2020-05-18T00:00:00Z,18,5,2020,57,0,Kenya,KE,KEN,51393010,Africa,50,887,53
2020-05-19T00:00:00Z,19,5,2020,25,0,Kenya,KE,KEN,51393010,Africa,50,912,54
2020-05-20T00:00:00Z,20,5,2020,51,0,Kenya,KE,KEN,51393010,Africa,50,963,55
2020-05-21T00:00:00Z,21,5,2020,66,0,Kenya,KE,KEN,51393010,Africa,50,1029,56
2020-05-22T00:00:00Z,22,5,2020,80,0,Kenya,KE,KEN,51393010,Africa,50,1109,57
2020-05-23T00:00:00Z,23,5,2020,52,0,Kenya,KE,KEN,51393010,Africa,50,1161,58
2020-05-24T00:00:00Z,24,5,2020,31,0,Kenya,KE,KEN,51393010,Africa,50,1192,59
2020-05-25T00:00:00Z,25,5,2020,22,1,Kenya,KE,KEN,51393010,Africa,51,1214,60
2020-05-26T00:00:00Z,26,5,2020,72,1,Kenya,KE,KEN,51393010,Africa,52,1286,61
2020-05-27T00:00:00Z,27,5,2020,62,0,Kenya,KE,KEN,51393010,Africa,52,1348,62
2020-03-23T00:00:00Z,23,3,2020,7,1,Kosovo,XK,XKX,1845300,Europe,1,31,1
2020-03-24T00:00:00Z,24,3,2020,30,0,Kosovo,XK,XKX,1845300,Europe,1,61,2
2020-03-25T00:00:00Z,25,3,2020,2,0,Kosovo,XK,XKX,1845300,Europe,1,63,3
2020-03-26T00:00:00Z,26,3,2020,8,0,Kosovo,XK,XKX,1845300,Europe,1,71,4
2020-03-27T00:00:00Z,27,3,2020,8,0,Kosovo,XK,XKX,1845300,Europe,1,79,5
2020-03-28T00:00:00Z,28,3,2020,7,0,Kosovo,XK,XKX,1845300,Europe,1,86,6
2020-03-29T00:00:00Z,29,3,2020,2,0,Kosovo,XK,XKX,1845300,Europe,1,88,7
2020-03-30T00:00:00Z,30,3,2020,3,0,Kosovo,XK,XKX,1845300,Europe,1,91,8
2020-03-31T00:00:00Z,31,3,2020,15,0,Kosovo,XK,XKX,1845300,Europe,1,106,9
2020-04-01T00:00:00Z,1,4,2020,6,0,Kosovo,XK,XKX,1845300,Europe,1,112,10
2020-04-02T00:00:00Z,2,4,2020,0,0,Kosovo,XK,XKX,1845300,Europe,1,112,11
2020-04-03T00:00:00Z,3,4,2020,13,0,Kosovo,XK,XKX,1845300,Europe,1,125,12
2020-04-04T00:00:00Z,4,4,2020,1,0,Kosovo,XK,XKX,1845300,Europe,1,126,13
2020-04-05T00:00:00Z,5,4,2020,6,0,Kosovo,XK,XKX,1845300,Europe,1,132,14
2020-04-06T00:00:00Z,6,4,2020,8,0,Kosovo,XK,XKX,1845300,Europe,1,140,15
2020-04-07T00:00:00Z,7,4,2020,5,2,Kosovo,XK,XKX,1845300,Europe,3,145,16
2020-04-08T00:00:00Z,8,4,2020,39,2,Kosovo,XK,XKX,1845300,Europe,5,184,17
2020-04-09T00:00:00Z,9,4,2020,0,0,Kosovo,XK,XKX,1845300,Europe,5,184,18
2020-04-10T00:00:00Z,10,4,2020,43,2,Kosovo,XK,XKX,1845300,Europe,7,227,19
2020-04-11T00:00:00Z,11,4,2020,23,0,Kosovo,XK,XKX,1845300,Europe,7,250,20
2020-04-12T00:00:00Z,12,4,2020,33,0,Kosovo,XK,XKX,1845300,Europe,7,283,21
2020-04-13T00:00:00Z,13,4,2020,79,0,Kosovo,XK,XKX,1845300,Europe,7,362,22
2020-04-14T00:00:00Z,14,4,2020,15,1,Kosovo,XK,XKX,1845300,Europe,8,377,23
2020-04-15T00:00:00Z,15,4,2020,10,0,Kosovo,XK,XKX,1845300,Europe,8,387,24
2020-04-16T00:00:00Z,16,4,2020,36,1,Kosovo,XK,XKX,1845300,Europe,9,423,25
2020-04-17T00:00:00Z,17,4,2020,26,2,Kosovo,XK,XKX,1845300,Europe,11,449,26
2020-04-18T00:00:00Z,18,4,2020,31,1,Kosovo,XK,XKX,1845300,Europe,12,480,27
2020-04-19T00:00:00Z,19,4,2020,30,0,Kosovo,XK,XKX,1845300,Europe,12,510,28
2020-04-20T00:00:00Z,20,4,2020,0,0,Kosovo,XK,XKX,1845300,Europe,12,510,29
2020-04-21T00:00:00Z,21,4,2020,88,3,Kosovo,XK,XKX,1845300,Europe,15,598,30
2020-04-22T00:00:00Z,22,4,2020,6,3,Kosovo,XK,XKX,1845300,Europe,18,604,31
2020-04-23T00:00:00Z,23,4,2020,26,0,Kosovo,XK,XKX,1845300,Europe,18,630,32
2020-04-24T00:00:00Z,24,4,2020,39,1,Kosovo,XK,XKX,1845300,Europe,19,669,33
2020-04-25T00:00:00Z,25,4,2020,34,0,Kosovo,XK,XKX,1845300,Europe,19,703,34
2020-04-26T00:00:00Z,26,4,2020,28,1,Kosovo,XK,XKX,1845300,Europe,20,731,35
2020-04-27T00:00:00Z,27,4,2020,32,1,Kosovo,XK,XKX,1845300,Europe,21,763,36
2020-04-28T00:00:00Z,28,4,2020,17,1,Kosovo,XK,XKX,1845300,Europe,22,780,37
2020-04-29T00:00:00Z,29,4,2020,10,0,Kosovo,XK,XKX,1845300,Europe,22,790,38
2020-04-30T00:00:00Z,30,4,2020,9,0,Kosovo,XK,XKX,1845300,Europe,22,799,39
2020-05-01T00:00:00Z,1,5,2020,0,0,Kosovo,XK,XKX,1845300,Europe,22,799,40
2020-05-02T00:00:00Z,2,5,2020,14,0,Kosovo,XK,XKX,1845300,Europe,22,813,41
2020-05-03T00:00:00Z,3,5,2020,10,0,Kosovo,XK,XKX,1845300,Europe,22,823,42
2020-05-04T00:00:00Z,4,5,2020,28,0,Kosovo,XK,XKX,1845300,Europe,22,851,43
2020-05-05T00:00:00Z,5,5,2020,4,4,Kosovo,XK,XKX,1845300,Europe,26,855,44
2020-05-06T00:00:00Z,6,5,2020,1,0,Kosovo,XK,XKX,1845300,Europe,26,856,45
2020-05-07T00:00:00Z,7,5,2020,4,0,Kosovo,XK,XKX,1845300,Europe,26,860,46
2020-05-08T00:00:00Z,8,5,2020,1,1,Kosovo,XK,XKX,1845300,Europe,27,861,47
2020-05-09T00:00:00Z,9,5,2020,1,1,Kosovo,XK,XKX,1845300,Europe,28,862,48
2020-05-10T00:00:00Z,10,5,2020,8,0,Kosovo,XK,XKX,1845300,Europe,28,870,49
2020-05-11T00:00:00Z,11,5,2020,0,0,Kosovo,XK,XKX,1845300,Europe,28,870,50
2020-05-12T00:00:00Z,12,5,2020,14,0,Kosovo,XK,XKX,1845300,Europe,28,884,51
2020-05-13T00:00:00Z,13,5,2020,35,1,Kosovo,XK,XKX,1845300,Europe,29,919,52
2020-05-14T00:00:00Z,14,5,2020,0,0,Kosovo,XK,XKX,1845300,Europe,29,919,53
2020-05-15T00:00:00Z,15,5,2020,25,0,Kosovo,XK,XKX,1845300,Europe,29,944,54
2020-05-16T00:00:00Z,16,5,2020,0,0,Kosovo,XK,XKX,1845300,Europe,29,944,55
2020-05-17T00:00:00Z,17,5,2020,0,0,Kosovo,XK,XKX,1845300,Europe,29,944,56
2020-05-18T00:00:00Z,18,5,2020,11,0,Kosovo,XK,XKX,1845300,Europe,29,955,57
2020-05-19T00:00:00Z,19,5,2020,0,0,Kosovo,XK,XKX,1845300,Europe,29,955,58
2020-05-20T00:00:00Z,20,5,2020,34,0,Kosovo,XK,XKX,1845300,Europe,29,989,59
2020-05-21T00:00:00Z,21,5,2020,0,0,Kosovo,XK,XKX,1845300,Europe,29,989,60
2020-05-22T00:00:00Z,22,5,2020,14,0,Kosovo,XK,XKX,1845300,Europe,29,1003,61
2020-05-23T00:00:00Z,23,5,2020,1,0,Kosovo,XK,XKX,1845300,Europe,29,1004,62
2020-05-24T00:00:00Z,24,5,2020,21,0,Kosovo,XK,XKX,1845300,Europe,29,1025,63
2020-05-25T00:00:00Z,25,5,2020,7,0,Kosovo,XK,XKX,1845300,Europe,29,1032,64
2020-05-26T00:00:00Z,26,5,2020,6,1,Kosovo,XK,XKX,1845300,Europe,30,1038,65
2020-05-27T00:00:00Z,27,5,2020,0,0,Kosovo,XK,XKX,1845300,Europe,30,1038,66
2020-04-05T00:00:00Z,5,4,2020,137,1,Kuwait,KW,KWT,4137309,Asia,1,479,1
2020-04-06T00:00:00Z,6,4,2020,77,0,Kuwait,KW,KWT,4137309,Asia,1,556,2
2020-04-07T00:00:00Z,7,4,2020,109,0,Kuwait,KW,KWT,4137309,Asia,1,665,3
2020-04-08T00:00:00Z,8,4,2020,78,0,Kuwait,KW,KWT,4137309,Asia,1,743,4
2020-04-09T00:00:00Z,9,4,2020,112,0,Kuwait,KW,KWT,4137309,Asia,1,855,5
2020-04-10T00:00:00Z,10,4,2020,55,0,Kuwait,KW,KWT,4137309,Asia,1,910,6
2020-04-11T00:00:00Z,11,4,2020,83,0,Kuwait,KW,KWT,4137309,Asia,1,993,7
2020-04-12T00:00:00Z,12,4,2020,161,0,Kuwait,KW,KWT,4137309,Asia,1,1154,8
2020-04-13T00:00:00Z,13,4,2020,80,0,Kuwait,KW,KWT,4137309,Asia,1,1234,9
2020-04-14T00:00:00Z,14,4,2020,66,1,Kuwait,KW,KWT,4137309,Asia,2,1300,10
2020-04-15T00:00:00Z,15,4,2020,55,1,Kuwait,KW,KWT,4137309,Asia,3,1355,11
2020-04-16T00:00:00Z,16,4,2020,50,0,Kuwait,KW,KWT,4137309,Asia,3,1405,12
2020-04-17T00:00:00Z,17,4,2020,119,0,Kuwait,KW,KWT,4137309,Asia,3,1524,13
2020-04-18T00:00:00Z,18,4,2020,134,2,Kuwait,KW,KWT,4137309,Asia,5,1658,14
2020-04-19T00:00:00Z,19,4,2020,94,1,Kuwait,KW,KWT,4137309,Asia,6,1752,15
2020-04-20T00:00:00Z,20,4,2020,163,1,Kuwait,KW,KWT,4137309,Asia,7,1915,16
2020-04-21T00:00:00Z,21,4,2020,80,2,Kuwait,KW,KWT,4137309,Asia,9,1995,17
2020-04-22T00:00:00Z,22,4,2020,85,2,Kuwait,KW,KWT,4137309,Asia,11,2080,18
2020-04-23T00:00:00Z,23,4,2020,168,2,Kuwait,KW,KWT,4137309,Asia,13,2248,19
2020-04-24T00:00:00Z,24,4,2020,151,1,Kuwait,KW,KWT,4137309,Asia,14,2399,20
2020-04-25T00:00:00Z,25,4,2020,215,1,Kuwait,KW,KWT,4137309,Asia,15,2614,21
2020-04-26T00:00:00Z,26,4,2020,278,4,Kuwait,KW,KWT,4137309,Asia,19,2892,22
2020-04-27T00:00:00Z,27,4,2020,183,1,Kuwait,KW,KWT,4137309,Asia,20,3075,23
2020-04-28T00:00:00Z,28,4,2020,213,2,Kuwait,KW,KWT,4137309,Asia,22,3288,24
2020-04-29T00:00:00Z,29,4,2020,152,1,Kuwait,KW,KWT,4137309,Asia,23,3440,25
2020-04-30T00:00:00Z,30,4,2020,300,1,Kuwait,KW,KWT,4137309,Asia,24,3740,26
2020-05-01T00:00:00Z,1,5,2020,284,2,Kuwait,KW,KWT,4137309,Asia,26,4024,27
2020-05-02T00:00:00Z,2,5,2020,353,4,Kuwait,KW,KWT,4137309,Asia,30,4377,28
2020-05-03T00:00:00Z,3,5,2020,242,3,Kuwait,KW,KWT,4137309,Asia,33,4619,29
2020-05-04T00:00:00Z,4,5,2020,364,5,Kuwait,KW,KWT,4137309,Asia,38,4983,30
2020-05-05T00:00:00Z,5,5,2020,295,2,Kuwait,KW,KWT,4137309,Asia,40,5278,31
2020-05-06T00:00:00Z,6,5,2020,526,0,Kuwait,KW,KWT,4137309,Asia,40,5804,32
2020-05-07T00:00:00Z,7,5,2020,485,2,Kuwait,KW,KWT,4137309,Asia,42,6289,33
2020-05-08T00:00:00Z,8,5,2020,278,2,Kuwait,KW,KWT,4137309,Asia,44,6567,34
2020-05-09T00:00:00Z,9,5,2020,641,3,Kuwait,KW,KWT,4137309,Asia,47,7208,35
2020-05-10T00:00:00Z,10,5,2020,415,2,Kuwait,KW,KWT,4137309,Asia,49,7623,36
2020-05-11T00:00:00Z,11,5,2020,1065,9,Kuwait,KW,KWT,4137309,Asia,58,8688,37
2020-05-12T00:00:00Z,12,5,2020,598,7,Kuwait,KW,KWT,4137309,Asia,65,9286,38
2020-05-13T00:00:00Z,13,5,2020,991,10,Kuwait,KW,KWT,4137309,Asia,75,10277,39
2020-05-14T00:00:00Z,14,5,2020,751,7,Kuwait,KW,KWT,4137309,Asia,82,11028,40
2020-05-15T00:00:00Z,15,5,2020,947,6,Kuwait,KW,KWT,4137309,Asia,88,11975,41
2020-05-16T00:00:00Z,16,5,2020,885,8,Kuwait,KW,KWT,4137309,Asia,96,12860,42
2020-05-17T00:00:00Z,17,5,2020,942,11,Kuwait,KW,KWT,4137309,Asia,107,13802,43
2020-05-18T00:00:00Z,18,5,2020,1048,5,Kuwait,KW,KWT,4137309,Asia,112,14850,44
2020-05-19T00:00:00Z,19,5,2020,841,6,Kuwait,KW,KWT,4137309,Asia,118,15691,45
2020-05-20T00:00:00Z,20,5,2020,1073,3,Kuwait,KW,KWT,4137309,Asia,121,16764,46
2020-05-21T00:00:00Z,21,5,2020,804,3,Kuwait,KW,KWT,4137309,Asia,124,17568,47
2020-05-22T00:00:00Z,22,5,2020,1041,5,Kuwait,KW,KWT,4137309,Asia,129,18609,48
2020-05-23T00:00:00Z,23,5,2020,955,9,Kuwait,KW,KWT,4137309,Asia,138,19564,49
2020-05-24T00:00:00Z,24,5,2020,900,10,Kuwait,KW,KWT,4137309,Asia,148,20464,50
2020-05-25T00:00:00Z,25,5,2020,838,8,Kuwait,KW,KWT,4137309,Asia,156,21302,51
2020-05-26T00:00:00Z,26,5,2020,665,9,Kuwait,KW,KWT,4137309,Asia,165,21967,52
2020-05-27T00:00:00Z,27,5,2020,608,7,Kuwait,KW,KWT,4137309,Asia,172,22575,53
2020-04-02T00:00:00Z,2,4,2020,5,1,Kyrgyzstan,KG,KGZ,6315800,Asia,1,112,1
2020-04-03T00:00:00Z,3,4,2020,13,0,Kyrgyzstan,KG,KGZ,6315800,Asia,1,125,2
2020-04-04T00:00:00Z,4,4,2020,19,0,Kyrgyzstan,KG,KGZ,6315800,Asia,1,144,3
2020-04-05T00:00:00Z,5,4,2020,0,0,Kyrgyzstan,KG,KGZ,6315800,Asia,1,144,4
2020-04-06T00:00:00Z,6,4,2020,72,3,Kyrgyzstan,KG,KGZ,6315800,Asia,4,216,5
2020-04-07T00:00:00Z,7,4,2020,12,0,Kyrgyzstan,KG,KGZ,6315800,Asia,4,228,6
2020-04-08T00:00:00Z,8,4,2020,42,0,Kyrgyzstan,KG,KGZ,6315800,Asia,4,270,7
2020-04-09T00:00:00Z,9,4,2020,10,0,Kyrgyzstan,KG,KGZ,6315800,Asia,4,280,8
2020-04-10T00:00:00Z,10,4,2020,18,1,Kyrgyzstan,KG,KGZ,6315800,Asia,5,298,9
2020-04-11T00:00:00Z,11,4,2020,41,0,Kyrgyzstan,KG,KGZ,6315800,Asia,5,339,10
2020-04-12T00:00:00Z,12,4,2020,38,0,Kyrgyzstan,KG,KGZ,6315800,Asia,5,377,11
2020-04-13T00:00:00Z,13,4,2020,42,0,Kyrgyzstan,KG,KGZ,6315800,Asia,5,419,12
2020-04-14T00:00:00Z,14,4,2020,11,0,Kyrgyzstan,KG,KGZ,6315800,Asia,5,430,13
2020-04-15T00:00:00Z,15,4,2020,19,0,Kyrgyzstan,KG,KGZ,6315800,Asia,5,449,14
2020-04-16T00:00:00Z,16,4,2020,17,0,Kyrgyzstan,KG,KGZ,6315800,Asia,5,466,15
2020-04-17T00:00:00Z,17,4,2020,23,0,Kyrgyzstan,KG,KGZ,6315800,Asia,5,489,16
2020-04-18T00:00:00Z,18,4,2020,17,0,Kyrgyzstan,KG,KGZ,6315800,Asia,5,506,17
2020-04-19T00:00:00Z,19,4,2020,48,0,Kyrgyzstan,KG,KGZ,6315800,Asia,5,554,18
2020-04-20T00:00:00Z,20,4,2020,14,2,Kyrgyzstan,KG,KGZ,6315800,Asia,7,568,19
2020-04-21T00:00:00Z,21,4,2020,22,0,Kyrgyzstan,KG,KGZ,6315800,Asia,7,590,20
2020-04-22T00:00:00Z,22,4,2020,22,0,Kyrgyzstan,KG,KGZ,6315800,Asia,7,612,21
2020-04-23T00:00:00Z,23,4,2020,19,1,Kyrgyzstan,KG,KGZ,6315800,Asia,8,631,22
2020-04-24T00:00:00Z,24,4,2020,25,0,Kyrgyzstan,KG,KGZ,6315800,Asia,8,656,23
2020-04-25T00:00:00Z,25,4,2020,9,0,Kyrgyzstan,KG,KGZ,6315800,Asia,8,665,24
2020-04-26T00:00:00Z,26,4,2020,17,0,Kyrgyzstan,KG,KGZ,6315800,Asia,8,682,25
2020-04-27T00:00:00Z,27,4,2020,13,0,Kyrgyzstan,KG,KGZ,6315800,Asia,8,695,26
2020-04-28T00:00:00Z,28,4,2020,13,0,Kyrgyzstan,KG,KGZ,6315800,Asia,8,708,27
2020-04-29T00:00:00Z,29,4,2020,21,0,Kyrgyzstan,KG,KGZ,6315800,Asia,8,729,28
2020-04-30T00:00:00Z,30,4,2020,17,0,Kyrgyzstan,KG,KGZ,6315800,Asia,8,746,29
2020-05-01T00:00:00Z,1,5,2020,0,0,Kyrgyzstan,KG,KGZ,6315800,Asia,8,746,30
2020-05-02T00:00:00Z,2,5,2020,23,0,Kyrgyzstan,KG,KGZ,6315800,Asia,8,769,31
2020-05-03T00:00:00Z,3,5,2020,26,2,Kyrgyzstan,KG,KGZ,6315800,Asia,10,795,32
2020-05-04T00:00:00Z,4,5,2020,35,0,Kyrgyzstan,KG,KGZ,6315800,Asia,10,830,33
2020-05-05T00:00:00Z,5,5,2020,13,1,Kyrgyzstan,KG,KGZ,6315800,Asia,11,843,34
2020-05-06T00:00:00Z,6,5,2020,28,1,Kyrgyzstan,KG,KGZ,6315800,Asia,12,871,35
2020-05-07T00:00:00Z,7,5,2020,24,0,Kyrgyzstan,KG,KGZ,6315800,Asia,12,895,36
2020-05-08T00:00:00Z,8,5,2020,11,0,Kyrgyzstan,KG,KGZ,6315800,Asia,12,906,37
2020-05-09T00:00:00Z,9,5,2020,25,0,Kyrgyzstan,KG,KGZ,6315800,Asia,12,931,38
2020-05-10T00:00:00Z,10,5,2020,71,0,Kyrgyzstan,KG,KGZ,6315800,Asia,12,1002,39
2020-05-11T00:00:00Z,11,5,2020,14,0,Kyrgyzstan,KG,KGZ,6315800,Asia,12,1016,40
2020-05-12T00:00:00Z,12,5,2020,21,0,Kyrgyzstan,KG,KGZ,6315800,Asia,12,1037,41
2020-05-13T00:00:00Z,13,5,2020,7,0,Kyrgyzstan,KG,KGZ,6315800,Asia,12,1044,42
2020-05-14T00:00:00Z,14,5,2020,38,0,Kyrgyzstan,KG,KGZ,6315800,Asia,12,1082,43
2020-05-15T00:00:00Z,15,5,2020,29,2,Kyrgyzstan,KG,KGZ,6315800,Asia,14,1111,44
2020-05-16T00:00:00Z,16,5,2020,6,0,Kyrgyzstan,KG,KGZ,6315800,Asia,14,1117,45
2020-05-17T00:00:00Z,17,5,2020,21,0,Kyrgyzstan,KG,KGZ,6315800,Asia,14,1138,46
2020-05-18T00:00:00Z,18,5,2020,78,0,Kyrgyzstan,KG,KGZ,6315800,Asia,14,1216,47
2020-05-19T00:00:00Z,19,5,2020,27,0,Kyrgyzstan,KG,KGZ,6315800,Asia,14,1243,48
2020-05-20T00:00:00Z,20,5,2020,27,0,Kyrgyzstan,KG,KGZ,6315800,Asia,14,1270,49
2020-05-21T00:00:00Z,21,5,2020,43,0,Kyrgyzstan,KG,KGZ,6315800,Asia,14,1313,50
2020-05-22T00:00:00Z,22,5,2020,37,0,Kyrgyzstan,KG,KGZ,6315800,Asia,14,1350,51
2020-05-23T00:00:00Z,23,5,2020,14,0,Kyrgyzstan,KG,KGZ,6315800,Asia,14,1364,52
2020-05-24T00:00:00Z,24,5,2020,39,0,Kyrgyzstan,KG,KGZ,6315800,Asia,14,1403,53
2020-05-25T00:00:00Z,25,5,2020,30,2,Kyrgyzstan,KG,KGZ,6315800,Asia,16,1433,54
2020-05-26T00:00:00Z,26,5,2020,35,0,Kyrgyzstan,KG,KGZ,6315800,Asia,16,1468,55
2020-05-27T00:00:00Z,27,5,2020,52,0,Kyrgyzstan,KG,KGZ,6315800,Asia,16,1520,56
2020-04-04T00:00:00Z,4,4,2020,35,1,Latvia,LV,LVA,1926542,Europe,1,493,1
2020-04-05T00:00:00Z,5,4,2020,16,0,Latvia,LV,LVA,1926542,Europe,1,509,2
2020-04-06T00:00:00Z,6,4,2020,24,0,Latvia,LV,LVA,1926542,Europe,1,533,3
2020-04-07T00:00:00Z,7,4,2020,9,0,Latvia,LV,LVA,1926542,Europe,1,542,4
2020-04-08T00:00:00Z,8,4,2020,6,1,Latvia,LV,LVA,1926542,Europe,2,548,5
2020-04-09T00:00:00Z,9,4,2020,29,0,Latvia,LV,LVA,1926542,Europe,2,577,6
2020-04-10T00:00:00Z,10,4,2020,12,0,Latvia,LV,LVA,1926542,Europe,2,589,7
2020-04-11T00:00:00Z,11,4,2020,23,0,Latvia,LV,LVA,1926542,Europe,2,612,8
2020-04-12T00:00:00Z,12,4,2020,18,1,Latvia,LV,LVA,1926542,Europe,3,630,9
2020-04-13T00:00:00Z,13,4,2020,21,2,Latvia,LV,LVA,1926542,Europe,5,651,10
2020-04-14T00:00:00Z,14,4,2020,4,0,Latvia,LV,LVA,1926542,Europe,5,655,11
2020-04-15T00:00:00Z,15,4,2020,2,0,Latvia,LV,LVA,1926542,Europe,5,657,12
2020-04-16T00:00:00Z,16,4,2020,9,0,Latvia,LV,LVA,1926542,Europe,5,666,13
2020-04-17T00:00:00Z,17,4,2020,9,0,Latvia,LV,LVA,1926542,Europe,5,675,14
2020-04-18T00:00:00Z,18,4,2020,7,0,Latvia,LV,LVA,1926542,Europe,5,682,15
2020-04-19T00:00:00Z,19,4,2020,30,0,Latvia,LV,LVA,1926542,Europe,5,712,16
2020-04-20T00:00:00Z,20,4,2020,15,0,Latvia,LV,LVA,1926542,Europe,5,727,17
2020-04-21T00:00:00Z,21,4,2020,12,0,Latvia,LV,LVA,1926542,Europe,5,739,18
2020-04-22T00:00:00Z,22,4,2020,9,4,Latvia,LV,LVA,1926542,Europe,9,748,19
2020-04-23T00:00:00Z,23,4,2020,13,2,Latvia,LV,LVA,1926542,Europe,11,761,20
2020-04-24T00:00:00Z,24,4,2020,17,0,Latvia,LV,LVA,1926542,Europe,11,778,21
2020-04-25T00:00:00Z,25,4,2020,6,1,Latvia,LV,LVA,1926542,Europe,12,784,22
2020-04-26T00:00:00Z,26,4,2020,20,0,Latvia,LV,LVA,1926542,Europe,12,804,23
2020-04-27T00:00:00Z,27,4,2020,8,0,Latvia,LV,LVA,1926542,Europe,12,812,24
2020-04-28T00:00:00Z,28,4,2020,6,1,Latvia,LV,LVA,1926542,Europe,13,818,25
2020-04-29T00:00:00Z,29,4,2020,18,0,Latvia,LV,LVA,1926542,Europe,13,836,26
2020-04-30T00:00:00Z,30,4,2020,13,2,Latvia,LV,LVA,1926542,Europe,15,849,27
2020-05-01T00:00:00Z,1,5,2020,9,0,Latvia,LV,LVA,1926542,Europe,15,858,28
2020-05-02T00:00:00Z,2,5,2020,12,1,Latvia,LV,LVA,1926542,Europe,16,870,29
2020-05-03T00:00:00Z,3,5,2020,1,0,Latvia,LV,LVA,1926542,Europe,16,871,30
2020-05-04T00:00:00Z,4,5,2020,8,0,Latvia,LV,LVA,1926542,Europe,16,879,31
2020-05-05T00:00:00Z,5,5,2020,17,0,Latvia,LV,LVA,1926542,Europe,16,896,32
2020-05-06T00:00:00Z,6,5,2020,0,1,Latvia,LV,LVA,1926542,Europe,17,896,33
2020-05-07T00:00:00Z,7,5,2020,4,0,Latvia,LV,LVA,1926542,Europe,17,900,34
2020-05-08T00:00:00Z,8,5,2020,9,1,Latvia,LV,LVA,1926542,Europe,18,909,35
2020-05-09T00:00:00Z,9,5,2020,19,0,Latvia,LV,LVA,1926542,Europe,18,928,36
2020-05-10T00:00:00Z,10,5,2020,2,0,Latvia,LV,LVA,1926542,Europe,18,930,37
2020-05-11T00:00:00Z,11,5,2020,9,0,Latvia,LV,LVA,1926542,Europe,18,939,38
2020-05-12T00:00:00Z,12,5,2020,7,0,Latvia,LV,LVA,1926542,Europe,18,946,39
2020-05-13T00:00:00Z,13,5,2020,4,0,Latvia,LV,LVA,1926542,Europe,18,950,40
2020-05-14T00:00:00Z,14,5,2020,1,1,Latvia,LV,LVA,1926542,Europe,19,951,41
2020-05-15T00:00:00Z,15,5,2020,11,0,Latvia,LV,LVA,1926542,Europe,19,962,42
2020-05-16T00:00:00Z,16,5,2020,8,0,Latvia,LV,LVA,1926542,Europe,19,970,43
2020-05-17T00:00:00Z,17,5,2020,27,0,Latvia,LV,LVA,1926542,Europe,19,997,44
2020-05-18T00:00:00Z,18,5,2020,11,0,Latvia,LV,LVA,1926542,Europe,19,1008,45
2020-05-19T00:00:00Z,19,5,2020,1,0,Latvia,LV,LVA,1926542,Europe,19,1009,46
2020-05-20T00:00:00Z,20,5,2020,3,2,Latvia,LV,LVA,1926542,Europe,21,1012,47
2020-05-21T00:00:00Z,21,5,2020,4,0,Latvia,LV,LVA,1926542,Europe,21,1016,48
2020-05-22T00:00:00Z,22,5,2020,9,1,Latvia,LV,LVA,1926542,Europe,22,1025,49
2020-05-23T00:00:00Z,23,5,2020,5,0,Latvia,LV,LVA,1926542,Europe,22,1030,50
2020-05-24T00:00:00Z,24,5,2020,16,0,Latvia,LV,LVA,1926542,Europe,22,1046,51
2020-05-25T00:00:00Z,25,5,2020,1,0,Latvia,LV,LVA,1926542,Europe,22,1047,52
2020-05-26T00:00:00Z,26,5,2020,2,0,Latvia,LV,LVA,1926542,Europe,22,1049,53
2020-05-27T00:00:00Z,27,5,2020,4,0,Latvia,LV,LVA,1926542,Europe,22,1053,54
2020-03-11T00:00:00Z,11,3,2020,0,1,Lebanon,LB,LBN,6848925,Asia,1,41,1
2020-03-12T00:00:00Z,12,3,2020,20,1,Lebanon,LB,LBN,6848925,Asia,2,61,2
2020-03-13T00:00:00Z,13,3,2020,5,0,Lebanon,LB,LBN,6848925,Asia,2,66,3
2020-03-15T00:00:00Z,15,3,2020,27,1,Lebanon,LB,LBN,6848925,Asia,3,93,4
2020-03-16T00:00:00Z,16,3,2020,6,0,Lebanon,LB,LBN,6848925,Asia,3,99,5
2020-03-17T00:00:00Z,17,3,2020,21,0,Lebanon,LB,LBN,6848925,Asia,3,120,6
2020-03-18T00:00:00Z,18,3,2020,0,0,Lebanon,LB,LBN,6848925,Asia,3,120,7
2020-03-19T00:00:00Z,19,3,2020,13,1,Lebanon,LB,LBN,6848925,Asia,4,133,8
2020-03-20T00:00:00Z,20,3,2020,16,0,Lebanon,LB,LBN,6848925,Asia,4,149,9
2020-03-21T00:00:00Z,21,3,2020,14,0,Lebanon,LB,LBN,6848925,Asia,4,163,10
2020-03-22T00:00:00Z,22,3,2020,67,0,Lebanon,LB,LBN,6848925,Asia,4,230,11
2020-03-23T00:00:00Z,23,3,2020,18,0,Lebanon,LB,LBN,6848925,Asia,4,248,12
2020-03-24T00:00:00Z,24,3,2020,19,0,Lebanon,LB,LBN,6848925,Asia,4,267,13
2020-03-25T00:00:00Z,25,3,2020,37,0,Lebanon,LB,LBN,6848925,Asia,4,304,14
2020-03-26T00:00:00Z,26,3,2020,29,0,Lebanon,LB,LBN,6848925,Asia,4,333,15
2020-03-27T00:00:00Z,27,3,2020,35,2,Lebanon,LB,LBN,6848925,Asia,6,368,16
2020-03-28T00:00:00Z,28,3,2020,23,1,Lebanon,LB,LBN,6848925,Asia,7,391,17
2020-03-29T00:00:00Z,29,3,2020,21,1,Lebanon,LB,LBN,6848925,Asia,8,412,18
2020-03-30T00:00:00Z,30,3,2020,26,2,Lebanon,LB,LBN,6848925,Asia,10,438,19
2020-03-31T00:00:00Z,31,3,2020,8,1,Lebanon,LB,LBN,6848925,Asia,11,446,20
2020-04-01T00:00:00Z,1,4,2020,17,1,Lebanon,LB,LBN,6848925,Asia,12,463,21
2020-04-02T00:00:00Z,2,4,2020,16,0,Lebanon,LB,LBN,6848925,Asia,12,479,22
2020-04-03T00:00:00Z,3,4,2020,15,4,Lebanon,LB,LBN,6848925,Asia,16,494,23
2020-04-04T00:00:00Z,4,4,2020,0,0,Lebanon,LB,LBN,6848925,Asia,16,494,24
2020-04-05T00:00:00Z,5,4,2020,26,1,Lebanon,LB,LBN,6848925,Asia,17,520,25
2020-04-06T00:00:00Z,6,4,2020,7,1,Lebanon,LB,LBN,6848925,Asia,18,527,26
2020-04-07T00:00:00Z,7,4,2020,14,1,Lebanon,LB,LBN,6848925,Asia,19,541,27
2020-04-08T00:00:00Z,8,4,2020,7,0,Lebanon,LB,LBN,6848925,Asia,19,548,28
2020-04-09T00:00:00Z,9,4,2020,27,0,Lebanon,LB,LBN,6848925,Asia,19,575,29
2020-04-10T00:00:00Z,10,4,2020,7,0,Lebanon,LB,LBN,6848925,Asia,19,582,30
2020-04-11T00:00:00Z,11,4,2020,27,1,Lebanon,LB,LBN,6848925,Asia,20,609,31
2020-04-12T00:00:00Z,12,4,2020,10,0,Lebanon,LB,LBN,6848925,Asia,20,619,32
2020-04-13T00:00:00Z,13,4,2020,11,0,Lebanon,LB,LBN,6848925,Asia,20,630,33
2020-04-14T00:00:00Z,14,4,2020,2,0,Lebanon,LB,LBN,6848925,Asia,20,632,34
2020-04-15T00:00:00Z,15,4,2020,9,1,Lebanon,LB,LBN,6848925,Asia,21,641,35
2020-04-16T00:00:00Z,16,4,2020,17,0,Lebanon,LB,LBN,6848925,Asia,21,658,36
2020-04-17T00:00:00Z,17,4,2020,5,0,Lebanon,LB,LBN,6848925,Asia,21,663,37
2020-04-18T00:00:00Z,18,4,2020,5,0,Lebanon,LB,LBN,6848925,Asia,21,668,38
2020-04-19T00:00:00Z,19,4,2020,4,0,Lebanon,LB,LBN,6848925,Asia,21,672,39
2020-04-20T00:00:00Z,20,4,2020,1,0,Lebanon,LB,LBN,6848925,Asia,21,673,40
2020-04-21T00:00:00Z,21,4,2020,4,0,Lebanon,LB,LBN,6848925,Asia,21,677,41
2020-04-22T00:00:00Z,22,4,2020,0,0,Lebanon,LB,LBN,6848925,Asia,21,677,42
2020-04-23T00:00:00Z,23,4,2020,5,1,Lebanon,LB,LBN,6848925,Asia,22,682,43
2020-04-24T00:00:00Z,24,4,2020,6,0,Lebanon,LB,LBN,6848925,Asia,22,688,44
2020-04-25T00:00:00Z,25,4,2020,8,0,Lebanon,LB,LBN,6848925,Asia,22,696,45
2020-04-26T00:00:00Z,26,4,2020,8,2,Lebanon,LB,LBN,6848925,Asia,24,704,46
2020-04-27T00:00:00Z,27,4,2020,3,0,Lebanon,LB,LBN,6848925,Asia,24,707,47
2020-04-28T00:00:00Z,28,4,2020,3,0,Lebanon,LB,LBN,6848925,Asia,24,710,48
2020-04-29T00:00:00Z,29,4,2020,7,0,Lebanon,LB,LBN,6848925,Asia,24,717,49
2020-04-30T00:00:00Z,30,4,2020,4,0,Lebanon,LB,LBN,6848925,Asia,24,721,50
2020-05-01T00:00:00Z,1,5,2020,4,0,Lebanon,LB,LBN,6848925,Asia,24,725,51
2020-05-02T00:00:00Z,2,5,2020,4,0,Lebanon,LB,LBN,6848925,Asia,24,729,52
2020-05-03T00:00:00Z,3,5,2020,4,1,Lebanon,LB,LBN,6848925,Asia,25,733,53
2020-05-04T00:00:00Z,4,5,2020,4,0,Lebanon,LB,LBN,6848925,Asia,25,737,54
2020-05-05T00:00:00Z,5,5,2020,3,0,Lebanon,LB,LBN,6848925,Asia,25,740,55
2020-05-06T00:00:00Z,6,5,2020,1,0,Lebanon,LB,LBN,6848925,Asia,25,741,56
2020-05-07T00:00:00Z,7,5,2020,9,0,Lebanon,LB,LBN,6848925,Asia,25,750,57
2020-05-08T00:00:00Z,8,5,2020,34,0,Lebanon,LB,LBN,6848925,Asia,25,784,58
2020-05-09T00:00:00Z,9,5,2020,12,1,Lebanon,LB,LBN,6848925,Asia,26,796,59
2020-05-10T00:00:00Z,10,5,2020,13,0,Lebanon,LB,LBN,6848925,Asia,26,809,60
2020-05-11T00:00:00Z,11,5,2020,36,0,Lebanon,LB,LBN,6848925,Asia,26,845,61
2020-05-12T00:00:00Z,12,5,2020,14,0,Lebanon,LB,LBN,6848925,Asia,26,859,62
2020-05-13T00:00:00Z,13,5,2020,11,0,Lebanon,LB,LBN,6848925,Asia,26,870,63
2020-05-14T00:00:00Z,14,5,2020,8,0,Lebanon,LB,LBN,6848925,Asia,26,878,64
2020-05-15T00:00:00Z,15,5,2020,8,0,Lebanon,LB,LBN,6848925,Asia,26,886,65
2020-05-16T00:00:00Z,16,5,2020,5,0,Lebanon,LB,LBN,6848925,Asia,26,891,66
2020-05-17T00:00:00Z,17,5,2020,11,0,Lebanon,LB,LBN,6848925,Asia,26,902,67
2020-05-18T00:00:00Z,18,5,2020,9,0,Lebanon,LB,LBN,6848925,Asia,26,911,68
2020-05-19T00:00:00Z,19,5,2020,20,0,Lebanon,LB,LBN,6848925,Asia,26,931,69
2020-05-20T00:00:00Z,20,5,2020,23,0,Lebanon,LB,LBN,6848925,Asia,26,954,70
2020-05-21T00:00:00Z,21,5,2020,7,0,Lebanon,LB,LBN,6848925,Asia,26,961,71
2020-05-22T00:00:00Z,22,5,2020,63,0,Lebanon,LB,LBN,6848925,Asia,26,1024,72
2020-05-23T00:00:00Z,23,5,2020,62,0,Lebanon,LB,LBN,6848925,Asia,26,1086,73
2020-05-24T00:00:00Z,24,5,2020,11,0,Lebanon,LB,LBN,6848925,Asia,26,1097,74
2020-05-25T00:00:00Z,25,5,2020,17,0,Lebanon,LB,LBN,6848925,Asia,26,1114,75
2020-05-26T00:00:00Z,26,5,2020,5,0,Lebanon,LB,LBN,6848925,Asia,26,1119,76
2020-05-27T00:00:00Z,27,5,2020,21,0,Lebanon,LB,LBN,6848925,Asia,26,1140,77
2020-04-05T00:00:00Z,5,4,2020,3,1,Liberia,LR,LBR,4818977,Africa,1,10,1
2020-04-06T00:00:00Z,6,4,2020,3,2,Liberia,LR,LBR,4818977,Africa,3,13,2
2020-04-07T00:00:00Z,7,4,2020,1,0,Liberia,LR,LBR,4818977,Africa,3,14,3
2020-04-08T00:00:00Z,8,4,2020,0,0,Liberia,LR,LBR,4818977,Africa,3,14,4
2020-04-09T00:00:00Z,9,4,2020,17,1,Liberia,LR,LBR,4818977,Africa,4,31,5
2020-04-10T00:00:00Z,10,4,2020,0,0,Liberia,LR,LBR,4818977,Africa,4,31,6
2020-04-11T00:00:00Z,11,4,2020,6,0,Liberia,LR,LBR,4818977,Africa,4,37,7
2020-04-12T00:00:00Z,12,4,2020,11,1,Liberia,LR,LBR,4818977,Africa,5,48,8
2020-04-13T00:00:00Z,13,4,2020,2,0,Liberia,LR,LBR,4818977,Africa,5,50,9
2020-04-14T00:00:00Z,14,4,2020,9,1,Liberia,LR,LBR,4818977,Africa,6,59,10
2020-04-15T00:00:00Z,15,4,2020,0,0,Liberia,LR,LBR,4818977,Africa,6,59,11
2020-04-16T00:00:00Z,16,4,2020,0,0,Liberia,LR,LBR,4818977,Africa,6,59,12
2020-04-17T00:00:00Z,17,4,2020,14,0,Liberia,LR,LBR,4818977,Africa,6,73,13
2020-04-18T00:00:00Z,18,4,2020,3,1,Liberia,LR,LBR,4818977,Africa,7,76,14
2020-04-19T00:00:00Z,19,4,2020,5,0,Liberia,LR,LBR,4818977,Africa,7,81,15
2020-04-20T00:00:00Z,20,4,2020,10,1,Liberia,LR,LBR,4818977,Africa,8,91,16
2020-04-21T00:00:00Z,21,4,2020,8,0,Liberia,LR,LBR,4818977,Africa,8,99,17
2020-04-22T00:00:00Z,22,4,2020,2,0,Liberia,LR,LBR,4818977,Africa,8,101,18
2020-04-23T00:00:00Z,23,4,2020,0,0,Liberia,LR,LBR,4818977,Africa,8,101,19
2020-04-24T00:00:00Z,24,4,2020,0,0,Liberia,LR,LBR,4818977,Africa,8,101,20
2020-04-25T00:00:00Z,25,4,2020,16,0,Liberia,LR,LBR,4818977,Africa,8,117,21
2020-04-26T00:00:00Z,26,4,2020,3,3,Liberia,LR,LBR,4818977,Africa,11,120,22
2020-04-27T00:00:00Z,27,4,2020,4,1,Liberia,LR,LBR,4818977,Africa,12,124,23
2020-04-28T00:00:00Z,28,4,2020,9,4,Liberia,LR,LBR,4818977,Africa,16,133,24
2020-04-29T00:00:00Z,29,4,2020,8,0,Liberia,LR,LBR,4818977,Africa,16,141,25
2020-04-30T00:00:00Z,30,4,2020,0,0,Liberia,LR,LBR,4818977,Africa,16,141,26
2020-05-01T00:00:00Z,1,5,2020,0,0,Liberia,LR,LBR,4818977,Africa,16,141,27
2020-05-02T00:00:00Z,2,5,2020,11,2,Liberia,LR,LBR,4818977,Africa,18,152,28
2020-05-03T00:00:00Z,3,5,2020,2,0,Liberia,LR,LBR,4818977,Africa,18,154,29
2020-05-04T00:00:00Z,4,5,2020,4,0,Liberia,LR,LBR,4818977,Africa,18,158,30
2020-05-05T00:00:00Z,5,5,2020,8,0,Liberia,LR,LBR,4818977,Africa,18,166,31
2020-05-06T00:00:00Z,6,5,2020,4,2,Liberia,LR,LBR,4818977,Africa,20,170,32
2020-05-07T00:00:00Z,7,5,2020,8,0,Liberia,LR,LBR,4818977,Africa,20,178,33
2020-05-08T00:00:00Z,8,5,2020,11,0,Liberia,LR,LBR,4818977,Africa,20,189,34
2020-05-09T00:00:00Z,9,5,2020,10,0,Liberia,LR,LBR,4818977,Africa,20,199,35
2020-05-10T00:00:00Z,10,5,2020,0,0,Liberia,LR,LBR,4818977,Africa,20,199,36
2020-05-11T00:00:00Z,11,5,2020,0,0,Liberia,LR,LBR,4818977,Africa,20,199,37
2020-05-12T00:00:00Z,12,5,2020,12,0,Liberia,LR,LBR,4818977,Africa,20,211,38
2020-05-13T00:00:00Z,13,5,2020,1,0,Liberia,LR,LBR,4818977,Africa,20,212,39
2020-05-14T00:00:00Z,14,5,2020,1,0,Liberia,LR,LBR,4818977,Africa,20,213,40
2020-05-15T00:00:00Z,15,5,2020,2,0,Liberia,LR,LBR,4818977,Africa,20,215,41
2020-05-16T00:00:00Z,16,5,2020,4,0,Liberia,LR,LBR,4818977,Africa,20,219,42
2020-05-17T00:00:00Z,17,5,2020,4,0,Liberia,LR,LBR,4818977,Africa,20,223,43
2020-05-18T00:00:00Z,18,5,2020,3,1,Liberia,LR,LBR,4818977,Africa,21,226,44
2020-05-19T00:00:00Z,19,5,2020,3,1,Liberia,LR,LBR,4818977,Africa,22,229,45
2020-05-20T00:00:00Z,20,5,2020,4,1,Liberia,LR,LBR,4818977,Africa,23,233,46
2020-05-21T00:00:00Z,21,5,2020,5,0,Liberia,LR,LBR,4818977,Africa,23,238,47
2020-05-22T00:00:00Z,22,5,2020,2,0,Liberia,LR,LBR,4818977,Africa,23,240,48
2020-05-23T00:00:00Z,23,5,2020,9,1,Liberia,LR,LBR,4818977,Africa,24,249,49
2020-05-24T00:00:00Z,24,5,2020,6,2,Liberia,LR,LBR,4818977,Africa,26,255,50
2020-05-25T00:00:00Z,25,5,2020,10,0,Liberia,LR,LBR,4818977,Africa,26,265,51
2020-05-26T00:00:00Z,26,5,2020,0,0,Liberia,LR,LBR,4818977,Africa,26,265,52
2020-05-27T00:00:00Z,27,5,2020,1,0,Liberia,LR,LBR,4818977,Africa,26,266,53
2020-04-03T00:00:00Z,3,4,2020,1,1,Libya,LY,LBY,6678567,Africa,1,11,1
2020-04-04T00:00:00Z,4,4,2020,0,0,Libya,LY,LBY,6678567,Africa,1,11,2
2020-04-05T00:00:00Z,5,4,2020,7,0,Libya,LY,LBY,6678567,Africa,1,18,3
2020-04-06T00:00:00Z,6,4,2020,0,0,Libya,LY,LBY,6678567,Africa,1,18,4
2020-04-07T00:00:00Z,7,4,2020,0,0,Libya,LY,LBY,6678567,Africa,1,18,5
2020-04-08T00:00:00Z,8,4,2020,1,0,Libya,LY,LBY,6678567,Africa,1,19,6
2020-04-09T00:00:00Z,9,4,2020,2,0,Libya,LY,LBY,6678567,Africa,1,21,7
2020-04-10T00:00:00Z,10,4,2020,3,0,Libya,LY,LBY,6678567,Africa,1,24,8
2020-04-11T00:00:00Z,11,4,2020,0,0,Libya,LY,LBY,6678567,Africa,1,24,9
2020-04-12T00:00:00Z,12,4,2020,1,0,Libya,LY,LBY,6678567,Africa,1,25,10
2020-04-13T00:00:00Z,13,4,2020,0,0,Libya,LY,LBY,6678567,Africa,1,25,11
2020-04-14T00:00:00Z,14,4,2020,1,0,Libya,LY,LBY,6678567,Africa,1,26,12
2020-04-15T00:00:00Z,15,4,2020,9,0,Libya,LY,LBY,6678567,Africa,1,35,13
2020-04-16T00:00:00Z,16,4,2020,13,0,Libya,LY,LBY,6678567,Africa,1,48,14
2020-04-17T00:00:00Z,17,4,2020,1,0,Libya,LY,LBY,6678567,Africa,1,49,15
2020-04-18T00:00:00Z,18,4,2020,0,0,Libya,LY,LBY,6678567,Africa,1,49,16
2020-04-19T00:00:00Z,19,4,2020,0,0,Libya,LY,LBY,6678567,Africa,1,49,17
2020-04-20T00:00:00Z,20,4,2020,0,0,Libya,LY,LBY,6678567,Africa,1,49,18
2020-04-21T00:00:00Z,21,4,2020,2,0,Libya,LY,LBY,6678567,Africa,1,51,19
2020-04-22T00:00:00Z,22,4,2020,0,0,Libya,LY,LBY,6678567,Africa,1,51,20
2020-04-23T00:00:00Z,23,4,2020,8,0,Libya,LY,LBY,6678567,Africa,1,59,21
2020-04-24T00:00:00Z,24,4,2020,1,1,Libya,LY,LBY,6678567,Africa,2,60,22
2020-04-25T00:00:00Z,25,4,2020,1,0,Libya,LY,LBY,6678567,Africa,2,61,23
2020-04-26T00:00:00Z,26,4,2020,0,0,Libya,LY,LBY,6678567,Africa,2,61,24
2020-04-27T00:00:00Z,27,4,2020,0,0,Libya,LY,LBY,6678567,Africa,2,61,25
2020-04-28T00:00:00Z,28,4,2020,0,0,Libya,LY,LBY,6678567,Africa,2,61,26
2020-04-29T00:00:00Z,29,4,2020,0,0,Libya,LY,LBY,6678567,Africa,2,61,27
2020-04-30T00:00:00Z,30,4,2020,0,0,Libya,LY,LBY,6678567,Africa,2,61,28
2020-05-01T00:00:00Z,1,5,2020,0,1,Libya,LY,LBY,6678567,Africa,3,61,29
2020-05-02T00:00:00Z,2,5,2020,2,0,Libya,LY,LBY,6678567,Africa,3,63,30
2020-05-03T00:00:00Z,3,5,2020,0,0,Libya,LY,LBY,6678567,Africa,3,63,31
2020-05-04T00:00:00Z,4,5,2020,0,0,Libya,LY,LBY,6678567,Africa,3,63,32
2020-05-05T00:00:00Z,5,5,2020,0,0,Libya,LY,LBY,6678567,Africa,3,63,33
2020-05-06T00:00:00Z,6,5,2020,0,0,Libya,LY,LBY,6678567,Africa,3,63,34
2020-05-07T00:00:00Z,7,5,2020,1,0,Libya,LY,LBY,6678567,Africa,3,64,35
2020-05-08T00:00:00Z,8,5,2020,0,0,Libya,LY,LBY,6678567,Africa,3,64,36
2020-05-09T00:00:00Z,9,5,2020,0,0,Libya,LY,LBY,6678567,Africa,3,64,37
2020-05-10T00:00:00Z,10,5,2020,0,0,Libya,LY,LBY,6678567,Africa,3,64,38
2020-05-11T00:00:00Z,11,5,2020,0,0,Libya,LY,LBY,6678567,Africa,3,64,39
2020-05-12T00:00:00Z,12,5,2020,0,0,Libya,LY,LBY,6678567,Africa,3,64,40
2020-05-13T00:00:00Z,13,5,2020,0,0,Libya,LY,LBY,6678567,Africa,3,64,41
2020-05-14T00:00:00Z,14,5,2020,0,0,Libya,LY,LBY,6678567,Africa,3,64,42
2020-05-15T00:00:00Z,15,5,2020,0,0,Libya,LY,LBY,6678567,Africa,3,64,43
2020-05-16T00:00:00Z,16,5,2020,0,0,Libya,LY,LBY,6678567,Africa,3,64,44
2020-05-17T00:00:00Z,17,5,2020,1,0,Libya,LY,LBY,6678567,Africa,3,65,45
2020-05-18T00:00:00Z,18,5,2020,0,0,Libya,LY,LBY,6678567,Africa,3,65,46
2020-05-19T00:00:00Z,19,5,2020,0,0,Libya,LY,LBY,6678567,Africa,3,65,47
2020-05-20T00:00:00Z,20,5,2020,3,0,Libya,LY,LBY,6678567,Africa,3,68,48
2020-05-21T00:00:00Z,21,5,2020,1,0,Libya,LY,LBY,6678567,Africa,3,69,49
2020-05-22T00:00:00Z,22,5,2020,2,0,Libya,LY,LBY,6678567,Africa,3,71,50
2020-05-23T00:00:00Z,23,5,2020,1,0,Libya,LY,LBY,6678567,Africa,3,72,51
2020-05-24T00:00:00Z,24,5,2020,3,0,Libya,LY,LBY,6678567,Africa,3,75,52
2020-05-25T00:00:00Z,25,5,2020,0,0,Libya,LY,LBY,6678567,Africa,3,75,53
2020-05-26T00:00:00Z,26,5,2020,0,0,Libya,LY,LBY,6678567,Africa,3,75,54
2020-05-27T00:00:00Z,27,5,2020,2,0,Libya,LY,LBY,6678567,Africa,3,77,55
2020-04-05T00:00:00Z,5,4,2020,2,1,Liechtenstein,LI,LIE,37910,Europe,1,77,1
2020-04-06T00:00:00Z,6,4,2020,1,0,Liechtenstein,LI,LIE,37910,Europe,1,78,2
2020-04-07T00:00:00Z,7,4,2020,0,0,Liechtenstein,LI,LIE,37910,Europe,1,78,3
2020-04-08T00:00:00Z,8,4,2020,0,0,Liechtenstein,LI,LIE,37910,Europe,1,78,4
2020-04-09T00:00:00Z,9,4,2020,1,0,Liechtenstein,LI,LIE,37910,Europe,1,79,5
2020-04-10T00:00:00Z,10,4,2020,0,0,Liechtenstein,LI,LIE,37910,Europe,1,79,6
2020-04-11T00:00:00Z,11,4,2020,1,0,Liechtenstein,LI,LIE,37910,Europe,1,80,7
2020-04-12T00:00:00Z,12,4,2020,0,0,Liechtenstein,LI,LIE,37910,Europe,1,80,8
2020-04-13T00:00:00Z,13,4,2020,0,0,Liechtenstein,LI,LIE,37910,Europe,1,80,9
2020-04-14T00:00:00Z,14,4,2020,1,0,Liechtenstein,LI,LIE,37910,Europe,1,81,10
2020-04-15T00:00:00Z,15,4,2020,0,0,Liechtenstein,LI,LIE,37910,Europe,1,81,11
2020-04-16T00:00:00Z,16,4,2020,0,0,Liechtenstein,LI,LIE,37910,Europe,1,81,12
2020-04-17T00:00:00Z,17,4,2020,0,0,Liechtenstein,LI,LIE,37910,Europe,1,81,13
2020-04-18T00:00:00Z,18,4,2020,0,0,Liechtenstein,LI,LIE,37910,Europe,1,81,14
2020-04-19T00:00:00Z,19,4,2020,1,0,Liechtenstein,LI,LIE,37910,Europe,1,82,15
2020-04-20T00:00:00Z,20,4,2020,0,0,Liechtenstein,LI,LIE,37910,Europe,1,82,16
2020-04-21T00:00:00Z,21,4,2020,0,0,Liechtenstein,LI,LIE,37910,Europe,1,82,17
2020-04-22T00:00:00Z,22,4,2020,0,0,Liechtenstein,LI,LIE,37910,Europe,1,82,18
2020-04-23T00:00:00Z,23,4,2020,0,0,Liechtenstein,LI,LIE,37910,Europe,1,82,19
2020-04-24T00:00:00Z,24,4,2020,0,0,Liechtenstein,LI,LIE,37910,Europe,1,82,20
2020-04-25T00:00:00Z,25,4,2020,0,0,Liechtenstein,LI,LIE,37910,Europe,1,82,21
2020-04-26T00:00:00Z,26,4,2020,1,0,Liechtenstein,LI,LIE,37910,Europe,1,83,22
2020-04-27T00:00:00Z,27,4,2020,0,0,Liechtenstein,LI,LIE,37910,Europe,1,83,23
2020-04-28T00:00:00Z,28,4,2020,0,0,Liechtenstein,LI,LIE,37910,Europe,1,83,24
2020-04-29T00:00:00Z,29,4,2020,0,0,Liechtenstein,LI,LIE,37910,Europe,1,83,25
2020-04-30T00:00:00Z,30,4,2020,0,0,Liechtenstein,LI,LIE,37910,Europe,1,83,26
2020-05-01T00:00:00Z,1,5,2020,0,0,Liechtenstein,LI,LIE,37910,Europe,1,83,27
2020-05-02T00:00:00Z,2,5,2020,0,0,Liechtenstein,LI,LIE,37910,Europe,1,83,28
2020-05-03T00:00:00Z,3,5,2020,0,0,Liechtenstein,LI,LIE,37910,Europe,1,83,29
2020-05-04T00:00:00Z,4,5,2020,0,0,Liechtenstein,LI,LIE,37910,Europe,1,83,30
2020-05-05T00:00:00Z,5,5,2020,0,0,Liechtenstein,LI,LIE,37910,Europe,1,83,31
2020-05-06T00:00:00Z,6,5,2020,0,0,Liechtenstein,LI,LIE,37910,Europe,1,83,32
2020-05-07T00:00:00Z,7,5,2020,0,0,Liechtenstein,LI,LIE,37910,Europe,1,83,33
2020-05-08T00:00:00Z,8,5,2020,0,0,Liechtenstein,LI,LIE,37910,Europe,1,83,34
2020-05-09T00:00:00Z,9,5,2020,0,0,Liechtenstein,LI,LIE,37910,Europe,1,83,35
2020-05-10T00:00:00Z,10,5,2020,0,0,Liechtenstein,LI,LIE,37910,Europe,1,83,36
2020-05-11T00:00:00Z,11,5,2020,0,0,Liechtenstein,LI,LIE,37910,Europe,1,83,37
2020-05-12T00:00:00Z,12,5,2020,0,0,Liechtenstein,LI,LIE,37910,Europe,1,83,38
2020-05-13T00:00:00Z,13,5,2020,0,0,Liechtenstein,LI,LIE,37910,Europe,1,83,39
2020-05-14T00:00:00Z,14,5,2020,0,0,Liechtenstein,LI,LIE,37910,Europe,1,83,40
2020-05-15T00:00:00Z,15,5,2020,0,0,Liechtenstein,LI,LIE,37910,Europe,1,83,41
2020-05-16T00:00:00Z,16,5,2020,0,0,Liechtenstein,LI,LIE,37910,Europe,1,83,42
2020-05-17T00:00:00Z,17,5,2020,0,0,Liechtenstein,LI,LIE,37910,Europe,1,83,43
2020-05-18T00:00:00Z,18,5,2020,0,0,Liechtenstein,LI,LIE,37910,Europe,1,83,44
2020-05-19T00:00:00Z,19,5,2020,0,0,Liechtenstein,LI,LIE,37910,Europe,1,83,45
2020-05-20T00:00:00Z,20,5,2020,0,0,Liechtenstein,LI,LIE,37910,Europe,1,83,46
2020-05-21T00:00:00Z,21,5,2020,0,0,Liechtenstein,LI,LIE,37910,Europe,1,83,47
2020-05-22T00:00:00Z,22,5,2020,0,0,Liechtenstein,LI,LIE,37910,Europe,1,83,48
2020-05-23T00:00:00Z,23,5,2020,0,0,Liechtenstein,LI,LIE,37910,Europe,1,83,49
2020-05-24T00:00:00Z,24,5,2020,0,0,Liechtenstein,LI,LIE,37910,Europe,1,83,50
2020-05-25T00:00:00Z,25,5,2020,0,0,Liechtenstein,LI,LIE,37910,Europe,1,83,51
2020-05-26T00:00:00Z,26,5,2020,0,0,Liechtenstein,LI,LIE,37910,Europe,1,83,52
2020-05-27T00:00:00Z,27,5,2020,0,0,Liechtenstein,LI,LIE,37910,Europe,1,83,53
2020-03-21T00:00:00Z,21,3,2020,21,1,Lithuania,LT,LTU,2789533,Europe,1,69,1
2020-03-22T00:00:00Z,22,3,2020,36,0,Lithuania,LT,LTU,2789533,Europe,1,105,2
2020-03-23T00:00:00Z,23,3,2020,38,0,Lithuania,LT,LTU,2789533,Europe,1,143,3
2020-03-24T00:00:00Z,24,3,2020,36,0,Lithuania,LT,LTU,2789533,Europe,1,179,4
2020-03-25T00:00:00Z,25,3,2020,30,1,Lithuania,LT,LTU,2789533,Europe,2,209,5
2020-03-26T00:00:00Z,26,3,2020,65,2,Lithuania,LT,LTU,2789533,Europe,4,274,6
2020-03-27T00:00:00Z,27,3,2020,25,0,Lithuania,LT,LTU,2789533,Europe,4,299,7
2020-03-28T00:00:00Z,28,3,2020,59,1,Lithuania,LT,LTU,2789533,Europe,5,358,8
2020-03-29T00:00:00Z,29,3,2020,36,2,Lithuania,LT,LTU,2789533,Europe,7,394,9
2020-03-30T00:00:00Z,30,3,2020,90,0,Lithuania,LT,LTU,2789533,Europe,7,484,10
2020-03-31T00:00:00Z,31,3,2020,0,0,Lithuania,LT,LTU,2789533,Europe,7,484,11
2020-04-01T00:00:00Z,1,4,2020,49,0,Lithuania,LT,LTU,2789533,Europe,7,533,12
2020-04-02T00:00:00Z,2,4,2020,48,1,Lithuania,LT,LTU,2789533,Europe,8,581,13
2020-04-03T00:00:00Z,3,4,2020,68,1,Lithuania,LT,LTU,2789533,Europe,9,649,14
2020-04-04T00:00:00Z,4,4,2020,122,0,Lithuania,LT,LTU,2789533,Europe,9,771,15
2020-04-05T00:00:00Z,5,4,2020,0,0,Lithuania,LT,LTU,2789533,Europe,9,771,16
2020-04-06T00:00:00Z,6,4,2020,40,4,Lithuania,LT,LTU,2789533,Europe,13,811,17
2020-04-07T00:00:00Z,7,4,2020,32,1,Lithuania,LT,LTU,2789533,Europe,14,843,18
2020-04-08T00:00:00Z,8,4,2020,37,1,Lithuania,LT,LTU,2789533,Europe,15,880,19
2020-04-09T00:00:00Z,9,4,2020,32,0,Lithuania,LT,LTU,2789533,Europe,15,912,20
2020-04-10T00:00:00Z,10,4,2020,43,0,Lithuania,LT,LTU,2789533,Europe,15,955,21
2020-04-11T00:00:00Z,11,4,2020,44,2,Lithuania,LT,LTU,2789533,Europe,17,999,22
2020-04-12T00:00:00Z,12,4,2020,54,6,Lithuania,LT,LTU,2789533,Europe,23,1053,23
2020-04-13T00:00:00Z,13,4,2020,9,1,Lithuania,LT,LTU,2789533,Europe,24,1062,24
2020-04-14T00:00:00Z,14,4,2020,8,0,Lithuania,LT,LTU,2789533,Europe,24,1070,25
2020-04-15T00:00:00Z,15,4,2020,0,0,Lithuania,LT,LTU,2789533,Europe,24,1070,26
2020-04-16T00:00:00Z,16,4,2020,21,5,Lithuania,LT,LTU,2789533,Europe,29,1091,27
2020-04-17T00:00:00Z,17,4,2020,58,3,Lithuania,LT,LTU,2789533,Europe,32,1149,28
2020-04-18T00:00:00Z,18,4,2020,90,1,Lithuania,LT,LTU,2789533,Europe,33,1239,29
2020-04-19T00:00:00Z,19,4,2020,59,0,Lithuania,LT,LTU,2789533,Europe,33,1298,30
2020-04-20T00:00:00Z,20,4,2020,28,3,Lithuania,LT,LTU,2789533,Europe,36,1326,31
2020-04-21T00:00:00Z,21,4,2020,24,1,Lithuania,LT,LTU,2789533,Europe,37,1350,32
2020-04-22T00:00:00Z,22,4,2020,20,1,Lithuania,LT,LTU,2789533,Europe,38,1370,33
2020-04-23T00:00:00Z,23,4,2020,28,0,Lithuania,LT,LTU,2789533,Europe,38,1398,34
2020-04-24T00:00:00Z,24,4,2020,12,2,Lithuania,LT,LTU,2789533,Europe,40,1410,35
2020-04-25T00:00:00Z,25,4,2020,0,0,Lithuania,LT,LTU,2789533,Europe,40,1410,36
2020-04-26T00:00:00Z,26,4,2020,16,1,Lithuania,LT,LTU,2789533,Europe,41,1426,37
2020-04-27T00:00:00Z,27,4,2020,12,0,Lithuania,LT,LTU,2789533,Europe,41,1438,38
2020-04-28T00:00:00Z,28,4,2020,11,0,Lithuania,LT,LTU,2789533,Europe,41,1449,39
2020-04-29T00:00:00Z,29,4,2020,-105,3,Lithuania,LT,LTU,2789533,Europe,44,1344,40
2020-04-30T00:00:00Z,30,4,2020,31,1,Lithuania,LT,LTU,2789533,Europe,45,1375,41
2020-05-01T00:00:00Z,1,5,2020,10,0,Lithuania,LT,LTU,2789533,Europe,45,1385,42
2020-05-02T00:00:00Z,2,5,2020,14,0,Lithuania,LT,LTU,2789533,Europe,45,1399,43
2020-05-03T00:00:00Z,3,5,2020,7,1,Lithuania,LT,LTU,2789533,Europe,46,1406,44
2020-05-04T00:00:00Z,4,5,2020,4,0,Lithuania,LT,LTU,2789533,Europe,46,1410,45
2020-05-05T00:00:00Z,5,5,2020,9,0,Lithuania,LT,LTU,2789533,Europe,46,1419,46
2020-05-06T00:00:00Z,6,5,2020,4,0,Lithuania,LT,LTU,2789533,Europe,46,1423,47
2020-05-07T00:00:00Z,7,5,2020,5,2,Lithuania,LT,LTU,2789533,Europe,48,1428,48
2020-05-08T00:00:00Z,8,5,2020,5,1,Lithuania,LT,LTU,2789533,Europe,49,1433,49
2020-05-09T00:00:00Z,9,5,2020,3,0,Lithuania,LT,LTU,2789533,Europe,49,1436,50
2020-05-10T00:00:00Z,10,5,2020,8,1,Lithuania,LT,LTU,2789533,Europe,50,1444,51
2020-05-11T00:00:00Z,11,5,2020,35,0,Lithuania,LT,LTU,2789533,Europe,50,1479,52
2020-05-12T00:00:00Z,12,5,2020,6,0,Lithuania,LT,LTU,2789533,Europe,50,1485,53
2020-05-13T00:00:00Z,13,5,2020,6,0,Lithuania,LT,LTU,2789533,Europe,50,1491,54
2020-05-14T00:00:00Z,14,5,2020,14,4,Lithuania,LT,LTU,2789533,Europe,54,1505,55
2020-05-15T00:00:00Z,15,5,2020,6,0,Lithuania,LT,LTU,2789533,Europe,54,1511,56
2020-05-16T00:00:00Z,16,5,2020,12,0,Lithuania,LT,LTU,2789533,Europe,54,1523,57
2020-05-17T00:00:00Z,17,5,2020,11,1,Lithuania,LT,LTU,2789533,Europe,55,1534,58
2020-05-18T00:00:00Z,18,5,2020,7,1,Lithuania,LT,LTU,2789533,Europe,56,1541,59
2020-05-19T00:00:00Z,19,5,2020,6,3,Lithuania,LT,LTU,2789533,Europe,59,1547,60
2020-05-20T00:00:00Z,20,5,2020,15,1,Lithuania,LT,LTU,2789533,Europe,60,1562,61
2020-05-21T00:00:00Z,21,5,2020,15,0,Lithuania,LT,LTU,2789533,Europe,60,1577,62
2020-05-22T00:00:00Z,22,5,2020,17,1,Lithuania,LT,LTU,2789533,Europe,61,1594,63
2020-05-23T00:00:00Z,23,5,2020,10,0,Lithuania,LT,LTU,2789533,Europe,61,1604,64
2020-05-24T00:00:00Z,24,5,2020,12,2,Lithuania,LT,LTU,2789533,Europe,63,1616,65
2020-05-25T00:00:00Z,25,5,2020,7,0,Lithuania,LT,LTU,2789533,Europe,63,1623,66
2020-05-26T00:00:00Z,26,5,2020,12,0,Lithuania,LT,LTU,2789533,Europe,63,1635,67
2020-05-27T00:00:00Z,27,5,2020,4,2,Lithuania,LT,LTU,2789533,Europe,65,1639,68
2020-03-14T00:00:00Z,14,3,2020,12,1,Luxembourg,LU,LUX,607728,Europe,1,38,1
2020-03-16T00:00:00Z,16,3,2020,39,0,Luxembourg,LU,LUX,607728,Europe,1,77,2
2020-03-17T00:00:00Z,17,3,2020,4,0,Luxembourg,LU,LUX,607728,Europe,1,81,3
2020-03-18T00:00:00Z,18,3,2020,59,0,Luxembourg,LU,LUX,607728,Europe,1,140,4
2020-03-19T00:00:00Z,19,3,2020,70,1,Luxembourg,LU,LUX,607728,Europe,2,210,5
2020-03-20T00:00:00Z,20,3,2020,135,2,Luxembourg,LU,LUX,607728,Europe,4,345,6
2020-03-21T00:00:00Z,21,3,2020,139,1,Luxembourg,LU,LUX,607728,Europe,5,484,7
2020-03-22T00:00:00Z,22,3,2020,186,3,Luxembourg,LU,LUX,607728,Europe,8,670,8
2020-03-23T00:00:00Z,23,3,2020,128,0,Luxembourg,LU,LUX,607728,Europe,8,798,9
2020-03-24T00:00:00Z,24,3,2020,77,0,Luxembourg,LU,LUX,607728,Europe,8,875,10
2020-03-25T00:00:00Z,25,3,2020,224,0,Luxembourg,LU,LUX,607728,Europe,8,1099,11
2020-03-26T00:00:00Z,26,3,2020,234,0,Luxembourg,LU,LUX,607728,Europe,8,1333,12
2020-03-27T00:00:00Z,27,3,2020,120,1,Luxembourg,LU,LUX,607728,Europe,9,1453,13
2020-03-28T00:00:00Z,28,3,2020,152,6,Luxembourg,LU,LUX,607728,Europe,15,1605,14
2020-03-29T00:00:00Z,29,3,2020,226,3,Luxembourg,LU,LUX,607728,Europe,18,1831,15
2020-03-30T00:00:00Z,30,3,2020,119,3,Luxembourg,LU,LUX,607728,Europe,21,1950,16
2020-03-31T00:00:00Z,31,3,2020,38,1,Luxembourg,LU,LUX,607728,Europe,22,1988,17
2020-04-01T00:00:00Z,1,4,2020,190,1,Luxembourg,LU,LUX,607728,Europe,23,2178,18
2020-04-02T00:00:00Z,2,4,2020,141,6,Luxembourg,LU,LUX,607728,Europe,29,2319,19
2020-04-03T00:00:00Z,3,4,2020,168,1,Luxembourg,LU,LUX,607728,Europe,30,2487,20
2020-04-04T00:00:00Z,4,4,2020,125,1,Luxembourg,LU,LUX,607728,Europe,31,2612,21
2020-04-05T00:00:00Z,5,4,2020,117,0,Luxembourg,LU,LUX,607728,Europe,31,2729,22
2020-04-06T00:00:00Z,6,4,2020,75,5,Luxembourg,LU,LUX,607728,Europe,36,2804,23
2020-04-07T00:00:00Z,7,4,2020,39,5,Luxembourg,LU,LUX,607728,Europe,41,2843,24
2020-04-08T00:00:00Z,8,4,2020,127,3,Luxembourg,LU,LUX,607728,Europe,44,2970,25
2020-04-09T00:00:00Z,9,4,2020,64,2,Luxembourg,LU,LUX,607728,Europe,46,3034,26
2020-04-10T00:00:00Z,10,4,2020,81,6,Luxembourg,LU,LUX,607728,Europe,52,3115,27
2020-04-11T00:00:00Z,11,4,2020,108,2,Luxembourg,LU,LUX,607728,Europe,54,3223,28
2020-04-12T00:00:00Z,12,4,2020,47,8,Luxembourg,LU,LUX,607728,Europe,62,3270,29
2020-04-13T00:00:00Z,13,4,2020,11,4,Luxembourg,LU,LUX,607728,Europe,66,3281,30
2020-04-14T00:00:00Z,14,4,2020,11,1,Luxembourg,LU,LUX,607728,Europe,67,3292,31
2020-04-15T00:00:00Z,15,4,2020,15,0,Luxembourg,LU,LUX,607728,Europe,67,3307,32
2020-04-16T00:00:00Z,16,4,2020,66,2,Luxembourg,LU,LUX,607728,Europe,69,3373,33
2020-04-17T00:00:00Z,17,4,2020,71,0,Luxembourg,LU,LUX,607728,Europe,69,3444,34
2020-04-18T00:00:00Z,18,4,2020,36,3,Luxembourg,LU,LUX,607728,Europe,72,3480,35
2020-04-19T00:00:00Z,19,4,2020,57,0,Luxembourg,LU,LUX,607728,Europe,72,3537,36
2020-04-20T00:00:00Z,20,4,2020,13,1,Luxembourg,LU,LUX,607728,Europe,73,3550,37
2020-04-21T00:00:00Z,21,4,2020,8,2,Luxembourg,LU,LUX,607728,Europe,75,3558,38
2020-04-22T00:00:00Z,22,4,2020,60,3,Luxembourg,LU,LUX,607728,Europe,78,3618,39
2020-04-23T00:00:00Z,23,4,2020,36,2,Luxembourg,LU,LUX,607728,Europe,80,3654,40
2020-04-24T00:00:00Z,24,4,2020,11,3,Luxembourg,LU,LUX,607728,Europe,83,3665,41
2020-04-25T00:00:00Z,25,4,2020,30,2,Luxembourg,LU,LUX,607728,Europe,85,3695,42
2020-04-26T00:00:00Z,26,4,2020,16,0,Luxembourg,LU,LUX,607728,Europe,85,3711,43
2020-04-27T00:00:00Z,27,4,2020,12,3,Luxembourg,LU,LUX,607728,Europe,88,3723,44
2020-04-28T00:00:00Z,28,4,2020,6,0,Luxembourg,LU,LUX,607728,Europe,88,3729,45
2020-04-29T00:00:00Z,29,4,2020,12,1,Luxembourg,LU,LUX,607728,Europe,89,3741,46
2020-04-30T00:00:00Z,30,4,2020,28,0,Luxembourg,LU,LUX,607728,Europe,89,3769,47
2020-05-01T00:00:00Z,1,5,2020,15,1,Luxembourg,LU,LUX,607728,Europe,90,3784,48
2020-05-02T00:00:00Z,2,5,2020,18,2,Luxembourg,LU,LUX,607728,Europe,92,3802,49
2020-05-03T00:00:00Z,3,5,2020,10,0,Luxembourg,LU,LUX,607728,Europe,92,3812,50
2020-05-04T00:00:00Z,4,5,2020,12,4,Luxembourg,LU,LUX,607728,Europe,96,3824,51
2020-05-05T00:00:00Z,5,5,2020,4,0,Luxembourg,LU,LUX,607728,Europe,96,3828,52
2020-05-06T00:00:00Z,6,5,2020,12,0,Luxembourg,LU,LUX,607728,Europe,96,3840,53
2020-05-07T00:00:00Z,7,5,2020,11,2,Luxembourg,LU,LUX,607728,Europe,98,3851,54
2020-05-08T00:00:00Z,8,5,2020,8,2,Luxembourg,LU,LUX,607728,Europe,100,3859,55
2020-05-09T00:00:00Z,9,5,2020,12,0,Luxembourg,LU,LUX,607728,Europe,100,3871,56
2020-05-10T00:00:00Z,10,5,2020,6,1,Luxembourg,LU,LUX,607728,Europe,101,3877,57
2020-05-11T00:00:00Z,11,5,2020,9,0,Luxembourg,LU,LUX,607728,Europe,101,3886,58
2020-05-12T00:00:00Z,12,5,2020,2,0,Luxembourg,LU,LUX,607728,Europe,101,3888,59
2020-05-13T00:00:00Z,13,5,2020,6,1,Luxembourg,LU,LUX,607728,Europe,102,3894,60
2020-05-14T00:00:00Z,14,5,2020,10,1,Luxembourg,LU,LUX,607728,Europe,103,3904,61
2020-05-15T00:00:00Z,15,5,2020,11,0,Luxembourg,LU,LUX,607728,Europe,103,3915,62
2020-05-16T00:00:00Z,16,5,2020,8,1,Luxembourg,LU,LUX,607728,Europe,104,3923,63
2020-05-17T00:00:00Z,17,5,2020,7,0,Luxembourg,LU,LUX,607728,Europe,104,3930,64
2020-05-18T00:00:00Z,18,5,2020,15,3,Luxembourg,LU,LUX,607728,Europe,107,3945,65
2020-05-19T00:00:00Z,19,5,2020,2,0,Luxembourg,LU,LUX,607728,Europe,107,3947,66
2020-05-20T00:00:00Z,20,5,2020,11,2,Luxembourg,LU,LUX,607728,Europe,109,3958,67
2020-05-21T00:00:00Z,21,5,2020,13,0,Luxembourg,LU,LUX,607728,Europe,109,3971,68
2020-05-22T00:00:00Z,22,5,2020,9,0,Luxembourg,LU,LUX,607728,Europe,109,3980,69
2020-05-23T00:00:00Z,23,5,2020,1,0,Luxembourg,LU,LUX,607728,Europe,109,3981,70
2020-05-24T00:00:00Z,24,5,2020,9,0,Luxembourg,LU,LUX,607728,Europe,109,3990,71
2020-05-25T00:00:00Z,25,5,2020,2,1,Luxembourg,LU,LUX,607728,Europe,110,3992,72
2020-05-26T00:00:00Z,26,5,2020,1,0,Luxembourg,LU,LUX,607728,Europe,110,3993,73
2020-05-27T00:00:00Z,27,5,2020,2,0,Luxembourg,LU,LUX,607728,Europe,110,3995,74
2020-05-18T00:00:00Z,18,5,2020,21,1,Madagascar,MG,MDG,26262368,Africa,1,304,1
2020-05-19T00:00:00Z,19,5,2020,18,0,Madagascar,MG,MDG,26262368,Africa,1,322,2
2020-05-20T00:00:00Z,20,5,2020,4,1,Madagascar,MG,MDG,26262368,Africa,2,326,3
2020-05-21T00:00:00Z,21,5,2020,45,0,Madagascar,MG,MDG,26262368,Africa,2,371,4
2020-05-22T00:00:00Z,22,5,2020,34,0,Madagascar,MG,MDG,26262368,Africa,2,405,5
2020-05-23T00:00:00Z,23,5,2020,43,0,Madagascar,MG,MDG,26262368,Africa,2,448,6
2020-05-24T00:00:00Z,24,5,2020,0,0,Madagascar,MG,MDG,26262368,Africa,2,448,7
2020-05-25T00:00:00Z,25,5,2020,79,0,Madagascar,MG,MDG,26262368,Africa,2,527,8
2020-05-26T00:00:00Z,26,5,2020,15,0,Madagascar,MG,MDG,26262368,Africa,2,542,9
2020-05-27T00:00:00Z,27,5,2020,44,0,Madagascar,MG,MDG,26262368,Africa,2,586,10
2020-04-08T00:00:00Z,8,4,2020,3,1,Malawi,MW,MWI,18143315,Africa,1,8,1
2020-04-09T00:00:00Z,9,4,2020,0,0,Malawi,MW,MWI,18143315,Africa,1,8,2
2020-04-10T00:00:00Z,10,4,2020,0,0,Malawi,MW,MWI,18143315,Africa,1,8,3
2020-04-11T00:00:00Z,11,4,2020,1,0,Malawi,MW,MWI,18143315,Africa,1,9,4
2020-04-12T00:00:00Z,12,4,2020,3,1,Malawi,MW,MWI,18143315,Africa,2,12,5
2020-04-13T00:00:00Z,13,4,2020,1,0,Malawi,MW,MWI,18143315,Africa,2,13,6
2020-04-14T00:00:00Z,14,4,2020,3,0,Malawi,MW,MWI,18143315,Africa,2,16,7
2020-04-15T00:00:00Z,15,4,2020,0,0,Malawi,MW,MWI,18143315,Africa,2,16,8
2020-04-16T00:00:00Z,16,4,2020,0,0,Malawi,MW,MWI,18143315,Africa,2,16,9
2020-04-17T00:00:00Z,17,4,2020,0,0,Malawi,MW,MWI,18143315,Africa,2,16,10
2020-04-18T00:00:00Z,18,4,2020,1,0,Malawi,MW,MWI,18143315,Africa,2,17,11
2020-04-19T00:00:00Z,19,4,2020,0,0,Malawi,MW,MWI,18143315,Africa,2,17,12
2020-04-20T00:00:00Z,20,4,2020,0,0,Malawi,MW,MWI,18143315,Africa,2,17,13
2020-04-21T00:00:00Z,21,4,2020,0,0,Malawi,MW,MWI,18143315,Africa,2,17,14
2020-04-22T00:00:00Z,22,4,2020,1,0,Malawi,MW,MWI,18143315,Africa,2,18,15
2020-04-23T00:00:00Z,23,4,2020,5,1,Malawi,MW,MWI,18143315,Africa,3,23,16
2020-04-24T00:00:00Z,24,4,2020,10,0,Malawi,MW,MWI,18143315,Africa,3,33,17
2020-04-25T00:00:00Z,25,4,2020,0,0,Malawi,MW,MWI,18143315,Africa,3,33,18
2020-04-26T00:00:00Z,26,4,2020,0,0,Malawi,MW,MWI,18143315,Africa,3,33,19
2020-04-27T00:00:00Z,27,4,2020,1,0,Malawi,MW,MWI,18143315,Africa,3,34,20
2020-04-28T00:00:00Z,28,4,2020,2,0,Malawi,MW,MWI,18143315,Africa,3,36,21
2020-04-29T00:00:00Z,29,4,2020,0,0,Malawi,MW,MWI,18143315,Africa,3,36,22
2020-04-30T00:00:00Z,30,4,2020,0,0,Malawi,MW,MWI,18143315,Africa,3,36,23
2020-05-01T00:00:00Z,1,5,2020,1,0,Malawi,MW,MWI,18143315,Africa,3,37,24
2020-05-02T00:00:00Z,2,5,2020,0,0,Malawi,MW,MWI,18143315,Africa,3,37,25
2020-05-03T00:00:00Z,3,5,2020,1,0,Malawi,MW,MWI,18143315,Africa,3,38,26
2020-05-04T00:00:00Z,4,5,2020,1,0,Malawi,MW,MWI,18143315,Africa,3,39,27
2020-05-05T00:00:00Z,5,5,2020,2,0,Malawi,MW,MWI,18143315,Africa,3,41,28
2020-05-06T00:00:00Z,6,5,2020,0,0,Malawi,MW,MWI,18143315,Africa,3,41,29
2020-05-07T00:00:00Z,7,5,2020,2,0,Malawi,MW,MWI,18143315,Africa,3,43,30
2020-05-08T00:00:00Z,8,5,2020,0,0,Malawi,MW,MWI,18143315,Africa,3,43,31
2020-05-09T00:00:00Z,9,5,2020,0,0,Malawi,MW,MWI,18143315,Africa,3,43,32
2020-05-10T00:00:00Z,10,5,2020,13,0,Malawi,MW,MWI,18143315,Africa,3,56,33
2020-05-11T00:00:00Z,11,5,2020,0,0,Malawi,MW,MWI,18143315,Africa,3,56,34
2020-05-12T00:00:00Z,12,5,2020,1,0,Malawi,MW,MWI,18143315,Africa,3,57,35
2020-05-13T00:00:00Z,13,5,2020,1,0,Malawi,MW,MWI,18143315,Africa,3,58,36
2020-05-14T00:00:00Z,14,5,2020,5,0,Malawi,MW,MWI,18143315,Africa,3,63,37
2020-05-15T00:00:00Z,15,5,2020,0,0,Malawi,MW,MWI,18143315,Africa,3,63,38
2020-05-16T00:00:00Z,16,5,2020,0,0,Malawi,MW,MWI,18143315,Africa,3,63,39
2020-05-17T00:00:00Z,17,5,2020,2,0,Malawi,MW,MWI,18143315,Africa,3,65,40
2020-05-18T00:00:00Z,18,5,2020,5,0,Malawi,MW,MWI,18143315,Africa,3,70,41
2020-05-19T00:00:00Z,19,5,2020,0,0,Malawi,MW,MWI,18143315,Africa,3,70,42
2020-05-20T00:00:00Z,20,5,2020,1,0,Malawi,MW,MWI,18143315,Africa,3,71,43
2020-05-21T00:00:00Z,21,5,2020,1,0,Malawi,MW,MWI,18143315,Africa,3,72,44
2020-05-22T00:00:00Z,22,5,2020,0,0,Malawi,MW,MWI,18143315,Africa,3,72,45
2020-05-23T00:00:00Z,23,5,2020,10,0,Malawi,MW,MWI,18143315,Africa,3,82,46
2020-05-24T00:00:00Z,24,5,2020,1,1,Malawi,MW,MWI,18143315,Africa,4,83,47
2020-05-25T00:00:00Z,25,5,2020,0,0,Malawi,MW,MWI,18143315,Africa,4,83,48
2020-05-26T00:00:00Z,26,5,2020,18,0,Malawi,MW,MWI,18143315,Africa,4,101,49
2020-05-27T00:00:00Z,27,5,2020,0,0,Malawi,MW,MWI,18143315,Africa,4,101,50
2020-03-18T00:00:00Z,18,3,2020,120,2,Malaysia,MY,MYS,31528585,Asia,2,673,1
2020-03-19T00:00:00Z,19,3,2020,117,0,Malaysia,MY,MYS,31528585,Asia,2,790,2
2020-03-20T00:00:00Z,20,3,2020,110,0,Malaysia,MY,MYS,31528585,Asia,2,900,3
2020-03-21T00:00:00Z,21,3,2020,130,0,Malaysia,MY,MYS,31528585,Asia,2,1030,4
2020-03-22T00:00:00Z,22,3,2020,153,2,Malaysia,MY,MYS,31528585,Asia,4,1183,5
2020-03-23T00:00:00Z,23,3,2020,123,6,Malaysia,MY,MYS,31528585,Asia,10,1306,6
2020-03-24T00:00:00Z,24,3,2020,212,4,Malaysia,MY,MYS,31528585,Asia,14,1518,7
2020-03-25T00:00:00Z,25,3,2020,106,1,Malaysia,MY,MYS,31528585,Asia,15,1624,8
2020-03-26T00:00:00Z,26,3,2020,172,4,Malaysia,MY,MYS,31528585,Asia,19,1796,9
2020-03-27T00:00:00Z,27,3,2020,235,4,Malaysia,MY,MYS,31528585,Asia,23,2031,10
2020-03-28T00:00:00Z,28,3,2020,130,3,Malaysia,MY,MYS,31528585,Asia,26,2161,11
2020-03-29T00:00:00Z,29,3,2020,159,1,Malaysia,MY,MYS,31528585,Asia,27,2320,12
2020-03-30T00:00:00Z,30,3,2020,150,7,Malaysia,MY,MYS,31528585,Asia,34,2470,13
2020-03-31T00:00:00Z,31,3,2020,156,3,Malaysia,MY,MYS,31528585,Asia,37,2626,14
2020-04-01T00:00:00Z,1,4,2020,140,6,Malaysia,MY,MYS,31528585,Asia,43,2766,15
2020-04-02T00:00:00Z,2,4,2020,142,2,Malaysia,MY,MYS,31528585,Asia,45,2908,16
2020-04-03T00:00:00Z,3,4,2020,208,5,Malaysia,MY,MYS,31528585,Asia,50,3116,17
2020-04-04T00:00:00Z,4,4,2020,217,3,Malaysia,MY,MYS,31528585,Asia,53,3333,18
2020-04-05T00:00:00Z,5,4,2020,150,4,Malaysia,MY,MYS,31528585,Asia,57,3483,19
2020-04-06T00:00:00Z,6,4,2020,179,4,Malaysia,MY,MYS,31528585,Asia,61,3662,20
2020-04-07T00:00:00Z,7,4,2020,131,1,Malaysia,MY,MYS,31528585,Asia,62,3793,21
2020-04-08T00:00:00Z,8,4,2020,170,1,Malaysia,MY,MYS,31528585,Asia,63,3963,22
2020-04-09T00:00:00Z,9,4,2020,156,2,Malaysia,MY,MYS,31528585,Asia,65,4119,23
2020-04-10T00:00:00Z,10,4,2020,109,2,Malaysia,MY,MYS,31528585,Asia,67,4228,24
2020-04-11T00:00:00Z,11,4,2020,118,3,Malaysia,MY,MYS,31528585,Asia,70,4346,25
2020-04-12T00:00:00Z,12,4,2020,184,3,Malaysia,MY,MYS,31528585,Asia,73,4530,26
2020-04-13T00:00:00Z,13,4,2020,153,3,Malaysia,MY,MYS,31528585,Asia,76,4683,27
2020-04-14T00:00:00Z,14,4,2020,134,1,Malaysia,MY,MYS,31528585,Asia,77,4817,28
2020-04-15T00:00:00Z,15,4,2020,170,5,Malaysia,MY,MYS,31528585,Asia,82,4987,29
2020-04-16T00:00:00Z,16,4,2020,85,1,Malaysia,MY,MYS,31528585,Asia,83,5072,30
2020-04-17T00:00:00Z,17,4,2020,110,1,Malaysia,MY,MYS,31528585,Asia,84,5182,31
2020-04-18T00:00:00Z,18,4,2020,69,2,Malaysia,MY,MYS,31528585,Asia,86,5251,32
2020-04-19T00:00:00Z,19,4,2020,54,2,Malaysia,MY,MYS,31528585,Asia,88,5305,33
2020-04-20T00:00:00Z,20,4,2020,84,1,Malaysia,MY,MYS,31528585,Asia,89,5389,34
2020-04-21T00:00:00Z,21,4,2020,36,0,Malaysia,MY,MYS,31528585,Asia,89,5425,35
2020-04-22T00:00:00Z,22,4,2020,57,3,Malaysia,MY,MYS,31528585,Asia,92,5482,36
2020-04-23T00:00:00Z,23,4,2020,50,1,Malaysia,MY,MYS,31528585,Asia,93,5532,37
2020-04-24T00:00:00Z,24,4,2020,71,2,Malaysia,MY,MYS,31528585,Asia,95,5603,38
2020-04-25T00:00:00Z,25,4,2020,88,1,Malaysia,MY,MYS,31528585,Asia,96,5691,39
2020-04-26T00:00:00Z,26,4,2020,51,2,Malaysia,MY,MYS,31528585,Asia,98,5742,40
2020-04-27T00:00:00Z,27,4,2020,38,0,Malaysia,MY,MYS,31528585,Asia,98,5780,41
2020-04-28T00:00:00Z,28,4,2020,40,1,Malaysia,MY,MYS,31528585,Asia,99,5820,42
2020-04-29T00:00:00Z,29,4,2020,31,1,Malaysia,MY,MYS,31528585,Asia,100,5851,43
2020-04-30T00:00:00Z,30,4,2020,94,0,Malaysia,MY,MYS,31528585,Asia,100,5945,44
2020-05-01T00:00:00Z,1,5,2020,57,2,Malaysia,MY,MYS,31528585,Asia,102,6002,45
2020-05-02T00:00:00Z,2,5,2020,69,1,Malaysia,MY,MYS,31528585,Asia,103,6071,46
2020-05-03T00:00:00Z,3,5,2020,105,0,Malaysia,MY,MYS,31528585,Asia,103,6176,47
2020-05-04T00:00:00Z,4,5,2020,122,2,Malaysia,MY,MYS,31528585,Asia,105,6298,48
2020-05-05T00:00:00Z,5,5,2020,55,0,Malaysia,MY,MYS,31528585,Asia,105,6353,49
2020-05-06T00:00:00Z,6,5,2020,30,1,Malaysia,MY,MYS,31528585,Asia,106,6383,50
2020-05-07T00:00:00Z,7,5,2020,45,1,Malaysia,MY,MYS,31528585,Asia,107,6428,51
2020-05-08T00:00:00Z,8,5,2020,39,0,Malaysia,MY,MYS,31528585,Asia,107,6467,52
2020-05-09T00:00:00Z,9,5,2020,68,0,Malaysia,MY,MYS,31528585,Asia,107,6535,53
2020-05-10T00:00:00Z,10,5,2020,54,1,Malaysia,MY,MYS,31528585,Asia,108,6589,54
2020-05-11T00:00:00Z,11,5,2020,67,0,Malaysia,MY,MYS,31528585,Asia,108,6656,55
2020-05-12T00:00:00Z,12,5,2020,70,1,Malaysia,MY,MYS,31528585,Asia,109,6726,56
2020-05-13T00:00:00Z,13,5,2020,16,0,Malaysia,MY,MYS,31528585,Asia,109,6742,57
2020-05-14T00:00:00Z,14,5,2020,37,2,Malaysia,MY,MYS,31528585,Asia,111,6779,58
2020-05-15T00:00:00Z,15,5,2020,40,1,Malaysia,MY,MYS,31528585,Asia,112,6819,59
2020-05-16T00:00:00Z,16,5,2020,36,0,Malaysia,MY,MYS,31528585,Asia,112,6855,60
2020-05-17T00:00:00Z,17,5,2020,17,1,Malaysia,MY,MYS,31528585,Asia,113,6872,61
2020-05-18T00:00:00Z,18,5,2020,22,0,Malaysia,MY,MYS,31528585,Asia,113,6894,62
2020-05-19T00:00:00Z,19,5,2020,47,0,Malaysia,MY,MYS,31528585,Asia,113,6941,63
2020-05-20T00:00:00Z,20,5,2020,37,1,Malaysia,MY,MYS,31528585,Asia,114,6978,64
2020-05-21T00:00:00Z,21,5,2020,31,0,Malaysia,MY,MYS,31528585,Asia,114,7009,65
2020-05-22T00:00:00Z,22,5,2020,50,0,Malaysia,MY,MYS,31528585,Asia,114,7059,66
2020-05-23T00:00:00Z,23,5,2020,78,1,Malaysia,MY,MYS,31528585,Asia,115,7137,67
2020-05-24T00:00:00Z,24,5,2020,48,0,Malaysia,MY,MYS,31528585,Asia,115,7185,68
2020-05-25T00:00:00Z,25,5,2020,60,0,Malaysia,MY,MYS,31528585,Asia,115,7245,69
2020-05-26T00:00:00Z,26,5,2020,172,0,Malaysia,MY,MYS,31528585,Asia,115,7417,70
2020-05-27T00:00:00Z,27,5,2020,187,0,Malaysia,MY,MYS,31528585,Asia,115,7604,71
2020-05-01T00:00:00Z,1,5,2020,191,1,Maldives,MV,MDV,515696,Asia,1,468,1
2020-05-02T00:00:00Z,2,5,2020,23,0,Maldives,MV,MDV,515696,Asia,1,491,2
2020-05-03T00:00:00Z,3,5,2020,28,0,Maldives,MV,MDV,515696,Asia,1,519,3
2020-05-04T00:00:00Z,4,5,2020,8,0,Maldives,MV,MDV,515696,Asia,1,527,4
2020-05-05T00:00:00Z,5,5,2020,24,0,Maldives,MV,MDV,515696,Asia,1,551,5
2020-05-06T00:00:00Z,6,5,2020,22,0,Maldives,MV,MDV,515696,Asia,1,573,6
2020-05-07T00:00:00Z,7,5,2020,44,1,Maldives,MV,MDV,515696,Asia,2,617,7
2020-05-08T00:00:00Z,8,5,2020,25,1,Maldives,MV,MDV,515696,Asia,3,642,8
2020-05-09T00:00:00Z,9,5,2020,2,0,Maldives,MV,MDV,515696,Asia,3,644,9
2020-05-10T00:00:00Z,10,5,2020,146,0,Maldives,MV,MDV,515696,Asia,3,790,10
2020-05-11T00:00:00Z,11,5,2020,45,0,Maldives,MV,MDV,515696,Asia,3,835,11
2020-05-12T00:00:00Z,12,5,2020,62,0,Maldives,MV,MDV,515696,Asia,3,897,12
2020-05-13T00:00:00Z,13,5,2020,7,0,Maldives,MV,MDV,515696,Asia,3,904,13
2020-05-14T00:00:00Z,14,5,2020,51,1,Maldives,MV,MDV,515696,Asia,4,955,14
2020-05-15T00:00:00Z,15,5,2020,27,0,Maldives,MV,MDV,515696,Asia,4,982,15
2020-05-16T00:00:00Z,16,5,2020,49,0,Maldives,MV,MDV,515696,Asia,4,1031,16
2020-05-17T00:00:00Z,17,5,2020,47,0,Maldives,MV,MDV,515696,Asia,4,1078,17
2020-05-18T00:00:00Z,18,5,2020,16,0,Maldives,MV,MDV,515696,Asia,4,1094,18
2020-05-19T00:00:00Z,19,5,2020,12,0,Maldives,MV,MDV,515696,Asia,4,1106,19
2020-05-20T00:00:00Z,20,5,2020,37,0,Maldives,MV,MDV,515696,Asia,4,1143,20
2020-05-21T00:00:00Z,21,5,2020,43,0,Maldives,MV,MDV,515696,Asia,4,1186,21
2020-05-22T00:00:00Z,22,5,2020,30,0,Maldives,MV,MDV,515696,Asia,4,1216,22
2020-05-23T00:00:00Z,23,5,2020,58,0,Maldives,MV,MDV,515696,Asia,4,1274,23
2020-05-24T00:00:00Z,24,5,2020,29,0,Maldives,MV,MDV,515696,Asia,4,1303,24
2020-05-25T00:00:00Z,25,5,2020,68,0,Maldives,MV,MDV,515696,Asia,4,1371,25
2020-05-26T00:00:00Z,26,5,2020,24,0,Maldives,MV,MDV,515696,Asia,4,1395,26
2020-05-27T00:00:00Z,27,5,2020,43,1,Maldives,MV,MDV,515696,Asia,5,1438,27
2020-04-01T00:00:00Z,1,4,2020,0,1,Mali,ML,MLI,19077690,Africa,1,18,1
2020-04-02T00:00:00Z,2,4,2020,10,0,Mali,ML,MLI,19077690,Africa,1,28,2
2020-04-03T00:00:00Z,3,4,2020,8,2,Mali,ML,MLI,19077690,Africa,3,36,3
2020-04-04T00:00:00Z,4,4,2020,3,0,Mali,ML,MLI,19077690,Africa,3,39,4
2020-04-05T00:00:00Z,5,4,2020,2,0,Mali,ML,MLI,19077690,Africa,3,41,5
2020-04-06T00:00:00Z,6,4,2020,4,2,Mali,ML,MLI,19077690,Africa,5,45,6
2020-04-07T00:00:00Z,7,4,2020,2,0,Mali,ML,MLI,19077690,Africa,5,47,7
2020-04-08T00:00:00Z,8,4,2020,9,0,Mali,ML,MLI,19077690,Africa,5,56,8
2020-04-09T00:00:00Z,9,4,2020,3,2,Mali,ML,MLI,19077690,Africa,7,59,9
2020-04-10T00:00:00Z,10,4,2020,0,0,Mali,ML,MLI,19077690,Africa,7,59,10
2020-04-11T00:00:00Z,11,4,2020,28,0,Mali,ML,MLI,19077690,Africa,7,87,11
2020-04-12T00:00:00Z,12,4,2020,18,2,Mali,ML,MLI,19077690,Africa,9,105,12
2020-04-13T00:00:00Z,13,4,2020,11,0,Mali,ML,MLI,19077690,Africa,9,116,13
2020-04-14T00:00:00Z,14,4,2020,7,1,Mali,ML,MLI,19077690,Africa,10,123,14
2020-04-15T00:00:00Z,15,4,2020,21,3,Mali,ML,MLI,19077690,Africa,13,144,15
2020-04-16T00:00:00Z,16,4,2020,4,0,Mali,ML,MLI,19077690,Africa,13,148,16
2020-04-17T00:00:00Z,17,4,2020,23,0,Mali,ML,MLI,19077690,Africa,13,171,17
2020-04-18T00:00:00Z,18,4,2020,19,0,Mali,ML,MLI,19077690,Africa,13,190,18
2020-04-19T00:00:00Z,19,4,2020,26,0,Mali,ML,MLI,19077690,Africa,13,216,19
2020-04-20T00:00:00Z,20,4,2020,8,1,Mali,ML,MLI,19077690,Africa,14,224,20
2020-04-21T00:00:00Z,21,4,2020,22,0,Mali,ML,MLI,19077690,Africa,14,246,21
2020-04-22T00:00:00Z,22,4,2020,12,0,Mali,ML,MLI,19077690,Africa,14,258,22
2020-04-23T00:00:00Z,23,4,2020,35,3,Mali,ML,MLI,19077690,Africa,17,293,23
2020-04-24T00:00:00Z,24,4,2020,16,4,Mali,ML,MLI,19077690,Africa,21,309,24
2020-04-25T00:00:00Z,25,4,2020,16,0,Mali,ML,MLI,19077690,Africa,21,325,25
2020-04-26T00:00:00Z,26,4,2020,45,0,Mali,ML,MLI,19077690,Africa,21,370,26
2020-04-27T00:00:00Z,27,4,2020,19,2,Mali,ML,MLI,19077690,Africa,23,389,27
2020-04-28T00:00:00Z,28,4,2020,19,0,Mali,ML,MLI,19077690,Africa,23,408,28
2020-04-29T00:00:00Z,29,4,2020,16,1,Mali,ML,MLI,19077690,Africa,24,424,29
2020-04-30T00:00:00Z,30,4,2020,58,1,Mali,ML,MLI,19077690,Africa,25,482,30
2020-05-01T00:00:00Z,1,5,2020,8,1,Mali,ML,MLI,19077690,Africa,26,490,31
2020-05-02T00:00:00Z,2,5,2020,18,0,Mali,ML,MLI,19077690,Africa,26,508,32
2020-05-03T00:00:00Z,3,5,2020,36,0,Mali,ML,MLI,19077690,Africa,26,544,33
2020-05-04T00:00:00Z,4,5,2020,19,1,Mali,ML,MLI,19077690,Africa,27,563,34
2020-05-05T00:00:00Z,5,5,2020,17,2,Mali,ML,MLI,19077690,Africa,29,580,35
2020-05-06T00:00:00Z,6,5,2020,32,3,Mali,ML,MLI,19077690,Africa,32,612,36
2020-05-07T00:00:00Z,7,5,2020,19,0,Mali,ML,MLI,19077690,Africa,32,631,37
2020-05-08T00:00:00Z,8,5,2020,19,0,Mali,ML,MLI,19077690,Africa,32,650,38
2020-05-09T00:00:00Z,9,5,2020,18,3,Mali,ML,MLI,19077690,Africa,35,668,39
2020-05-10T00:00:00Z,10,5,2020,24,2,Mali,ML,MLI,19077690,Africa,37,692,40
2020-05-11T00:00:00Z,11,5,2020,12,1,Mali,ML,MLI,19077690,Africa,38,704,41
2020-05-12T00:00:00Z,12,5,2020,8,1,Mali,ML,MLI,19077690,Africa,39,712,42
2020-05-13T00:00:00Z,13,5,2020,18,1,Mali,ML,MLI,19077690,Africa,40,730,43
2020-05-14T00:00:00Z,14,5,2020,28,4,Mali,ML,MLI,19077690,Africa,44,758,44
2020-05-15T00:00:00Z,15,5,2020,21,2,Mali,ML,MLI,19077690,Africa,46,779,45
2020-05-16T00:00:00Z,16,5,2020,27,0,Mali,ML,MLI,19077690,Africa,46,806,46
2020-05-17T00:00:00Z,17,5,2020,29,2,Mali,ML,MLI,19077690,Africa,48,835,47
2020-05-18T00:00:00Z,18,5,2020,25,4,Mali,ML,MLI,19077690,Africa,52,860,48
2020-05-19T00:00:00Z,19,5,2020,14,0,Mali,ML,MLI,19077690,Africa,52,874,49
2020-05-20T00:00:00Z,20,5,2020,27,1,Mali,ML,MLI,19077690,Africa,53,901,50
2020-05-21T00:00:00Z,21,5,2020,30,2,Mali,ML,MLI,19077690,Africa,55,931,51
2020-05-22T00:00:00Z,22,5,2020,16,5,Mali,ML,MLI,19077690,Africa,60,947,52
2020-05-23T00:00:00Z,23,5,2020,22,2,Mali,ML,MLI,19077690,Africa,62,969,53
2020-05-24T00:00:00Z,24,5,2020,46,1,Mali,ML,MLI,19077690,Africa,63,1015,54
2020-05-25T00:00:00Z,25,5,2020,15,2,Mali,ML,MLI,19077690,Africa,65,1030,55
2020-05-26T00:00:00Z,26,5,2020,29,2,Mali,ML,MLI,19077690,Africa,67,1059,56
2020-05-27T00:00:00Z,27,5,2020,18,3,Mali,ML,MLI,19077690,Africa,70,1077,57
2020-04-09T00:00:00Z,9,4,2020,9,1,Malta,MT,MLT,483530,Europe,1,307,1
2020-04-10T00:00:00Z,10,4,2020,35,1,Malta,MT,MLT,483530,Europe,2,342,2
2020-04-11T00:00:00Z,11,4,2020,18,0,Malta,MT,MLT,483530,Europe,2,360,3
2020-04-12T00:00:00Z,12,4,2020,13,1,Malta,MT,MLT,483530,Europe,3,373,4
2020-04-13T00:00:00Z,13,4,2020,11,0,Malta,MT,MLT,483530,Europe,3,384,5
2020-04-14T00:00:00Z,14,4,2020,1,0,Malta,MT,MLT,483530,Europe,3,385,6
2020-04-15T00:00:00Z,15,4,2020,8,0,Malta,MT,MLT,483530,Europe,3,393,7
2020-04-16T00:00:00Z,16,4,2020,15,0,Malta,MT,MLT,483530,Europe,3,408,8
2020-04-17T00:00:00Z,17,4,2020,5,0,Malta,MT,MLT,483530,Europe,3,413,9
2020-04-18T00:00:00Z,18,4,2020,9,0,Malta,MT,MLT,483530,Europe,3,422,10
2020-04-19T00:00:00Z,19,4,2020,4,0,Malta,MT,MLT,483530,Europe,3,426,11
2020-04-20T00:00:00Z,20,4,2020,2,0,Malta,MT,MLT,483530,Europe,3,428,12
2020-04-21T00:00:00Z,21,4,2020,5,0,Malta,MT,MLT,483530,Europe,3,433,13
2020-04-22T00:00:00Z,22,4,2020,11,0,Malta,MT,MLT,483530,Europe,3,444,14
2020-04-23T00:00:00Z,23,4,2020,1,0,Malta,MT,MLT,483530,Europe,3,445,15
2020-04-24T00:00:00Z,24,4,2020,1,0,Malta,MT,MLT,483530,Europe,3,446,16
2020-04-25T00:00:00Z,25,4,2020,1,0,Malta,MT,MLT,483530,Europe,3,447,17
2020-04-26T00:00:00Z,26,4,2020,1,1,Malta,MT,MLT,483530,Europe,4,448,18
2020-04-27T00:00:00Z,27,4,2020,0,0,Malta,MT,MLT,483530,Europe,4,448,19
2020-04-28T00:00:00Z,28,4,2020,2,0,Malta,MT,MLT,483530,Europe,4,450,20
2020-04-29T00:00:00Z,29,4,2020,0,0,Malta,MT,MLT,483530,Europe,4,450,21
2020-04-30T00:00:00Z,30,4,2020,13,0,Malta,MT,MLT,483530,Europe,4,463,22
2020-05-01T00:00:00Z,1,5,2020,2,0,Malta,MT,MLT,483530,Europe,4,465,23
2020-05-02T00:00:00Z,2,5,2020,2,0,Malta,MT,MLT,483530,Europe,4,467,24
2020-05-03T00:00:00Z,3,5,2020,0,0,Malta,MT,MLT,483530,Europe,4,467,25
2020-05-04T00:00:00Z,4,5,2020,10,0,Malta,MT,MLT,483530,Europe,4,477,26
2020-05-05T00:00:00Z,5,5,2020,3,0,Malta,MT,MLT,483530,Europe,4,480,27
2020-05-06T00:00:00Z,6,5,2020,2,1,Malta,MT,MLT,483530,Europe,5,482,28
2020-05-07T00:00:00Z,7,5,2020,2,0,Malta,MT,MLT,483530,Europe,5,484,29
2020-05-08T00:00:00Z,8,5,2020,2,0,Malta,MT,MLT,483530,Europe,5,486,30
2020-05-09T00:00:00Z,9,5,2020,3,0,Malta,MT,MLT,483530,Europe,5,489,31
2020-05-10T00:00:00Z,10,5,2020,1,0,Malta,MT,MLT,483530,Europe,5,490,32
2020-05-11T00:00:00Z,11,5,2020,6,0,Malta,MT,MLT,483530,Europe,5,496,33
2020-05-12T00:00:00Z,12,5,2020,7,0,Malta,MT,MLT,483530,Europe,5,503,34
2020-05-13T00:00:00Z,13,5,2020,0,0,Malta,MT,MLT,483530,Europe,5,503,35
2020-05-14T00:00:00Z,14,5,2020,5,1,Malta,MT,MLT,483530,Europe,6,508,36
2020-05-15T00:00:00Z,15,5,2020,14,0,Malta,MT,MLT,483530,Europe,6,522,37
2020-05-16T00:00:00Z,16,5,2020,10,0,Malta,MT,MLT,483530,Europe,6,532,38
2020-05-17T00:00:00Z,17,5,2020,14,0,Malta,MT,MLT,483530,Europe,6,546,39
2020-05-18T00:00:00Z,18,5,2020,7,0,Malta,MT,MLT,483530,Europe,6,553,40
2020-05-19T00:00:00Z,19,5,2020,5,0,Malta,MT,MLT,483530,Europe,6,558,41
2020-05-20T00:00:00Z,20,5,2020,2,0,Malta,MT,MLT,483530,Europe,6,560,42
2020-05-21T00:00:00Z,21,5,2020,24,0,Malta,MT,MLT,483530,Europe,6,584,43
2020-05-22T00:00:00Z,22,5,2020,15,0,Malta,MT,MLT,483530,Europe,6,599,44
2020-05-23T00:00:00Z,23,5,2020,1,0,Malta,MT,MLT,483530,Europe,6,600,45
2020-05-24T00:00:00Z,24,5,2020,9,0,Malta,MT,MLT,483530,Europe,6,609,46
2020-05-25T00:00:00Z,25,5,2020,1,0,Malta,MT,MLT,483530,Europe,6,610,47
2020-05-26T00:00:00Z,26,5,2020,1,0,Malta,MT,MLT,483530,Europe,6,611,48
2020-05-27T00:00:00Z,27,5,2020,0,0,Malta,MT,MLT,483530,Europe,6,611,49
2020-04-03T00:00:00Z,3,4,2020,1,1,Mauritania,MR,MRT,4403319,Africa,1,6,1
2020-04-04T00:00:00Z,4,4,2020,0,0,Mauritania,MR,MRT,4403319,Africa,1,6,2
2020-04-05T00:00:00Z,5,4,2020,0,0,Mauritania,MR,MRT,4403319,Africa,1,6,3
2020-04-06T00:00:00Z,6,4,2020,0,0,Mauritania,MR,MRT,4403319,Africa,1,6,4
2020-04-07T00:00:00Z,7,4,2020,0,0,Mauritania,MR,MRT,4403319,Africa,1,6,5
2020-04-08T00:00:00Z,8,4,2020,0,0,Mauritania,MR,MRT,4403319,Africa,1,6,6
2020-04-09T00:00:00Z,9,4,2020,0,0,Mauritania,MR,MRT,4403319,Africa,1,6,7
2020-04-10T00:00:00Z,10,4,2020,1,0,Mauritania,MR,MRT,4403319,Africa,1,7,8
2020-04-11T00:00:00Z,11,4,2020,0,0,Mauritania,MR,MRT,4403319,Africa,1,7,9
2020-04-12T00:00:00Z,12,4,2020,0,0,Mauritania,MR,MRT,4403319,Africa,1,7,10
2020-04-13T00:00:00Z,13,4,2020,0,0,Mauritania,MR,MRT,4403319,Africa,1,7,11
2020-04-14T00:00:00Z,14,4,2020,0,0,Mauritania,MR,MRT,4403319,Africa,1,7,12
2020-04-15T00:00:00Z,15,4,2020,0,0,Mauritania,MR,MRT,4403319,Africa,1,7,13
2020-04-16T00:00:00Z,16,4,2020,0,0,Mauritania,MR,MRT,4403319,Africa,1,7,14
2020-04-17T00:00:00Z,17,4,2020,0,0,Mauritania,MR,MRT,4403319,Africa,1,7,15
2020-04-18T00:00:00Z,18,4,2020,0,0,Mauritania,MR,MRT,4403319,Africa,1,7,16
2020-04-19T00:00:00Z,19,4,2020,0,0,Mauritania,MR,MRT,4403319,Africa,1,7,17
2020-04-20T00:00:00Z,20,4,2020,0,0,Mauritania,MR,MRT,4403319,Africa,1,7,18
2020-04-21T00:00:00Z,21,4,2020,0,0,Mauritania,MR,MRT,4403319,Africa,1,7,19
2020-04-22T00:00:00Z,22,4,2020,0,0,Mauritania,MR,MRT,4403319,Africa,1,7,20
2020-04-23T00:00:00Z,23,4,2020,0,0,Mauritania,MR,MRT,4403319,Africa,1,7,21
2020-04-24T00:00:00Z,24,4,2020,0,0,Mauritania,MR,MRT,4403319,Africa,1,7,22
2020-04-25T00:00:00Z,25,4,2020,0,0,Mauritania,MR,MRT,4403319,Africa,1,7,23
2020-04-26T00:00:00Z,26,4,2020,0,0,Mauritania,MR,MRT,4403319,Africa,1,7,24
2020-04-27T00:00:00Z,27,4,2020,0,0,Mauritania,MR,MRT,4403319,Africa,1,7,25
2020-04-28T00:00:00Z,28,4,2020,0,0,Mauritania,MR,MRT,4403319,Africa,1,7,26
2020-04-29T00:00:00Z,29,4,2020,0,0,Mauritania,MR,MRT,4403319,Africa,1,7,27
2020-04-30T00:00:00Z,30,4,2020,0,0,Mauritania,MR,MRT,4403319,Africa,1,7,28
2020-05-01T00:00:00Z,1,5,2020,1,0,Mauritania,MR,MRT,4403319,Africa,1,8,29
2020-05-02T00:00:00Z,2,5,2020,0,0,Mauritania,MR,MRT,4403319,Africa,1,8,30
2020-05-03T00:00:00Z,3,5,2020,0,0,Mauritania,MR,MRT,4403319,Africa,1,8,31
2020-05-04T00:00:00Z,4,5,2020,0,0,Mauritania,MR,MRT,4403319,Africa,1,8,32
2020-05-05T00:00:00Z,5,5,2020,0,0,Mauritania,MR,MRT,4403319,Africa,1,8,33
2020-05-06T00:00:00Z,6,5,2020,0,0,Mauritania,MR,MRT,4403319,Africa,1,8,34
2020-05-07T00:00:00Z,7,5,2020,0,0,Mauritania,MR,MRT,4403319,Africa,1,8,35
2020-05-08T00:00:00Z,8,5,2020,0,0,Mauritania,MR,MRT,4403319,Africa,1,8,36
2020-05-09T00:00:00Z,9,5,2020,0,0,Mauritania,MR,MRT,4403319,Africa,1,8,37
2020-05-10T00:00:00Z,10,5,2020,0,0,Mauritania,MR,MRT,4403319,Africa,1,8,38
2020-05-11T00:00:00Z,11,5,2020,0,0,Mauritania,MR,MRT,4403319,Africa,1,8,39
2020-05-12T00:00:00Z,12,5,2020,0,0,Mauritania,MR,MRT,4403319,Africa,1,8,40
2020-05-13T00:00:00Z,13,5,2020,0,0,Mauritania,MR,MRT,4403319,Africa,1,8,41
2020-05-14T00:00:00Z,14,5,2020,1,1,Mauritania,MR,MRT,4403319,Africa,2,9,42
2020-05-15T00:00:00Z,15,5,2020,7,0,Mauritania,MR,MRT,4403319,Africa,2,16,43
2020-05-16T00:00:00Z,16,5,2020,13,1,Mauritania,MR,MRT,4403319,Africa,3,29,44
2020-05-17T00:00:00Z,17,5,2020,0,0,Mauritania,MR,MRT,4403319,Africa,3,29,45
2020-05-18T00:00:00Z,18,5,2020,33,1,Mauritania,MR,MRT,4403319,Africa,4,62,46
2020-05-19T00:00:00Z,19,5,2020,19,0,Mauritania,MR,MRT,4403319,Africa,4,81,47
2020-05-20T00:00:00Z,20,5,2020,0,0,Mauritania,MR,MRT,4403319,Africa,4,81,48
2020-05-21T00:00:00Z,21,5,2020,50,0,Mauritania,MR,MRT,4403319,Africa,4,131,49
2020-05-22T00:00:00Z,22,5,2020,42,1,Mauritania,MR,MRT,4403319,Africa,5,173,50
2020-05-23T00:00:00Z,23,5,2020,0,0,Mauritania,MR,MRT,4403319,Africa,5,173,51
2020-05-24T00:00:00Z,24,5,2020,54,1,Mauritania,MR,MRT,4403319,Africa,6,227,52
2020-05-25T00:00:00Z,25,5,2020,10,0,Mauritania,MR,MRT,4403319,Africa,6,237,53
2020-05-26T00:00:00Z,26,5,2020,0,0,Mauritania,MR,MRT,4403319,Africa,6,237,54
2020-05-27T00:00:00Z,27,5,2020,25,3,Mauritania,MR,MRT,4403319,Africa,9,262,55
2020-03-22T00:00:00Z,22,3,2020,2,1,Mauritius,MU,MUS,1265303,Africa,1,14,1
2020-03-23T00:00:00Z,23,3,2020,14,1,Mauritius,MU,MUS,1265303,Africa,2,28,2
2020-03-24T00:00:00Z,24,3,2020,8,0,Mauritius,MU,MUS,1265303,Africa,2,36,3
2020-03-25T00:00:00Z,25,3,2020,6,0,Mauritius,MU,MUS,1265303,Africa,2,42,4
2020-03-26T00:00:00Z,26,3,2020,6,0,Mauritius,MU,MUS,1265303,Africa,2,48,5
2020-03-27T00:00:00Z,27,3,2020,33,0,Mauritius,MU,MUS,1265303,Africa,2,81,6
2020-03-28T00:00:00Z,28,3,2020,13,0,Mauritius,MU,MUS,1265303,Africa,2,94,7
2020-03-29T00:00:00Z,29,3,2020,8,0,Mauritius,MU,MUS,1265303,Africa,2,102,8
2020-03-30T00:00:00Z,30,3,2020,8,1,Mauritius,MU,MUS,1265303,Africa,3,110,9
2020-03-31T00:00:00Z,31,3,2020,18,0,Mauritius,MU,MUS,1265303,Africa,3,128,10
2020-04-01T00:00:00Z,1,4,2020,15,0,Mauritius,MU,MUS,1265303,Africa,3,143,11
2020-04-02T00:00:00Z,2,4,2020,11,2,Mauritius,MU,MUS,1265303,Africa,5,154,12
2020-04-03T00:00:00Z,3,4,2020,15,2,Mauritius,MU,MUS,1265303,Africa,7,169,13
2020-04-04T00:00:00Z,4,4,2020,17,0,Mauritius,MU,MUS,1265303,Africa,7,186,14
2020-04-05T00:00:00Z,5,4,2020,10,0,Mauritius,MU,MUS,1265303,Africa,7,196,15
2020-04-06T00:00:00Z,6,4,2020,31,0,Mauritius,MU,MUS,1265303,Africa,7,227,16
2020-04-07T00:00:00Z,7,4,2020,17,0,Mauritius,MU,MUS,1265303,Africa,7,244,17
2020-04-08T00:00:00Z,8,4,2020,24,0,Mauritius,MU,MUS,1265303,Africa,7,268,18
2020-04-09T00:00:00Z,9,4,2020,5,0,Mauritius,MU,MUS,1265303,Africa,7,273,19
2020-04-10T00:00:00Z,10,4,2020,41,0,Mauritius,MU,MUS,1265303,Africa,7,314,20
2020-04-11T00:00:00Z,11,4,2020,4,2,Mauritius,MU,MUS,1265303,Africa,9,318,21
2020-04-12T00:00:00Z,12,4,2020,1,0,Mauritius,MU,MUS,1265303,Africa,9,319,22
2020-04-13T00:00:00Z,13,4,2020,5,0,Mauritius,MU,MUS,1265303,Africa,9,324,23
2020-04-14T00:00:00Z,14,4,2020,0,0,Mauritius,MU,MUS,1265303,Africa,9,324,24
2020-04-15T00:00:00Z,15,4,2020,0,0,Mauritius,MU,MUS,1265303,Africa,9,324,25
2020-04-16T00:00:00Z,16,4,2020,0,0,Mauritius,MU,MUS,1265303,Africa,9,324,26
2020-04-17T00:00:00Z,17,4,2020,0,0,Mauritius,MU,MUS,1265303,Africa,9,324,27
2020-04-18T00:00:00Z,18,4,2020,0,0,Mauritius,MU,MUS,1265303,Africa,9,324,28
2020-04-19T00:00:00Z,19,4,2020,1,0,Mauritius,MU,MUS,1265303,Africa,9,325,29
2020-04-20T00:00:00Z,20,4,2020,3,0,Mauritius,MU,MUS,1265303,Africa,9,328,30
2020-04-21T00:00:00Z,21,4,2020,0,0,Mauritius,MU,MUS,1265303,Africa,9,328,31
2020-04-22T00:00:00Z,22,4,2020,0,0,Mauritius,MU,MUS,1265303,Africa,9,328,32
2020-04-23T00:00:00Z,23,4,2020,1,0,Mauritius,MU,MUS,1265303,Africa,9,329,33
2020-04-24T00:00:00Z,24,4,2020,2,0,Mauritius,MU,MUS,1265303,Africa,9,331,34
2020-04-25T00:00:00Z,25,4,2020,0,0,Mauritius,MU,MUS,1265303,Africa,9,331,35
2020-04-26T00:00:00Z,26,4,2020,0,0,Mauritius,MU,MUS,1265303,Africa,9,331,36
2020-04-27T00:00:00Z,27,4,2020,1,0,Mauritius,MU,MUS,1265303,Africa,9,332,37
2020-04-28T00:00:00Z,28,4,2020,0,1,Mauritius,MU,MUS,1265303,Africa,10,332,38
2020-04-29T00:00:00Z,29,4,2020,0,0,Mauritius,MU,MUS,1265303,Africa,10,332,39
2020-04-30T00:00:00Z,30,4,2020,0,0,Mauritius,MU,MUS,1265303,Africa,10,332,40
2020-05-01T00:00:00Z,1,5,2020,0,0,Mauritius,MU,MUS,1265303,Africa,10,332,41
2020-05-02T00:00:00Z,2,5,2020,0,0,Mauritius,MU,MUS,1265303,Africa,10,332,42
2020-05-03T00:00:00Z,3,5,2020,0,0,Mauritius,MU,MUS,1265303,Africa,10,332,43
2020-05-04T00:00:00Z,4,5,2020,0,0,Mauritius,MU,MUS,1265303,Africa,10,332,44
2020-05-05T00:00:00Z,5,5,2020,0,0,Mauritius,MU,MUS,1265303,Africa,10,332,45
2020-05-06T00:00:00Z,6,5,2020,0,0,Mauritius,MU,MUS,1265303,Africa,10,332,46
2020-05-07T00:00:00Z,7,5,2020,0,0,Mauritius,MU,MUS,1265303,Africa,10,332,47
2020-05-08T00:00:00Z,8,5,2020,0,0,Mauritius,MU,MUS,1265303,Africa,10,332,48
2020-05-09T00:00:00Z,9,5,2020,0,0,Mauritius,MU,MUS,1265303,Africa,10,332,49
2020-05-10T00:00:00Z,10,5,2020,0,0,Mauritius,MU,MUS,1265303,Africa,10,332,50
2020-05-11T00:00:00Z,11,5,2020,0,0,Mauritius,MU,MUS,1265303,Africa,10,332,51
2020-05-12T00:00:00Z,12,5,2020,0,0,Mauritius,MU,MUS,1265303,Africa,10,332,52
2020-05-13T00:00:00Z,13,5,2020,0,0,Mauritius,MU,MUS,1265303,Africa,10,332,53
2020-05-14T00:00:00Z,14,5,2020,0,0,Mauritius,MU,MUS,1265303,Africa,10,332,54
2020-05-15T00:00:00Z,15,5,2020,0,0,Mauritius,MU,MUS,1265303,Africa,10,332,55
2020-05-16T00:00:00Z,16,5,2020,0,0,Mauritius,MU,MUS,1265303,Africa,10,332,56
2020-05-17T00:00:00Z,17,5,2020,0,0,Mauritius,MU,MUS,1265303,Africa,10,332,57
2020-05-18T00:00:00Z,18,5,2020,0,0,Mauritius,MU,MUS,1265303,Africa,10,332,58
2020-05-19T00:00:00Z,19,5,2020,0,0,Mauritius,MU,MUS,1265303,Africa,10,332,59
2020-05-20T00:00:00Z,20,5,2020,0,0,Mauritius,MU,MUS,1265303,Africa,10,332,60
2020-05-21T00:00:00Z,21,5,2020,0,0,Mauritius,MU,MUS,1265303,Africa,10,332,61
2020-05-22T00:00:00Z,22,5,2020,0,0,Mauritius,MU,MUS,1265303,Africa,10,332,62
2020-05-23T00:00:00Z,23,5,2020,0,0,Mauritius,MU,MUS,1265303,Africa,10,332,63
2020-05-24T00:00:00Z,24,5,2020,0,0,Mauritius,MU,MUS,1265303,Africa,10,332,64
2020-05-25T00:00:00Z,25,5,2020,2,0,Mauritius,MU,MUS,1265303,Africa,10,334,65
2020-05-26T00:00:00Z,26,5,2020,0,0,Mauritius,MU,MUS,1265303,Africa,10,334,66
2020-05-27T00:00:00Z,27,5,2020,0,0,Mauritius,MU,MUS,1265303,Africa,10,334,67
2020-03-21T00:00:00Z,21,3,2020,39,2,Mexico,MX,MEX,126190788,America,2,203,1
2020-03-22T00:00:00Z,22,3,2020,48,0,Mexico,MX,MEX,126190788,America,2,251,2
2020-03-23T00:00:00Z,23,3,2020,65,0,Mexico,MX,MEX,126190788,America,2,316,3
2020-03-24T00:00:00Z,24,3,2020,51,2,Mexico,MX,MEX,126190788,America,4,367,4
2020-03-25T00:00:00Z,25,3,2020,38,1,Mexico,MX,MEX,126190788,America,5,405,5
2020-03-26T00:00:00Z,26,3,2020,70,0,Mexico,MX,MEX,126190788,America,5,475,6
2020-03-27T00:00:00Z,27,3,2020,110,3,Mexico,MX,MEX,126190788,America,8,585,7
2020-03-28T00:00:00Z,28,3,2020,132,4,Mexico,MX,MEX,126190788,America,12,717,8
2020-03-29T00:00:00Z,29,3,2020,131,4,Mexico,MX,MEX,126190788,America,16,848,9
2020-03-30T00:00:00Z,30,3,2020,145,4,Mexico,MX,MEX,126190788,America,20,993,10
2020-03-31T00:00:00Z,31,3,2020,101,8,Mexico,MX,MEX,126190788,America,28,1094,11
2020-04-01T00:00:00Z,1,4,2020,121,1,Mexico,MX,MEX,126190788,America,29,1215,12
2020-04-02T00:00:00Z,2,4,2020,163,8,Mexico,MX,MEX,126190788,America,37,1378,13
2020-04-03T00:00:00Z,3,4,2020,132,13,Mexico,MX,MEX,126190788,America,50,1510,14
2020-04-04T00:00:00Z,4,4,2020,178,10,Mexico,MX,MEX,126190788,America,60,1688,15
2020-04-05T00:00:00Z,5,4,2020,202,19,Mexico,MX,MEX,126190788,America,79,1890,16
2020-04-06T00:00:00Z,6,4,2020,253,15,Mexico,MX,MEX,126190788,America,94,2143,17
2020-04-07T00:00:00Z,7,4,2020,296,31,Mexico,MX,MEX,126190788,America,125,2439,18
2020-04-08T00:00:00Z,8,4,2020,346,16,Mexico,MX,MEX,126190788,America,141,2785,19
2020-04-09T00:00:00Z,9,4,2020,396,33,Mexico,MX,MEX,126190788,America,174,3181,20
2020-04-10T00:00:00Z,10,4,2020,260,20,Mexico,MX,MEX,126190788,America,194,3441,21
2020-04-11T00:00:00Z,11,4,2020,403,39,Mexico,MX,MEX,126190788,America,233,3844,22
2020-04-12T00:00:00Z,12,4,2020,375,40,Mexico,MX,MEX,126190788,America,273,4219,23
2020-04-13T00:00:00Z,13,4,2020,442,23,Mexico,MX,MEX,126190788,America,296,4661,24
2020-04-14T00:00:00Z,14,4,2020,353,36,Mexico,MX,MEX,126190788,America,332,5014,25
2020-04-15T00:00:00Z,15,4,2020,385,74,Mexico,MX,MEX,126190788,America,406,5399,26
2020-04-16T00:00:00Z,16,4,2020,448,43,Mexico,MX,MEX,126190788,America,449,5847,27
2020-04-17T00:00:00Z,17,4,2020,450,37,Mexico,MX,MEX,126190788,America,486,6297,28
2020-04-18T00:00:00Z,18,4,2020,578,60,Mexico,MX,MEX,126190788,America,546,6875,29
2020-04-19T00:00:00Z,19,4,2020,622,104,Mexico,MX,MEX,126190788,America,650,7497,30
2020-04-20T00:00:00Z,20,4,2020,764,36,Mexico,MX,MEX,126190788,America,686,8261,31
2020-04-21T00:00:00Z,21,4,2020,511,26,Mexico,MX,MEX,126190788,America,712,8772,32
2020-04-22T00:00:00Z,22,4,2020,729,145,Mexico,MX,MEX,126190788,America,857,9501,33
2020-04-23T00:00:00Z,23,4,2020,1043,113,Mexico,MX,MEX,126190788,America,970,10544,34
2020-04-24T00:00:00Z,24,4,2020,1089,99,Mexico,MX,MEX,126190788,America,1069,11633,35
2020-04-25T00:00:00Z,25,4,2020,1239,152,Mexico,MX,MEX,126190788,America,1221,12872,36
2020-04-26T00:00:00Z,26,4,2020,970,84,Mexico,MX,MEX,126190788,America,1305,13842,37
2020-04-27T00:00:00Z,27,4,2020,835,46,Mexico,MX,MEX,126190788,America,1351,14677,38
2020-04-28T00:00:00Z,28,4,2020,852,83,Mexico,MX,MEX,126190788,America,1434,15529,39
2020-04-29T00:00:00Z,29,4,2020,1223,135,Mexico,MX,MEX,126190788,America,1569,16752,40
2020-04-30T00:00:00Z,30,4,2020,1047,163,Mexico,MX,MEX,126190788,America,1732,17799,41
2020-05-01T00:00:00Z,1,5,2020,1425,127,Mexico,MX,MEX,126190788,America,1859,19224,42
2020-05-02T00:00:00Z,2,5,2020,1515,113,Mexico,MX,MEX,126190788,America,1972,20739,43
2020-05-03T00:00:00Z,3,5,2020,1349,89,Mexico,MX,MEX,126190788,America,2061,22088,44
2020-05-04T00:00:00Z,4,5,2020,1383,93,Mexico,MX,MEX,126190788,America,2154,23471,45
2020-05-05T00:00:00Z,5,5,2020,1434,117,Mexico,MX,MEX,126190788,America,2271,24905,46
2020-05-06T00:00:00Z,6,5,2020,1120,236,Mexico,MX,MEX,126190788,America,2507,26025,47
2020-05-07T00:00:00Z,7,5,2020,1609,197,Mexico,MX,MEX,126190788,America,2704,27634,48
2020-05-08T00:00:00Z,8,5,2020,1982,257,Mexico,MX,MEX,126190788,America,2961,29616,49
2020-05-09T00:00:00Z,9,5,2020,1906,199,Mexico,MX,MEX,126190788,America,3160,31522,50
2020-05-10T00:00:00Z,10,5,2020,1938,193,Mexico,MX,MEX,126190788,America,3353,33460,51
2020-05-11T00:00:00Z,11,5,2020,1562,112,Mexico,MX,MEX,126190788,America,3465,35022,52
2020-05-12T00:00:00Z,12,5,2020,1305,108,Mexico,MX,MEX,126190788,America,3573,36327,53
2020-05-13T00:00:00Z,13,5,2020,1997,353,Mexico,MX,MEX,126190788,America,3926,38324,54
2020-05-14T00:00:00Z,14,5,2020,1862,294,Mexico,MX,MEX,126190788,America,4220,40186,55
2020-05-15T00:00:00Z,15,5,2020,2409,257,Mexico,MX,MEX,126190788,America,4477,42595,56
2020-05-16T00:00:00Z,16,5,2020,2437,290,Mexico,MX,MEX,126190788,America,4767,45032,57
2020-05-17T00:00:00Z,17,5,2020,2112,278,Mexico,MX,MEX,126190788,America,5045,47144,58
2020-05-18T00:00:00Z,18,5,2020,2075,132,Mexico,MX,MEX,126190788,America,5177,49219,59
2020-05-19T00:00:00Z,19,5,2020,2414,155,Mexico,MX,MEX,126190788,America,5332,51633,60
2020-05-20T00:00:00Z,20,5,2020,2713,334,Mexico,MX,MEX,126190788,America,5666,54346,61
2020-05-21T00:00:00Z,21,5,2020,2248,424,Mexico,MX,MEX,126190788,America,6090,56594,62
2020-05-22T00:00:00Z,22,5,2020,2973,420,Mexico,MX,MEX,126190788,America,6510,59567,63
2020-05-23T00:00:00Z,23,5,2020,2960,479,Mexico,MX,MEX,126190788,America,6989,62527,64
2020-05-24T00:00:00Z,24,5,2020,3329,190,Mexico,MX,MEX,126190788,America,7179,65856,65
2020-05-25T00:00:00Z,25,5,2020,2764,215,Mexico,MX,MEX,126190788,America,7394,68620,66
2020-05-26T00:00:00Z,26,5,2020,2485,239,Mexico,MX,MEX,126190788,America,7633,71105,67
2020-05-27T00:00:00Z,27,5,2020,3455,501,Mexico,MX,MEX,126190788,America,8134,74560,68
2020-03-19T00:00:00Z,19,3,2020,6,1,Moldova,MD,MDA,3545883,Europe,1,36,1
2020-03-20T00:00:00Z,20,3,2020,13,0,Moldova,MD,MDA,3545883,Europe,1,49,2
2020-03-21T00:00:00Z,21,3,2020,17,0,Moldova,MD,MDA,3545883,Europe,1,66,3
2020-03-22T00:00:00Z,22,3,2020,14,0,Moldova,MD,MDA,3545883,Europe,1,80,4
2020-03-23T00:00:00Z,23,3,2020,14,0,Moldova,MD,MDA,3545883,Europe,1,94,5
2020-03-24T00:00:00Z,24,3,2020,15,0,Moldova,MD,MDA,3545883,Europe,1,109,6
2020-03-25T00:00:00Z,25,3,2020,16,0,Moldova,MD,MDA,3545883,Europe,1,125,7
2020-03-26T00:00:00Z,26,3,2020,24,0,Moldova,MD,MDA,3545883,Europe,1,149,8
2020-03-27T00:00:00Z,27,3,2020,28,0,Moldova,MD,MDA,3545883,Europe,1,177,9
2020-03-28T00:00:00Z,28,3,2020,22,1,Moldova,MD,MDA,3545883,Europe,2,199,10
2020-03-29T00:00:00Z,29,3,2020,32,0,Moldova,MD,MDA,3545883,Europe,2,231,11
2020-03-30T00:00:00Z,30,3,2020,32,0,Moldova,MD,MDA,3545883,Europe,2,263,12
2020-03-31T00:00:00Z,31,3,2020,35,0,Moldova,MD,MDA,3545883,Europe,2,298,13
2020-04-01T00:00:00Z,1,4,2020,55,2,Moldova,MD,MDA,3545883,Europe,4,353,14
2020-04-02T00:00:00Z,2,4,2020,70,1,Moldova,MD,MDA,3545883,Europe,5,423,15
2020-04-03T00:00:00Z,3,4,2020,82,1,Moldova,MD,MDA,3545883,Europe,6,505,16
2020-04-04T00:00:00Z,4,4,2020,86,2,Moldova,MD,MDA,3545883,Europe,8,591,17
2020-04-05T00:00:00Z,5,4,2020,161,4,Moldova,MD,MDA,3545883,Europe,12,752,18
2020-04-06T00:00:00Z,6,4,2020,112,3,Moldova,MD,MDA,3545883,Europe,15,864,19
2020-04-07T00:00:00Z,7,4,2020,101,4,Moldova,MD,MDA,3545883,Europe,19,965,20
2020-04-08T00:00:00Z,8,4,2020,91,3,Moldova,MD,MDA,3545883,Europe,22,1056,21
2020-04-09T00:00:00Z,9,4,2020,118,5,Moldova,MD,MDA,3545883,Europe,27,1174,22
2020-04-10T00:00:00Z,10,4,2020,115,2,Moldova,MD,MDA,3545883,Europe,29,1289,23
2020-04-11T00:00:00Z,11,4,2020,149,0,Moldova,MD,MDA,3545883,Europe,29,1438,24
2020-04-12T00:00:00Z,12,4,2020,122,1,Moldova,MD,MDA,3545883,Europe,30,1560,25
2020-04-13T00:00:00Z,13,4,2020,102,2,Moldova,MD,MDA,3545883,Europe,32,1662,26
2020-04-14T00:00:00Z,14,4,2020,50,4,Moldova,MD,MDA,3545883,Europe,36,1712,27
2020-04-15T00:00:00Z,15,4,2020,222,4,Moldova,MD,MDA,3545883,Europe,40,1934,28
2020-04-16T00:00:00Z,16,4,2020,115,6,Moldova,MD,MDA,3545883,Europe,46,2049,29
2020-04-17T00:00:00Z,17,4,2020,105,8,Moldova,MD,MDA,3545883,Europe,54,2154,30
2020-04-18T00:00:00Z,18,4,2020,110,2,Moldova,MD,MDA,3545883,Europe,56,2264,31
2020-04-19T00:00:00Z,19,4,2020,87,4,Moldova,MD,MDA,3545883,Europe,60,2351,32
2020-04-20T00:00:00Z,20,4,2020,121,7,Moldova,MD,MDA,3545883,Europe,67,2472,33
2020-04-21T00:00:00Z,21,4,2020,76,3,Moldova,MD,MDA,3545883,Europe,70,2548,34
2020-04-22T00:00:00Z,22,4,2020,66,3,Moldova,MD,MDA,3545883,Europe,73,2614,35
2020-04-23T00:00:00Z,23,4,2020,164,3,Moldova,MD,MDA,3545883,Europe,76,2778,36
2020-04-24T00:00:00Z,24,4,2020,148,4,Moldova,MD,MDA,3545883,Europe,80,2926,37
2020-04-25T00:00:00Z,25,4,2020,184,7,Moldova,MD,MDA,3545883,Europe,87,3110,38
2020-04-26T00:00:00Z,26,4,2020,194,7,Moldova,MD,MDA,3545883,Europe,94,3304,39
2020-04-27T00:00:00Z,27,4,2020,104,2,Moldova,MD,MDA,3545883,Europe,96,3408,40
2020-04-28T00:00:00Z,28,4,2020,73,6,Moldova,MD,MDA,3545883,Europe,102,3481,41
2020-04-29T00:00:00Z,29,4,2020,157,5,Moldova,MD,MDA,3545883,Europe,107,3638,42
2020-04-30T00:00:00Z,30,4,2020,133,4,Moldova,MD,MDA,3545883,Europe,111,3771,43
2020-05-01T00:00:00Z,1,5,2020,126,8,Moldova,MD,MDA,3545883,Europe,119,3897,44
2020-05-02T00:00:00Z,2,5,2020,83,3,Moldova,MD,MDA,3545883,Europe,122,3980,45
2020-05-03T00:00:00Z,3,5,2020,72,2,Moldova,MD,MDA,3545883,Europe,124,4052,46
2020-05-04T00:00:00Z,4,5,2020,69,1,Moldova,MD,MDA,3545883,Europe,125,4121,47
2020-05-05T00:00:00Z,5,5,2020,127,7,Moldova,MD,MDA,3545883,Europe,132,4248,48
2020-05-06T00:00:00Z,6,5,2020,115,4,Moldova,MD,MDA,3545883,Europe,136,4363,49
2020-05-07T00:00:00Z,7,5,2020,113,7,Moldova,MD,MDA,3545883,Europe,143,4476,50
2020-05-08T00:00:00Z,8,5,2020,129,2,Moldova,MD,MDA,3545883,Europe,145,4605,51
2020-05-09T00:00:00Z,9,5,2020,123,7,Moldova,MD,MDA,3545883,Europe,152,4728,52
2020-05-10T00:00:00Z,10,5,2020,139,9,Moldova,MD,MDA,3545883,Europe,161,4867,53
2020-05-11T00:00:00Z,11,5,2020,60,8,Moldova,MD,MDA,3545883,Europe,169,4927,54
2020-05-12T00:00:00Z,12,5,2020,68,6,Moldova,MD,MDA,3545883,Europe,175,4995,55
2020-05-13T00:00:00Z,13,5,2020,159,7,Moldova,MD,MDA,3545883,Europe,182,5154,56
2020-05-14T00:00:00Z,14,5,2020,252,3,Moldova,MD,MDA,3545883,Europe,185,5406,57
2020-05-15T00:00:00Z,15,5,2020,147,9,Moldova,MD,MDA,3545883,Europe,194,5553,58
2020-05-16T00:00:00Z,16,5,2020,192,3,Moldova,MD,MDA,3545883,Europe,197,5745,59
2020-05-17T00:00:00Z,17,5,2020,189,10,Moldova,MD,MDA,3545883,Europe,207,5934,60
2020-05-18T00:00:00Z,18,5,2020,126,4,Moldova,MD,MDA,3545883,Europe,211,6060,61
2020-05-19T00:00:00Z,19,5,2020,78,4,Moldova,MD,MDA,3545883,Europe,215,6138,62
2020-05-20T00:00:00Z,20,5,2020,202,6,Moldova,MD,MDA,3545883,Europe,221,6340,63
2020-05-21T00:00:00Z,21,5,2020,213,7,Moldova,MD,MDA,3545883,Europe,228,6553,64
2020-05-22T00:00:00Z,22,5,2020,151,5,Moldova,MD,MDA,3545883,Europe,233,6704,65
2020-05-23T00:00:00Z,23,5,2020,143,4,Moldova,MD,MDA,3545883,Europe,237,6847,66
2020-05-24T00:00:00Z,24,5,2020,147,5,Moldova,MD,MDA,3545883,Europe,242,6994,67
2020-05-25T00:00:00Z,25,5,2020,99,8,Moldova,MD,MDA,3545883,Europe,250,7093,68
2020-05-26T00:00:00Z,26,5,2020,54,11,Moldova,MD,MDA,3545883,Europe,261,7147,69
2020-05-27T00:00:00Z,27,5,2020,158,6,Moldova,MD,MDA,3545883,Europe,267,7305,70
2020-04-05T00:00:00Z,5,4,2020,2,2,Monaco,MC,MCO,38682,Europe,2,66,1
2020-04-06T00:00:00Z,6,4,2020,7,0,Monaco,MC,MCO,38682,Europe,2,73,2
2020-04-07T00:00:00Z,7,4,2020,4,0,Monaco,MC,MCO,38682,Europe,2,77,3
2020-04-08T00:00:00Z,8,4,2020,2,0,Monaco,MC,MCO,38682,Europe,2,79,4
2020-04-09T00:00:00Z,9,4,2020,2,0,Monaco,MC,MCO,38682,Europe,2,81,5
2020-04-10T00:00:00Z,10,4,2020,3,0,Monaco,MC,MCO,38682,Europe,2,84,6
2020-04-11T00:00:00Z,11,4,2020,6,0,Monaco,MC,MCO,38682,Europe,2,90,7
2020-04-12T00:00:00Z,12,4,2020,2,0,Monaco,MC,MCO,38682,Europe,2,92,8
2020-04-13T00:00:00Z,13,4,2020,1,0,Monaco,MC,MCO,38682,Europe,2,93,9
2020-04-14T00:00:00Z,14,4,2020,0,0,Monaco,MC,MCO,38682,Europe,2,93,10
2020-04-15T00:00:00Z,15,4,2020,0,0,Monaco,MC,MCO,38682,Europe,2,93,11
2020-04-16T00:00:00Z,16,4,2020,0,1,Monaco,MC,MCO,38682,Europe,3,93,12
2020-04-17T00:00:00Z,17,4,2020,0,0,Monaco,MC,MCO,38682,Europe,3,93,13
2020-04-18T00:00:00Z,18,4,2020,1,0,Monaco,MC,MCO,38682,Europe,3,94,14
2020-04-19T00:00:00Z,19,4,2020,0,0,Monaco,MC,MCO,38682,Europe,3,94,15
2020-04-20T00:00:00Z,20,4,2020,0,0,Monaco,MC,MCO,38682,Europe,3,94,16
2020-04-21T00:00:00Z,21,4,2020,0,0,Monaco,MC,MCO,38682,Europe,3,94,17
2020-04-22T00:00:00Z,22,4,2020,0,0,Monaco,MC,MCO,38682,Europe,3,94,18
2020-04-23T00:00:00Z,23,4,2020,0,0,Monaco,MC,MCO,38682,Europe,3,94,19
2020-04-24T00:00:00Z,24,4,2020,0,1,Monaco,MC,MCO,38682,Europe,4,94,20
2020-04-25T00:00:00Z,25,4,2020,0,0,Monaco,MC,MCO,38682,Europe,4,94,21
2020-04-26T00:00:00Z,26,4,2020,0,0,Monaco,MC,MCO,38682,Europe,4,94,22
2020-04-27T00:00:00Z,27,4,2020,0,0,Monaco,MC,MCO,38682,Europe,4,94,23
2020-04-28T00:00:00Z,28,4,2020,1,0,Monaco,MC,MCO,38682,Europe,4,95,24
2020-04-29T00:00:00Z,29,4,2020,0,0,Monaco,MC,MCO,38682,Europe,4,95,25
2020-04-30T00:00:00Z,30,4,2020,0,0,Monaco,MC,MCO,38682,Europe,4,95,26
2020-05-01T00:00:00Z,1,5,2020,0,0,Monaco,MC,MCO,38682,Europe,4,95,27
2020-05-02T00:00:00Z,2,5,2020,0,0,Monaco,MC,MCO,38682,Europe,4,95,28
2020-05-03T00:00:00Z,3,5,2020,0,0,Monaco,MC,MCO,38682,Europe,4,95,29
2020-05-04T00:00:00Z,4,5,2020,0,0,Monaco,MC,MCO,38682,Europe,4,95,30
2020-05-05T00:00:00Z,5,5,2020,0,0,Monaco,MC,MCO,38682,Europe,4,95,31
2020-05-06T00:00:00Z,6,5,2020,0,0,Monaco,MC,MCO,38682,Europe,4,95,32
2020-05-07T00:00:00Z,7,5,2020,0,0,Monaco,MC,MCO,38682,Europe,4,95,33
2020-05-08T00:00:00Z,8,5,2020,0,0,Monaco,MC,MCO,38682,Europe,4,95,34
2020-05-09T00:00:00Z,9,5,2020,0,0,Monaco,MC,MCO,38682,Europe,4,95,35
2020-05-10T00:00:00Z,10,5,2020,1,0,Monaco,MC,MCO,38682,Europe,4,96,36
2020-05-11T00:00:00Z,11,5,2020,0,0,Monaco,MC,MCO,38682,Europe,4,96,37
2020-05-12T00:00:00Z,12,5,2020,0,0,Monaco,MC,MCO,38682,Europe,4,96,38
2020-05-13T00:00:00Z,13,5,2020,0,0,Monaco,MC,MCO,38682,Europe,4,96,39
2020-05-14T00:00:00Z,14,5,2020,0,0,Monaco,MC,MCO,38682,Europe,4,96,40
2020-05-15T00:00:00Z,15,5,2020,0,0,Monaco,MC,MCO,38682,Europe,4,96,41
2020-05-16T00:00:00Z,16,5,2020,0,1,Monaco,MC,MCO,38682,Europe,5,96,42
2020-05-17T00:00:00Z,17,5,2020,0,0,Monaco,MC,MCO,38682,Europe,5,96,43
2020-05-18T00:00:00Z,18,5,2020,0,0,Monaco,MC,MCO,38682,Europe,5,96,44
2020-05-19T00:00:00Z,19,5,2020,1,0,Monaco,MC,MCO,38682,Europe,5,97,45
2020-05-20T00:00:00Z,20,5,2020,0,0,Monaco,MC,MCO,38682,Europe,5,97,46
2020-05-21T00:00:00Z,21,5,2020,0,0,Monaco,MC,MCO,38682,Europe,5,97,47
2020-05-22T00:00:00Z,22,5,2020,0,0,Monaco,MC,MCO,38682,Europe,5,97,48
2020-05-23T00:00:00Z,23,5,2020,0,0,Monaco,MC,MCO,38682,Europe,5,97,49
2020-05-24T00:00:00Z,24,5,2020,1,0,Monaco,MC,MCO,38682,Europe,5,98,50
2020-05-25T00:00:00Z,25,5,2020,0,0,Monaco,MC,MCO,38682,Europe,5,98,51
2020-05-26T00:00:00Z,26,5,2020,0,0,Monaco,MC,MCO,38682,Europe,5,98,52
2020-05-27T00:00:00Z,27,5,2020,0,0,Monaco,MC,MCO,38682,Europe,5,98,53
2020-03-27T00:00:00Z,27,3,2020,14,1,Montenegro,ME,MNE,622345,Europe,1,67,1
2020-03-28T00:00:00Z,28,3,2020,8,0,Montenegro,ME,MNE,622345,Europe,1,75,2
2020-03-29T00:00:00Z,29,3,2020,9,0,Montenegro,ME,MNE,622345,Europe,1,84,3
2020-03-30T00:00:00Z,30,3,2020,1,0,Montenegro,ME,MNE,622345,Europe,1,85,4
2020-03-31T00:00:00Z,31,3,2020,6,0,Montenegro,ME,MNE,622345,Europe,1,91,5
2020-04-01T00:00:00Z,1,4,2020,18,0,Montenegro,ME,MNE,622345,Europe,1,109,6
2020-04-02T00:00:00Z,2,4,2020,14,0,Montenegro,ME,MNE,622345,Europe,1,123,7
2020-04-03T00:00:00Z,3,4,2020,21,1,Montenegro,ME,MNE,622345,Europe,2,144,8
2020-04-04T00:00:00Z,4,4,2020,30,0,Montenegro,ME,MNE,622345,Europe,2,174,9
2020-04-05T00:00:00Z,5,4,2020,27,0,Montenegro,ME,MNE,622345,Europe,2,201,10
2020-04-06T00:00:00Z,6,4,2020,13,0,Montenegro,ME,MNE,622345,Europe,2,214,11
2020-04-07T00:00:00Z,7,4,2020,19,0,Montenegro,ME,MNE,622345,Europe,2,233,12
2020-04-08T00:00:00Z,8,4,2020,8,0,Montenegro,ME,MNE,622345,Europe,2,241,13
2020-04-09T00:00:00Z,9,4,2020,8,0,Montenegro,ME,MNE,622345,Europe,2,249,14
2020-04-10T00:00:00Z,10,4,2020,3,0,Montenegro,ME,MNE,622345,Europe,2,252,15
2020-04-11T00:00:00Z,11,4,2020,5,0,Montenegro,ME,MNE,622345,Europe,2,257,16
2020-04-12T00:00:00Z,12,4,2020,6,0,Montenegro,ME,MNE,622345,Europe,2,263,17
2020-04-13T00:00:00Z,13,4,2020,9,1,Montenegro,ME,MNE,622345,Europe,3,272,18
2020-04-14T00:00:00Z,14,4,2020,2,0,Montenegro,ME,MNE,622345,Europe,3,274,19
2020-04-15T00:00:00Z,15,4,2020,9,1,Montenegro,ME,MNE,622345,Europe,4,283,20
2020-04-16T00:00:00Z,16,4,2020,5,0,Montenegro,ME,MNE,622345,Europe,4,288,21
2020-04-17T00:00:00Z,17,4,2020,15,0,Montenegro,ME,MNE,622345,Europe,4,303,22
2020-04-18T00:00:00Z,18,4,2020,0,0,Montenegro,ME,MNE,622345,Europe,4,303,23
2020-04-19T00:00:00Z,19,4,2020,4,1,Montenegro,ME,MNE,622345,Europe,5,307,24
2020-04-20T00:00:00Z,20,4,2020,1,0,Montenegro,ME,MNE,622345,Europe,5,308,25
2020-04-21T00:00:00Z,21,4,2020,4,0,Montenegro,ME,MNE,622345,Europe,5,312,26
2020-04-22T00:00:00Z,22,4,2020,1,0,Montenegro,ME,MNE,622345,Europe,5,313,27
2020-04-23T00:00:00Z,23,4,2020,2,0,Montenegro,ME,MNE,622345,Europe,5,315,28
2020-04-24T00:00:00Z,24,4,2020,4,0,Montenegro,ME,MNE,622345,Europe,5,319,29
2020-04-25T00:00:00Z,25,4,2020,0,1,Montenegro,ME,MNE,622345,Europe,6,319,30
2020-04-26T00:00:00Z,26,4,2020,1,0,Montenegro,ME,MNE,622345,Europe,6,320,31
2020-04-27T00:00:00Z,27,4,2020,1,1,Montenegro,ME,MNE,622345,Europe,7,321,32
2020-04-28T00:00:00Z,28,4,2020,0,0,Montenegro,ME,MNE,622345,Europe,7,321,33
2020-04-29T00:00:00Z,29,4,2020,0,0,Montenegro,ME,MNE,622345,Europe,7,321,34
2020-04-30T00:00:00Z,30,4,2020,1,0,Montenegro,ME,MNE,622345,Europe,7,322,35
2020-05-01T00:00:00Z,1,5,2020,0,0,Montenegro,ME,MNE,622345,Europe,7,322,36
2020-05-02T00:00:00Z,2,5,2020,0,0,Montenegro,ME,MNE,622345,Europe,7,322,37
2020-05-03T00:00:00Z,3,5,2020,0,0,Montenegro,ME,MNE,622345,Europe,7,322,38
2020-05-04T00:00:00Z,4,5,2020,0,1,Montenegro,ME,MNE,622345,Europe,8,322,39
2020-05-05T00:00:00Z,5,5,2020,1,0,Montenegro,ME,MNE,622345,Europe,8,323,40
2020-05-06T00:00:00Z,6,5,2020,1,0,Montenegro,ME,MNE,622345,Europe,8,324,41
2020-05-07T00:00:00Z,7,5,2020,0,0,Montenegro,ME,MNE,622345,Europe,8,324,42
2020-05-08T00:00:00Z,8,5,2020,0,0,Montenegro,ME,MNE,622345,Europe,8,324,43
2020-05-09T00:00:00Z,9,5,2020,0,0,Montenegro,ME,MNE,622345,Europe,8,324,44
2020-05-10T00:00:00Z,10,5,2020,0,0,Montenegro,ME,MNE,622345,Europe,8,324,45
2020-05-11T00:00:00Z,11,5,2020,0,1,Montenegro,ME,MNE,622345,Europe,9,324,46
2020-05-12T00:00:00Z,12,5,2020,0,0,Montenegro,ME,MNE,622345,Europe,9,324,47
2020-05-13T00:00:00Z,13,5,2020,0,0,Montenegro,ME,MNE,622345,Europe,9,324,48
2020-05-14T00:00:00Z,14,5,2020,0,0,Montenegro,ME,MNE,622345,Europe,9,324,49
2020-05-15T00:00:00Z,15,5,2020,0,0,Montenegro,ME,MNE,622345,Europe,9,324,50
2020-05-16T00:00:00Z,16,5,2020,0,0,Montenegro,ME,MNE,622345,Europe,9,324,51
2020-05-17T00:00:00Z,17,5,2020,0,0,Montenegro,ME,MNE,622345,Europe,9,324,52
2020-05-18T00:00:00Z,18,5,2020,0,0,Montenegro,ME,MNE,622345,Europe,9,324,53
2020-05-19T00:00:00Z,19,5,2020,0,0,Montenegro,ME,MNE,622345,Europe,9,324,54
2020-05-20T00:00:00Z,20,5,2020,0,0,Montenegro,ME,MNE,622345,Europe,9,324,55
2020-05-21T00:00:00Z,21,5,2020,0,0,Montenegro,ME,MNE,622345,Europe,9,324,56
2020-05-22T00:00:00Z,22,5,2020,0,0,Montenegro,ME,MNE,622345,Europe,9,324,57
2020-05-23T00:00:00Z,23,5,2020,0,0,Montenegro,ME,MNE,622345,Europe,9,324,58
2020-05-24T00:00:00Z,24,5,2020,0,0,Montenegro,ME,MNE,622345,Europe,9,324,59
2020-05-25T00:00:00Z,25,5,2020,0,0,Montenegro,ME,MNE,622345,Europe,9,324,60
2020-05-26T00:00:00Z,26,5,2020,0,0,Montenegro,ME,MNE,622345,Europe,9,324,61
2020-05-27T00:00:00Z,27,5,2020,0,0,Montenegro,ME,MNE,622345,Europe,9,324,62
2020-04-26T00:00:00Z,26,4,2020,0,1,Montserrat,MS,MSR,5900,America,1,11,1
2020-04-27T00:00:00Z,27,4,2020,0,0,Montserrat,MS,MSR,5900,America,1,11,2
2020-04-28T00:00:00Z,28,4,2020,0,0,Montserrat,MS,MSR,5900,America,1,11,3
2020-04-29T00:00:00Z,29,4,2020,0,0,Montserrat,MS,MSR,5900,America,1,11,4
2020-04-30T00:00:00Z,30,4,2020,0,0,Montserrat,MS,MSR,5900,America,1,11,5
2020-05-01T00:00:00Z,1,5,2020,0,0,Montserrat,MS,MSR,5900,America,1,11,6
2020-05-02T00:00:00Z,2,5,2020,0,0,Montserrat,MS,MSR,5900,America,1,11,7
2020-05-03T00:00:00Z,3,5,2020,0,0,Montserrat,MS,MSR,5900,America,1,11,8
2020-05-04T00:00:00Z,4,5,2020,0,0,Montserrat,MS,MSR,5900,America,1,11,9
2020-05-05T00:00:00Z,5,5,2020,0,0,Montserrat,MS,MSR,5900,America,1,11,10
2020-05-06T00:00:00Z,6,5,2020,0,0,Montserrat,MS,MSR,5900,America,1,11,11
2020-05-07T00:00:00Z,7,5,2020,0,0,Montserrat,MS,MSR,5900,America,1,11,12
2020-05-08T00:00:00Z,8,5,2020,0,0,Montserrat,MS,MSR,5900,America,1,11,13
2020-05-09T00:00:00Z,9,5,2020,0,0,Montserrat,MS,MSR,5900,America,1,11,14
2020-05-10T00:00:00Z,10,5,2020,0,0,Montserrat,MS,MSR,5900,America,1,11,15
2020-05-11T00:00:00Z,11,5,2020,0,0,Montserrat,MS,MSR,5900,America,1,11,16
2020-05-12T00:00:00Z,12,5,2020,0,0,Montserrat,MS,MSR,5900,America,1,11,17
2020-05-13T00:00:00Z,13,5,2020,0,0,Montserrat,MS,MSR,5900,America,1,11,18
2020-05-14T00:00:00Z,14,5,2020,0,0,Montserrat,MS,MSR,5900,America,1,11,19
2020-05-15T00:00:00Z,15,5,2020,0,0,Montserrat,MS,MSR,5900,America,1,11,20
2020-05-16T00:00:00Z,16,5,2020,0,0,Montserrat,MS,MSR,5900,America,1,11,21
2020-05-17T00:00:00Z,17,5,2020,0,0,Montserrat,MS,MSR,5900,America,1,11,22
2020-05-18T00:00:00Z,18,5,2020,0,0,Montserrat,MS,MSR,5900,America,1,11,23
2020-05-19T00:00:00Z,19,5,2020,0,0,Montserrat,MS,MSR,5900,America,1,11,24
2020-05-20T00:00:00Z,20,5,2020,0,0,Montserrat,MS,MSR,5900,America,1,11,25
2020-05-21T00:00:00Z,21,5,2020,0,0,Montserrat,MS,MSR,5900,America,1,11,26
2020-05-22T00:00:00Z,22,5,2020,0,0,Montserrat,MS,MSR,5900,America,1,11,27
2020-05-23T00:00:00Z,23,5,2020,0,0,Montserrat,MS,MSR,5900,America,1,11,28
2020-05-24T00:00:00Z,24,5,2020,0,0,Montserrat,MS,MSR,5900,America,1,11,29
2020-05-25T00:00:00Z,25,5,2020,0,0,Montserrat,MS,MSR,5900,America,1,11,30
2020-05-26T00:00:00Z,26,5,2020,0,0,Montserrat,MS,MSR,5900,America,1,11,31
2020-05-27T00:00:00Z,27,5,2020,0,0,Montserrat,MS,MSR,5900,America,1,11,32
2020-03-12T00:00:00Z,12,3,2020,3,1,Morocco,MA,MAR,36029138,Africa,1,5,1
2020-03-13T00:00:00Z,13,3,2020,1,0,Morocco,MA,MAR,36029138,Africa,1,6,2
2020-03-14T00:00:00Z,14,3,2020,1,0,Morocco,MA,MAR,36029138,Africa,1,7,3
2020-03-15T00:00:00Z,15,3,2020,11,0,Morocco,MA,MAR,36029138,Africa,1,18,4
2020-03-16T00:00:00Z,16,3,2020,10,0,Morocco,MA,MAR,36029138,Africa,1,28,5
2020-03-17T00:00:00Z,17,3,2020,9,0,Morocco,MA,MAR,36029138,Africa,1,37,6
2020-03-18T00:00:00Z,18,3,2020,7,1,Morocco,MA,MAR,36029138,Africa,2,44,7
2020-03-19T00:00:00Z,19,3,2020,10,0,Morocco,MA,MAR,36029138,Africa,2,54,8
2020-03-20T00:00:00Z,20,3,2020,9,0,Morocco,MA,MAR,36029138,Africa,2,63,9
2020-03-21T00:00:00Z,21,3,2020,23,1,Morocco,MA,MAR,36029138,Africa,3,86,10
2020-03-22T00:00:00Z,22,3,2020,10,0,Morocco,MA,MAR,36029138,Africa,3,96,11
2020-03-23T00:00:00Z,23,3,2020,19,1,Morocco,MA,MAR,36029138,Africa,4,115,12
2020-03-24T00:00:00Z,24,3,2020,19,0,Morocco,MA,MAR,36029138,Africa,4,134,13
2020-03-25T00:00:00Z,25,3,2020,36,1,Morocco,MA,MAR,36029138,Africa,5,170,14
2020-03-26T00:00:00Z,26,3,2020,55,1,Morocco,MA,MAR,36029138,Africa,6,225,15
2020-03-27T00:00:00Z,27,3,2020,50,4,Morocco,MA,MAR,36029138,Africa,10,275,16
2020-03-28T00:00:00Z,28,3,2020,70,13,Morocco,MA,MAR,36029138,Africa,23,345,17
2020-03-29T00:00:00Z,29,3,2020,13,0,Morocco,MA,MAR,36029138,Africa,23,358,18
2020-03-30T00:00:00Z,30,3,2020,121,3,Morocco,MA,MAR,36029138,Africa,26,479,19
2020-03-31T00:00:00Z,31,3,2020,77,7,Morocco,MA,MAR,36029138,Africa,33,556,20
2020-04-01T00:00:00Z,1,4,2020,61,3,Morocco,MA,MAR,36029138,Africa,36,617,21
2020-04-02T00:00:00Z,2,4,2020,37,3,Morocco,MA,MAR,36029138,Africa,39,654,22
2020-04-03T00:00:00Z,3,4,2020,54,5,Morocco,MA,MAR,36029138,Africa,44,708,23
2020-04-04T00:00:00Z,4,4,2020,0,0,Morocco,MA,MAR,36029138,Africa,44,708,24
2020-04-05T00:00:00Z,5,4,2020,211,15,Morocco,MA,MAR,36029138,Africa,59,919,25
2020-04-06T00:00:00Z,6,4,2020,102,11,Morocco,MA,MAR,36029138,Africa,70,1021,26
2020-04-07T00:00:00Z,7,4,2020,99,10,Morocco,MA,MAR,36029138,Africa,80,1120,27
2020-04-08T00:00:00Z,8,4,2020,64,10,Morocco,MA,MAR,36029138,Africa,90,1184,28
2020-04-09T00:00:00Z,9,4,2020,91,3,Morocco,MA,MAR,36029138,Africa,93,1275,29
2020-04-10T00:00:00Z,10,4,2020,99,4,Morocco,MA,MAR,36029138,Africa,97,1374,30
2020-04-11T00:00:00Z,11,4,2020,74,10,Morocco,MA,MAR,36029138,Africa,107,1448,31
2020-04-12T00:00:00Z,12,4,2020,97,4,Morocco,MA,MAR,36029138,Africa,111,1545,32
2020-04-13T00:00:00Z,13,4,2020,116,7,Morocco,MA,MAR,36029138,Africa,118,1661,33
2020-04-14T00:00:00Z,14,4,2020,102,8,Morocco,MA,MAR,36029138,Africa,126,1763,34
2020-04-15T00:00:00Z,15,4,2020,125,0,Morocco,MA,MAR,36029138,Africa,126,1888,35
2020-04-16T00:00:00Z,16,4,2020,136,1,Morocco,MA,MAR,36029138,Africa,127,2024,36
2020-04-17T00:00:00Z,17,4,2020,259,3,Morocco,MA,MAR,36029138,Africa,130,2283,37
2020-04-18T00:00:00Z,18,4,2020,281,5,Morocco,MA,MAR,36029138,Africa,135,2564,38
2020-04-19T00:00:00Z,19,4,2020,121,2,Morocco,MA,MAR,36029138,Africa,137,2685,39
2020-04-20T00:00:00Z,20,4,2020,170,4,Morocco,MA,MAR,36029138,Africa,141,2855,40
2020-04-21T00:00:00Z,21,4,2020,191,2,Morocco,MA,MAR,36029138,Africa,143,3046,41
2020-04-22T00:00:00Z,22,4,2020,163,2,Morocco,MA,MAR,36029138,Africa,145,3209,42
2020-04-23T00:00:00Z,23,4,2020,168,4,Morocco,MA,MAR,36029138,Africa,149,3377,43
2020-04-24T00:00:00Z,24,4,2020,191,6,Morocco,MA,MAR,36029138,Africa,155,3568,44
2020-04-25T00:00:00Z,25,4,2020,190,3,Morocco,MA,MAR,36029138,Africa,158,3758,45
2020-04-26T00:00:00Z,26,4,2020,139,1,Morocco,MA,MAR,36029138,Africa,159,3897,46
2020-04-27T00:00:00Z,27,4,2020,168,2,Morocco,MA,MAR,36029138,Africa,161,4065,47
2020-04-28T00:00:00Z,28,4,2020,55,1,Morocco,MA,MAR,36029138,Africa,162,4120,48
2020-04-29T00:00:00Z,29,4,2020,132,3,Morocco,MA,MAR,36029138,Africa,165,4252,49
2020-04-30T00:00:00Z,30,4,2020,69,3,Morocco,MA,MAR,36029138,Africa,168,4321,50
2020-05-01T00:00:00Z,1,5,2020,102,2,Morocco,MA,MAR,36029138,Africa,170,4423,51
2020-05-02T00:00:00Z,2,5,2020,146,1,Morocco,MA,MAR,36029138,Africa,171,4569,52
2020-05-03T00:00:00Z,3,5,2020,160,2,Morocco,MA,MAR,36029138,Africa,173,4729,53
2020-05-04T00:00:00Z,4,5,2020,174,1,Morocco,MA,MAR,36029138,Africa,174,4903,54
2020-05-05T00:00:00Z,5,5,2020,140,5,Morocco,MA,MAR,36029138,Africa,179,5043,55
2020-05-06T00:00:00Z,6,5,2020,176,2,Morocco,MA,MAR,36029138,Africa,181,5219,56
2020-05-07T00:00:00Z,7,5,2020,189,2,Morocco,MA,MAR,36029138,Africa,183,5408,57
2020-05-08T00:00:00Z,8,5,2020,140,0,Morocco,MA,MAR,36029138,Africa,183,5548,58
2020-05-09T00:00:00Z,9,5,2020,163,3,Morocco,MA,MAR,36029138,Africa,186,5711,59
2020-05-10T00:00:00Z,10,5,2020,199,0,Morocco,MA,MAR,36029138,Africa,186,5910,60
2020-05-11T00:00:00Z,11,5,2020,153,2,Morocco,MA,MAR,36029138,Africa,188,6063,61
2020-05-12T00:00:00Z,12,5,2020,218,0,Morocco,MA,MAR,36029138,Africa,188,6281,62
2020-05-13T00:00:00Z,13,5,2020,137,0,Morocco,MA,MAR,36029138,Africa,188,6418,63
2020-05-14T00:00:00Z,14,5,2020,94,0,Morocco,MA,MAR,36029138,Africa,188,6512,64
2020-05-15T00:00:00Z,15,5,2020,95,2,Morocco,MA,MAR,36029138,Africa,190,6607,65
2020-05-16T00:00:00Z,16,5,2020,45,0,Morocco,MA,MAR,36029138,Africa,190,6652,66
2020-05-17T00:00:00Z,17,5,2020,89,2,Morocco,MA,MAR,36029138,Africa,192,6741,67
2020-05-18T00:00:00Z,18,5,2020,129,0,Morocco,MA,MAR,36029138,Africa,192,6870,68
2020-05-19T00:00:00Z,19,5,2020,82,0,Morocco,MA,MAR,36029138,Africa,192,6952,69
2020-05-20T00:00:00Z,20,5,2020,71,1,Morocco,MA,MAR,36029138,Africa,193,7023,70
2020-05-21T00:00:00Z,21,5,2020,110,1,Morocco,MA,MAR,36029138,Africa,194,7133,71
2020-05-22T00:00:00Z,22,5,2020,78,2,Morocco,MA,MAR,36029138,Africa,196,7211,72
2020-05-23T00:00:00Z,23,5,2020,121,1,Morocco,MA,MAR,36029138,Africa,197,7332,73
2020-05-24T00:00:00Z,24,5,2020,74,1,Morocco,MA,MAR,36029138,Africa,198,7406,74
2020-05-25T00:00:00Z,25,5,2020,27,1,Morocco,MA,MAR,36029138,Africa,199,7433,75
2020-05-26T00:00:00Z,26,5,2020,99,1,Morocco,MA,MAR,36029138,Africa,200,7532,76
2020-05-27T00:00:00Z,27,5,2020,45,2,Morocco,MA,MAR,36029138,Africa,202,7577,77
2020-05-26T00:00:00Z,26,5,2020,15,1,Mozambique,MZ,MOZ,29495962,Africa,1,209,1
2020-05-27T00:00:00Z,27,5,2020,4,0,Mozambique,MZ,MOZ,29495962,Africa,1,213,2
2020-04-01T00:00:00Z,1,4,2020,1,1,Myanmar,MM,MMR,53708395,Asia,1,15,1
2020-04-02T00:00:00Z,2,4,2020,1,0,Myanmar,MM,MMR,53708395,Asia,1,16,2
2020-04-03T00:00:00Z,3,4,2020,4,0,Myanmar,MM,MMR,53708395,Asia,1,20,3
2020-04-04T00:00:00Z,4,4,2020,0,0,Myanmar,MM,MMR,53708395,Asia,1,20,4
2020-04-05T00:00:00Z,5,4,2020,1,0,Myanmar,MM,MMR,53708395,Asia,1,21,5
2020-04-06T00:00:00Z,6,4,2020,0,0,Myanmar,MM,MMR,53708395,Asia,1,21,6
2020-04-07T00:00:00Z,7,4,2020,1,0,Myanmar,MM,MMR,53708395,Asia,1,22,7
2020-04-08T00:00:00Z,8,4,2020,0,0,Myanmar,MM,MMR,53708395,Asia,1,22,8
2020-04-09T00:00:00Z,9,4,2020,0,2,Myanmar,MM,MMR,53708395,Asia,3,22,9
2020-04-10T00:00:00Z,10,4,2020,5,0,Myanmar,MM,MMR,53708395,Asia,3,27,10
2020-04-11T00:00:00Z,11,4,2020,1,0,Myanmar,MM,MMR,53708395,Asia,3,28,11
2020-04-12T00:00:00Z,12,4,2020,3,0,Myanmar,MM,MMR,53708395,Asia,3,31,12
2020-04-13T00:00:00Z,13,4,2020,10,1,Myanmar,MM,MMR,53708395,Asia,4,41,13
2020-04-14T00:00:00Z,14,4,2020,21,0,Myanmar,MM,MMR,53708395,Asia,4,62,14
2020-04-15T00:00:00Z,15,4,2020,12,0,Myanmar,MM,MMR,53708395,Asia,4,74,15
2020-04-16T00:00:00Z,16,4,2020,0,0,Myanmar,MM,MMR,53708395,Asia,4,74,16
2020-04-17T00:00:00Z,17,4,2020,11,0,Myanmar,MM,MMR,53708395,Asia,4,85,17
2020-04-18T00:00:00Z,18,4,2020,9,1,Myanmar,MM,MMR,53708395,Asia,5,94,18
2020-04-19T00:00:00Z,19,4,2020,13,0,Myanmar,MM,MMR,53708395,Asia,5,107,19
2020-04-20T00:00:00Z,20,4,2020,4,0,Myanmar,MM,MMR,53708395,Asia,5,111,20
2020-04-21T00:00:00Z,21,4,2020,8,0,Myanmar,MM,MMR,53708395,Asia,5,119,21
2020-04-22T00:00:00Z,22,4,2020,2,0,Myanmar,MM,MMR,53708395,Asia,5,121,22
2020-04-23T00:00:00Z,23,4,2020,6,0,Myanmar,MM,MMR,53708395,Asia,5,127,23
2020-04-24T00:00:00Z,24,4,2020,5,0,Myanmar,MM,MMR,53708395,Asia,5,132,24
2020-04-25T00:00:00Z,25,4,2020,12,0,Myanmar,MM,MMR,53708395,Asia,5,144,25
2020-04-26T00:00:00Z,26,4,2020,2,0,Myanmar,MM,MMR,53708395,Asia,5,146,26
2020-04-27T00:00:00Z,27,4,2020,0,0,Myanmar,MM,MMR,53708395,Asia,5,146,27
2020-04-28T00:00:00Z,28,4,2020,0,0,Myanmar,MM,MMR,53708395,Asia,5,146,28
2020-04-29T00:00:00Z,29,4,2020,4,0,Myanmar,MM,MMR,53708395,Asia,5,150,29
2020-04-30T00:00:00Z,30,4,2020,0,1,Myanmar,MM,MMR,53708395,Asia,6,150,30
2020-05-01T00:00:00Z,1,5,2020,1,0,Myanmar,MM,MMR,53708395,Asia,6,151,31
2020-05-02T00:00:00Z,2,5,2020,0,0,Myanmar,MM,MMR,53708395,Asia,6,151,32
2020-05-03T00:00:00Z,3,5,2020,0,0,Myanmar,MM,MMR,53708395,Asia,6,151,33
2020-05-04T00:00:00Z,4,5,2020,4,0,Myanmar,MM,MMR,53708395,Asia,6,155,34
2020-05-05T00:00:00Z,5,5,2020,6,0,Myanmar,MM,MMR,53708395,Asia,6,161,35
2020-05-06T00:00:00Z,6,5,2020,0,0,Myanmar,MM,MMR,53708395,Asia,6,161,36
2020-05-07T00:00:00Z,7,5,2020,1,0,Myanmar,MM,MMR,53708395,Asia,6,162,37
2020-05-08T00:00:00Z,8,5,2020,14,0,Myanmar,MM,MMR,53708395,Asia,6,176,38
2020-05-09T00:00:00Z,9,5,2020,1,0,Myanmar,MM,MMR,53708395,Asia,6,177,39
2020-05-10T00:00:00Z,10,5,2020,1,0,Myanmar,MM,MMR,53708395,Asia,6,178,40
2020-05-11T00:00:00Z,11,5,2020,2,0,Myanmar,MM,MMR,53708395,Asia,6,180,41
2020-05-12T00:00:00Z,12,5,2020,0,0,Myanmar,MM,MMR,53708395,Asia,6,180,42
2020-05-13T00:00:00Z,13,5,2020,0,0,Myanmar,MM,MMR,53708395,Asia,6,180,43
2020-05-14T00:00:00Z,14,5,2020,1,0,Myanmar,MM,MMR,53708395,Asia,6,181,44
2020-05-15T00:00:00Z,15,5,2020,0,0,Myanmar,MM,MMR,53708395,Asia,6,181,45
2020-05-16T00:00:00Z,16,5,2020,1,0,Myanmar,MM,MMR,53708395,Asia,6,182,46
2020-05-17T00:00:00Z,17,5,2020,0,0,Myanmar,MM,MMR,53708395,Asia,6,182,47
2020-05-18T00:00:00Z,18,5,2020,5,0,Myanmar,MM,MMR,53708395,Asia,6,187,48
2020-05-19T00:00:00Z,19,5,2020,4,0,Myanmar,MM,MMR,53708395,Asia,6,191,49
2020-05-20T00:00:00Z,20,5,2020,2,0,Myanmar,MM,MMR,53708395,Asia,6,193,50
2020-05-21T00:00:00Z,21,5,2020,6,0,Myanmar,MM,MMR,53708395,Asia,6,199,51
2020-05-22T00:00:00Z,22,5,2020,0,0,Myanmar,MM,MMR,53708395,Asia,6,199,52
2020-05-23T00:00:00Z,23,5,2020,2,0,Myanmar,MM,MMR,53708395,Asia,6,201,53
2020-05-24T00:00:00Z,24,5,2020,0,0,Myanmar,MM,MMR,53708395,Asia,6,201,54
2020-05-25T00:00:00Z,25,5,2020,0,0,Myanmar,MM,MMR,53708395,Asia,6,201,55
2020-05-26T00:00:00Z,26,5,2020,2,0,Myanmar,MM,MMR,53708395,Asia,6,203,56
2020-05-27T00:00:00Z,27,5,2020,3,0,Myanmar,MM,MMR,53708395,Asia,6,206,57
2020-05-17T00:00:00Z,17,5,2020,15,1,Nepal,NP,NPL,28087871,Asia,1,291,1
2020-05-18T00:00:00Z,18,5,2020,13,1,Nepal,NP,NPL,28087871,Asia,2,304,2
2020-05-19T00:00:00Z,19,5,2020,71,0,Nepal,NP,NPL,28087871,Asia,2,375,3
2020-05-20T00:00:00Z,20,5,2020,27,0,Nepal,NP,NPL,28087871,Asia,2,402,4
2020-05-21T00:00:00Z,21,5,2020,42,0,Nepal,NP,NPL,28087871,Asia,2,444,5
2020-05-22T00:00:00Z,22,5,2020,43,1,Nepal,NP,NPL,28087871,Asia,3,487,6
2020-05-23T00:00:00Z,23,5,2020,61,0,Nepal,NP,NPL,28087871,Asia,3,548,7
2020-05-24T00:00:00Z,24,5,2020,36,0,Nepal,NP,NPL,28087871,Asia,3,584,8
2020-05-25T00:00:00Z,25,5,2020,19,0,Nepal,NP,NPL,28087871,Asia,3,603,9
2020-05-26T00:00:00Z,26,5,2020,79,1,Nepal,NP,NPL,28087871,Asia,4,682,10
2020-05-27T00:00:00Z,27,5,2020,90,0,Nepal,NP,NPL,28087871,Asia,4,772,11
2020-03-07T00:00:00Z,7,3,2020,46,1,Netherlands,NL,NLD,17231017,Europe,1,128,1
2020-03-08T00:00:00Z,8,3,2020,60,0,Netherlands,NL,NLD,17231017,Europe,1,188,2
2020-03-09T00:00:00Z,9,3,2020,77,2,Netherlands,NL,NLD,17231017,Europe,3,265,3
2020-03-10T00:00:00Z,10,3,2020,56,0,Netherlands,NL,NLD,17231017,Europe,3,321,4
2020-03-11T00:00:00Z,11,3,2020,61,1,Netherlands,NL,NLD,17231017,Europe,4,382,5
2020-03-12T00:00:00Z,12,3,2020,121,1,Netherlands,NL,NLD,17231017,Europe,5,503,6
2020-03-13T00:00:00Z,13,3,2020,111,0,Netherlands,NL,NLD,17231017,Europe,5,614,7
2020-03-14T00:00:00Z,14,3,2020,190,0,Netherlands,NL,NLD,17231017,Europe,5,804,8
2020-03-15T00:00:00Z,15,3,2020,155,7,Netherlands,NL,NLD,17231017,Europe,12,959,9
2020-03-16T00:00:00Z,16,3,2020,176,8,Netherlands,NL,NLD,17231017,Europe,20,1135,10
2020-03-17T00:00:00Z,17,3,2020,278,4,Netherlands,NL,NLD,17231017,Europe,24,1413,11
2020-03-18T00:00:00Z,18,3,2020,292,19,Netherlands,NL,NLD,17231017,Europe,43,1705,12
2020-03-19T00:00:00Z,19,3,2020,346,15,Netherlands,NL,NLD,17231017,Europe,58,2051,13
2020-03-20T00:00:00Z,20,3,2020,409,18,Netherlands,NL,NLD,17231017,Europe,76,2460,14
2020-03-21T00:00:00Z,21,3,2020,534,30,Netherlands,NL,NLD,17231017,Europe,106,2994,15
2020-03-22T00:00:00Z,22,3,2020,637,30,Netherlands,NL,NLD,17231017,Europe,136,3631,16
2020-03-23T00:00:00Z,23,3,2020,573,43,Netherlands,NL,NLD,17231017,Europe,179,4204,17
2020-03-24T00:00:00Z,24,3,2020,545,34,Netherlands,NL,NLD,17231017,Europe,213,4749,18
2020-03-25T00:00:00Z,25,3,2020,811,63,Netherlands,NL,NLD,17231017,Europe,276,5560,19
2020-03-26T00:00:00Z,26,3,2020,852,80,Netherlands,NL,NLD,17231017,Europe,356,6412,20
2020-03-27T00:00:00Z,27,3,2020,1019,78,Netherlands,NL,NLD,17231017,Europe,434,7431,21
2020-03-28T00:00:00Z,28,3,2020,1172,112,Netherlands,NL,NLD,17231017,Europe,546,8603,22
2020-03-29T00:00:00Z,29,3,2020,1159,93,Netherlands,NL,NLD,17231017,Europe,639,9762,23
2020-03-30T00:00:00Z,30,3,2020,1104,132,Netherlands,NL,NLD,17231017,Europe,771,10866,24
2020-03-31T00:00:00Z,31,3,2020,884,93,Netherlands,NL,NLD,17231017,Europe,864,11750,25
2020-04-01T00:00:00Z,1,4,2020,845,175,Netherlands,NL,NLD,17231017,Europe,1039,12595,26
2020-04-02T00:00:00Z,2,4,2020,1019,134,Netherlands,NL,NLD,17231017,Europe,1173,13614,27
2020-04-03T00:00:00Z,3,4,2020,1083,166,Netherlands,NL,NLD,17231017,Europe,1339,14697,28
2020-04-04T00:00:00Z,4,4,2020,1026,148,Netherlands,NL,NLD,17231017,Europe,1487,15723,29
2020-04-05T00:00:00Z,5,4,2020,904,164,Netherlands,NL,NLD,17231017,Europe,1651,16627,30
2020-04-06T00:00:00Z,6,4,2020,1224,115,Netherlands,NL,NLD,17231017,Europe,1766,17851,31
2020-04-07T00:00:00Z,7,4,2020,952,101,Netherlands,NL,NLD,17231017,Europe,1867,18803,32
2020-04-08T00:00:00Z,8,4,2020,777,234,Netherlands,NL,NLD,17231017,Europe,2101,19580,33
2020-04-09T00:00:00Z,9,4,2020,969,147,Netherlands,NL,NLD,17231017,Europe,2248,20549,34
2020-04-10T00:00:00Z,10,4,2020,1213,148,Netherlands,NL,NLD,17231017,Europe,2396,21762,35
2020-04-11T00:00:00Z,11,4,2020,1335,115,Netherlands,NL,NLD,17231017,Europe,2511,23097,36
2020-04-12T00:00:00Z,12,4,2020,1316,132,Netherlands,NL,NLD,17231017,Europe,2643,24413,37
2020-04-13T00:00:00Z,13,4,2020,1174,94,Netherlands,NL,NLD,17231017,Europe,2737,25587,38
2020-04-14T00:00:00Z,14,4,2020,964,86,Netherlands,NL,NLD,17231017,Europe,2823,26551,39
2020-04-15T00:00:00Z,15,4,2020,868,122,Netherlands,NL,NLD,17231017,Europe,2945,27419,40
2020-04-16T00:00:00Z,16,4,2020,734,189,Netherlands,NL,NLD,17231017,Europe,3134,28153,41
2020-04-17T00:00:00Z,17,4,2020,1061,181,Netherlands,NL,NLD,17231017,Europe,3315,29214,42
2020-04-18T00:00:00Z,18,4,2020,1235,144,Netherlands,NL,NLD,17231017,Europe,3459,30449,43
2020-04-19T00:00:00Z,19,4,2020,1140,142,Netherlands,NL,NLD,17231017,Europe,3601,31589,44
2020-04-20T00:00:00Z,20,4,2020,1066,83,Netherlands,NL,NLD,17231017,Europe,3684,32655,45
2020-04-21T00:00:00Z,21,4,2020,750,67,Netherlands,NL,NLD,17231017,Europe,3751,33405,46
2020-04-22T00:00:00Z,22,4,2020,729,165,Netherlands,NL,NLD,17231017,Europe,3916,34134,47
2020-04-23T00:00:00Z,23,4,2020,708,138,Netherlands,NL,NLD,17231017,Europe,4054,34842,48
2020-04-24T00:00:00Z,24,4,2020,887,123,Netherlands,NL,NLD,17231017,Europe,4177,35729,49
2020-04-25T00:00:00Z,25,4,2020,806,112,Netherlands,NL,NLD,17231017,Europe,4289,36535,50
2020-04-26T00:00:00Z,26,4,2020,655,120,Netherlands,NL,NLD,17231017,Europe,4409,37190,51
2020-04-27T00:00:00Z,27,4,2020,655,66,Netherlands,NL,NLD,17231017,Europe,4475,37845,52
2020-04-28T00:00:00Z,28,4,2020,400,43,Netherlands,NL,NLD,17231017,Europe,4518,38245,53
2020-04-29T00:00:00Z,29,4,2020,171,48,Netherlands,NL,NLD,17231017,Europe,4566,38416,54
2020-04-30T00:00:00Z,30,4,2020,386,145,Netherlands,NL,NLD,17231017,Europe,4711,38802,55
2020-05-01T00:00:00Z,1,5,2020,514,84,Netherlands,NL,NLD,17231017,Europe,4795,39316,56
2020-05-02T00:00:00Z,2,5,2020,475,98,Netherlands,NL,NLD,17231017,Europe,4893,39791,57
2020-05-03T00:00:00Z,3,5,2020,445,94,Netherlands,NL,NLD,17231017,Europe,4987,40236,58
2020-05-04T00:00:00Z,4,5,2020,335,69,Netherlands,NL,NLD,17231017,Europe,5056,40571,59
2020-05-05T00:00:00Z,5,5,2020,199,26,Netherlands,NL,NLD,17231017,Europe,5082,40770,60
2020-05-06T00:00:00Z,6,5,2020,317,86,Netherlands,NL,NLD,17231017,Europe,5168,41087,61
2020-05-07T00:00:00Z,7,5,2020,232,36,Netherlands,NL,NLD,17231017,Europe,5204,41319,62
2020-05-08T00:00:00Z,8,5,2020,455,84,Netherlands,NL,NLD,17231017,Europe,5288,41774,63
2020-05-09T00:00:00Z,9,5,2020,319,71,Netherlands,NL,NLD,17231017,Europe,5359,42093,64
2020-05-10T00:00:00Z,10,5,2020,289,63,Netherlands,NL,NLD,17231017,Europe,5422,42382,65
2020-05-11T00:00:00Z,11,5,2020,245,18,Netherlands,NL,NLD,17231017,Europe,5440,42627,66
2020-05-12T00:00:00Z,12,5,2020,161,16,Netherlands,NL,NLD,17231017,Europe,5456,42788,67
2020-05-13T00:00:00Z,13,5,2020,196,54,Netherlands,NL,NLD,17231017,Europe,5510,42984,68
2020-05-14T00:00:00Z,14,5,2020,227,52,Netherlands,NL,NLD,17231017,Europe,5562,43211,69
2020-05-15T00:00:00Z,15,5,2020,270,28,Netherlands,NL,NLD,17231017,Europe,5590,43481,70
2020-05-16T00:00:00Z,16,5,2020,200,53,Netherlands,NL,NLD,17231017,Europe,5643,43681,71
2020-05-17T00:00:00Z,17,5,2020,189,27,Netherlands,NL,NLD,17231017,Europe,5670,43870,72
2020-05-18T00:00:00Z,18,5,2020,125,10,Netherlands,NL,NLD,17231017,Europe,5680,43995,73
2020-05-19T00:00:00Z,19,5,2020,146,14,Netherlands,NL,NLD,17231017,Europe,5694,44141,74
2020-05-20T00:00:00Z,20,5,2020,108,21,Netherlands,NL,NLD,17231017,Europe,5715,44249,75
2020-05-21T00:00:00Z,21,5,2020,198,33,Netherlands,NL,NLD,17231017,Europe,5748,44447,76
2020-05-22T00:00:00Z,22,5,2020,253,27,Netherlands,NL,NLD,17231017,Europe,5775,44700,77
2020-05-23T00:00:00Z,23,5,2020,188,13,Netherlands,NL,NLD,17231017,Europe,5788,44888,78
2020-05-24T00:00:00Z,24,5,2020,176,23,Netherlands,NL,NLD,17231017,Europe,5811,45064,79
2020-05-25T00:00:00Z,25,5,2020,172,11,Netherlands,NL,NLD,17231017,Europe,5822,45236,80
2020-05-26T00:00:00Z,26,5,2020,209,8,Netherlands,NL,NLD,17231017,Europe,5830,45445,81
2020-05-27T00:00:00Z,27,5,2020,133,26,Netherlands,NL,NLD,17231017,Europe,5856,45578,82
2020-03-29T00:00:00Z,29,3,2020,60,1,New_Zealand,NZ,NZL,4885500,Oceania,1,476,1
2020-03-30T00:00:00Z,30,3,2020,76,0,New_Zealand,NZ,NZL,4885500,Oceania,1,552,2
2020-03-31T00:00:00Z,31,3,2020,95,0,New_Zealand,NZ,NZL,4885500,Oceania,1,647,3
2020-04-01T00:00:00Z,1,4,2020,0,0,New_Zealand,NZ,NZL,4885500,Oceania,1,647,4
2020-04-02T00:00:00Z,2,4,2020,76,0,New_Zealand,NZ,NZL,4885500,Oceania,1,723,5
2020-04-03T00:00:00Z,3,4,2020,49,0,New_Zealand,NZ,NZL,4885500,Oceania,1,772,6
2020-04-04T00:00:00Z,4,4,2020,52,0,New_Zealand,NZ,NZL,4885500,Oceania,1,824,7
2020-04-05T00:00:00Z,5,4,2020,48,0,New_Zealand,NZ,NZL,4885500,Oceania,1,872,8
2020-04-06T00:00:00Z,6,4,2020,39,0,New_Zealand,NZ,NZL,4885500,Oceania,1,911,9
2020-04-07T00:00:00Z,7,4,2020,32,0,New_Zealand,NZ,NZL,4885500,Oceania,1,943,10
2020-04-08T00:00:00Z,8,4,2020,26,0,New_Zealand,NZ,NZL,4885500,Oceania,1,969,11
2020-04-09T00:00:00Z,9,4,2020,23,0,New_Zealand,NZ,NZL,4885500,Oceania,1,992,12
2020-04-10T00:00:00Z,10,4,2020,23,1,New_Zealand,NZ,NZL,4885500,Oceania,2,1015,13
2020-04-11T00:00:00Z,11,4,2020,20,2,New_Zealand,NZ,NZL,4885500,Oceania,4,1035,14
2020-04-12T00:00:00Z,12,4,2020,14,0,New_Zealand,NZ,NZL,4885500,Oceania,4,1049,15
2020-04-13T00:00:00Z,13,4,2020,15,1,New_Zealand,NZ,NZL,4885500,Oceania,5,1064,16
2020-04-14T00:00:00Z,14,4,2020,8,4,New_Zealand,NZ,NZL,4885500,Oceania,9,1072,17
2020-04-15T00:00:00Z,15,4,2020,6,0,New_Zealand,NZ,NZL,4885500,Oceania,9,1078,18
2020-04-16T00:00:00Z,16,4,2020,6,0,New_Zealand,NZ,NZL,4885500,Oceania,9,1084,19
2020-04-17T00:00:00Z,17,4,2020,2,2,New_Zealand,NZ,NZL,4885500,Oceania,11,1086,20
2020-04-18T00:00:00Z,18,4,2020,8,0,New_Zealand,NZ,NZL,4885500,Oceania,11,1094,21
2020-04-19T00:00:00Z,19,4,2020,4,1,New_Zealand,NZ,NZL,4885500,Oceania,12,1098,22
2020-04-20T00:00:00Z,20,4,2020,7,0,New_Zealand,NZ,NZL,4885500,Oceania,12,1105,23
2020-04-21T00:00:00Z,21,4,2020,2,1,New_Zealand,NZ,NZL,4885500,Oceania,13,1107,24
2020-04-22T00:00:00Z,22,4,2020,5,1,New_Zealand,NZ,NZL,4885500,Oceania,14,1112,25
2020-04-23T00:00:00Z,23,4,2020,0,2,New_Zealand,NZ,NZL,4885500,Oceania,16,1112,26
2020-04-24T00:00:00Z,24,4,2020,2,1,New_Zealand,NZ,NZL,4885500,Oceania,17,1114,27
2020-04-25T00:00:00Z,25,4,2020,3,1,New_Zealand,NZ,NZL,4885500,Oceania,18,1117,28
2020-04-26T00:00:00Z,26,4,2020,4,0,New_Zealand,NZ,NZL,4885500,Oceania,18,1121,29
2020-04-27T00:00:00Z,27,4,2020,1,1,New_Zealand,NZ,NZL,4885500,Oceania,19,1122,30
2020-04-28T00:00:00Z,28,4,2020,2,0,New_Zealand,NZ,NZL,4885500,Oceania,19,1124,31
2020-04-29T00:00:00Z,29,4,2020,2,0,New_Zealand,NZ,NZL,4885500,Oceania,19,1126,32
2020-04-30T00:00:00Z,30,4,2020,3,0,New_Zealand,NZ,NZL,4885500,Oceania,19,1129,33
2020-05-01T00:00:00Z,1,5,2020,3,0,New_Zealand,NZ,NZL,4885500,Oceania,19,1132,34
2020-05-02T00:00:00Z,2,5,2020,2,1,New_Zealand,NZ,NZL,4885500,Oceania,20,1134,35
2020-05-03T00:00:00Z,3,5,2020,2,0,New_Zealand,NZ,NZL,4885500,Oceania,20,1136,36
2020-05-04T00:00:00Z,4,5,2020,1,0,New_Zealand,NZ,NZL,4885500,Oceania,20,1137,37
2020-05-05T00:00:00Z,5,5,2020,0,0,New_Zealand,NZ,NZL,4885500,Oceania,20,1137,38
2020-05-06T00:00:00Z,6,5,2020,1,1,New_Zealand,NZ,NZL,4885500,Oceania,21,1138,39
2020-05-07T00:00:00Z,7,5,2020,1,0,New_Zealand,NZ,NZL,4885500,Oceania,21,1139,40
2020-05-08T00:00:00Z,8,5,2020,2,0,New_Zealand,NZ,NZL,4885500,Oceania,21,1141,41
2020-05-09T00:00:00Z,9,5,2020,1,0,New_Zealand,NZ,NZL,4885500,Oceania,21,1142,42
2020-05-10T00:00:00Z,10,5,2020,2,0,New_Zealand,NZ,NZL,4885500,Oceania,21,1144,43
2020-05-11T00:00:00Z,11,5,2020,3,0,New_Zealand,NZ,NZL,4885500,Oceania,21,1147,44
2020-05-12T00:00:00Z,12,5,2020,0,0,New_Zealand,NZ,NZL,4885500,Oceania,21,1147,45
2020-05-13T00:00:00Z,13,5,2020,0,0,New_Zealand,NZ,NZL,4885500,Oceania,21,1147,46
2020-05-14T00:00:00Z,14,5,2020,0,0,New_Zealand,NZ,NZL,4885500,Oceania,21,1147,47
2020-05-15T00:00:00Z,15,5,2020,1,0,New_Zealand,NZ,NZL,4885500,Oceania,21,1148,48
2020-05-16T00:00:00Z,16,5,2020,0,0,New_Zealand,NZ,NZL,4885500,Oceania,21,1148,49
2020-05-17T00:00:00Z,17,5,2020,1,0,New_Zealand,NZ,NZL,4885500,Oceania,21,1149,50
2020-05-18T00:00:00Z,18,5,2020,0,0,New_Zealand,NZ,NZL,4885500,Oceania,21,1149,51
2020-05-19T00:00:00Z,19,5,2020,4,0,New_Zealand,NZ,NZL,4885500,Oceania,21,1153,52
2020-05-20T00:00:00Z,20,5,2020,0,0,New_Zealand,NZ,NZL,4885500,Oceania,21,1153,53
2020-05-21T00:00:00Z,21,5,2020,0,0,New_Zealand,NZ,NZL,4885500,Oceania,21,1153,54
2020-05-22T00:00:00Z,22,5,2020,1,0,New_Zealand,NZ,NZL,4885500,Oceania,21,1154,55
2020-05-23T00:00:00Z,23,5,2020,0,0,New_Zealand,NZ,NZL,4885500,Oceania,21,1154,56
2020-05-24T00:00:00Z,24,5,2020,0,0,New_Zealand,NZ,NZL,4885500,Oceania,21,1154,57
2020-05-25T00:00:00Z,25,5,2020,0,0,New_Zealand,NZ,NZL,4885500,Oceania,21,1154,58
2020-05-26T00:00:00Z,26,5,2020,0,0,New_Zealand,NZ,NZL,4885500,Oceania,21,1154,59
2020-05-27T00:00:00Z,27,5,2020,0,0,New_Zealand,NZ,NZL,4885500,Oceania,21,1154,60
2020-03-28T00:00:00Z,28,3,2020,0,1,Nicaragua,NI,NIC,6465513,America,1,2,1
2020-03-29T00:00:00Z,29,3,2020,2,0,Nicaragua,NI,NIC,6465513,America,1,4,2
2020-03-30T00:00:00Z,30,3,2020,0,0,Nicaragua,NI,NIC,6465513,America,1,4,3
2020-03-31T00:00:00Z,31,3,2020,0,0,Nicaragua,NI,NIC,6465513,America,1,4,4
2020-04-01T00:00:00Z,1,4,2020,0,0,Nicaragua,NI,NIC,6465513,America,1,4,5
2020-04-02T00:00:00Z,2,4,2020,1,0,Nicaragua,NI,NIC,6465513,America,1,5,6
2020-04-03T00:00:00Z,3,4,2020,0,0,Nicaragua,NI,NIC,6465513,America,1,5,7
2020-04-04T00:00:00Z,4,4,2020,0,0,Nicaragua,NI,NIC,6465513,America,1,5,8
2020-04-05T00:00:00Z,5,4,2020,0,0,Nicaragua,NI,NIC,6465513,America,1,5,9
2020-04-06T00:00:00Z,6,4,2020,0,0,Nicaragua,NI,NIC,6465513,America,1,5,10
2020-04-07T00:00:00Z,7,4,2020,1,0,Nicaragua,NI,NIC,6465513,America,1,6,11
2020-04-08T00:00:00Z,8,4,2020,0,0,Nicaragua,NI,NIC,6465513,America,1,6,12
2020-04-09T00:00:00Z,9,4,2020,0,0,Nicaragua,NI,NIC,6465513,America,1,6,13
2020-04-10T00:00:00Z,10,4,2020,0,0,Nicaragua,NI,NIC,6465513,America,1,6,14
2020-04-11T00:00:00Z,11,4,2020,1,0,Nicaragua,NI,NIC,6465513,America,1,7,15
2020-04-12T00:00:00Z,12,4,2020,0,0,Nicaragua,NI,NIC,6465513,America,1,7,16
2020-04-13T00:00:00Z,13,4,2020,2,0,Nicaragua,NI,NIC,6465513,America,1,9,17
2020-04-14T00:00:00Z,14,4,2020,0,0,Nicaragua,NI,NIC,6465513,America,1,9,18
2020-04-15T00:00:00Z,15,4,2020,0,0,Nicaragua,NI,NIC,6465513,America,1,9,19
2020-04-16T00:00:00Z,16,4,2020,0,0,Nicaragua,NI,NIC,6465513,America,1,9,20
2020-04-17T00:00:00Z,17,4,2020,0,0,Nicaragua,NI,NIC,6465513,America,1,9,21
2020-04-18T00:00:00Z,18,4,2020,0,0,Nicaragua,NI,NIC,6465513,America,1,9,22
2020-04-19T00:00:00Z,19,4,2020,0,0,Nicaragua,NI,NIC,6465513,America,1,9,23
2020-04-20T00:00:00Z,20,4,2020,0,0,Nicaragua,NI,NIC,6465513,America,1,9,24
2020-04-21T00:00:00Z,21,4,2020,0,1,Nicaragua,NI,NIC,6465513,America,2,9,25
2020-04-22T00:00:00Z,22,4,2020,1,0,Nicaragua,NI,NIC,6465513,America,2,10,26
2020-04-23T00:00:00Z,23,4,2020,0,0,Nicaragua,NI,NIC,6465513,America,2,10,27
2020-04-24T00:00:00Z,24,4,2020,0,0,Nicaragua,NI,NIC,6465513,America,2,10,28
2020-04-25T00:00:00Z,25,4,2020,1,1,Nicaragua,NI,NIC,6465513,America,3,11,29
2020-04-26T00:00:00Z,26,4,2020,1,0,Nicaragua,NI,NIC,6465513,America,3,12,30
2020-04-27T00:00:00Z,27,4,2020,1,0,Nicaragua,NI,NIC,6465513,America,3,13,31
2020-04-28T00:00:00Z,28,4,2020,0,0,Nicaragua,NI,NIC,6465513,America,3,13,32
2020-04-29T00:00:00Z,29,4,2020,0,0,Nicaragua,NI,NIC,6465513,America,3,13,33
2020-04-30T00:00:00Z,30,4,2020,1,1,Nicaragua,NI,NIC,6465513,America,4,14,34
2020-05-01T00:00:00Z,1,5,2020,0,0,Nicaragua,NI,NIC,6465513,America,4,14,35
2020-05-02T00:00:00Z,2,5,2020,0,0,Nicaragua,NI,NIC,6465513,America,4,14,36
2020-05-03T00:00:00Z,3,5,2020,0,0,Nicaragua,NI,NIC,6465513,America,4,14,37
2020-05-04T00:00:00Z,4,5,2020,0,1,Nicaragua,NI,NIC,6465513,America,5,14,38
2020-05-05T00:00:00Z,5,5,2020,1,0,Nicaragua,NI,NIC,6465513,America,5,15,39
2020-05-06T00:00:00Z,6,5,2020,1,0,Nicaragua,NI,NIC,6465513,America,5,16,40
2020-05-07T00:00:00Z,7,5,2020,0,0,Nicaragua,NI,NIC,6465513,America,5,16,41
2020-05-08T00:00:00Z,8,5,2020,0,0,Nicaragua,NI,NIC,6465513,America,5,16,42
2020-05-09T00:00:00Z,9,5,2020,0,0,Nicaragua,NI,NIC,6465513,America,5,16,43
2020-05-10T00:00:00Z,10,5,2020,0,0,Nicaragua,NI,NIC,6465513,America,5,16,44
2020-05-11T00:00:00Z,11,5,2020,0,0,Nicaragua,NI,NIC,6465513,America,5,16,45
2020-05-12T00:00:00Z,12,5,2020,0,0,Nicaragua,NI,NIC,6465513,America,5,16,46
2020-05-13T00:00:00Z,13,5,2020,9,3,Nicaragua,NI,NIC,6465513,America,8,25,47
2020-05-14T00:00:00Z,14,5,2020,0,0,Nicaragua,NI,NIC,6465513,America,8,25,48
2020-05-15T00:00:00Z,15,5,2020,0,0,Nicaragua,NI,NIC,6465513,America,8,25,49
2020-05-16T00:00:00Z,16,5,2020,0,0,Nicaragua,NI,NIC,6465513,America,8,25,50
2020-05-17T00:00:00Z,17,5,2020,0,0,Nicaragua,NI,NIC,6465513,America,8,25,51
2020-05-18T00:00:00Z,18,5,2020,0,0,Nicaragua,NI,NIC,6465513,America,8,25,52
2020-05-19T00:00:00Z,19,5,2020,0,0,Nicaragua,NI,NIC,6465513,America,8,25,53
2020-05-20T00:00:00Z,20,5,2020,0,0,Nicaragua,NI,NIC,6465513,America,8,25,54
2020-05-21T00:00:00Z,21,5,2020,0,0,Nicaragua,NI,NIC,6465513,America,8,25,55
2020-05-22T00:00:00Z,22,5,2020,0,0,Nicaragua,NI,NIC,6465513,America,8,25,56
2020-05-23T00:00:00Z,23,5,2020,254,9,Nicaragua,NI,NIC,6465513,America,17,279,57
2020-05-24T00:00:00Z,24,5,2020,0,0,Nicaragua,NI,NIC,6465513,America,17,279,58
2020-05-25T00:00:00Z,25,5,2020,0,0,Nicaragua,NI,NIC,6465513,America,17,279,59
2020-05-26T00:00:00Z,26,5,2020,0,0,Nicaragua,NI,NIC,6465513,America,17,279,60
2020-05-27T00:00:00Z,27,5,2020,480,18,Nicaragua,NI,NIC,6465513,America,35,759,61
2020-03-25T00:00:00Z,25,3,2020,5,1,Niger,NE,NER,22442948,Africa,1,7,1
2020-03-26T00:00:00Z,26,3,2020,0,0,Niger,NE,NER,22442948,Africa,1,7,2
2020-03-27T00:00:00Z,27,3,2020,3,0,Niger,NE,NER,22442948,Africa,1,10,3
2020-03-28T00:00:00Z,28,3,2020,0,0,Niger,NE,NER,22442948,Africa,1,10,4
2020-03-29T00:00:00Z,29,3,2020,0,0,Niger,NE,NER,22442948,Africa,1,10,5
2020-03-30T00:00:00Z,30,3,2020,0,0,Niger,NE,NER,22442948,Africa,1,10,6
2020-03-31T00:00:00Z,31,3,2020,10,2,Niger,NE,NER,22442948,Africa,3,20,7
2020-04-01T00:00:00Z,1,4,2020,0,0,Niger,NE,NER,22442948,Africa,3,20,8
2020-04-02T00:00:00Z,2,4,2020,54,2,Niger,NE,NER,22442948,Africa,5,74,9
2020-04-03T00:00:00Z,3,4,2020,0,0,Niger,NE,NER,22442948,Africa,5,74,10
2020-04-04T00:00:00Z,4,4,2020,24,0,Niger,NE,NER,22442948,Africa,5,98,11
2020-04-05T00:00:00Z,5,4,2020,22,0,Niger,NE,NER,22442948,Africa,5,120,12
2020-04-06T00:00:00Z,6,4,2020,64,5,Niger,NE,NER,22442948,Africa,10,184,13
2020-04-07T00:00:00Z,7,4,2020,69,0,Niger,NE,NER,22442948,Africa,10,253,14
2020-04-08T00:00:00Z,8,4,2020,25,1,Niger,NE,NER,22442948,Africa,11,278,15
2020-04-09T00:00:00Z,9,4,2020,64,0,Niger,NE,NER,22442948,Africa,11,342,16
2020-04-10T00:00:00Z,10,4,2020,68,0,Niger,NE,NER,22442948,Africa,11,410,17
2020-04-11T00:00:00Z,11,4,2020,28,0,Niger,NE,NER,22442948,Africa,11,438,18
2020-04-12T00:00:00Z,12,4,2020,53,0,Niger,NE,NER,22442948,Africa,11,491,19
2020-04-13T00:00:00Z,13,4,2020,38,1,Niger,NE,NER,22442948,Africa,12,529,20
2020-04-14T00:00:00Z,14,4,2020,19,1,Niger,NE,NER,22442948,Africa,13,548,21
2020-04-15T00:00:00Z,15,4,2020,22,1,Niger,NE,NER,22442948,Africa,14,570,22
2020-04-16T00:00:00Z,16,4,2020,14,0,Niger,NE,NER,22442948,Africa,14,584,23
2020-04-17T00:00:00Z,17,4,2020,25,1,Niger,NE,NER,22442948,Africa,15,609,24
2020-04-18T00:00:00Z,18,4,2020,18,3,Niger,NE,NER,22442948,Africa,18,627,25
2020-04-19T00:00:00Z,19,4,2020,12,1,Niger,NE,NER,22442948,Africa,19,639,26
2020-04-20T00:00:00Z,20,4,2020,9,1,Niger,NE,NER,22442948,Africa,20,648,27
2020-04-21T00:00:00Z,21,4,2020,7,0,Niger,NE,NER,22442948,Africa,20,655,28
2020-04-22T00:00:00Z,22,4,2020,0,0,Niger,NE,NER,22442948,Africa,20,655,29
2020-04-23T00:00:00Z,23,4,2020,7,2,Niger,NE,NER,22442948,Africa,22,662,30
2020-04-24T00:00:00Z,24,4,2020,9,2,Niger,NE,NER,22442948,Africa,24,671,31
2020-04-25T00:00:00Z,25,4,2020,10,0,Niger,NE,NER,22442948,Africa,24,681,32
2020-04-26T00:00:00Z,26,4,2020,3,3,Niger,NE,NER,22442948,Africa,27,684,33
2020-04-27T00:00:00Z,27,4,2020,12,2,Niger,NE,NER,22442948,Africa,29,696,34
2020-04-28T00:00:00Z,28,4,2020,5,0,Niger,NE,NER,22442948,Africa,29,701,35
2020-04-29T00:00:00Z,29,4,2020,8,2,Niger,NE,NER,22442948,Africa,31,709,36
2020-04-30T00:00:00Z,30,4,2020,4,1,Niger,NE,NER,22442948,Africa,32,713,37
2020-05-01T00:00:00Z,1,5,2020,6,0,Niger,NE,NER,22442948,Africa,32,719,38
2020-05-02T00:00:00Z,2,5,2020,9,1,Niger,NE,NER,22442948,Africa,33,728,39
2020-05-03T00:00:00Z,3,5,2020,8,2,Niger,NE,NER,22442948,Africa,35,736,40
2020-05-04T00:00:00Z,4,5,2020,14,1,Niger,NE,NER,22442948,Africa,36,750,41
2020-05-05T00:00:00Z,5,5,2020,5,1,Niger,NE,NER,22442948,Africa,37,755,42
2020-05-06T00:00:00Z,6,5,2020,8,1,Niger,NE,NER,22442948,Africa,38,763,43
2020-05-07T00:00:00Z,7,5,2020,7,0,Niger,NE,NER,22442948,Africa,38,770,44
2020-05-08T00:00:00Z,8,5,2020,11,4,Niger,NE,NER,22442948,Africa,42,781,45
2020-05-09T00:00:00Z,9,5,2020,14,2,Niger,NE,NER,22442948,Africa,44,795,46
2020-05-10T00:00:00Z,10,5,2020,20,1,Niger,NE,NER,22442948,Africa,45,815,47
2020-05-11T00:00:00Z,11,5,2020,6,1,Niger,NE,NER,22442948,Africa,46,821,48
2020-05-12T00:00:00Z,12,5,2020,11,0,Niger,NE,NER,22442948,Africa,46,832,49
2020-05-13T00:00:00Z,13,5,2020,22,1,Niger,NE,NER,22442948,Africa,47,854,50
2020-05-14T00:00:00Z,14,5,2020,6,2,Niger,NE,NER,22442948,Africa,49,860,51
2020-05-15T00:00:00Z,15,5,2020,16,1,Niger,NE,NER,22442948,Africa,50,876,52
2020-05-16T00:00:00Z,16,5,2020,9,1,Niger,NE,NER,22442948,Africa,51,885,53
2020-05-17T00:00:00Z,17,5,2020,4,0,Niger,NE,NER,22442948,Africa,51,889,54
2020-05-18T00:00:00Z,18,5,2020,15,3,Niger,NE,NER,22442948,Africa,54,904,55
2020-05-19T00:00:00Z,19,5,2020,5,1,Niger,NE,NER,22442948,Africa,55,909,56
2020-05-20T00:00:00Z,20,5,2020,5,0,Niger,NE,NER,22442948,Africa,55,914,57
2020-05-21T00:00:00Z,21,5,2020,6,3,Niger,NE,NER,22442948,Africa,58,920,58
2020-05-22T00:00:00Z,22,5,2020,4,2,Niger,NE,NER,22442948,Africa,60,924,59
2020-05-23T00:00:00Z,23,5,2020,13,0,Niger,NE,NER,22442948,Africa,60,937,60
2020-05-24T00:00:00Z,24,5,2020,6,1,Niger,NE,NER,22442948,Africa,61,943,61
2020-05-25T00:00:00Z,25,5,2020,2,0,Niger,NE,NER,22442948,Africa,61,945,62
2020-05-26T00:00:00Z,26,5,2020,6,1,Niger,NE,NER,22442948,Africa,62,951,63
2020-05-27T00:00:00Z,27,5,2020,1,1,Niger,NE,NER,22442948,Africa,63,952,64
2020-03-24T00:00:00Z,24,3,2020,10,1,Nigeria,NG,NGA,195874740,Africa,1,40,1
2020-03-25T00:00:00Z,25,3,2020,4,0,Nigeria,NG,NGA,195874740,Africa,1,44,2
2020-03-26T00:00:00Z,26,3,2020,7,0,Nigeria,NG,NGA,195874740,Africa,1,51,3
2020-03-27T00:00:00Z,27,3,2020,14,0,Nigeria,NG,NGA,195874740,Africa,1,65,4
2020-03-28T00:00:00Z,28,3,2020,16,0,Nigeria,NG,NGA,195874740,Africa,1,81,5
2020-03-29T00:00:00Z,29,3,2020,16,0,Nigeria,NG,NGA,195874740,Africa,1,97,6
2020-03-30T00:00:00Z,30,3,2020,0,0,Nigeria,NG,NGA,195874740,Africa,1,97,7
2020-03-31T00:00:00Z,31,3,2020,34,1,Nigeria,NG,NGA,195874740,Africa,2,131,8
2020-04-01T00:00:00Z,1,4,2020,0,0,Nigeria,NG,NGA,195874740,Africa,2,131,9
2020-04-02T00:00:00Z,2,4,2020,20,0,Nigeria,NG,NGA,195874740,Africa,2,151,10
2020-04-03T00:00:00Z,3,4,2020,23,0,Nigeria,NG,NGA,195874740,Africa,2,174,11
2020-04-04T00:00:00Z,4,4,2020,16,0,Nigeria,NG,NGA,195874740,Africa,2,190,12
2020-04-05T00:00:00Z,5,4,2020,20,2,Nigeria,NG,NGA,195874740,Africa,4,210,13
2020-04-06T00:00:00Z,6,4,2020,22,1,Nigeria,NG,NGA,195874740,Africa,5,232,14
2020-04-07T00:00:00Z,7,4,2020,6,0,Nigeria,NG,NGA,195874740,Africa,5,238,15
2020-04-08T00:00:00Z,8,4,2020,16,1,Nigeria,NG,NGA,195874740,Africa,6,254,16
2020-04-09T00:00:00Z,9,4,2020,22,0,Nigeria,NG,NGA,195874740,Africa,6,276,17
2020-04-10T00:00:00Z,10,4,2020,12,1,Nigeria,NG,NGA,195874740,Africa,7,288,18
2020-04-11T00:00:00Z,11,4,2020,17,0,Nigeria,NG,NGA,195874740,Africa,7,305,19
2020-04-12T00:00:00Z,12,4,2020,13,3,Nigeria,NG,NGA,195874740,Africa,10,318,20
2020-04-13T00:00:00Z,13,4,2020,5,0,Nigeria,NG,NGA,195874740,Africa,10,323,21
2020-04-14T00:00:00Z,14,4,2020,20,0,Nigeria,NG,NGA,195874740,Africa,10,343,22
2020-04-15T00:00:00Z,15,4,2020,30,1,Nigeria,NG,NGA,195874740,Africa,11,373,23
2020-04-16T00:00:00Z,16,4,2020,34,1,Nigeria,NG,NGA,195874740,Africa,12,407,24
2020-04-17T00:00:00Z,17,4,2020,35,1,Nigeria,NG,NGA,195874740,Africa,13,442,25
2020-04-18T00:00:00Z,18,4,2020,51,4,Nigeria,NG,NGA,195874740,Africa,17,493,26
2020-04-19T00:00:00Z,19,4,2020,49,2,Nigeria,NG,NGA,195874740,Africa,19,542,27
2020-04-20T00:00:00Z,20,4,2020,85,2,Nigeria,NG,NGA,195874740,Africa,21,627,28
2020-04-21T00:00:00Z,21,4,2020,38,1,Nigeria,NG,NGA,195874740,Africa,22,665,29
2020-04-22T00:00:00Z,22,4,2020,117,3,Nigeria,NG,NGA,195874740,Africa,25,782,30
2020-04-23T00:00:00Z,23,4,2020,91,3,Nigeria,NG,NGA,195874740,Africa,28,873,31
2020-04-24T00:00:00Z,24,4,2020,108,3,Nigeria,NG,NGA,195874740,Africa,31,981,32
2020-04-25T00:00:00Z,25,4,2020,114,1,Nigeria,NG,NGA,195874740,Africa,32,1095,33
2020-04-26T00:00:00Z,26,4,2020,87,3,Nigeria,NG,NGA,195874740,Africa,35,1182,34
2020-04-27T00:00:00Z,27,4,2020,91,5,Nigeria,NG,NGA,195874740,Africa,40,1273,35
2020-04-28T00:00:00Z,28,4,2020,64,0,Nigeria,NG,NGA,195874740,Africa,40,1337,36
2020-04-29T00:00:00Z,29,4,2020,195,4,Nigeria,NG,NGA,195874740,Africa,44,1532,37
2020-04-30T00:00:00Z,30,4,2020,196,7,Nigeria,NG,NGA,195874740,Africa,51,1728,38
2020-05-01T00:00:00Z,1,5,2020,204,7,Nigeria,NG,NGA,195874740,Africa,58,1932,39
2020-05-02T00:00:00Z,2,5,2020,238,10,Nigeria,NG,NGA,195874740,Africa,68,2170,40
2020-05-03T00:00:00Z,3,5,2020,218,17,Nigeria,NG,NGA,195874740,Africa,85,2388,41
2020-05-04T00:00:00Z,4,5,2020,170,2,Nigeria,NG,NGA,195874740,Africa,87,2558,42
2020-05-05T00:00:00Z,5,5,2020,244,6,Nigeria,NG,NGA,195874740,Africa,93,2802,43
2020-05-06T00:00:00Z,6,5,2020,148,5,Nigeria,NG,NGA,195874740,Africa,98,2950,44
2020-05-07T00:00:00Z,7,5,2020,195,5,Nigeria,NG,NGA,195874740,Africa,103,3145,45
2020-05-08T00:00:00Z,8,5,2020,381,4,Nigeria,NG,NGA,195874740,Africa,107,3526,46
2020-05-09T00:00:00Z,9,5,2020,386,10,Nigeria,NG,NGA,195874740,Africa,117,3912,47
2020-05-10T00:00:00Z,10,5,2020,239,11,Nigeria,NG,NGA,195874740,Africa,128,4151,48
2020-05-11T00:00:00Z,11,5,2020,248,15,Nigeria,NG,NGA,195874740,Africa,143,4399,49
2020-05-12T00:00:00Z,12,5,2020,242,7,Nigeria,NG,NGA,195874740,Africa,150,4641,50
2020-05-13T00:00:00Z,13,5,2020,146,8,Nigeria,NG,NGA,195874740,Africa,158,4787,51
2020-05-14T00:00:00Z,14,5,2020,184,6,Nigeria,NG,NGA,195874740,Africa,164,4971,52
2020-05-15T00:00:00Z,15,5,2020,191,3,Nigeria,NG,NGA,195874740,Africa,167,5162,53
2020-05-16T00:00:00Z,16,5,2020,283,4,Nigeria,NG,NGA,195874740,Africa,171,5445,54
2020-05-17T00:00:00Z,17,5,2020,176,5,Nigeria,NG,NGA,195874740,Africa,176,5621,55
2020-05-18T00:00:00Z,18,5,2020,338,6,Nigeria,NG,NGA,195874740,Africa,182,5959,56
2020-05-19T00:00:00Z,19,5,2020,216,9,Nigeria,NG,NGA,195874740,Africa,191,6175,57
2020-05-20T00:00:00Z,20,5,2020,226,1,Nigeria,NG,NGA,195874740,Africa,192,6401,58
2020-05-21T00:00:00Z,21,5,2020,276,8,Nigeria,NG,NGA,195874740,Africa,200,6677,59
2020-05-22T00:00:00Z,22,5,2020,339,11,Nigeria,NG,NGA,195874740,Africa,211,7016,60
2020-05-23T00:00:00Z,23,5,2020,245,10,Nigeria,NG,NGA,195874740,Africa,221,7261,61
2020-05-24T00:00:00Z,24,5,2020,265,0,Nigeria,NG,NGA,195874740,Africa,221,7526,62
2020-05-25T00:00:00Z,25,5,2020,313,5,Nigeria,NG,NGA,195874740,Africa,226,7839,63
2020-05-26T00:00:00Z,26,5,2020,229,7,Nigeria,NG,NGA,195874740,Africa,233,8068,64
2020-05-27T00:00:00Z,27,5,2020,276,16,Nigeria,NG,NGA,195874740,Africa,249,8344,65
2020-03-23T00:00:00Z,23,3,2020,29,1,North_Macedonia,MK,MKD,2082958,Europe,1,114,1
2020-03-24T00:00:00Z,24,3,2020,22,1,North_Macedonia,MK,MKD,2082958,Europe,2,136,2
2020-03-25T00:00:00Z,25,3,2020,12,0,North_Macedonia,MK,MKD,2082958,Europe,2,148,3
2020-03-26T00:00:00Z,26,3,2020,29,0,North_Macedonia,MK,MKD,2082958,Europe,2,177,4
2020-03-27T00:00:00Z,27,3,2020,24,1,North_Macedonia,MK,MKD,2082958,Europe,3,201,5
2020-03-28T00:00:00Z,28,3,2020,18,0,North_Macedonia,MK,MKD,2082958,Europe,3,219,6
2020-03-29T00:00:00Z,29,3,2020,22,1,North_Macedonia,MK,MKD,2082958,Europe,4,241,7
2020-03-30T00:00:00Z,30,3,2020,18,2,North_Macedonia,MK,MKD,2082958,Europe,6,259,8
2020-03-31T00:00:00Z,31,3,2020,26,1,North_Macedonia,MK,MKD,2082958,Europe,7,285,9
2020-04-01T00:00:00Z,1,4,2020,44,2,North_Macedonia,MK,MKD,2082958,Europe,9,329,10
2020-04-02T00:00:00Z,2,4,2020,25,1,North_Macedonia,MK,MKD,2082958,Europe,10,354,11
2020-04-03T00:00:00Z,3,4,2020,0,1,North_Macedonia,MK,MKD,2082958,Europe,11,354,12
2020-04-04T00:00:00Z,4,4,2020,76,1,North_Macedonia,MK,MKD,2082958,Europe,12,430,13
2020-04-05T00:00:00Z,5,4,2020,53,5,North_Macedonia,MK,MKD,2082958,Europe,17,483,14
2020-04-06T00:00:00Z,6,4,2020,0,0,North_Macedonia,MK,MKD,2082958,Europe,17,483,15
2020-04-07T00:00:00Z,7,4,2020,87,4,North_Macedonia,MK,MKD,2082958,Europe,21,570,16
2020-04-08T00:00:00Z,8,4,2020,29,5,North_Macedonia,MK,MKD,2082958,Europe,26,599,17
2020-04-09T00:00:00Z,9,4,2020,18,4,North_Macedonia,MK,MKD,2082958,Europe,30,617,18
2020-04-10T00:00:00Z,10,4,2020,46,2,North_Macedonia,MK,MKD,2082958,Europe,32,663,19
2020-04-11T00:00:00Z,11,4,2020,48,0,North_Macedonia,MK,MKD,2082958,Europe,32,711,20
2020-04-12T00:00:00Z,12,4,2020,49,2,North_Macedonia,MK,MKD,2082958,Europe,34,760,21
2020-04-13T00:00:00Z,13,4,2020,68,0,North_Macedonia,MK,MKD,2082958,Europe,34,828,22
2020-04-14T00:00:00Z,14,4,2020,26,4,North_Macedonia,MK,MKD,2082958,Europe,38,854,23
2020-04-15T00:00:00Z,15,4,2020,54,6,North_Macedonia,MK,MKD,2082958,Europe,44,908,24
2020-04-16T00:00:00Z,16,4,2020,66,1,North_Macedonia,MK,MKD,2082958,Europe,45,974,25
2020-04-17T00:00:00Z,17,4,2020,107,1,North_Macedonia,MK,MKD,2082958,Europe,46,1081,26
2020-04-18T00:00:00Z,18,4,2020,36,3,North_Macedonia,MK,MKD,2082958,Europe,49,1117,27
2020-04-19T00:00:00Z,19,4,2020,53,0,North_Macedonia,MK,MKD,2082958,Europe,49,1170,28
2020-04-20T00:00:00Z,20,4,2020,37,2,North_Macedonia,MK,MKD,2082958,Europe,51,1207,29
2020-04-21T00:00:00Z,21,4,2020,18,3,North_Macedonia,MK,MKD,2082958,Europe,54,1225,30
2020-04-22T00:00:00Z,22,4,2020,6,1,North_Macedonia,MK,MKD,2082958,Europe,55,1231,31
2020-04-23T00:00:00Z,23,4,2020,28,1,North_Macedonia,MK,MKD,2082958,Europe,56,1259,32
2020-04-24T00:00:00Z,24,4,2020,41,0,North_Macedonia,MK,MKD,2082958,Europe,56,1300,33
2020-04-25T00:00:00Z,25,4,2020,26,1,North_Macedonia,MK,MKD,2082958,Europe,57,1326,34
2020-04-26T00:00:00Z,26,4,2020,41,2,North_Macedonia,MK,MKD,2082958,Europe,59,1367,35
2020-04-27T00:00:00Z,27,4,2020,19,2,North_Macedonia,MK,MKD,2082958,Europe,61,1386,36
2020-04-28T00:00:00Z,28,4,2020,13,4,North_Macedonia,MK,MKD,2082958,Europe,65,1399,37
2020-04-29T00:00:00Z,29,4,2020,22,6,North_Macedonia,MK,MKD,2082958,Europe,71,1421,38
2020-04-30T00:00:00Z,30,4,2020,21,2,North_Macedonia,MK,MKD,2082958,Europe,73,1442,39
2020-05-01T00:00:00Z,1,5,2020,23,4,North_Macedonia,MK,MKD,2082958,Europe,77,1465,40
2020-05-02T00:00:00Z,2,5,2020,29,4,North_Macedonia,MK,MKD,2082958,Europe,81,1494,41
2020-05-03T00:00:00Z,3,5,2020,12,1,North_Macedonia,MK,MKD,2082958,Europe,82,1506,42
2020-05-04T00:00:00Z,4,5,2020,5,2,North_Macedonia,MK,MKD,2082958,Europe,84,1511,43
2020-05-05T00:00:00Z,5,5,2020,7,1,North_Macedonia,MK,MKD,2082958,Europe,85,1518,44
2020-05-06T00:00:00Z,6,5,2020,8,1,North_Macedonia,MK,MKD,2082958,Europe,86,1526,45
2020-05-07T00:00:00Z,7,5,2020,13,2,North_Macedonia,MK,MKD,2082958,Europe,88,1539,46
2020-05-08T00:00:00Z,8,5,2020,33,1,North_Macedonia,MK,MKD,2082958,Europe,89,1572,47
2020-05-09T00:00:00Z,9,5,2020,14,1,North_Macedonia,MK,MKD,2082958,Europe,90,1586,48
2020-05-10T00:00:00Z,10,5,2020,36,1,North_Macedonia,MK,MKD,2082958,Europe,91,1622,49
2020-05-11T00:00:00Z,11,5,2020,20,0,North_Macedonia,MK,MKD,2082958,Europe,91,1642,50
2020-05-12T00:00:00Z,12,5,2020,22,0,North_Macedonia,MK,MKD,2082958,Europe,91,1664,51
2020-05-13T00:00:00Z,13,5,2020,10,1,North_Macedonia,MK,MKD,2082958,Europe,92,1674,52
2020-05-14T00:00:00Z,14,5,2020,20,3,North_Macedonia,MK,MKD,2082958,Europe,95,1694,53
2020-05-15T00:00:00Z,15,5,2020,29,0,North_Macedonia,MK,MKD,2082958,Europe,95,1723,54
2020-05-16T00:00:00Z,16,5,2020,17,2,North_Macedonia,MK,MKD,2082958,Europe,97,1740,55
2020-05-17T00:00:00Z,17,5,2020,22,1,North_Macedonia,MK,MKD,2082958,Europe,98,1762,56
2020-05-18T00:00:00Z,18,5,2020,30,3,North_Macedonia,MK,MKD,2082958,Europe,101,1792,57
2020-05-19T00:00:00Z,19,5,2020,25,3,North_Macedonia,MK,MKD,2082958,Europe,104,1817,58
2020-05-20T00:00:00Z,20,5,2020,22,2,North_Macedonia,MK,MKD,2082958,Europe,106,1839,59
2020-05-21T00:00:00Z,21,5,2020,19,4,North_Macedonia,MK,MKD,2082958,Europe,110,1858,60
2020-05-22T00:00:00Z,22,5,2020,40,1,North_Macedonia,MK,MKD,2082958,Europe,111,1898,61
2020-05-23T00:00:00Z,23,5,2020,23,1,North_Macedonia,MK,MKD,2082958,Europe,112,1921,62
2020-05-24T00:00:00Z,24,5,2020,20,1,North_Macedonia,MK,MKD,2082958,Europe,113,1941,63
2020-05-25T00:00:00Z,25,5,2020,37,0,North_Macedonia,MK,MKD,2082958,Europe,113,1978,64
2020-05-26T00:00:00Z,26,5,2020,21,0,North_Macedonia,MK,MKD,2082958,Europe,113,1999,65
2020-05-27T00:00:00Z,27,5,2020,16,3,North_Macedonia,MK,MKD,2082958,Europe,116,2015,66
2020-04-02T00:00:00Z,2,4,2020,0,1,Northern_Mariana_Islands,MP,MNP,56882,Oceania,1,6,1
2020-04-03T00:00:00Z,3,4,2020,2,0,Northern_Mariana_Islands,MP,MNP,56882,Oceania,1,8,2
2020-04-04T00:00:00Z,4,4,2020,0,0,Northern_Mariana_Islands,MP,MNP,56882,Oceania,1,8,3
2020-04-05T00:00:00Z,5,4,2020,0,0,Northern_Mariana_Islands,MP,MNP,56882,Oceania,1,8,4
2020-04-06T00:00:00Z,6,4,2020,0,0,Northern_Mariana_Islands,MP,MNP,56882,Oceania,1,8,5
2020-04-07T00:00:00Z,7,4,2020,0,0,Northern_Mariana_Islands,MP,MNP,56882,Oceania,1,8,6
2020-04-08T00:00:00Z,8,4,2020,0,1,Northern_Mariana_Islands,MP,MNP,56882,Oceania,2,8,7
2020-04-09T00:00:00Z,9,4,2020,3,0,Northern_Mariana_Islands,MP,MNP,56882,Oceania,2,11,8
2020-04-10T00:00:00Z,10,4,2020,0,0,Northern_Mariana_Islands,MP,MNP,56882,Oceania,2,11,9
2020-04-11T00:00:00Z,11,4,2020,0,0,Northern_Mariana_Islands,MP,MNP,56882,Oceania,2,11,10
2020-04-12T00:00:00Z,12,4,2020,0,0,Northern_Mariana_Islands,MP,MNP,56882,Oceania,2,11,11
2020-04-13T00:00:00Z,13,4,2020,0,0,Northern_Mariana_Islands,MP,MNP,56882,Oceania,2,11,12
2020-04-14T00:00:00Z,14,4,2020,0,0,Northern_Mariana_Islands,MP,MNP,56882,Oceania,2,11,13
2020-04-15T00:00:00Z,15,4,2020,2,0,Northern_Mariana_Islands,MP,MNP,56882,Oceania,2,13,14
2020-04-16T00:00:00Z,16,4,2020,0,0,Northern_Mariana_Islands,MP,MNP,56882,Oceania,2,13,15
2020-04-17T00:00:00Z,17,4,2020,0,0,Northern_Mariana_Islands,MP,MNP,56882,Oceania,2,13,16
2020-04-18T00:00:00Z,18,4,2020,1,0,Northern_Mariana_Islands,MP,MNP,56882,Oceania,2,14,17
2020-04-19T00:00:00Z,19,4,2020,0,0,Northern_Mariana_Islands,MP,MNP,56882,Oceania,2,14,18
2020-04-20T00:00:00Z,20,4,2020,0,0,Northern_Mariana_Islands,MP,MNP,56882,Oceania,2,14,19
2020-04-21T00:00:00Z,21,4,2020,0,0,Northern_Mariana_Islands,MP,MNP,56882,Oceania,2,14,20
2020-04-22T00:00:00Z,22,4,2020,0,0,Northern_Mariana_Islands,MP,MNP,56882,Oceania,2,14,21
2020-04-23T00:00:00Z,23,4,2020,0,0,Northern_Mariana_Islands,MP,MNP,56882,Oceania,2,14,22
2020-04-24T00:00:00Z,24,4,2020,0,0,Northern_Mariana_Islands,MP,MNP,56882,Oceania,2,14,23
2020-04-25T00:00:00Z,25,4,2020,0,0,Northern_Mariana_Islands,MP,MNP,56882,Oceania,2,14,24
2020-04-26T00:00:00Z,26,4,2020,0,0,Northern_Mariana_Islands,MP,MNP,56882,Oceania,2,14,25
2020-04-27T00:00:00Z,27,4,2020,0,0,Northern_Mariana_Islands,MP,MNP,56882,Oceania,2,14,26
2020-04-28T00:00:00Z,28,4,2020,0,0,Northern_Mariana_Islands,MP,MNP,56882,Oceania,2,14,27
2020-04-29T00:00:00Z,29,4,2020,0,0,Northern_Mariana_Islands,MP,MNP,56882,Oceania,2,14,28
2020-04-30T00:00:00Z,30,4,2020,0,0,Northern_Mariana_Islands,MP,MNP,56882,Oceania,2,14,29
2020-05-01T00:00:00Z,1,5,2020,0,0,Northern_Mariana_Islands,MP,MNP,56882,Oceania,2,14,30
2020-05-02T00:00:00Z,2,5,2020,0,0,Northern_Mariana_Islands,MP,MNP,56882,Oceania,2,14,31
2020-05-03T00:00:00Z,3,5,2020,0,0,Northern_Mariana_Islands,MP,MNP,56882,Oceania,2,14,32
2020-05-04T00:00:00Z,4,5,2020,0,0,Northern_Mariana_Islands,MP,MNP,56882,Oceania,2,14,33
2020-05-05T00:00:00Z,5,5,2020,0,0,Northern_Mariana_Islands,MP,MNP,56882,Oceania,2,14,34
2020-05-06T00:00:00Z,6,5,2020,0,0,Northern_Mariana_Islands,MP,MNP,56882,Oceania,2,14,35
2020-05-07T00:00:00Z,7,5,2020,1,0,Northern_Mariana_Islands,MP,MNP,56882,Oceania,2,15,36
2020-05-08T00:00:00Z,8,5,2020,0,0,Northern_Mariana_Islands,MP,MNP,56882,Oceania,2,15,37
2020-05-09T00:00:00Z,9,5,2020,0,0,Northern_Mariana_Islands,MP,MNP,56882,Oceania,2,15,38
2020-05-10T00:00:00Z,10,5,2020,1,0,Northern_Mariana_Islands,MP,MNP,56882,Oceania,2,16,39
2020-05-11T00:00:00Z,11,5,2020,0,0,Northern_Mariana_Islands,MP,MNP,56882,Oceania,2,16,40
2020-05-12T00:00:00Z,12,5,2020,3,0,Northern_Mariana_Islands,MP,MNP,56882,Oceania,2,19,41
2020-05-13T00:00:00Z,13,5,2020,0,0,Northern_Mariana_Islands,MP,MNP,56882,Oceania,2,19,42
2020-05-14T00:00:00Z,14,5,2020,0,0,Northern_Mariana_Islands,MP,MNP,56882,Oceania,2,19,43
2020-05-15T00:00:00Z,15,5,2020,0,0,Northern_Mariana_Islands,MP,MNP,56882,Oceania,2,19,44
2020-05-16T00:00:00Z,16,5,2020,0,0,Northern_Mariana_Islands,MP,MNP,56882,Oceania,2,19,45
2020-05-17T00:00:00Z,17,5,2020,2,0,Northern_Mariana_Islands,MP,MNP,56882,Oceania,2,21,46
2020-05-18T00:00:00Z,18,5,2020,0,0,Northern_Mariana_Islands,MP,MNP,56882,Oceania,2,21,47
2020-05-19T00:00:00Z,19,5,2020,0,0,Northern_Mariana_Islands,MP,MNP,56882,Oceania,2,21,48
2020-05-20T00:00:00Z,20,5,2020,0,0,Northern_Mariana_Islands,MP,MNP,56882,Oceania,2,21,49
2020-05-21T00:00:00Z,21,5,2020,1,0,Northern_Mariana_Islands,MP,MNP,56882,Oceania,2,22,50
2020-05-22T00:00:00Z,22,5,2020,0,0,Northern_Mariana_Islands,MP,MNP,56882,Oceania,2,22,51
2020-05-23T00:00:00Z,23,5,2020,0,0,Northern_Mariana_Islands,MP,MNP,56882,Oceania,2,22,52
2020-05-24T00:00:00Z,24,5,2020,0,0,Northern_Mariana_Islands,MP,MNP,56882,Oceania,2,22,53
2020-05-25T00:00:00Z,25,5,2020,0,0,Northern_Mariana_Islands,MP,MNP,56882,Oceania,2,22,54
2020-05-26T00:00:00Z,26,5,2020,0,0,Northern_Mariana_Islands,MP,MNP,56882,Oceania,2,22,55
2020-05-27T00:00:00Z,27,5,2020,0,0,Northern_Mariana_Islands,MP,MNP,56882,Oceania,2,22,56
2020-03-13T00:00:00Z,13,3,2020,132,1,Norway,NO,NOR,5314336,Europe,1,621,1
2020-03-14T00:00:00Z,14,3,2020,0,0,Norway,NO,NOR,5314336,Europe,1,621,2
2020-03-15T00:00:00Z,15,3,2020,286,0,Norway,NO,NOR,5314336,Europe,1,907,3
2020-03-16T00:00:00Z,16,3,2020,170,0,Norway,NO,NOR,5314336,Europe,1,1077,4
2020-03-17T00:00:00Z,17,3,2020,92,2,Norway,NO,NOR,5314336,Europe,3,1169,5
2020-03-18T00:00:00Z,18,3,2020,139,0,Norway,NO,NOR,5314336,Europe,3,1308,6
2020-03-19T00:00:00Z,19,3,2020,115,0,Norway,NO,NOR,5314336,Europe,3,1423,7
2020-03-20T00:00:00Z,20,3,2020,129,3,Norway,NO,NOR,5314336,Europe,6,1552,8
2020-03-21T00:00:00Z,21,3,2020,190,1,Norway,NO,NOR,5314336,Europe,7,1742,9
2020-03-22T00:00:00Z,22,3,2020,184,0,Norway,NO,NOR,5314336,Europe,7,1926,10
2020-03-23T00:00:00Z,23,3,2020,206,0,Norway,NO,NOR,5314336,Europe,7,2132,11
2020-03-24T00:00:00Z,24,3,2020,239,1,Norway,NO,NOR,5314336,Europe,8,2371,12
2020-03-25T00:00:00Z,25,3,2020,195,2,Norway,NO,NOR,5314336,Europe,10,2566,13
2020-03-26T00:00:00Z,26,3,2020,350,2,Norway,NO,NOR,5314336,Europe,12,2916,14
2020-03-27T00:00:00Z,27,3,2020,240,2,Norway,NO,NOR,5314336,Europe,14,3156,15
2020-03-28T00:00:00Z,28,3,2020,425,2,Norway,NO,NOR,5314336,Europe,16,3581,16
2020-03-29T00:00:00Z,29,3,2020,264,4,Norway,NO,NOR,5314336,Europe,20,3845,17
2020-03-30T00:00:00Z,30,3,2020,257,2,Norway,NO,NOR,5314336,Europe,22,4102,18
2020-03-31T00:00:00Z,31,3,2020,124,4,Norway,NO,NOR,5314336,Europe,26,4226,19
2020-04-01T00:00:00Z,1,4,2020,221,2,Norway,NO,NOR,5314336,Europe,28,4447,20
2020-04-02T00:00:00Z,2,4,2020,218,4,Norway,NO,NOR,5314336,Europe,32,4665,21
2020-04-03T00:00:00Z,3,4,2020,270,10,Norway,NO,NOR,5314336,Europe,42,4935,22
2020-04-04T00:00:00Z,4,4,2020,273,2,Norway,NO,NOR,5314336,Europe,44,5208,23
2020-04-05T00:00:00Z,5,4,2020,302,6,Norway,NO,NOR,5314336,Europe,50,5510,24
2020-04-06T00:00:00Z,6,4,2020,130,8,Norway,NO,NOR,5314336,Europe,58,5640,25
2020-04-07T00:00:00Z,7,4,2020,115,1,Norway,NO,NOR,5314336,Europe,59,5755,26
2020-04-08T00:00:00Z,8,4,2020,108,10,Norway,NO,NOR,5314336,Europe,69,5863,27
2020-04-09T00:00:00Z,9,4,2020,147,11,Norway,NO,NOR,5314336,Europe,80,6010,28
2020-04-10T00:00:00Z,10,4,2020,150,8,Norway,NO,NOR,5314336,Europe,88,6160,29
2020-04-11T00:00:00Z,11,4,2020,84,4,Norway,NO,NOR,5314336,Europe,92,6244,30
2020-04-12T00:00:00Z,12,4,2020,76,6,Norway,NO,NOR,5314336,Europe,98,6320,31
2020-04-13T00:00:00Z,13,4,2020,95,5,Norway,NO,NOR,5314336,Europe,103,6415,32
2020-04-14T00:00:00Z,14,4,2020,73,11,Norway,NO,NOR,5314336,Europe,114,6488,33
2020-04-15T00:00:00Z,15,4,2020,78,13,Norway,NO,NOR,5314336,Europe,127,6566,34
2020-04-16T00:00:00Z,16,4,2020,111,3,Norway,NO,NOR,5314336,Europe,130,6677,35
2020-04-17T00:00:00Z,17,4,2020,114,6,Norway,NO,NOR,5314336,Europe,136,6791,36
2020-04-18T00:00:00Z,18,4,2020,0,0,Norway,NO,NOR,5314336,Europe,136,6791,37
2020-04-19T00:00:00Z,19,4,2020,193,12,Norway,NO,NOR,5314336,Europe,148,6984,38
2020-04-20T00:00:00Z,20,4,2020,84,6,Norway,NO,NOR,5314336,Europe,154,7068,39
2020-04-21T00:00:00Z,21,4,2020,45,0,Norway,NO,NOR,5314336,Europe,154,7113,40
2020-04-22T00:00:00Z,22,4,2020,53,9,Norway,NO,NOR,5314336,Europe,163,7166,41
2020-04-23T00:00:00Z,23,4,2020,84,6,Norway,NO,NOR,5314336,Europe,169,7250,42
2020-04-24T00:00:00Z,24,4,2020,95,11,Norway,NO,NOR,5314336,Europe,180,7345,43
2020-04-25T00:00:00Z,25,4,2020,63,11,Norway,NO,NOR,5314336,Europe,191,7408,44
2020-04-26T00:00:00Z,26,4,2020,59,2,Norway,NO,NOR,5314336,Europe,193,7467,45
2020-04-27T00:00:00Z,27,4,2020,38,0,Norway,NO,NOR,5314336,Europe,193,7505,46
2020-04-28T00:00:00Z,28,4,2020,28,0,Norway,NO,NOR,5314336,Europe,193,7533,47
2020-04-29T00:00:00Z,29,4,2020,72,2,Norway,NO,NOR,5314336,Europe,195,7605,48
2020-04-30T00:00:00Z,30,4,2020,62,7,Norway,NO,NOR,5314336,Europe,202,7667,49
2020-05-01T00:00:00Z,1,5,2020,43,2,Norway,NO,NOR,5314336,Europe,204,7710,50
2020-05-02T00:00:00Z,2,5,2020,49,0,Norway,NO,NOR,5314336,Europe,204,7759,51
2020-05-03T00:00:00Z,3,5,2020,0,0,Norway,NO,NOR,5314336,Europe,204,7759,52
2020-05-04T00:00:00Z,4,5,2020,50,4,Norway,NO,NOR,5314336,Europe,208,7809,53
2020-05-05T00:00:00Z,5,5,2020,38,0,Norway,NO,NOR,5314336,Europe,208,7847,54
2020-05-06T00:00:00Z,6,5,2020,56,1,Norway,NO,NOR,5314336,Europe,209,7903,55
2020-05-07T00:00:00Z,7,5,2020,50,0,Norway,NO,NOR,5314336,Europe,209,7953,56
2020-05-08T00:00:00Z,8,5,2020,42,0,Norway,NO,NOR,5314336,Europe,209,7995,57
2020-05-09T00:00:00Z,9,5,2020,39,4,Norway,NO,NOR,5314336,Europe,213,8034,58
2020-05-10T00:00:00Z,10,5,2020,35,0,Norway,NO,NOR,5314336,Europe,213,8069,59
2020-05-11T00:00:00Z,11,5,2020,30,4,Norway,NO,NOR,5314336,Europe,217,8099,60
2020-05-12T00:00:00Z,12,5,2020,7,7,Norway,NO,NOR,5314336,Europe,224,8106,61
2020-05-13T00:00:00Z,13,5,2020,29,4,Norway,NO,NOR,5314336,Europe,228,8135,62
2020-05-14T00:00:00Z,14,5,2020,23,1,Norway,NO,NOR,5314336,Europe,229,8158,63
2020-05-15T00:00:00Z,15,5,2020,17,3,Norway,NO,NOR,5314336,Europe,232,8175,64
2020-05-16T00:00:00Z,16,5,2020,22,0,Norway,NO,NOR,5314336,Europe,232,8197,65
2020-05-17T00:00:00Z,17,5,2020,0,0,Norway,NO,NOR,5314336,Europe,232,8197,66
2020-05-18T00:00:00Z,18,5,2020,0,0,Norway,NO,NOR,5314336,Europe,232,8197,67
2020-05-19T00:00:00Z,19,5,2020,52,1,Norway,NO,NOR,5314336,Europe,233,8249,68
2020-05-20T00:00:00Z,20,5,2020,8,0,Norway,NO,NOR,5314336,Europe,233,8257,69
2020-05-21T00:00:00Z,21,5,2020,11,1,Norway,NO,NOR,5314336,Europe,234,8268,70
2020-05-22T00:00:00Z,22,5,2020,0,0,Norway,NO,NOR,5314336,Europe,234,8268,71
2020-05-23T00:00:00Z,23,5,2020,41,1,Norway,NO,NOR,5314336,Europe,235,8309,72
2020-05-24T00:00:00Z,24,5,2020,0,0,Norway,NO,NOR,5314336,Europe,235,8309,73
2020-05-25T00:00:00Z,25,5,2020,0,0,Norway,NO,NOR,5314336,Europe,235,8309,74
2020-05-26T00:00:00Z,26,5,2020,43,0,Norway,NO,NOR,5314336,Europe,235,8352,75
2020-05-27T00:00:00Z,27,5,2020,12,0,Norway,NO,NOR,5314336,Europe,235,8364,76
2020-04-01T00:00:00Z,1,4,2020,13,1,Oman,OM,OMN,4829483,Asia,1,192,1
2020-04-02T00:00:00Z,2,4,2020,18,0,Oman,OM,OMN,4829483,Asia,1,210,2
2020-04-03T00:00:00Z,3,4,2020,21,0,Oman,OM,OMN,4829483,Asia,1,231,3
2020-04-04T00:00:00Z,4,4,2020,0,0,Oman,OM,OMN,4829483,Asia,1,231,4
2020-04-05T00:00:00Z,5,4,2020,46,1,Oman,OM,OMN,4829483,Asia,2,277,5
2020-04-06T00:00:00Z,6,4,2020,21,0,Oman,OM,OMN,4829483,Asia,2,298,6
2020-04-07T00:00:00Z,7,4,2020,73,0,Oman,OM,OMN,4829483,Asia,2,371,7
2020-04-08T00:00:00Z,8,4,2020,48,0,Oman,OM,OMN,4829483,Asia,2,419,8
2020-04-09T00:00:00Z,9,4,2020,0,0,Oman,OM,OMN,4829483,Asia,2,419,9
2020-04-10T00:00:00Z,10,4,2020,38,1,Oman,OM,OMN,4829483,Asia,3,457,10
2020-04-11T00:00:00Z,11,4,2020,27,0,Oman,OM,OMN,4829483,Asia,3,484,11
2020-04-12T00:00:00Z,12,4,2020,62,0,Oman,OM,OMN,4829483,Asia,3,546,12
2020-04-13T00:00:00Z,13,4,2020,53,1,Oman,OM,OMN,4829483,Asia,4,599,13
2020-04-14T00:00:00Z,14,4,2020,214,0,Oman,OM,OMN,4829483,Asia,4,813,14
2020-04-15T00:00:00Z,15,4,2020,97,0,Oman,OM,OMN,4829483,Asia,4,910,15
2020-04-16T00:00:00Z,16,4,2020,0,0,Oman,OM,OMN,4829483,Asia,4,910,16
2020-04-17T00:00:00Z,17,4,2020,109,0,Oman,OM,OMN,4829483,Asia,4,1019,17
2020-04-18T00:00:00Z,18,4,2020,50,2,Oman,OM,OMN,4829483,Asia,6,1069,18
2020-04-19T00:00:00Z,19,4,2020,111,0,Oman,OM,OMN,4829483,Asia,6,1180,19
2020-04-20T00:00:00Z,20,4,2020,86,1,Oman,OM,OMN,4829483,Asia,7,1266,20
2020-04-21T00:00:00Z,21,4,2020,242,1,Oman,OM,OMN,4829483,Asia,8,1508,21
2020-04-22T00:00:00Z,22,4,2020,0,0,Oman,OM,OMN,4829483,Asia,8,1508,22
2020-04-23T00:00:00Z,23,4,2020,106,0,Oman,OM,OMN,4829483,Asia,8,1614,23
2020-04-24T00:00:00Z,24,4,2020,102,1,Oman,OM,OMN,4829483,Asia,9,1716,24
2020-04-25T00:00:00Z,25,4,2020,74,1,Oman,OM,OMN,4829483,Asia,10,1790,25
2020-04-26T00:00:00Z,26,4,2020,115,0,Oman,OM,OMN,4829483,Asia,10,1905,26
2020-04-27T00:00:00Z,27,4,2020,93,0,Oman,OM,OMN,4829483,Asia,10,1998,27
2020-04-28T00:00:00Z,28,4,2020,51,0,Oman,OM,OMN,4829483,Asia,10,2049,28
2020-04-29T00:00:00Z,29,4,2020,82,0,Oman,OM,OMN,4829483,Asia,10,2131,29
2020-04-30T00:00:00Z,30,4,2020,143,0,Oman,OM,OMN,4829483,Asia,10,2274,30
2020-05-01T00:00:00Z,1,5,2020,74,1,Oman,OM,OMN,4829483,Asia,11,2348,31
2020-05-02T00:00:00Z,2,5,2020,99,0,Oman,OM,OMN,4829483,Asia,11,2447,32
2020-05-03T00:00:00Z,3,5,2020,36,1,Oman,OM,OMN,4829483,Asia,12,2483,33
2020-05-04T00:00:00Z,4,5,2020,85,0,Oman,OM,OMN,4829483,Asia,12,2568,34
2020-05-05T00:00:00Z,5,5,2020,69,0,Oman,OM,OMN,4829483,Asia,12,2637,35
2020-05-06T00:00:00Z,6,5,2020,98,0,Oman,OM,OMN,4829483,Asia,12,2735,36
2020-05-07T00:00:00Z,7,5,2020,168,1,Oman,OM,OMN,4829483,Asia,13,2903,37
2020-05-08T00:00:00Z,8,5,2020,55,1,Oman,OM,OMN,4829483,Asia,14,2958,38
2020-05-09T00:00:00Z,9,5,2020,154,1,Oman,OM,OMN,4829483,Asia,15,3112,39
2020-05-10T00:00:00Z,10,5,2020,112,2,Oman,OM,OMN,4829483,Asia,17,3224,40
2020-05-11T00:00:00Z,11,5,2020,175,0,Oman,OM,OMN,4829483,Asia,17,3399,41
2020-05-12T00:00:00Z,12,5,2020,175,0,Oman,OM,OMN,4829483,Asia,17,3574,42
2020-05-13T00:00:00Z,13,5,2020,147,0,Oman,OM,OMN,4829483,Asia,17,3721,43
2020-05-14T00:00:00Z,14,5,2020,298,0,Oman,OM,OMN,4829483,Asia,17,4019,44
2020-05-15T00:00:00Z,15,5,2020,322,2,Oman,OM,OMN,4829483,Asia,19,4341,45
2020-05-16T00:00:00Z,16,5,2020,284,0,Oman,OM,OMN,4829483,Asia,19,4625,46
2020-05-17T00:00:00Z,17,5,2020,404,2,Oman,OM,OMN,4829483,Asia,21,5029,47
2020-05-18T00:00:00Z,18,5,2020,157,1,Oman,OM,OMN,4829483,Asia,22,5186,48
2020-05-19T00:00:00Z,19,5,2020,193,4,Oman,OM,OMN,4829483,Asia,26,5379,49
2020-05-20T00:00:00Z,20,5,2020,292,1,Oman,OM,OMN,4829483,Asia,27,5671,50
2020-05-21T00:00:00Z,21,5,2020,372,3,Oman,OM,OMN,4829483,Asia,30,6043,51
2020-05-22T00:00:00Z,22,5,2020,327,1,Oman,OM,OMN,4829483,Asia,31,6370,52
2020-05-23T00:00:00Z,23,5,2020,424,1,Oman,OM,OMN,4829483,Asia,32,6794,53
2020-05-24T00:00:00Z,24,5,2020,463,4,Oman,OM,OMN,4829483,Asia,36,7257,54
2020-05-25T00:00:00Z,25,5,2020,513,1,Oman,OM,OMN,4829483,Asia,37,7770,55
2020-05-26T00:00:00Z,26,5,2020,0,0,Oman,OM,OMN,4829483,Asia,37,7770,56
2020-05-27T00:00:00Z,27,5,2020,348,0,Oman,OM,OMN,4829483,Asia,37,8118,57
2020-03-20T00:00:00Z,20,3,2020,176,2,Pakistan,PK,PAK,212215030,Asia,2,478,1
2020-03-21T00:00:00Z,21,3,2020,17,1,Pakistan,PK,PAK,212215030,Asia,3,495,2
2020-03-22T00:00:00Z,22,3,2020,151,0,Pakistan,PK,PAK,212215030,Asia,3,646,3
2020-03-23T00:00:00Z,23,3,2020,138,2,Pakistan,PK,PAK,212215030,Asia,5,784,4
2020-03-24T00:00:00Z,24,3,2020,103,1,Pakistan,PK,PAK,212215030,Asia,6,887,5
2020-03-25T00:00:00Z,25,3,2020,104,1,Pakistan,PK,PAK,212215030,Asia,7,991,6
2020-03-26T00:00:00Z,26,3,2020,66,1,Pakistan,PK,PAK,212215030,Asia,8,1057,7
2020-03-27T00:00:00Z,27,3,2020,140,1,Pakistan,PK,PAK,212215030,Asia,9,1197,8
2020-03-28T00:00:00Z,28,3,2020,0,0,Pakistan,PK,PAK,212215030,Asia,9,1197,9
2020-03-29T00:00:00Z,29,3,2020,211,2,Pakistan,PK,PAK,212215030,Asia,11,1408,10
2020-03-30T00:00:00Z,30,3,2020,118,2,Pakistan,PK,PAK,212215030,Asia,13,1526,11
2020-03-31T00:00:00Z,31,3,2020,99,5,Pakistan,PK,PAK,212215030,Asia,18,1625,12
2020-04-01T00:00:00Z,1,4,2020,414,8,Pakistan,PK,PAK,212215030,Asia,26,2039,13
2020-04-02T00:00:00Z,2,4,2020,252,5,Pakistan,PK,PAK,212215030,Asia,31,2291,14
2020-04-03T00:00:00Z,3,4,2020,0,0,Pakistan,PK,PAK,212215030,Asia,31,2291,15
2020-04-04T00:00:00Z,4,4,2020,0,0,Pakistan,PK,PAK,212215030,Asia,31,2291,16
2020-04-05T00:00:00Z,5,4,2020,159,4,Pakistan,PK,PAK,212215030,Asia,35,2450,17
2020-04-06T00:00:00Z,6,4,2020,827,15,Pakistan,PK,PAK,212215030,Asia,50,3277,18
2020-04-07T00:00:00Z,7,4,2020,587,4,Pakistan,PK,PAK,212215030,Asia,54,3864,19
2020-04-08T00:00:00Z,8,4,2020,208,4,Pakistan,PK,PAK,212215030,Asia,58,4072,20
2020-04-09T00:00:00Z,9,4,2020,250,5,Pakistan,PK,PAK,212215030,Asia,63,4322,21
2020-04-10T00:00:00Z,10,4,2020,279,3,Pakistan,PK,PAK,212215030,Asia,66,4601,22
2020-04-11T00:00:00Z,11,4,2020,187,5,Pakistan,PK,PAK,212215030,Asia,71,4788,23
2020-04-12T00:00:00Z,12,4,2020,250,15,Pakistan,PK,PAK,212215030,Asia,86,5038,24
2020-04-13T00:00:00Z,13,4,2020,336,7,Pakistan,PK,PAK,212215030,Asia,93,5374,25
2020-04-14T00:00:00Z,14,4,2020,342,3,Pakistan,PK,PAK,212215030,Asia,96,5716,26
2020-04-15T00:00:00Z,15,4,2020,272,11,Pakistan,PK,PAK,212215030,Asia,107,5988,27
2020-04-16T00:00:00Z,16,4,2020,517,17,Pakistan,PK,PAK,212215030,Asia,124,6505,28
2020-04-17T00:00:00Z,17,4,2020,520,11,Pakistan,PK,PAK,212215030,Asia,135,7025,29
2020-04-18T00:00:00Z,18,4,2020,456,8,Pakistan,PK,PAK,212215030,Asia,143,7481,30
2020-04-19T00:00:00Z,19,4,2020,512,16,Pakistan,PK,PAK,212215030,Asia,159,7993,31
2020-04-20T00:00:00Z,20,4,2020,425,17,Pakistan,PK,PAK,212215030,Asia,176,8418,32
2020-04-21T00:00:00Z,21,4,2020,798,16,Pakistan,PK,PAK,212215030,Asia,192,9216,33
2020-04-22T00:00:00Z,22,4,2020,533,17,Pakistan,PK,PAK,212215030,Asia,209,9749,34
2020-04-23T00:00:00Z,23,4,2020,0,0,Pakistan,PK,PAK,212215030,Asia,209,9749,35
2020-04-24T00:00:00Z,24,4,2020,1406,28,Pakistan,PK,PAK,212215030,Asia,237,11155,36
2020-04-25T00:00:00Z,25,4,2020,785,16,Pakistan,PK,PAK,212215030,Asia,253,11940,37
2020-04-26T00:00:00Z,26,4,2020,783,16,Pakistan,PK,PAK,212215030,Asia,269,12723,38
2020-04-27T00:00:00Z,27,4,2020,605,12,Pakistan,PK,PAK,212215030,Asia,281,13328,39
2020-04-28T00:00:00Z,28,4,2020,751,20,Pakistan,PK,PAK,212215030,Asia,301,14079,40
2020-04-29T00:00:00Z,29,4,2020,806,26,Pakistan,PK,PAK,212215030,Asia,327,14885,41
2020-04-30T00:00:00Z,30,4,2020,874,19,Pakistan,PK,PAK,212215030,Asia,346,15759,42
2020-05-01T00:00:00Z,1,5,2020,1058,39,Pakistan,PK,PAK,212215030,Asia,385,16817,43
2020-05-02T00:00:00Z,2,5,2020,1297,32,Pakistan,PK,PAK,212215030,Asia,417,18114,44
2020-05-03T00:00:00Z,3,5,2020,989,23,Pakistan,PK,PAK,212215030,Asia,440,19103,45
2020-05-04T00:00:00Z,4,5,2020,1083,22,Pakistan,PK,PAK,212215030,Asia,462,20186,46
2020-05-05T00:00:00Z,5,5,2020,1315,24,Pakistan,PK,PAK,212215030,Asia,486,21501,47
2020-05-06T00:00:00Z,6,5,2020,1049,40,Pakistan,PK,PAK,212215030,Asia,526,22550,48
2020-05-07T00:00:00Z,7,5,2020,1523,38,Pakistan,PK,PAK,212215030,Asia,564,24073,49
2020-05-08T00:00:00Z,8,5,2020,1764,30,Pakistan,PK,PAK,212215030,Asia,594,25837,50
2020-05-09T00:00:00Z,9,5,2020,1637,24,Pakistan,PK,PAK,212215030,Asia,618,27474,51
2020-05-10T00:00:00Z,10,5,2020,1991,21,Pakistan,PK,PAK,212215030,Asia,639,29465,52
2020-05-11T00:00:00Z,11,5,2020,1476,28,Pakistan,PK,PAK,212215030,Asia,667,30941,53
2020-05-12T00:00:00Z,12,5,2020,1140,39,Pakistan,PK,PAK,212215030,Asia,706,32081,54
2020-05-13T00:00:00Z,13,5,2020,2255,31,Pakistan,PK,PAK,212215030,Asia,737,34336,55
2020-05-14T00:00:00Z,14,5,2020,1452,33,Pakistan,PK,PAK,212215030,Asia,770,35788,56
2020-05-15T00:00:00Z,15,5,2020,1430,33,Pakistan,PK,PAK,212215030,Asia,803,37218,57
2020-05-16T00:00:00Z,16,5,2020,1581,31,Pakistan,PK,PAK,212215030,Asia,834,38799,58
2020-05-17T00:00:00Z,17,5,2020,1352,39,Pakistan,PK,PAK,212215030,Asia,873,40151,59
2020-05-18T00:00:00Z,18,5,2020,1974,30,Pakistan,PK,PAK,212215030,Asia,903,42125,60
2020-05-19T00:00:00Z,19,5,2020,1841,36,Pakistan,PK,PAK,212215030,Asia,939,43966,61
2020-05-20T00:00:00Z,20,5,2020,1932,46,Pakistan,PK,PAK,212215030,Asia,985,45898,62
2020-05-21T00:00:00Z,21,5,2020,2193,32,Pakistan,PK,PAK,212215030,Asia,1017,48091,63
2020-05-22T00:00:00Z,22,5,2020,2603,50,Pakistan,PK,PAK,212215030,Asia,1067,50694,64
2020-05-23T00:00:00Z,23,5,2020,1743,34,Pakistan,PK,PAK,212215030,Asia,1101,52437,65
2020-05-24T00:00:00Z,24,5,2020,2164,32,Pakistan,PK,PAK,212215030,Asia,1133,54601,66
2020-05-25T00:00:00Z,25,5,2020,1748,34,Pakistan,PK,PAK,212215030,Asia,1167,56349,67
2020-05-26T00:00:00Z,26,5,2020,1356,30,Pakistan,PK,PAK,212215030,Asia,1197,57705,68
2020-05-27T00:00:00Z,27,5,2020,1446,28,Pakistan,PK,PAK,212215030,Asia,1225,59151,69
2020-03-27T00:00:00Z,27,3,2020,22,1,Palestine,PS,PSE,4569087,Asia,1,84,1
2020-03-28T00:00:00Z,28,3,2020,7,0,Palestine,PS,PSE,4569087,Asia,1,91,2
2020-03-29T00:00:00Z,29,3,2020,6,0,Palestine,PS,PSE,4569087,Asia,1,97,3
2020-03-30T00:00:00Z,30,3,2020,9,0,Palestine,PS,PSE,4569087,Asia,1,106,4
2020-03-31T00:00:00Z,31,3,2020,9,0,Palestine,PS,PSE,4569087,Asia,1,115,5
2020-04-01T00:00:00Z,1,4,2020,2,0,Palestine,PS,PSE,4569087,Asia,1,117,6
2020-04-02T00:00:00Z,2,4,2020,17,0,Palestine,PS,PSE,4569087,Asia,1,134,7
2020-04-03T00:00:00Z,3,4,2020,21,0,Palestine,PS,PSE,4569087,Asia,1,155,8
2020-04-04T00:00:00Z,4,4,2020,0,0,Palestine,PS,PSE,4569087,Asia,1,155,9
2020-04-06T00:00:00Z,6,4,2020,62,0,Palestine,PS,PSE,4569087,Asia,1,217,10
2020-04-07T00:00:00Z,7,4,2020,36,0,Palestine,PS,PSE,4569087,Asia,1,253,11
2020-04-08T00:00:00Z,8,4,2020,7,0,Palestine,PS,PSE,4569087,Asia,1,260,12
2020-04-09T00:00:00Z,9,4,2020,3,0,Palestine,PS,PSE,4569087,Asia,1,263,13
2020-04-10T00:00:00Z,10,4,2020,0,0,Palestine,PS,PSE,4569087,Asia,1,263,14
2020-04-11T00:00:00Z,11,4,2020,3,1,Palestine,PS,PSE,4569087,Asia,2,266,15
2020-04-12T00:00:00Z,12,4,2020,2,0,Palestine,PS,PSE,4569087,Asia,2,268,16
2020-04-13T00:00:00Z,13,4,2020,0,0,Palestine,PS,PSE,4569087,Asia,2,268,17
2020-04-14T00:00:00Z,14,4,2020,0,0,Palestine,PS,PSE,4569087,Asia,2,268,18
2020-04-15T00:00:00Z,15,4,2020,19,0,Palestine,PS,PSE,4569087,Asia,2,287,19
2020-04-16T00:00:00Z,16,4,2020,4,0,Palestine,PS,PSE,4569087,Asia,2,291,20
2020-04-17T00:00:00Z,17,4,2020,3,0,Palestine,PS,PSE,4569087,Asia,2,294,21
2020-04-18T00:00:00Z,18,4,2020,13,0,Palestine,PS,PSE,4569087,Asia,2,307,22
2020-04-19T00:00:00Z,19,4,2020,6,0,Palestine,PS,PSE,4569087,Asia,2,313,23
2020-04-20T00:00:00Z,20,4,2020,9,0,Palestine,PS,PSE,4569087,Asia,2,322,24
2020-04-21T00:00:00Z,21,4,2020,7,0,Palestine,PS,PSE,4569087,Asia,2,329,25
2020-04-22T00:00:00Z,22,4,2020,0,0,Palestine,PS,PSE,4569087,Asia,2,329,26
2020-04-23T00:00:00Z,23,4,2020,6,0,Palestine,PS,PSE,4569087,Asia,2,335,27
2020-04-24T00:00:00Z,24,4,2020,1,0,Palestine,PS,PSE,4569087,Asia,2,336,28
2020-04-25T00:00:00Z,25,4,2020,4,0,Palestine,PS,PSE,4569087,Asia,2,340,29
2020-04-26T00:00:00Z,26,4,2020,2,0,Palestine,PS,PSE,4569087,Asia,2,342,30
2020-04-27T00:00:00Z,27,4,2020,153,0,Palestine,PS,PSE,4569087,Asia,2,495,31
2020-04-28T00:00:00Z,28,4,2020,0,0,Palestine,PS,PSE,4569087,Asia,2,495,32
2020-04-29T00:00:00Z,29,4,2020,0,0,Palestine,PS,PSE,4569087,Asia,2,495,33
2020-04-30T00:00:00Z,30,4,2020,12,0,Palestine,PS,PSE,4569087,Asia,2,507,34
2020-05-01T00:00:00Z,1,5,2020,0,2,Palestine,PS,PSE,4569087,Asia,4,507,35
2020-05-02T00:00:00Z,2,5,2020,10,0,Palestine,PS,PSE,4569087,Asia,4,517,36
2020-05-03T00:00:00Z,3,5,2020,0,0,Palestine,PS,PSE,4569087,Asia,4,517,37
2020-05-04T00:00:00Z,4,5,2020,5,0,Palestine,PS,PSE,4569087,Asia,4,522,38
2020-05-05T00:00:00Z,5,5,2020,2,0,Palestine,PS,PSE,4569087,Asia,4,524,39
2020-05-06T00:00:00Z,6,5,2020,14,0,Palestine,PS,PSE,4569087,Asia,4,538,40
2020-05-07T00:00:00Z,7,5,2020,8,0,Palestine,PS,PSE,4569087,Asia,4,546,41
2020-05-08T00:00:00Z,8,5,2020,1,0,Palestine,PS,PSE,4569087,Asia,4,547,42
2020-05-09T00:00:00Z,9,5,2020,0,0,Palestine,PS,PSE,4569087,Asia,4,547,43
2020-05-10T00:00:00Z,10,5,2020,0,0,Palestine,PS,PSE,4569087,Asia,4,547,44
2020-05-11T00:00:00Z,11,5,2020,0,0,Palestine,PS,PSE,4569087,Asia,4,547,45
2020-05-12T00:00:00Z,12,5,2020,0,0,Palestine,PS,PSE,4569087,Asia,4,547,46
2020-05-13T00:00:00Z,13,5,2020,0,0,Palestine,PS,PSE,4569087,Asia,4,547,47
2020-05-14T00:00:00Z,14,5,2020,1,0,Palestine,PS,PSE,4569087,Asia,4,548,48
2020-05-15T00:00:00Z,15,5,2020,0,0,Palestine,PS,PSE,4569087,Asia,4,548,49
2020-05-16T00:00:00Z,16,5,2020,6,0,Palestine,PS,PSE,4569087,Asia,4,554,50
2020-05-17T00:00:00Z,17,5,2020,0,0,Palestine,PS,PSE,4569087,Asia,4,554,51
2020-05-18T00:00:00Z,18,5,2020,6,0,Palestine,PS,PSE,4569087,Asia,4,560,52
2020-05-19T00:00:00Z,19,5,2020,7,0,Palestine,PS,PSE,4569087,Asia,4,567,53
2020-05-20T00:00:00Z,20,5,2020,3,0,Palestine,PS,PSE,4569087,Asia,4,570,54
2020-05-21T00:00:00Z,21,5,2020,7,0,Palestine,PS,PSE,4569087,Asia,4,577,55
2020-05-22T00:00:00Z,22,5,2020,25,0,Palestine,PS,PSE,4569087,Asia,4,602,56
2020-05-23T00:00:00Z,23,5,2020,0,0,Palestine,PS,PSE,4569087,Asia,4,602,57
2020-05-24T00:00:00Z,24,5,2020,0,1,Palestine,PS,PSE,4569087,Asia,5,602,58
2020-05-25T00:00:00Z,25,5,2020,0,0,Palestine,PS,PSE,4569087,Asia,5,602,59
2020-05-26T00:00:00Z,26,5,2020,0,0,Palestine,PS,PSE,4569087,Asia,5,602,60
2020-05-27T00:00:00Z,27,5,2020,3,0,Palestine,PS,PSE,4569087,Asia,5,605,61
2020-03-11T00:00:00Z,11,3,2020,6,1,Panama,PA,PAN,4176873,America,1,7,1
2020-03-12T00:00:00Z,12,3,2020,7,0,Panama,PA,PAN,4176873,America,1,14,2
2020-03-13T00:00:00Z,13,3,2020,13,0,Panama,PA,PAN,4176873,America,1,27,3
2020-03-14T00:00:00Z,14,3,2020,9,0,Panama,PA,PAN,4176873,America,1,36,4
2020-03-15T00:00:00Z,15,3,2020,7,0,Panama,PA,PAN,4176873,America,1,43,5
2020-03-16T00:00:00Z,16,3,2020,0,0,Panama,PA,PAN,4176873,America,1,43,6
2020-03-17T00:00:00Z,17,3,2020,26,0,Panama,PA,PAN,4176873,America,1,69,7
2020-03-18T00:00:00Z,18,3,2020,17,0,Panama,PA,PAN,4176873,America,1,86,8
2020-03-19T00:00:00Z,19,3,2020,23,0,Panama,PA,PAN,4176873,America,1,109,9
2020-03-20T00:00:00Z,20,3,2020,28,0,Panama,PA,PAN,4176873,America,1,137,10
2020-03-21T00:00:00Z,21,3,2020,63,0,Panama,PA,PAN,4176873,America,1,200,11
2020-03-22T00:00:00Z,22,3,2020,45,2,Panama,PA,PAN,4176873,America,3,245,12
2020-03-23T00:00:00Z,23,3,2020,68,0,Panama,PA,PAN,4176873,America,3,313,13
2020-03-24T00:00:00Z,24,3,2020,32,3,Panama,PA,PAN,4176873,America,6,345,14
2020-03-25T00:00:00Z,25,3,2020,98,0,Panama,PA,PAN,4176873,America,6,443,15
2020-03-26T00:00:00Z,26,3,2020,145,0,Panama,PA,PAN,4176873,America,6,588,16
2020-03-27T00:00:00Z,27,3,2020,86,3,Panama,PA,PAN,4176873,America,9,674,17
2020-03-28T00:00:00Z,28,3,2020,112,5,Panama,PA,PAN,4176873,America,14,786,18
2020-03-29T00:00:00Z,29,3,2020,115,3,Panama,PA,PAN,4176873,America,17,901,19
2020-03-30T00:00:00Z,30,3,2020,88,7,Panama,PA,PAN,4176873,America,24,989,20
2020-03-31T00:00:00Z,31,3,2020,86,2,Panama,PA,PAN,4176873,America,26,1075,21
2020-04-01T00:00:00Z,1,4,2020,106,4,Panama,PA,PAN,4176873,America,30,1181,22
2020-04-02T00:00:00Z,2,4,2020,136,2,Panama,PA,PAN,4176873,America,32,1317,23
2020-04-03T00:00:00Z,3,4,2020,158,5,Panama,PA,PAN,4176873,America,37,1475,24
2020-04-04T00:00:00Z,4,4,2020,198,4,Panama,PA,PAN,4176873,America,41,1673,25
2020-04-05T00:00:00Z,5,4,2020,128,5,Panama,PA,PAN,4176873,America,46,1801,26
2020-04-06T00:00:00Z,6,4,2020,187,8,Panama,PA,PAN,4176873,America,54,1988,27
2020-04-07T00:00:00Z,7,4,2020,112,1,Panama,PA,PAN,4176873,America,55,2100,28
2020-04-08T00:00:00Z,8,4,2020,149,4,Panama,PA,PAN,4176873,America,59,2249,29
2020-04-09T00:00:00Z,9,4,2020,279,4,Panama,PA,PAN,4176873,America,63,2528,30
2020-04-10T00:00:00Z,10,4,2020,224,3,Panama,PA,PAN,4176873,America,66,2752,31
2020-04-11T00:00:00Z,11,4,2020,222,8,Panama,PA,PAN,4176873,America,74,2974,32
2020-04-12T00:00:00Z,12,4,2020,260,5,Panama,PA,PAN,4176873,America,79,3234,33
2020-04-13T00:00:00Z,13,4,2020,166,8,Panama,PA,PAN,4176873,America,87,3400,34
2020-04-14T00:00:00Z,14,4,2020,72,7,Panama,PA,PAN,4176873,America,94,3472,35
2020-04-15T00:00:00Z,15,4,2020,102,1,Panama,PA,PAN,4176873,America,95,3574,36
2020-04-16T00:00:00Z,16,4,2020,177,8,Panama,PA,PAN,4176873,America,103,3751,37
2020-04-17T00:00:00Z,17,4,2020,265,6,Panama,PA,PAN,4176873,America,109,4016,38
2020-04-18T00:00:00Z,18,4,2020,194,7,Panama,PA,PAN,4176873,America,116,4210,39
2020-04-19T00:00:00Z,19,4,2020,63,4,Panama,PA,PAN,4176873,America,120,4273,40
2020-04-20T00:00:00Z,20,4,2020,194,6,Panama,PA,PAN,4176873,America,126,4467,41
2020-04-21T00:00:00Z,21,4,2020,191,10,Panama,PA,PAN,4176873,America,136,4658,42
2020-04-22T00:00:00Z,22,4,2020,163,5,Panama,PA,PAN,4176873,America,141,4821,43
2020-04-23T00:00:00Z,23,4,2020,171,3,Panama,PA,PAN,4176873,America,144,4992,44
2020-04-24T00:00:00Z,24,4,2020,174,2,Panama,PA,PAN,4176873,America,146,5166,45
2020-04-25T00:00:00Z,25,4,2020,172,8,Panama,PA,PAN,4176873,America,154,5338,46
2020-04-26T00:00:00Z,26,4,2020,200,5,Panama,PA,PAN,4176873,America,159,5538,47
2020-04-27T00:00:00Z,27,4,2020,241,6,Panama,PA,PAN,4176873,America,165,5779,48
2020-04-28T00:00:00Z,28,4,2020,242,2,Panama,PA,PAN,4176873,America,167,6021,49
2020-04-29T00:00:00Z,29,4,2020,179,9,Panama,PA,PAN,4176873,America,176,6200,50
2020-04-30T00:00:00Z,30,4,2020,178,2,Panama,PA,PAN,4176873,America,178,6378,51
2020-05-01T00:00:00Z,1,5,2020,154,10,Panama,PA,PAN,4176873,America,188,6532,52
2020-05-02T00:00:00Z,2,5,2020,188,4,Panama,PA,PAN,4176873,America,192,6720,53
2020-05-03T00:00:00Z,3,5,2020,370,5,Panama,PA,PAN,4176873,America,197,7090,54
2020-05-04T00:00:00Z,4,5,2020,107,3,Panama,PA,PAN,4176873,America,200,7197,55
2020-05-05T00:00:00Z,5,5,2020,190,3,Panama,PA,PAN,4176873,America,203,7387,56
2020-05-06T00:00:00Z,6,5,2020,136,7,Panama,PA,PAN,4176873,America,210,7523,57
2020-05-07T00:00:00Z,7,5,2020,208,8,Panama,PA,PAN,4176873,America,218,7731,58
2020-05-08T00:00:00Z,8,5,2020,137,7,Panama,PA,PAN,4176873,America,225,7868,59
2020-05-09T00:00:00Z,9,5,2020,202,6,Panama,PA,PAN,4176873,America,231,8070,60
2020-05-10T00:00:00Z,10,5,2020,212,6,Panama,PA,PAN,4176873,America,237,8282,61
2020-05-11T00:00:00Z,11,5,2020,166,7,Panama,PA,PAN,4176873,America,244,8448,62
2020-05-12T00:00:00Z,12,5,2020,168,5,Panama,PA,PAN,4176873,America,249,8616,63
2020-05-13T00:00:00Z,13,5,2020,167,3,Panama,PA,PAN,4176873,America,252,8783,64
2020-05-14T00:00:00Z,14,5,2020,161,4,Panama,PA,PAN,4176873,America,256,8944,65
2020-05-15T00:00:00Z,15,5,2020,174,4,Panama,PA,PAN,4176873,America,260,9118,66
2020-05-16T00:00:00Z,16,5,2020,150,6,Panama,PA,PAN,4176873,America,266,9268,67
2020-05-17T00:00:00Z,17,5,2020,181,3,Panama,PA,PAN,4176873,America,269,9449,68
2020-05-18T00:00:00Z,18,5,2020,157,6,Panama,PA,PAN,4176873,America,275,9606,69
2020-05-19T00:00:00Z,19,5,2020,120,4,Panama,PA,PAN,4176873,America,279,9726,70
2020-05-20T00:00:00Z,20,5,2020,141,2,Panama,PA,PAN,4176873,America,281,9867,71
2020-05-21T00:00:00Z,21,5,2020,110,6,Panama,PA,PAN,4176873,America,287,9977,72
2020-05-22T00:00:00Z,22,5,2020,139,4,Panama,PA,PAN,4176873,America,291,10116,73
2020-05-23T00:00:00Z,23,5,2020,151,4,Panama,PA,PAN,4176873,America,295,10267,74
2020-05-24T00:00:00Z,24,5,2020,310,4,Panama,PA,PAN,4176873,America,299,10577,75
2020-05-25T00:00:00Z,25,5,2020,349,7,Panama,PA,PAN,4176873,America,306,10926,76
2020-05-26T00:00:00Z,26,5,2020,257,4,Panama,PA,PAN,4176873,America,310,11183,77
2020-05-27T00:00:00Z,27,5,2020,264,3,Panama,PA,PAN,4176873,America,313,11447,78
2020-03-21T00:00:00Z,21,3,2020,5,1,Paraguay,PY,PRY,6956071,America,1,18,1
2020-03-22T00:00:00Z,22,3,2020,4,0,Paraguay,PY,PRY,6956071,America,1,22,2
2020-03-23T00:00:00Z,23,3,2020,0,0,Paraguay,PY,PRY,6956071,America,1,22,3
2020-03-24T00:00:00Z,24,3,2020,5,0,Paraguay,PY,PRY,6956071,America,1,27,4
2020-03-25T00:00:00Z,25,3,2020,10,2,Paraguay,PY,PRY,6956071,America,3,37,5
2020-03-26T00:00:00Z,26,3,2020,4,0,Paraguay,PY,PRY,6956071,America,3,41,6
2020-03-27T00:00:00Z,27,3,2020,11,0,Paraguay,PY,PRY,6956071,America,3,52,7
2020-03-28T00:00:00Z,28,3,2020,4,0,Paraguay,PY,PRY,6956071,America,3,56,8
2020-03-29T00:00:00Z,29,3,2020,3,0,Paraguay,PY,PRY,6956071,America,3,59,9
2020-03-30T00:00:00Z,30,3,2020,5,0,Paraguay,PY,PRY,6956071,America,3,64,10
2020-03-31T00:00:00Z,31,3,2020,1,0,Paraguay,PY,PRY,6956071,America,3,65,11
2020-04-01T00:00:00Z,1,4,2020,4,0,Paraguay,PY,PRY,6956071,America,3,69,12
2020-04-02T00:00:00Z,2,4,2020,0,0,Paraguay,PY,PRY,6956071,America,3,69,13
2020-04-03T00:00:00Z,3,4,2020,8,0,Paraguay,PY,PRY,6956071,America,3,77,14
2020-04-04T00:00:00Z,4,4,2020,19,0,Paraguay,PY,PRY,6956071,America,3,96,15
2020-04-05T00:00:00Z,5,4,2020,8,0,Paraguay,PY,PRY,6956071,America,3,104,16
2020-04-06T00:00:00Z,6,4,2020,9,2,Paraguay,PY,PRY,6956071,America,5,113,17
2020-04-07T00:00:00Z,7,4,2020,0,0,Paraguay,PY,PRY,6956071,America,5,113,18
2020-04-08T00:00:00Z,8,4,2020,2,0,Paraguay,PY,PRY,6956071,America,5,115,19
2020-04-09T00:00:00Z,9,4,2020,9,0,Paraguay,PY,PRY,6956071,America,5,124,20
2020-04-10T00:00:00Z,10,4,2020,5,1,Paraguay,PY,PRY,6956071,America,6,129,21
2020-04-11T00:00:00Z,11,4,2020,4,0,Paraguay,PY,PRY,6956071,America,6,133,22
2020-04-12T00:00:00Z,12,4,2020,1,0,Paraguay,PY,PRY,6956071,America,6,134,23
2020-04-13T00:00:00Z,13,4,2020,13,0,Paraguay,PY,PRY,6956071,America,6,147,24
2020-04-14T00:00:00Z,14,4,2020,12,1,Paraguay,PY,PRY,6956071,America,7,159,25
2020-04-15T00:00:00Z,15,4,2020,2,1,Paraguay,PY,PRY,6956071,America,8,161,26
2020-04-16T00:00:00Z,16,4,2020,13,0,Paraguay,PY,PRY,6956071,America,8,174,27
2020-04-17T00:00:00Z,17,4,2020,0,0,Paraguay,PY,PRY,6956071,America,8,174,28
2020-04-18T00:00:00Z,18,4,2020,28,0,Paraguay,PY,PRY,6956071,America,8,202,29
2020-04-19T00:00:00Z,19,4,2020,0,0,Paraguay,PY,PRY,6956071,America,8,202,30
2020-04-20T00:00:00Z,20,4,2020,4,0,Paraguay,PY,PRY,6956071,America,8,206,31
2020-04-21T00:00:00Z,21,4,2020,2,0,Paraguay,PY,PRY,6956071,America,8,208,32
2020-04-22T00:00:00Z,22,4,2020,5,1,Paraguay,PY,PRY,6956071,America,9,213,33
2020-04-23T00:00:00Z,23,4,2020,0,0,Paraguay,PY,PRY,6956071,America,9,213,34
2020-04-24T00:00:00Z,24,4,2020,7,0,Paraguay,PY,PRY,6956071,America,9,220,35
2020-04-25T00:00:00Z,25,4,2020,3,0,Paraguay,PY,PRY,6956071,America,9,223,36
2020-04-26T00:00:00Z,26,4,2020,5,0,Paraguay,PY,PRY,6956071,America,9,228,37
2020-04-27T00:00:00Z,27,4,2020,0,0,Paraguay,PY,PRY,6956071,America,9,228,38
2020-04-28T00:00:00Z,28,4,2020,2,0,Paraguay,PY,PRY,6956071,America,9,230,39
2020-04-29T00:00:00Z,29,4,2020,9,0,Paraguay,PY,PRY,6956071,America,9,239,40
2020-04-30T00:00:00Z,30,4,2020,10,0,Paraguay,PY,PRY,6956071,America,9,249,41
2020-05-01T00:00:00Z,1,5,2020,17,1,Paraguay,PY,PRY,6956071,America,10,266,42
2020-05-02T00:00:00Z,2,5,2020,67,0,Paraguay,PY,PRY,6956071,America,10,333,43
2020-05-03T00:00:00Z,3,5,2020,37,0,Paraguay,PY,PRY,6956071,America,10,370,44
2020-05-04T00:00:00Z,4,5,2020,26,0,Paraguay,PY,PRY,6956071,America,10,396,45
2020-05-05T00:00:00Z,5,5,2020,19,0,Paraguay,PY,PRY,6956071,America,10,415,46
2020-05-06T00:00:00Z,6,5,2020,16,0,Paraguay,PY,PRY,6956071,America,10,431,47
2020-05-07T00:00:00Z,7,5,2020,9,0,Paraguay,PY,PRY,6956071,America,10,440,48
2020-05-08T00:00:00Z,8,5,2020,22,0,Paraguay,PY,PRY,6956071,America,10,462,49
2020-05-09T00:00:00Z,9,5,2020,101,0,Paraguay,PY,PRY,6956071,America,10,563,50
2020-05-10T00:00:00Z,10,5,2020,126,0,Paraguay,PY,PRY,6956071,America,10,689,51
2020-05-11T00:00:00Z,11,5,2020,24,0,Paraguay,PY,PRY,6956071,America,10,713,52
2020-05-12T00:00:00Z,12,5,2020,11,0,Paraguay,PY,PRY,6956071,America,10,724,53
2020-05-13T00:00:00Z,13,5,2020,13,0,Paraguay,PY,PRY,6956071,America,10,737,54
2020-05-14T00:00:00Z,14,5,2020,3,1,Paraguay,PY,PRY,6956071,America,11,740,55
2020-05-15T00:00:00Z,15,5,2020,14,0,Paraguay,PY,PRY,6956071,America,11,754,56
2020-05-16T00:00:00Z,16,5,2020,5,0,Paraguay,PY,PRY,6956071,America,11,759,57
2020-05-17T00:00:00Z,17,5,2020,19,0,Paraguay,PY,PRY,6956071,America,11,778,58
2020-05-18T00:00:00Z,18,5,2020,8,0,Paraguay,PY,PRY,6956071,America,11,786,59
2020-05-19T00:00:00Z,19,5,2020,2,0,Paraguay,PY,PRY,6956071,America,11,788,60
2020-05-20T00:00:00Z,20,5,2020,41,0,Paraguay,PY,PRY,6956071,America,11,829,61
2020-05-21T00:00:00Z,21,5,2020,4,0,Paraguay,PY,PRY,6956071,America,11,833,62
2020-05-22T00:00:00Z,22,5,2020,3,0,Paraguay,PY,PRY,6956071,America,11,836,63
2020-05-23T00:00:00Z,23,5,2020,2,0,Paraguay,PY,PRY,6956071,America,11,838,64
2020-05-24T00:00:00Z,24,5,2020,12,0,Paraguay,PY,PRY,6956071,America,11,850,65
2020-05-25T00:00:00Z,25,5,2020,12,0,Paraguay,PY,PRY,6956071,America,11,862,66
2020-05-26T00:00:00Z,26,5,2020,3,0,Paraguay,PY,PRY,6956071,America,11,865,67
2020-05-27T00:00:00Z,27,5,2020,12,0,Paraguay,PY,PRY,6956071,America,11,877,68
2020-03-20T00:00:00Z,20,3,2020,89,2,Peru,PE,PER,31989256,America,2,234,1
2020-03-21T00:00:00Z,21,3,2020,29,1,Peru,PE,PER,31989256,America,3,263,2
2020-03-22T00:00:00Z,22,3,2020,55,2,Peru,PE,PER,31989256,America,5,318,3
2020-03-23T00:00:00Z,23,3,2020,45,0,Peru,PE,PER,31989256,America,5,363,4
2020-03-24T00:00:00Z,24,3,2020,32,0,Peru,PE,PER,31989256,America,5,395,5
2020-03-25T00:00:00Z,25,3,2020,21,2,Peru,PE,PER,31989256,America,7,416,6
2020-03-26T00:00:00Z,26,3,2020,142,1,Peru,PE,PER,31989256,America,8,558,7
2020-03-27T00:00:00Z,27,3,2020,22,1,Peru,PE,PER,31989256,America,9,580,8
2020-03-28T00:00:00Z,28,3,2020,55,2,Peru,PE,PER,31989256,America,11,635,9
2020-03-29T00:00:00Z,29,3,2020,36,5,Peru,PE,PER,31989256,America,16,671,10
2020-03-30T00:00:00Z,30,3,2020,181,2,Peru,PE,PER,31989256,America,18,852,11
2020-03-31T00:00:00Z,31,3,2020,98,6,Peru,PE,PER,31989256,America,24,950,12
2020-04-01T00:00:00Z,1,4,2020,115,6,Peru,PE,PER,31989256,America,30,1065,13
2020-04-02T00:00:00Z,2,4,2020,258,17,Peru,PE,PER,31989256,America,47,1323,14
2020-04-03T00:00:00Z,3,4,2020,91,8,Peru,PE,PER,31989256,America,55,1414,15
2020-04-04T00:00:00Z,4,4,2020,181,6,Peru,PE,PER,31989256,America,61,1595,16
2020-04-05T00:00:00Z,5,4,2020,151,12,Peru,PE,PER,31989256,America,73,1746,17
2020-04-06T00:00:00Z,6,4,2020,535,10,Peru,PE,PER,31989256,America,83,2281,18
2020-04-07T00:00:00Z,7,4,2020,280,9,Peru,PE,PER,31989256,America,92,2561,19
2020-04-08T00:00:00Z,8,4,2020,393,15,Peru,PE,PER,31989256,America,107,2954,20
2020-04-09T00:00:00Z,9,4,2020,1388,14,Peru,PE,PER,31989256,America,121,4342,21
2020-04-10T00:00:00Z,10,4,2020,914,17,Peru,PE,PER,31989256,America,138,5256,22
2020-04-11T00:00:00Z,11,4,2020,641,31,Peru,PE,PER,31989256,America,169,5897,23
2020-04-12T00:00:00Z,12,4,2020,951,12,Peru,PE,PER,31989256,America,181,6848,24
2020-04-13T00:00:00Z,13,4,2020,671,12,Peru,PE,PER,31989256,America,193,7519,25
2020-04-14T00:00:00Z,14,4,2020,0,0,Peru,PE,PER,31989256,America,193,7519,26
2020-04-15T00:00:00Z,15,4,2020,2784,37,Peru,PE,PER,31989256,America,230,10303,27
2020-04-16T00:00:00Z,16,4,2020,1172,24,Peru,PE,PER,31989256,America,254,11475,28
2020-04-17T00:00:00Z,17,4,2020,1016,20,Peru,PE,PER,31989256,America,274,12491,29
2020-04-18T00:00:00Z,18,4,2020,998,26,Peru,PE,PER,31989256,America,300,13489,30
2020-04-19T00:00:00Z,19,4,2020,931,48,Peru,PE,PER,31989256,America,348,14420,31
2020-04-20T00:00:00Z,20,4,2020,1208,52,Peru,PE,PER,31989256,America,400,15628,32
2020-04-21T00:00:00Z,21,4,2020,697,45,Peru,PE,PER,31989256,America,445,16325,33
2020-04-22T00:00:00Z,22,4,2020,1512,39,Peru,PE,PER,31989256,America,484,17837,34
2020-04-23T00:00:00Z,23,4,2020,1413,46,Peru,PE,PER,31989256,America,530,19250,35
2020-04-24T00:00:00Z,24,4,2020,1664,42,Peru,PE,PER,31989256,America,572,20914,36
2020-04-25T00:00:00Z,25,4,2020,734,62,Peru,PE,PER,31989256,America,634,21648,37
2020-04-26T00:00:00Z,26,4,2020,3683,66,Peru,PE,PER,31989256,America,700,25331,38
2020-04-27T00:00:00Z,27,4,2020,2186,28,Peru,PE,PER,31989256,America,728,27517,39
2020-04-28T00:00:00Z,28,4,2020,1182,54,Peru,PE,PER,31989256,America,782,28699,40
2020-04-29T00:00:00Z,29,4,2020,2491,72,Peru,PE,PER,31989256,America,854,31190,41
2020-04-30T00:00:00Z,30,4,2020,2741,89,Peru,PE,PER,31989256,America,943,33931,42
2020-05-01T00:00:00Z,1,5,2020,3045,108,Peru,PE,PER,31989256,America,1051,36976,43
2020-05-02T00:00:00Z,2,5,2020,3483,73,Peru,PE,PER,31989256,America,1124,40459,44
2020-05-03T00:00:00Z,3,5,2020,2075,76,Peru,PE,PER,31989256,America,1200,42534,45
2020-05-04T00:00:00Z,4,5,2020,3394,86,Peru,PE,PER,31989256,America,1286,45928,46
2020-05-05T00:00:00Z,5,5,2020,1444,58,Peru,PE,PER,31989256,America,1344,47372,47
2020-05-06T00:00:00Z,6,5,2020,3817,100,Peru,PE,PER,31989256,America,1444,51189,48
2020-05-07T00:00:00Z,7,5,2020,3628,89,Peru,PE,PER,31989256,America,1533,54817,49
2020-05-08T00:00:00Z,8,5,2020,3709,94,Peru,PE,PER,31989256,America,1627,58526,50
2020-05-09T00:00:00Z,9,5,2020,3321,87,Peru,PE,PER,31989256,America,1714,61847,51
2020-05-10T00:00:00Z,10,5,2020,3168,100,Peru,PE,PER,31989256,America,1814,65015,52
2020-05-11T00:00:00Z,11,5,2020,2292,75,Peru,PE,PER,31989256,America,1889,67307,53
2020-05-12T00:00:00Z,12,5,2020,1515,72,Peru,PE,PER,31989256,America,1961,68822,54
2020-05-13T00:00:00Z,13,5,2020,3237,96,Peru,PE,PER,31989256,America,2057,72059,55
2020-05-14T00:00:00Z,14,5,2020,4247,112,Peru,PE,PER,31989256,America,2169,76306,56
2020-05-15T00:00:00Z,15,5,2020,4298,98,Peru,PE,PER,31989256,America,2267,80604,57
2020-05-16T00:00:00Z,16,5,2020,3891,126,Peru,PE,PER,31989256,America,2393,84495,58
2020-05-17T00:00:00Z,17,5,2020,4046,130,Peru,PE,PER,31989256,America,2523,88541,59
2020-05-18T00:00:00Z,18,5,2020,3732,125,Peru,PE,PER,31989256,America,2648,92273,60
2020-05-19T00:00:00Z,19,5,2020,2660,141,Peru,PE,PER,31989256,America,2789,94933,61
2020-05-20T00:00:00Z,20,5,2020,4550,125,Peru,PE,PER,31989256,America,2914,99483,62
2020-05-21T00:00:00Z,21,5,2020,4537,110,Peru,PE,PER,31989256,America,3024,104020,63
2020-05-22T00:00:00Z,22,5,2020,4749,124,Peru,PE,PER,31989256,America,3148,108769,64
2020-05-23T00:00:00Z,23,5,2020,2929,96,Peru,PE,PER,31989256,America,3244,111698,65
2020-05-24T00:00:00Z,24,5,2020,4056,129,Peru,PE,PER,31989256,America,3373,115754,66
2020-05-25T00:00:00Z,25,5,2020,4205,83,Peru,PE,PER,31989256,America,3456,119959,67
2020-05-26T00:00:00Z,26,5,2020,4020,173,Peru,PE,PER,31989256,America,3629,123979,68
2020-05-27T00:00:00Z,27,5,2020,5772,159,Peru,PE,PER,31989256,America,3788,129751,69
2020-02-02T00:00:00Z,2,2,2020,1,1,Philippines,PH,PHL,106651922,Asia,1,2,1
2020-02-03T00:00:00Z,3,2,2020,0,0,Philippines,PH,PHL,106651922,Asia,1,2,2
2020-02-04T00:00:00Z,4,2,2020,0,0,Philippines,PH,PHL,106651922,Asia,1,2,3
2020-02-05T00:00:00Z,5,2,2020,0,0,Philippines,PH,PHL,106651922,Asia,1,2,4
2020-02-06T00:00:00Z,6,2,2020,1,0,Philippines,PH,PHL,106651922,Asia,1,3,5
2020-02-07T00:00:00Z,7,2,2020,0,0,Philippines,PH,PHL,106651922,Asia,1,3,6
2020-02-08T00:00:00Z,8,2,2020,0,0,Philippines,PH,PHL,106651922,Asia,1,3,7
2020-02-09T00:00:00Z,9,2,2020,0,0,Philippines,PH,PHL,106651922,Asia,1,3,8
2020-02-10T00:00:00Z,10,2,2020,0,0,Philippines,PH,PHL,106651922,Asia,1,3,9
2020-02-11T00:00:00Z,11,2,2020,0,0,Philippines,PH,PHL,106651922,Asia,1,3,10
2020-02-12T00:00:00Z,12,2,2020,0,0,Philippines,PH,PHL,106651922,Asia,1,3,11
2020-02-13T00:00:00Z,13,2,2020,0,0,Philippines,PH,PHL,106651922,Asia,1,3,12
2020-02-14T00:00:00Z,14,2,2020,0,0,Philippines,PH,PHL,106651922,Asia,1,3,13
2020-02-15T00:00:00Z,15,2,2020,0,0,Philippines,PH,PHL,106651922,Asia,1,3,14
2020-02-16T00:00:00Z,16,2,2020,0,0,Philippines,PH,PHL,106651922,Asia,1,3,15
2020-02-17T00:00:00Z,17,2,2020,0,0,Philippines,PH,PHL,106651922,Asia,1,3,16
2020-02-18T00:00:00Z,18,2,2020,0,0,Philippines,PH,PHL,106651922,Asia,1,3,17
2020-02-19T00:00:00Z,19,2,2020,0,0,Philippines,PH,PHL,106651922,Asia,1,3,18
2020-02-20T00:00:00Z,20,2,2020,0,0,Philippines,PH,PHL,106651922,Asia,1,3,19
2020-02-21T00:00:00Z,21,2,2020,0,0,Philippines,PH,PHL,106651922,Asia,1,3,20
2020-02-22T00:00:00Z,22,2,2020,0,0,Philippines,PH,PHL,106651922,Asia,1,3,21
2020-02-23T00:00:00Z,23,2,2020,0,0,Philippines,PH,PHL,106651922,Asia,1,3,22
2020-02-24T00:00:00Z,24,2,2020,0,0,Philippines,PH,PHL,106651922,Asia,1,3,23
2020-02-25T00:00:00Z,25,2,2020,0,0,Philippines,PH,PHL,106651922,Asia,1,3,24
2020-02-26T00:00:00Z,26,2,2020,0,0,Philippines,PH,PHL,106651922,Asia,1,3,25
2020-02-27T00:00:00Z,27,2,2020,0,0,Philippines,PH,PHL,106651922,Asia,1,3,26
2020-02-28T00:00:00Z,28,2,2020,0,0,Philippines,PH,PHL,106651922,Asia,1,3,27
2020-02-29T00:00:00Z,29,2,2020,0,0,Philippines,PH,PHL,106651922,Asia,1,3,28
2020-03-01T00:00:00Z,1,3,2020,0,0,Philippines,PH,PHL,106651922,Asia,1,3,29
2020-03-02T00:00:00Z,2,3,2020,0,0,Philippines,PH,PHL,106651922,Asia,1,3,30
2020-03-07T00:00:00Z,7,3,2020,2,0,Philippines,PH,PHL,106651922,Asia,1,5,31
2020-03-08T00:00:00Z,8,3,2020,1,0,Philippines,PH,PHL,106651922,Asia,1,6,32
2020-03-09T00:00:00Z,9,3,2020,4,0,Philippines,PH,PHL,106651922,Asia,1,10,33
2020-03-10T00:00:00Z,10,3,2020,23,0,Philippines,PH,PHL,106651922,Asia,1,33,34
2020-03-11T00:00:00Z,11,3,2020,0,0,Philippines,PH,PHL,106651922,Asia,1,33,35
2020-03-12T00:00:00Z,12,3,2020,16,1,Philippines,PH,PHL,106651922,Asia,2,49,36
2020-03-13T00:00:00Z,13,3,2020,3,0,Philippines,PH,PHL,106651922,Asia,2,52,37
2020-03-14T00:00:00Z,14,3,2020,12,4,Philippines,PH,PHL,106651922,Asia,6,64,38
2020-03-15T00:00:00Z,15,3,2020,47,0,Philippines,PH,PHL,106651922,Asia,6,111,39
2020-03-16T00:00:00Z,16,3,2020,29,6,Philippines,PH,PHL,106651922,Asia,12,140,40
2020-03-17T00:00:00Z,17,3,2020,2,0,Philippines,PH,PHL,106651922,Asia,12,142,41
2020-03-18T00:00:00Z,18,3,2020,45,2,Philippines,PH,PHL,106651922,Asia,14,187,42
2020-03-19T00:00:00Z,19,3,2020,15,3,Philippines,PH,PHL,106651922,Asia,17,202,43
2020-03-20T00:00:00Z,20,3,2020,28,1,Philippines,PH,PHL,106651922,Asia,18,230,44
2020-03-21T00:00:00Z,21,3,2020,0,0,Philippines,PH,PHL,106651922,Asia,18,230,45
2020-03-22T00:00:00Z,22,3,2020,150,7,Philippines,PH,PHL,106651922,Asia,25,380,46
2020-03-23T00:00:00Z,23,3,2020,0,0,Philippines,PH,PHL,106651922,Asia,25,380,47
2020-03-24T00:00:00Z,24,3,2020,82,8,Philippines,PH,PHL,106651922,Asia,33,462,48
2020-03-25T00:00:00Z,25,3,2020,90,2,Philippines,PH,PHL,106651922,Asia,35,552,49
2020-03-26T00:00:00Z,26,3,2020,84,3,Philippines,PH,PHL,106651922,Asia,38,636,50
2020-03-27T00:00:00Z,27,3,2020,71,7,Philippines,PH,PHL,106651922,Asia,45,707,51
2020-03-28T00:00:00Z,28,3,2020,96,9,Philippines,PH,PHL,106651922,Asia,54,803,52
2020-03-29T00:00:00Z,29,3,2020,272,14,Philippines,PH,PHL,106651922,Asia,68,1075,53
2020-03-30T00:00:00Z,30,3,2020,343,3,Philippines,PH,PHL,106651922,Asia,71,1418,54
2020-03-31T00:00:00Z,31,3,2020,666,17,Philippines,PH,PHL,106651922,Asia,88,2084,55
2020-04-01T00:00:00Z,1,4,2020,0,0,Philippines,PH,PHL,106651922,Asia,88,2084,56
2020-04-02T00:00:00Z,2,4,2020,227,8,Philippines,PH,PHL,106651922,Asia,96,2311,57
2020-04-03T00:00:00Z,3,4,2020,322,11,Philippines,PH,PHL,106651922,Asia,107,2633,58
2020-04-04T00:00:00Z,4,4,2020,385,29,Philippines,PH,PHL,106651922,Asia,136,3018,59
2020-04-05T00:00:00Z,5,4,2020,76,8,Philippines,PH,PHL,106651922,Asia,144,3094,60
2020-04-06T00:00:00Z,6,4,2020,152,8,Philippines,PH,PHL,106651922,Asia,152,3246,61
2020-04-07T00:00:00Z,7,4,2020,414,11,Philippines,PH,PHL,106651922,Asia,163,3660,62
2020-04-08T00:00:00Z,8,4,2020,104,14,Philippines,PH,PHL,106651922,Asia,177,3764,63
2020-04-09T00:00:00Z,9,4,2020,106,5,Philippines,PH,PHL,106651922,Asia,182,3870,64
2020-04-10T00:00:00Z,10,4,2020,206,21,Philippines,PH,PHL,106651922,Asia,203,4076,65
2020-04-11T00:00:00Z,11,4,2020,0,0,Philippines,PH,PHL,106651922,Asia,203,4076,66
2020-04-12T00:00:00Z,12,4,2020,352,44,Philippines,PH,PHL,106651922,Asia,247,4428,67
2020-04-13T00:00:00Z,13,4,2020,220,50,Philippines,PH,PHL,106651922,Asia,297,4648,68
2020-04-14T00:00:00Z,14,4,2020,284,18,Philippines,PH,PHL,106651922,Asia,315,4932,69
2020-04-15T00:00:00Z,15,4,2020,291,20,Philippines,PH,PHL,106651922,Asia,335,5223,70
2020-04-16T00:00:00Z,16,4,2020,230,14,Philippines,PH,PHL,106651922,Asia,349,5453,71
2020-04-17T00:00:00Z,17,4,2020,207,13,Philippines,PH,PHL,106651922,Asia,362,5660,72
2020-04-18T00:00:00Z,18,4,2020,218,25,Philippines,PH,PHL,106651922,Asia,387,5878,73
2020-04-19T00:00:00Z,19,4,2020,209,10,Philippines,PH,PHL,106651922,Asia,397,6087,74
2020-04-20T00:00:00Z,20,4,2020,172,12,Philippines,PH,PHL,106651922,Asia,409,6259,75
2020-04-21T00:00:00Z,21,4,2020,200,19,Philippines,PH,PHL,106651922,Asia,428,6459,76
2020-04-22T00:00:00Z,22,4,2020,140,9,Philippines,PH,PHL,106651922,Asia,437,6599,77
2020-04-23T00:00:00Z,23,4,2020,111,9,Philippines,PH,PHL,106651922,Asia,446,6710,78
2020-04-24T00:00:00Z,24,4,2020,271,16,Philippines,PH,PHL,106651922,Asia,462,6981,79
2020-04-25T00:00:00Z,25,4,2020,211,15,Philippines,PH,PHL,106651922,Asia,477,7192,80
2020-04-26T00:00:00Z,26,4,2020,102,17,Philippines,PH,PHL,106651922,Asia,494,7294,81
2020-04-27T00:00:00Z,27,4,2020,285,7,Philippines,PH,PHL,106651922,Asia,501,7579,82
2020-04-28T00:00:00Z,28,4,2020,198,10,Philippines,PH,PHL,106651922,Asia,511,7777,83
2020-04-29T00:00:00Z,29,4,2020,181,19,Philippines,PH,PHL,106651922,Asia,530,7958,84
2020-04-30T00:00:00Z,30,4,2020,254,28,Philippines,PH,PHL,106651922,Asia,558,8212,85
2020-05-01T00:00:00Z,1,5,2020,276,10,Philippines,PH,PHL,106651922,Asia,568,8488,86
2020-05-02T00:00:00Z,2,5,2020,284,11,Philippines,PH,PHL,106651922,Asia,579,8772,87
2020-05-03T00:00:00Z,3,5,2020,156,24,Philippines,PH,PHL,106651922,Asia,603,8928,88
2020-05-04T00:00:00Z,4,5,2020,295,4,Philippines,PH,PHL,106651922,Asia,607,9223,89
2020-05-05T00:00:00Z,5,5,2020,262,16,Philippines,PH,PHL,106651922,Asia,623,9485,90
2020-05-06T00:00:00Z,6,5,2020,199,14,Philippines,PH,PHL,106651922,Asia,637,9684,91
2020-05-07T00:00:00Z,7,5,2020,320,21,Philippines,PH,PHL,106651922,Asia,658,10004,92
2020-05-08T00:00:00Z,8,5,2020,339,27,Philippines,PH,PHL,106651922,Asia,685,10343,93
2020-05-09T00:00:00Z,9,5,2020,120,11,Philippines,PH,PHL,106651922,Asia,696,10463,94
2020-05-10T00:00:00Z,10,5,2020,147,8,Philippines,PH,PHL,106651922,Asia,704,10610,95
2020-05-11T00:00:00Z,11,5,2020,184,15,Philippines,PH,PHL,106651922,Asia,719,10794,96
2020-05-12T00:00:00Z,12,5,2020,292,7,Philippines,PH,PHL,106651922,Asia,726,11086,97
2020-05-13T00:00:00Z,13,5,2020,264,25,Philippines,PH,PHL,106651922,Asia,751,11350,98
2020-05-14T00:00:00Z,14,5,2020,268,21,Philippines,PH,PHL,106651922,Asia,772,11618,99
2020-05-15T00:00:00Z,15,5,2020,258,18,Philippines,PH,PHL,106651922,Asia,790,11876,100
2020-05-16T00:00:00Z,16,5,2020,215,16,Philippines,PH,PHL,106651922,Asia,806,12091,101
2020-05-17T00:00:00Z,17,5,2020,214,11,Philippines,PH,PHL,106651922,Asia,817,12305,102
2020-05-18T00:00:00Z,18,5,2020,208,7,Philippines,PH,PHL,106651922,Asia,824,12513,103
2020-05-19T00:00:00Z,19,5,2020,205,7,Philippines,PH,PHL,106651922,Asia,831,12718,104
2020-05-20T00:00:00Z,20,5,2020,224,6,Philippines,PH,PHL,106651922,Asia,837,12942,105
2020-05-21T00:00:00Z,21,5,2020,279,5,Philippines,PH,PHL,106651922,Asia,842,13221,106
2020-05-22T00:00:00Z,22,5,2020,213,4,Philippines,PH,PHL,106651922,Asia,846,13434,107
2020-05-23T00:00:00Z,23,5,2020,163,11,Philippines,PH,PHL,106651922,Asia,857,13597,108
2020-05-24T00:00:00Z,24,5,2020,180,6,Philippines,PH,PHL,106651922,Asia,863,13777,109
2020-05-25T00:00:00Z,25,5,2020,258,5,Philippines,PH,PHL,106651922,Asia,868,14035,110
2020-05-26T00:00:00Z,26,5,2020,284,5,Philippines,PH,PHL,106651922,Asia,873,14319,111
2020-05-27T00:00:00Z,27,5,2020,350,13,Philippines,PH,PHL,106651922,Asia,886,14669,112
2020-03-13T00:00:00Z,13,3,2020,18,1,Poland,PL,POL,37978548,Europe,1,49,1
2020-03-14T00:00:00Z,14,3,2020,19,1,Poland,PL,POL,37978548,Europe,2,68,2
2020-03-15T00:00:00Z,15,3,2020,36,1,Poland,PL,POL,37978548,Europe,3,104,3
2020-03-16T00:00:00Z,16,3,2020,21,0,Poland,PL,POL,37978548,Europe,3,125,4
2020-03-17T00:00:00Z,17,3,2020,52,1,Poland,PL,POL,37978548,Europe,4,177,5
2020-03-18T00:00:00Z,18,3,2020,61,1,Poland,PL,POL,37978548,Europe,5,238,6
2020-03-19T00:00:00Z,19,3,2020,49,0,Poland,PL,POL,37978548,Europe,5,287,7
2020-03-20T00:00:00Z,20,3,2020,68,0,Poland,PL,POL,37978548,Europe,5,355,8
2020-03-21T00:00:00Z,21,3,2020,70,0,Poland,PL,POL,37978548,Europe,5,425,9
2020-03-22T00:00:00Z,22,3,2020,111,0,Poland,PL,POL,37978548,Europe,5,536,10
2020-03-23T00:00:00Z,23,3,2020,98,2,Poland,PL,POL,37978548,Europe,7,634,11
2020-03-24T00:00:00Z,24,3,2020,115,1,Poland,PL,POL,37978548,Europe,8,749,12
2020-03-25T00:00:00Z,25,3,2020,152,2,Poland,PL,POL,37978548,Europe,10,901,13
2020-03-26T00:00:00Z,26,3,2020,150,4,Poland,PL,POL,37978548,Europe,14,1051,14
2020-03-27T00:00:00Z,27,3,2020,170,2,Poland,PL,POL,37978548,Europe,16,1221,15
2020-03-28T00:00:00Z,28,3,2020,168,0,Poland,PL,POL,37978548,Europe,16,1389,16
2020-03-29T00:00:00Z,29,3,2020,249,2,Poland,PL,POL,37978548,Europe,18,1638,17
2020-03-30T00:00:00Z,30,3,2020,224,4,Poland,PL,POL,37978548,Europe,22,1862,18
2020-03-31T00:00:00Z,31,3,2020,193,9,Poland,PL,POL,37978548,Europe,31,2055,19
2020-04-01T00:00:00Z,1,4,2020,256,2,Poland,PL,POL,37978548,Europe,33,2311,20
2020-04-02T00:00:00Z,2,4,2020,243,10,Poland,PL,POL,37978548,Europe,43,2554,21
2020-04-03T00:00:00Z,3,4,2020,392,14,Poland,PL,POL,37978548,Europe,57,2946,22
2020-04-04T00:00:00Z,4,4,2020,437,14,Poland,PL,POL,37978548,Europe,71,3383,23
2020-04-05T00:00:00Z,5,4,2020,244,8,Poland,PL,POL,37978548,Europe,79,3627,24
2020-04-06T00:00:00Z,6,4,2020,475,15,Poland,PL,POL,37978548,Europe,94,4102,25
2020-04-07T00:00:00Z,7,4,2020,311,13,Poland,PL,POL,37978548,Europe,107,4413,26
2020-04-08T00:00:00Z,8,4,2020,435,22,Poland,PL,POL,37978548,Europe,129,4848,27
2020-04-09T00:00:00Z,9,4,2020,357,30,Poland,PL,POL,37978548,Europe,159,5205,28
2020-04-10T00:00:00Z,10,4,2020,370,15,Poland,PL,POL,37978548,Europe,174,5575,29
2020-04-11T00:00:00Z,11,4,2020,380,7,Poland,PL,POL,37978548,Europe,181,5955,30
2020-04-12T00:00:00Z,12,4,2020,401,27,Poland,PL,POL,37978548,Europe,208,6356,31
2020-04-13T00:00:00Z,13,4,2020,318,24,Poland,PL,POL,37978548,Europe,232,6674,32
2020-04-14T00:00:00Z,14,4,2020,260,13,Poland,PL,POL,37978548,Europe,245,6934,33
2020-04-15T00:00:00Z,15,4,2020,268,18,Poland,PL,POL,37978548,Europe,263,7202,34
2020-04-16T00:00:00Z,16,4,2020,380,23,Poland,PL,POL,37978548,Europe,286,7582,35
2020-04-17T00:00:00Z,17,4,2020,336,28,Poland,PL,POL,37978548,Europe,314,7918,36
2020-04-18T00:00:00Z,18,4,2020,461,18,Poland,PL,POL,37978548,Europe,332,8379,37
2020-04-19T00:00:00Z,19,4,2020,363,15,Poland,PL,POL,37978548,Europe,347,8742,38
2020-04-20T00:00:00Z,20,4,2020,545,13,Poland,PL,POL,37978548,Europe,360,9287,39
2020-04-21T00:00:00Z,21,4,2020,306,20,Poland,PL,POL,37978548,Europe,380,9593,40
2020-04-22T00:00:00Z,22,4,2020,263,21,Poland,PL,POL,37978548,Europe,401,9856,41
2020-04-23T00:00:00Z,23,4,2020,313,25,Poland,PL,POL,37978548,Europe,426,10169,42
2020-04-24T00:00:00Z,24,4,2020,342,28,Poland,PL,POL,37978548,Europe,454,10511,43
2020-04-25T00:00:00Z,25,4,2020,381,40,Poland,PL,POL,37978548,Europe,494,10892,44
2020-04-26T00:00:00Z,26,4,2020,381,30,Poland,PL,POL,37978548,Europe,524,11273,45
2020-04-27T00:00:00Z,27,4,2020,344,11,Poland,PL,POL,37978548,Europe,535,11617,46
2020-04-28T00:00:00Z,28,4,2020,285,27,Poland,PL,POL,37978548,Europe,562,11902,47
2020-04-29T00:00:00Z,29,4,2020,316,34,Poland,PL,POL,37978548,Europe,596,12218,48
2020-04-30T00:00:00Z,30,4,2020,422,28,Poland,PL,POL,37978548,Europe,624,12640,49
2020-05-01T00:00:00Z,1,5,2020,237,20,Poland,PL,POL,37978548,Europe,644,12877,50
2020-05-02T00:00:00Z,2,5,2020,228,7,Poland,PL,POL,37978548,Europe,651,13105,51
2020-05-03T00:00:00Z,3,5,2020,270,13,Poland,PL,POL,37978548,Europe,664,13375,52
2020-05-04T00:00:00Z,4,5,2020,318,14,Poland,PL,POL,37978548,Europe,678,13693,53
2020-05-05T00:00:00Z,5,5,2020,313,20,Poland,PL,POL,37978548,Europe,698,14006,54
2020-05-06T00:00:00Z,6,5,2020,425,18,Poland,PL,POL,37978548,Europe,716,14431,55
2020-05-07T00:00:00Z,7,5,2020,309,17,Poland,PL,POL,37978548,Europe,733,14740,56
2020-05-08T00:00:00Z,8,5,2020,307,22,Poland,PL,POL,37978548,Europe,755,15047,57
2020-05-09T00:00:00Z,9,5,2020,319,21,Poland,PL,POL,37978548,Europe,776,15366,58
2020-05-10T00:00:00Z,10,5,2020,285,9,Poland,PL,POL,37978548,Europe,785,15651,59
2020-05-11T00:00:00Z,11,5,2020,345,15,Poland,PL,POL,37978548,Europe,800,15996,60
2020-05-12T00:00:00Z,12,5,2020,330,11,Poland,PL,POL,37978548,Europe,811,16326,61
2020-05-13T00:00:00Z,13,5,2020,595,28,Poland,PL,POL,37978548,Europe,839,16921,62
2020-05-14T00:00:00Z,14,5,2020,283,22,Poland,PL,POL,37978548,Europe,861,17204,63
2020-05-15T00:00:00Z,15,5,2020,411,22,Poland,PL,POL,37978548,Europe,883,17615,64
2020-05-16T00:00:00Z,16,5,2020,401,24,Poland,PL,POL,37978548,Europe,907,18016,65
2020-05-17T00:00:00Z,17,5,2020,241,8,Poland,PL,POL,37978548,Europe,915,18257,66
2020-05-18T00:00:00Z,18,5,2020,272,10,Poland,PL,POL,37978548,Europe,925,18529,67
2020-05-19T00:00:00Z,19,5,2020,356,11,Poland,PL,POL,37978548,Europe,936,18885,68
2020-05-20T00:00:00Z,20,5,2020,383,12,Poland,PL,POL,37978548,Europe,948,19268,69
2020-05-21T00:00:00Z,21,5,2020,471,14,Poland,PL,POL,37978548,Europe,962,19739,70
2020-05-22T00:00:00Z,22,5,2020,404,10,Poland,PL,POL,37978548,Europe,972,20143,71
2020-05-23T00:00:00Z,23,5,2020,476,10,Poland,PL,POL,37978548,Europe,982,20619,72
2020-05-24T00:00:00Z,24,5,2020,312,11,Poland,PL,POL,37978548,Europe,993,20931,73
2020-05-25T00:00:00Z,25,5,2020,395,3,Poland,PL,POL,37978548,Europe,996,21326,74
2020-05-26T00:00:00Z,26,5,2020,305,11,Poland,PL,POL,37978548,Europe,1007,21631,75
2020-05-27T00:00:00Z,27,5,2020,443,17,Poland,PL,POL,37978548,Europe,1024,22074,76
2020-03-18T00:00:00Z,18,3,2020,117,1,Portugal,PT,PRT,10281762,Europe,1,448,1
2020-03-19T00:00:00Z,19,3,2020,194,1,Portugal,PT,PRT,10281762,Europe,2,642,2
2020-03-20T00:00:00Z,20,3,2020,143,1,Portugal,PT,PRT,10281762,Europe,3,785,3
2020-03-21T00:00:00Z,21,3,2020,235,3,Portugal,PT,PRT,10281762,Europe,6,1020,4
2020-03-22T00:00:00Z,22,3,2020,260,6,Portugal,PT,PRT,10281762,Europe,12,1280,5
2020-03-23T00:00:00Z,23,3,2020,320,2,Portugal,PT,PRT,10281762,Europe,14,1600,6
2020-03-24T00:00:00Z,24,3,2020,460,9,Portugal,PT,PRT,10281762,Europe,23,2060,7
2020-03-25T00:00:00Z,25,3,2020,302,10,Portugal,PT,PRT,10281762,Europe,33,2362,8
2020-03-26T00:00:00Z,26,3,2020,633,10,Portugal,PT,PRT,10281762,Europe,43,2995,9
2020-03-27T00:00:00Z,27,3,2020,549,17,Portugal,PT,PRT,10281762,Europe,60,3544,10
2020-03-28T00:00:00Z,28,3,2020,724,16,Portugal,PT,PRT,10281762,Europe,76,4268,11
2020-03-29T00:00:00Z,29,3,2020,902,24,Portugal,PT,PRT,10281762,Europe,100,5170,12
2020-03-30T00:00:00Z,30,3,2020,792,19,Portugal,PT,PRT,10281762,Europe,119,5962,13
2020-03-31T00:00:00Z,31,3,2020,446,21,Portugal,PT,PRT,10281762,Europe,140,6408,14
2020-04-01T00:00:00Z,1,4,2020,1035,20,Portugal,PT,PRT,10281762,Europe,160,7443,15
2020-04-02T00:00:00Z,2,4,2020,808,27,Portugal,PT,PRT,10281762,Europe,187,8251,16
2020-04-03T00:00:00Z,3,4,2020,783,22,Portugal,PT,PRT,10281762,Europe,209,9034,17
2020-04-04T00:00:00Z,4,4,2020,852,37,Portugal,PT,PRT,10281762,Europe,246,9886,18
2020-04-05T00:00:00Z,5,4,2020,638,20,Portugal,PT,PRT,10281762,Europe,266,10524,19
2020-04-06T00:00:00Z,6,4,2020,754,29,Portugal,PT,PRT,10281762,Europe,295,11278,20
2020-04-07T00:00:00Z,7,4,2020,452,16,Portugal,PT,PRT,10281762,Europe,311,11730,21
2020-04-08T00:00:00Z,8,4,2020,712,34,Portugal,PT,PRT,10281762,Europe,345,12442,22
2020-04-09T00:00:00Z,9,4,2020,699,35,Portugal,PT,PRT,10281762,Europe,380,13141,23
2020-04-10T00:00:00Z,10,4,2020,815,29,Portugal,PT,PRT,10281762,Europe,409,13956,24
2020-04-11T00:00:00Z,11,4,2020,1516,26,Portugal,PT,PRT,10281762,Europe,435,15472,25
2020-04-12T00:00:00Z,12,4,2020,515,35,Portugal,PT,PRT,10281762,Europe,470,15987,26
2020-04-13T00:00:00Z,13,4,2020,598,34,Portugal,PT,PRT,10281762,Europe,504,16585,27
2020-04-14T00:00:00Z,14,4,2020,349,31,Portugal,PT,PRT,10281762,Europe,535,16934,28
2020-04-15T00:00:00Z,15,4,2020,514,32,Portugal,PT,PRT,10281762,Europe,567,17448,29
2020-04-16T00:00:00Z,16,4,2020,643,32,Portugal,PT,PRT,10281762,Europe,599,18091,30
2020-04-17T00:00:00Z,17,4,2020,750,30,Portugal,PT,PRT,10281762,Europe,629,18841,31
2020-04-18T00:00:00Z,18,4,2020,181,28,Portugal,PT,PRT,10281762,Europe,657,19022,32
2020-04-19T00:00:00Z,19,4,2020,663,30,Portugal,PT,PRT,10281762,Europe,687,19685,33
2020-04-20T00:00:00Z,20,4,2020,521,27,Portugal,PT,PRT,10281762,Europe,714,20206,34
2020-04-21T00:00:00Z,21,4,2020,657,21,Portugal,PT,PRT,10281762,Europe,735,20863,35
2020-04-22T00:00:00Z,22,4,2020,516,27,Portugal,PT,PRT,10281762,Europe,762,21379,36
2020-04-23T00:00:00Z,23,4,2020,603,23,Portugal,PT,PRT,10281762,Europe,785,21982,37
2020-04-24T00:00:00Z,24,4,2020,371,35,Portugal,PT,PRT,10281762,Europe,820,22353,38
2020-04-25T00:00:00Z,25,4,2020,918,60,Portugal,PT,PRT,10281762,Europe,880,23271,39
2020-04-26T00:00:00Z,26,4,2020,412,23,Portugal,PT,PRT,10281762,Europe,903,23683,40
2020-04-27T00:00:00Z,27,4,2020,163,25,Portugal,PT,PRT,10281762,Europe,928,23846,41
2020-04-28T00:00:00Z,28,4,2020,298,20,Portugal,PT,PRT,10281762,Europe,948,24144,42
2020-04-29T00:00:00Z,29,4,2020,180,25,Portugal,PT,PRT,10281762,Europe,973,24324,43
2020-04-30T00:00:00Z,30,4,2020,368,16,Portugal,PT,PRT,10281762,Europe,989,24692,44
2020-05-01T00:00:00Z,1,5,2020,295,18,Portugal,PT,PRT,10281762,Europe,1007,24987,45
2020-05-02T00:00:00Z,2,5,2020,364,0,Portugal,PT,PRT,10281762,Europe,1007,25351,46
2020-05-03T00:00:00Z,3,5,2020,-161,16,Portugal,PT,PRT,10281762,Europe,1023,25190,47
2020-05-04T00:00:00Z,4,5,2020,334,40,Portugal,PT,PRT,10281762,Europe,1063,25524,48
2020-05-05T00:00:00Z,5,5,2020,0,0,Portugal,PT,PRT,10281762,Europe,1063,25524,49
2020-05-06T00:00:00Z,6,5,2020,178,11,Portugal,PT,PRT,10281762,Europe,1074,25702,50
2020-05-07T00:00:00Z,7,5,2020,480,15,Portugal,PT,PRT,10281762,Europe,1089,26182,51
2020-05-08T00:00:00Z,8,5,2020,533,16,Portugal,PT,PRT,10281762,Europe,1105,26715,52
2020-05-09T00:00:00Z,9,5,2020,553,9,Portugal,PT,PRT,10281762,Europe,1114,27268,53
2020-05-10T00:00:00Z,10,5,2020,138,12,Portugal,PT,PRT,10281762,Europe,1126,27406,54
2020-05-11T00:00:00Z,11,5,2020,175,9,Portugal,PT,PRT,10281762,Europe,1135,27581,55
2020-05-12T00:00:00Z,12,5,2020,98,9,Portugal,PT,PRT,10281762,Europe,1144,27679,56
2020-05-13T00:00:00Z,13,5,2020,234,19,Portugal,PT,PRT,10281762,Europe,1163,27913,57
2020-05-14T00:00:00Z,14,5,2020,219,12,Portugal,PT,PRT,10281762,Europe,1175,28132,58
2020-05-15T00:00:00Z,15,5,2020,187,9,Portugal,PT,PRT,10281762,Europe,1184,28319,59
2020-05-16T00:00:00Z,16,5,2020,264,6,Portugal,PT,PRT,10281762,Europe,1190,28583,60
2020-05-17T00:00:00Z,17,5,2020,227,13,Portugal,PT,PRT,10281762,Europe,1203,28810,61
2020-05-18T00:00:00Z,18,5,2020,226,15,Portugal,PT,PRT,10281762,Europe,1218,29036,62
2020-05-19T00:00:00Z,19,5,2020,173,13,Portugal,PT,PRT,10281762,Europe,1231,29209,63
2020-05-20T00:00:00Z,20,5,2020,223,16,Portugal,PT,PRT,10281762,Europe,1247,29432,64
2020-05-21T00:00:00Z,21,5,2020,228,16,Portugal,PT,PRT,10281762,Europe,1263,29660,65
2020-05-22T00:00:00Z,22,5,2020,252,14,Portugal,PT,PRT,10281762,Europe,1277,29912,66
2020-05-23T00:00:00Z,23,5,2020,288,12,Portugal,PT,PRT,10281762,Europe,1289,30200,67
2020-05-24T00:00:00Z,24,5,2020,271,13,Portugal,PT,PRT,10281762,Europe,1302,30471,68
2020-05-25T00:00:00Z,25,5,2020,152,14,Portugal,PT,PRT,10281762,Europe,1316,30623,69
2020-05-26T00:00:00Z,26,5,2020,165,14,Portugal,PT,PRT,10281762,Europe,1330,30788,70
2020-05-27T00:00:00Z,27,5,2020,219,12,Portugal,PT,PRT,10281762,Europe,1342,31007,71
2020-03-28T00:00:00Z,28,3,2020,64,2,Puerto_Rico,PR,PRI,3195153,America,2,64,1
2020-03-29T00:00:00Z,29,3,2020,36,1,Puerto_Rico,PR,PRI,3195153,America,3,100,2
2020-03-30T00:00:00Z,30,3,2020,27,2,Puerto_Rico,PR,PRI,3195153,America,5,127,3
2020-03-31T00:00:00Z,31,3,2020,47,1,Puerto_Rico,PR,PRI,3195153,America,6,174,4
2020-04-01T00:00:00Z,1,4,2020,65,2,Puerto_Rico,PR,PRI,3195153,America,8,239,5
2020-04-02T00:00:00Z,2,4,2020,47,3,Puerto_Rico,PR,PRI,3195153,America,11,286,6
2020-04-03T00:00:00Z,3,4,2020,30,1,Puerto_Rico,PR,PRI,3195153,America,12,316,7
2020-04-04T00:00:00Z,4,4,2020,62,3,Puerto_Rico,PR,PRI,3195153,America,15,378,8
2020-04-05T00:00:00Z,5,4,2020,74,3,Puerto_Rico,PR,PRI,3195153,America,18,452,9
2020-04-06T00:00:00Z,6,4,2020,23,2,Puerto_Rico,PR,PRI,3195153,America,20,475,10
2020-04-07T00:00:00Z,7,4,2020,38,1,Puerto_Rico,PR,PRI,3195153,America,21,513,11
2020-04-08T00:00:00Z,8,4,2020,60,2,Puerto_Rico,PR,PRI,3195153,America,23,573,12
2020-04-09T00:00:00Z,9,4,2020,47,1,Puerto_Rico,PR,PRI,3195153,America,24,620,13
2020-04-10T00:00:00Z,10,4,2020,63,9,Puerto_Rico,PR,PRI,3195153,America,33,683,14
2020-04-11T00:00:00Z,11,4,2020,42,6,Puerto_Rico,PR,PRI,3195153,America,39,725,15
2020-04-12T00:00:00Z,12,4,2020,63,3,Puerto_Rico,PR,PRI,3195153,America,42,788,16
2020-04-13T00:00:00Z,13,4,2020,109,2,Puerto_Rico,PR,PRI,3195153,America,44,897,17
2020-04-14T00:00:00Z,14,4,2020,6,1,Puerto_Rico,PR,PRI,3195153,America,45,903,18
2020-04-15T00:00:00Z,15,4,2020,20,0,Puerto_Rico,PR,PRI,3195153,America,45,923,19
2020-04-16T00:00:00Z,16,4,2020,51,6,Puerto_Rico,PR,PRI,3195153,America,51,974,20
2020-04-17T00:00:00Z,17,4,2020,69,5,Puerto_Rico,PR,PRI,3195153,America,56,1043,21
2020-04-18T00:00:00Z,18,4,2020,25,2,Puerto_Rico,PR,PRI,3195153,America,58,1068,22
2020-04-19T00:00:00Z,19,4,2020,50,2,Puerto_Rico,PR,PRI,3195153,America,60,1118,23
2020-04-20T00:00:00Z,20,4,2020,95,2,Puerto_Rico,PR,PRI,3195153,America,62,1213,24
2020-04-21T00:00:00Z,21,4,2020,39,1,Puerto_Rico,PR,PRI,3195153,America,63,1252,25
2020-04-22T00:00:00Z,22,4,2020,0,0,Puerto_Rico,PR,PRI,3195153,America,63,1252,26
2020-04-23T00:00:00Z,23,4,2020,0,1,Puerto_Rico,PR,PRI,3195153,America,64,1252,27
2020-04-24T00:00:00Z,24,4,2020,0,5,Puerto_Rico,PR,PRI,3195153,America,69,1252,28
2020-04-25T00:00:00Z,25,4,2020,24,8,Puerto_Rico,PR,PRI,3195153,America,77,1276,29
2020-04-26T00:00:00Z,26,4,2020,31,6,Puerto_Rico,PR,PRI,3195153,America,83,1307,30
2020-04-27T00:00:00Z,27,4,2020,64,1,Puerto_Rico,PR,PRI,3195153,America,84,1371,31
2020-04-28T00:00:00Z,28,4,2020,18,0,Puerto_Rico,PR,PRI,3195153,America,84,1389,32
2020-04-29T00:00:00Z,29,4,2020,11,2,Puerto_Rico,PR,PRI,3195153,America,86,1400,33
2020-04-30T00:00:00Z,30,4,2020,33,0,Puerto_Rico,PR,PRI,3195153,America,86,1433,34
2020-05-01T00:00:00Z,1,5,2020,106,6,Puerto_Rico,PR,PRI,3195153,America,92,1539,35
2020-05-02T00:00:00Z,2,5,2020,36,2,Puerto_Rico,PR,PRI,3195153,America,94,1575,36
2020-05-03T00:00:00Z,3,5,2020,182,1,Puerto_Rico,PR,PRI,3195153,America,95,1757,37
2020-05-04T00:00:00Z,4,5,2020,51,2,Puerto_Rico,PR,PRI,3195153,America,97,1808,38
2020-05-05T00:00:00Z,5,5,2020,35,0,Puerto_Rico,PR,PRI,3195153,America,97,1843,39
2020-05-06T00:00:00Z,6,5,2020,81,2,Puerto_Rico,PR,PRI,3195153,America,99,1924,40
2020-05-07T00:00:00Z,7,5,2020,44,0,Puerto_Rico,PR,PRI,3195153,America,99,1968,41
2020-05-08T00:00:00Z,8,5,2020,63,3,Puerto_Rico,PR,PRI,3195153,America,102,2031,42
2020-05-09T00:00:00Z,9,5,2020,125,5,Puerto_Rico,PR,PRI,3195153,America,107,2156,43
2020-05-10T00:00:00Z,10,5,2020,17,1,Puerto_Rico,PR,PRI,3195153,America,108,2173,44
2020-05-11T00:00:00Z,11,5,2020,25,3,Puerto_Rico,PR,PRI,3195153,America,111,2198,45
2020-05-12T00:00:00Z,12,5,2020,58,2,Puerto_Rico,PR,PRI,3195153,America,113,2256,46
2020-05-13T00:00:00Z,13,5,2020,43,1,Puerto_Rico,PR,PRI,3195153,America,114,2299,47
2020-05-14T00:00:00Z,14,5,2020,30,1,Puerto_Rico,PR,PRI,3195153,America,115,2329,48
2020-05-15T00:00:00Z,15,5,2020,98,2,Puerto_Rico,PR,PRI,3195153,America,117,2427,49
2020-05-16T00:00:00Z,16,5,2020,115,5,Puerto_Rico,PR,PRI,3195153,America,122,2542,50
2020-05-17T00:00:00Z,17,5,2020,47,0,Puerto_Rico,PR,PRI,3195153,America,122,2589,51
2020-05-18T00:00:00Z,18,5,2020,57,1,Puerto_Rico,PR,PRI,3195153,America,123,2646,52
2020-05-19T00:00:00Z,19,5,2020,64,1,Puerto_Rico,PR,PRI,3195153,America,124,2710,53
2020-05-20T00:00:00Z,20,5,2020,95,0,Puerto_Rico,PR,PRI,3195153,America,124,2805,54
2020-05-21T00:00:00Z,21,5,2020,61,1,Puerto_Rico,PR,PRI,3195153,America,125,2866,55
2020-05-22T00:00:00Z,22,5,2020,47,1,Puerto_Rico,PR,PRI,3195153,America,126,2913,56
2020-05-23T00:00:00Z,23,5,2020,117,0,Puerto_Rico,PR,PRI,3195153,America,126,3030,57
2020-05-24T00:00:00Z,24,5,2020,70,1,Puerto_Rico,PR,PRI,3195153,America,127,3100,58
2020-05-25T00:00:00Z,25,5,2020,89,0,Puerto_Rico,PR,PRI,3195153,America,127,3189,59
2020-05-26T00:00:00Z,26,5,2020,71,2,Puerto_Rico,PR,PRI,3195153,America,129,3260,60
2020-05-27T00:00:00Z,27,5,2020,64,0,Puerto_Rico,PR,PRI,3195153,America,129,3324,61
2020-03-29T00:00:00Z,29,3,2020,28,1,Qatar,QA,QAT,2781677,Asia,1,590,1
2020-03-30T00:00:00Z,30,3,2020,44,0,Qatar,QA,QAT,2781677,Asia,1,634,2
2020-03-31T00:00:00Z,31,3,2020,59,0,Qatar,QA,QAT,2781677,Asia,1,693,3
2020-04-01T00:00:00Z,1,4,2020,88,1,Qatar,QA,QAT,2781677,Asia,2,781,4
2020-04-02T00:00:00Z,2,4,2020,54,0,Qatar,QA,QAT,2781677,Asia,2,835,5
2020-04-03T00:00:00Z,3,4,2020,114,1,Qatar,QA,QAT,2781677,Asia,3,949,6
2020-04-04T00:00:00Z,4,4,2020,0,0,Qatar,QA,QAT,2781677,Asia,3,949,7
2020-04-05T00:00:00Z,5,4,2020,376,0,Qatar,QA,QAT,2781677,Asia,3,1325,8
2020-04-06T00:00:00Z,6,4,2020,279,1,Qatar,QA,QAT,2781677,Asia,4,1604,9
2020-04-07T00:00:00Z,7,4,2020,228,0,Qatar,QA,QAT,2781677,Asia,4,1832,10
2020-04-08T00:00:00Z,8,4,2020,225,2,Qatar,QA,QAT,2781677,Asia,6,2057,11
2020-04-09T00:00:00Z,9,4,2020,153,0,Qatar,QA,QAT,2781677,Asia,6,2210,12
2020-04-10T00:00:00Z,10,4,2020,166,0,Qatar,QA,QAT,2781677,Asia,6,2376,13
2020-04-11T00:00:00Z,11,4,2020,136,0,Qatar,QA,QAT,2781677,Asia,6,2512,14
2020-04-12T00:00:00Z,12,4,2020,216,0,Qatar,QA,QAT,2781677,Asia,6,2728,15
2020-04-13T00:00:00Z,13,4,2020,251,1,Qatar,QA,QAT,2781677,Asia,7,2979,16
2020-04-14T00:00:00Z,14,4,2020,252,0,Qatar,QA,QAT,2781677,Asia,7,3231,17
2020-04-15T00:00:00Z,15,4,2020,197,0,Qatar,QA,QAT,2781677,Asia,7,3428,18
2020-04-16T00:00:00Z,16,4,2020,283,0,Qatar,QA,QAT,2781677,Asia,7,3711,19
2020-04-17T00:00:00Z,17,4,2020,392,0,Qatar,QA,QAT,2781677,Asia,7,4103,20
2020-04-18T00:00:00Z,18,4,2020,560,0,Qatar,QA,QAT,2781677,Asia,7,4663,21
2020-04-19T00:00:00Z,19,4,2020,345,1,Qatar,QA,QAT,2781677,Asia,8,5008,22
2020-04-20T00:00:00Z,20,4,2020,440,0,Qatar,QA,QAT,2781677,Asia,8,5448,23
2020-04-21T00:00:00Z,21,4,2020,567,1,Qatar,QA,QAT,2781677,Asia,9,6015,24
2020-04-22T00:00:00Z,22,4,2020,518,0,Qatar,QA,QAT,2781677,Asia,9,6533,25
2020-04-23T00:00:00Z,23,4,2020,608,1,Qatar,QA,QAT,2781677,Asia,10,7141,26
2020-04-24T00:00:00Z,24,4,2020,623,0,Qatar,QA,QAT,2781677,Asia,10,7764,27
2020-04-25T00:00:00Z,25,4,2020,761,0,Qatar,QA,QAT,2781677,Asia,10,8525,28
2020-04-26T00:00:00Z,26,4,2020,833,0,Qatar,QA,QAT,2781677,Asia,10,9358,29
2020-04-27T00:00:00Z,27,4,2020,929,0,Qatar,QA,QAT,2781677,Asia,10,10287,30
2020-04-28T00:00:00Z,28,4,2020,957,0,Qatar,QA,QAT,2781677,Asia,10,11244,31
2020-04-29T00:00:00Z,29,4,2020,677,0,Qatar,QA,QAT,2781677,Asia,10,11921,32
2020-04-30T00:00:00Z,30,4,2020,643,0,Qatar,QA,QAT,2781677,Asia,10,12564,33
2020-05-01T00:00:00Z,1,5,2020,845,0,Qatar,QA,QAT,2781677,Asia,10,13409,34
2020-05-02T00:00:00Z,2,5,2020,687,2,Qatar,QA,QAT,2781677,Asia,12,14096,35
2020-05-03T00:00:00Z,3,5,2020,776,0,Qatar,QA,QAT,2781677,Asia,12,14872,36
2020-05-04T00:00:00Z,4,5,2020,679,0,Qatar,QA,QAT,2781677,Asia,12,15551,37
2020-05-05T00:00:00Z,5,5,2020,640,0,Qatar,QA,QAT,2781677,Asia,12,16191,38
2020-05-06T00:00:00Z,6,5,2020,951,0,Qatar,QA,QAT,2781677,Asia,12,17142,39
2020-05-07T00:00:00Z,7,5,2020,830,0,Qatar,QA,QAT,2781677,Asia,12,17972,40
2020-05-08T00:00:00Z,8,5,2020,918,0,Qatar,QA,QAT,2781677,Asia,12,18890,41
2020-05-09T00:00:00Z,9,5,2020,1311,0,Qatar,QA,QAT,2781677,Asia,12,20201,42
2020-05-10T00:00:00Z,10,5,2020,1130,1,Qatar,QA,QAT,2781677,Asia,13,21331,43
2020-05-11T00:00:00Z,11,5,2020,1189,1,Qatar,QA,QAT,2781677,Asia,14,22520,44
2020-05-12T00:00:00Z,12,5,2020,1103,0,Qatar,QA,QAT,2781677,Asia,14,23623,45
2020-05-13T00:00:00Z,13,5,2020,1526,0,Qatar,QA,QAT,2781677,Asia,14,25149,46
2020-05-14T00:00:00Z,14,5,2020,1390,0,Qatar,QA,QAT,2781677,Asia,14,26539,47
2020-05-15T00:00:00Z,15,5,2020,1733,0,Qatar,QA,QAT,2781677,Asia,14,28272,48
2020-05-16T00:00:00Z,16,5,2020,1153,0,Qatar,QA,QAT,2781677,Asia,14,29425,49
2020-05-17T00:00:00Z,17,5,2020,1547,1,Qatar,QA,QAT,2781677,Asia,15,30972,50
2020-05-18T00:00:00Z,18,5,2020,1632,0,Qatar,QA,QAT,2781677,Asia,15,32604,51
2020-05-19T00:00:00Z,19,5,2020,1365,0,Qatar,QA,QAT,2781677,Asia,15,33969,52
2020-05-20T00:00:00Z,20,5,2020,1637,0,Qatar,QA,QAT,2781677,Asia,15,35606,53
2020-05-21T00:00:00Z,21,5,2020,1491,1,Qatar,QA,QAT,2781677,Asia,16,37097,54
2020-05-22T00:00:00Z,22,5,2020,1554,1,Qatar,QA,QAT,2781677,Asia,17,38651,55
2020-05-23T00:00:00Z,23,5,2020,1830,2,Qatar,QA,QAT,2781677,Asia,19,40481,56
2020-05-24T00:00:00Z,24,5,2020,1732,2,Qatar,QA,QAT,2781677,Asia,21,42213,57
2020-05-25T00:00:00Z,25,5,2020,1501,2,Qatar,QA,QAT,2781677,Asia,23,43714,58
2020-05-26T00:00:00Z,26,5,2020,1751,3,Qatar,QA,QAT,2781677,Asia,26,45465,59
2020-05-27T00:00:00Z,27,5,2020,1742,2,Qatar,QA,QAT,2781677,Asia,28,47207,60
2020-03-23T00:00:00Z,23,3,2020,66,2,Romania,RO,ROU,19473936,Europe,2,433,1
2020-03-24T00:00:00Z,24,3,2020,143,5,Romania,RO,ROU,19473936,Europe,7,576,2
2020-03-25T00:00:00Z,25,3,2020,186,4,Romania,RO,ROU,19473936,Europe,11,762,3
2020-03-26T00:00:00Z,26,3,2020,144,2,Romania,RO,ROU,19473936,Europe,13,906,4
2020-03-27T00:00:00Z,27,3,2020,123,4,Romania,RO,ROU,19473936,Europe,17,1029,5
2020-03-28T00:00:00Z,28,3,2020,263,7,Romania,RO,ROU,19473936,Europe,24,1292,6
2020-03-29T00:00:00Z,29,3,2020,160,5,Romania,RO,ROU,19473936,Europe,29,1452,7
2020-03-30T00:00:00Z,30,3,2020,308,11,Romania,RO,ROU,19473936,Europe,40,1760,8
2020-03-31T00:00:00Z,31,3,2020,192,4,Romania,RO,ROU,19473936,Europe,44,1952,9
2020-04-01T00:00:00Z,1,4,2020,293,25,Romania,RO,ROU,19473936,Europe,69,2245,10
2020-04-02T00:00:00Z,2,4,2020,215,16,Romania,RO,ROU,19473936,Europe,85,2460,11
2020-04-03T00:00:00Z,3,4,2020,278,9,Romania,RO,ROU,19473936,Europe,94,2738,12
2020-04-04T00:00:00Z,4,4,2020,445,39,Romania,RO,ROU,19473936,Europe,133,3183,13
2020-04-05T00:00:00Z,5,4,2020,430,8,Romania,RO,ROU,19473936,Europe,141,3613,14
2020-04-06T00:00:00Z,6,4,2020,251,7,Romania,RO,ROU,19473936,Europe,148,3864,15
2020-04-07T00:00:00Z,7,4,2020,193,9,Romania,RO,ROU,19473936,Europe,157,4057,16
2020-04-08T00:00:00Z,8,4,2020,360,25,Romania,RO,ROU,19473936,Europe,182,4417,17
2020-04-09T00:00:00Z,9,4,2020,344,27,Romania,RO,ROU,19473936,Europe,209,4761,18
2020-04-10T00:00:00Z,10,4,2020,441,20,Romania,RO,ROU,19473936,Europe,229,5202,19
2020-04-11T00:00:00Z,11,4,2020,265,28,Romania,RO,ROU,19473936,Europe,257,5467,20
2020-04-12T00:00:00Z,12,4,2020,523,25,Romania,RO,ROU,19473936,Europe,282,5990,21
2020-04-13T00:00:00Z,13,4,2020,310,24,Romania,RO,ROU,19473936,Europe,306,6300,22
2020-04-14T00:00:00Z,14,4,2020,333,12,Romania,RO,ROU,19473936,Europe,318,6633,23
2020-04-15T00:00:00Z,15,4,2020,246,26,Romania,RO,ROU,19473936,Europe,344,6879,24
2020-04-16T00:00:00Z,16,4,2020,337,28,Romania,RO,ROU,19473936,Europe,372,7216,25
2020-04-17T00:00:00Z,17,4,2020,491,15,Romania,RO,ROU,19473936,Europe,387,7707,26
2020-04-18T00:00:00Z,18,4,2020,360,13,Romania,RO,ROU,19473936,Europe,400,8067,27
2020-04-19T00:00:00Z,19,4,2020,351,17,Romania,RO,ROU,19473936,Europe,417,8418,28
2020-04-20T00:00:00Z,20,4,2020,328,17,Romania,RO,ROU,19473936,Europe,434,8746,29
2020-04-21T00:00:00Z,21,4,2020,190,17,Romania,RO,ROU,19473936,Europe,451,8936,30
2020-04-22T00:00:00Z,22,4,2020,306,32,Romania,RO,ROU,19473936,Europe,483,9242,31
2020-04-23T00:00:00Z,23,4,2020,468,25,Romania,RO,ROU,19473936,Europe,508,9710,32
2020-04-24T00:00:00Z,24,4,2020,386,19,Romania,RO,ROU,19473936,Europe,527,10096,33
2020-04-25T00:00:00Z,25,4,2020,321,25,Romania,RO,ROU,19473936,Europe,552,10417,34
2020-04-26T00:00:00Z,26,4,2020,218,23,Romania,RO,ROU,19473936,Europe,575,10635,35
2020-04-27T00:00:00Z,27,4,2020,401,33,Romania,RO,ROU,19473936,Europe,608,11036,36
2020-04-28T00:00:00Z,28,4,2020,303,23,Romania,RO,ROU,19473936,Europe,631,11339,37
2020-04-29T00:00:00Z,29,4,2020,277,19,Romania,RO,ROU,19473936,Europe,650,11616,38
2020-04-30T00:00:00Z,30,4,2020,362,25,Romania,RO,ROU,19473936,Europe,675,11978,39
2020-05-01T00:00:00Z,1,5,2020,262,42,Romania,RO,ROU,19473936,Europe,717,12240,40
2020-05-02T00:00:00Z,2,5,2020,327,27,Romania,RO,ROU,19473936,Europe,744,12567,41
2020-05-03T00:00:00Z,3,5,2020,165,27,Romania,RO,ROU,19473936,Europe,771,12732,42
2020-05-04T00:00:00Z,4,5,2020,431,9,Romania,RO,ROU,19473936,Europe,780,13163,43
2020-05-05T00:00:00Z,5,5,2020,349,23,Romania,RO,ROU,19473936,Europe,803,13512,44
2020-05-06T00:00:00Z,6,5,2020,325,24,Romania,RO,ROU,19473936,Europe,827,13837,45
2020-05-07T00:00:00Z,7,5,2020,270,31,Romania,RO,ROU,19473936,Europe,858,14107,46
2020-05-08T00:00:00Z,8,5,2020,392,18,Romania,RO,ROU,19473936,Europe,876,14499,47
2020-05-09T00:00:00Z,9,5,2020,312,22,Romania,RO,ROU,19473936,Europe,898,14811,48
2020-05-10T00:00:00Z,10,5,2020,320,28,Romania,RO,ROU,19473936,Europe,926,15131,49
2020-05-11T00:00:00Z,11,5,2020,231,26,Romania,RO,ROU,19473936,Europe,952,15362,50
2020-05-12T00:00:00Z,12,5,2020,226,20,Romania,RO,ROU,19473936,Europe,972,15588,51
2020-05-13T00:00:00Z,13,5,2020,190,30,Romania,RO,ROU,19473936,Europe,1002,15778,52
2020-05-14T00:00:00Z,14,5,2020,224,14,Romania,RO,ROU,19473936,Europe,1016,16002,53
2020-05-15T00:00:00Z,15,5,2020,245,30,Romania,RO,ROU,19473936,Europe,1046,16247,54
2020-05-16T00:00:00Z,16,5,2020,190,10,Romania,RO,ROU,19473936,Europe,1056,16437,55
2020-05-17T00:00:00Z,17,5,2020,267,25,Romania,RO,ROU,19473936,Europe,1081,16704,56
2020-05-18T00:00:00Z,18,5,2020,167,16,Romania,RO,ROU,19473936,Europe,1097,16871,57
2020-05-19T00:00:00Z,19,5,2020,165,10,Romania,RO,ROU,19473936,Europe,1107,17036,58
2020-05-20T00:00:00Z,20,5,2020,155,19,Romania,RO,ROU,19473936,Europe,1126,17191,59
2020-05-21T00:00:00Z,21,5,2020,196,15,Romania,RO,ROU,19473936,Europe,1141,17387,60
2020-05-22T00:00:00Z,22,5,2020,198,10,Romania,RO,ROU,19473936,Europe,1151,17585,61
2020-05-23T00:00:00Z,23,5,2020,127,8,Romania,RO,ROU,19473936,Europe,1159,17712,62
2020-05-24T00:00:00Z,24,5,2020,145,11,Romania,RO,ROU,19473936,Europe,1170,17857,63
2020-05-25T00:00:00Z,25,5,2020,213,9,Romania,RO,ROU,19473936,Europe,1179,18070,64
2020-05-26T00:00:00Z,26,5,2020,213,18,Romania,RO,ROU,19473936,Europe,1197,18283,65
2020-05-27T00:00:00Z,27,5,2020,146,13,Romania,RO,ROU,19473936,Europe,1210,18429,66
2020-03-27T00:00:00Z,27,3,2020,182,2,Russia,RU,RUS,144478050,Europe,2,840,1
2020-03-28T00:00:00Z,28,3,2020,196,2,Russia,RU,RUS,144478050,Europe,4,1036,2
2020-03-29T00:00:00Z,29,3,2020,228,1,Russia,RU,RUS,144478050,Europe,5,1264,3
2020-03-30T00:00:00Z,30,3,2020,270,3,Russia,RU,RUS,144478050,Europe,8,1534,4
2020-03-31T00:00:00Z,31,3,2020,302,2,Russia,RU,RUS,144478050,Europe,10,1836,5
2020-04-01T00:00:00Z,1,4,2020,501,7,Russia,RU,RUS,144478050,Europe,17,2337,6
2020-04-02T00:00:00Z,2,4,2020,440,7,Russia,RU,RUS,144478050,Europe,24,2777,7
2020-04-03T00:00:00Z,3,4,2020,771,6,Russia,RU,RUS,144478050,Europe,30,3548,8
2020-04-04T00:00:00Z,4,4,2020,601,4,Russia,RU,RUS,144478050,Europe,34,4149,9
2020-04-05T00:00:00Z,5,4,2020,582,9,Russia,RU,RUS,144478050,Europe,43,4731,10
2020-04-06T00:00:00Z,6,4,2020,658,2,Russia,RU,RUS,144478050,Europe,45,5389,11
2020-04-07T00:00:00Z,7,4,2020,954,2,Russia,RU,RUS,144478050,Europe,47,6343,12
2020-04-08T00:00:00Z,8,4,2020,1154,11,Russia,RU,RUS,144478050,Europe,58,7497,13
2020-04-09T00:00:00Z,9,4,2020,1175,5,Russia,RU,RUS,144478050,Europe,63,8672,14
2020-04-10T00:00:00Z,10,4,2020,1459,13,Russia,RU,RUS,144478050,Europe,76,10131,15
2020-04-11T00:00:00Z,11,4,2020,1786,18,Russia,RU,RUS,144478050,Europe,94,11917,16
2020-04-12T00:00:00Z,12,4,2020,1667,12,Russia,RU,RUS,144478050,Europe,106,13584,17
2020-04-13T00:00:00Z,13,4,2020,2186,24,Russia,RU,RUS,144478050,Europe,130,15770,18
2020-04-14T00:00:00Z,14,4,2020,2558,18,Russia,RU,RUS,144478050,Europe,148,18328,19
2020-04-15T00:00:00Z,15,4,2020,2774,22,Russia,RU,RUS,144478050,Europe,170,21102,20
2020-04-16T00:00:00Z,16,4,2020,3388,28,Russia,RU,RUS,144478050,Europe,198,24490,21
2020-04-17T00:00:00Z,17,4,2020,3448,34,Russia,RU,RUS,144478050,Europe,232,27938,22
2020-04-18T00:00:00Z,18,4,2020,4070,41,Russia,RU,RUS,144478050,Europe,273,32008,23
2020-04-19T00:00:00Z,19,4,2020,4785,40,Russia,RU,RUS,144478050,Europe,313,36793,24
2020-04-20T00:00:00Z,20,4,2020,6060,48,Russia,RU,RUS,144478050,Europe,361,42853,25
2020-04-21T00:00:00Z,21,4,2020,4268,44,Russia,RU,RUS,144478050,Europe,405,47121,26
2020-04-22T00:00:00Z,22,4,2020,5642,51,Russia,RU,RUS,144478050,Europe,456,52763,27
2020-04-23T00:00:00Z,23,4,2020,5236,57,Russia,RU,RUS,144478050,Europe,513,57999,28
2020-04-24T00:00:00Z,24,4,2020,4774,42,Russia,RU,RUS,144478050,Europe,555,62773,29
2020-04-25T00:00:00Z,25,4,2020,5849,60,Russia,RU,RUS,144478050,Europe,615,68622,30
2020-04-26T00:00:00Z,26,4,2020,5966,66,Russia,RU,RUS,144478050,Europe,681,74588,31
2020-04-27T00:00:00Z,27,4,2020,6361,66,Russia,RU,RUS,144478050,Europe,747,80949,32
2020-04-28T00:00:00Z,28,4,2020,6198,48,Russia,RU,RUS,144478050,Europe,795,87147,33
2020-04-29T00:00:00Z,29,4,2020,6411,72,Russia,RU,RUS,144478050,Europe,867,93558,34
2020-04-30T00:00:00Z,30,4,2020,5841,105,Russia,RU,RUS,144478050,Europe,972,99399,35
2020-05-01T00:00:00Z,1,5,2020,7099,101,Russia,RU,RUS,144478050,Europe,1073,106498,36
2020-05-02T00:00:00Z,2,5,2020,7933,96,Russia,RU,RUS,144478050,Europe,1169,114431,37
2020-05-03T00:00:00Z,3,5,2020,9623,53,Russia,RU,RUS,144478050,Europe,1222,124054,38
2020-05-04T00:00:00Z,4,5,2020,10633,58,Russia,RU,RUS,144478050,Europe,1280,134687,39
2020-05-05T00:00:00Z,5,5,2020,10581,76,Russia,RU,RUS,144478050,Europe,1356,145268,40
2020-05-06T00:00:00Z,6,5,2020,10102,95,Russia,RU,RUS,144478050,Europe,1451,155370,41
2020-05-07T00:00:00Z,7,5,2020,10559,86,Russia,RU,RUS,144478050,Europe,1537,165929,42
2020-05-08T00:00:00Z,8,5,2020,11231,88,Russia,RU,RUS,144478050,Europe,1625,177160,43
2020-05-09T00:00:00Z,9,5,2020,10699,98,Russia,RU,RUS,144478050,Europe,1723,187859,44
2020-05-10T00:00:00Z,10,5,2020,10817,104,Russia,RU,RUS,144478050,Europe,1827,198676,45
2020-05-11T00:00:00Z,11,5,2020,11012,88,Russia,RU,RUS,144478050,Europe,1915,209688,46
2020-05-12T00:00:00Z,12,5,2020,11656,94,Russia,RU,RUS,144478050,Europe,2009,221344,47
2020-05-13T00:00:00Z,13,5,2020,10899,107,Russia,RU,RUS,144478050,Europe,2116,232243,48
2020-05-14T00:00:00Z,14,5,2020,10028,96,Russia,RU,RUS,144478050,Europe,2212,242271,49
2020-05-15T00:00:00Z,15,5,2020,9974,93,Russia,RU,RUS,144478050,Europe,2305,252245,50
2020-05-16T00:00:00Z,16,5,2020,10598,113,Russia,RU,RUS,144478050,Europe,2418,262843,51
2020-05-17T00:00:00Z,17,5,2020,9200,119,Russia,RU,RUS,144478050,Europe,2537,272043,52
2020-05-18T00:00:00Z,18,5,2020,9709,94,Russia,RU,RUS,144478050,Europe,2631,281752,53
2020-05-19T00:00:00Z,19,5,2020,8926,91,Russia,RU,RUS,144478050,Europe,2722,290678,54
2020-05-20T00:00:00Z,20,5,2020,9263,115,Russia,RU,RUS,144478050,Europe,2837,299941,55
2020-05-21T00:00:00Z,21,5,2020,8764,135,Russia,RU,RUS,144478050,Europe,2972,308705,56
2020-05-22T00:00:00Z,22,5,2020,8849,127,Russia,RU,RUS,144478050,Europe,3099,317554,57
2020-05-23T00:00:00Z,23,5,2020,8894,150,Russia,RU,RUS,144478050,Europe,3249,326448,58
2020-05-24T00:00:00Z,24,5,2020,9434,139,Russia,RU,RUS,144478050,Europe,3388,335882,59
2020-05-25T00:00:00Z,25,5,2020,8599,153,Russia,RU,RUS,144478050,Europe,3541,344481,60
2020-05-26T00:00:00Z,26,5,2020,8946,92,Russia,RU,RUS,144478050,Europe,3633,353427,61
2020-05-27T00:00:00Z,27,5,2020,8915,174,Russia,RU,RUS,144478050,Europe,3807,362342,62
2020-03-02T00:00:00Z,2,3,2020,7,1,San_Marino,SM,SMR,33785,Europe,1,8,1
2020-03-04T00:00:00Z,4,3,2020,2,0,San_Marino,SM,SMR,33785,Europe,1,10,2
2020-03-05T00:00:00Z,5,3,2020,5,0,San_Marino,SM,SMR,33785,Europe,1,15,3
2020-03-06T00:00:00Z,6,3,2020,7,0,San_Marino,SM,SMR,33785,Europe,1,22,4
2020-03-07T00:00:00Z,7,3,2020,1,0,San_Marino,SM,SMR,33785,Europe,1,23,5
2020-03-08T00:00:00Z,8,3,2020,3,0,San_Marino,SM,SMR,33785,Europe,1,26,6
2020-03-09T00:00:00Z,9,3,2020,11,0,San_Marino,SM,SMR,33785,Europe,1,37,7
2020-03-10T00:00:00Z,10,3,2020,12,1,San_Marino,SM,SMR,33785,Europe,2,49,8
2020-03-11T00:00:00Z,11,3,2020,13,0,San_Marino,SM,SMR,33785,Europe,2,62,9
2020-03-12T00:00:00Z,12,3,2020,4,1,San_Marino,SM,SMR,33785,Europe,3,66,10
2020-03-13T00:00:00Z,13,3,2020,1,2,San_Marino,SM,SMR,33785,Europe,5,67,11
2020-03-14T00:00:00Z,14,3,2020,6,0,San_Marino,SM,SMR,33785,Europe,5,73,12
2020-03-15T00:00:00Z,15,3,2020,19,0,San_Marino,SM,SMR,33785,Europe,5,92,13
2020-03-16T00:00:00Z,16,3,2020,6,2,San_Marino,SM,SMR,33785,Europe,7,98,14
2020-03-17T00:00:00Z,17,3,2020,4,2,San_Marino,SM,SMR,33785,Europe,9,102,15
2020-03-18T00:00:00Z,18,3,2020,2,2,San_Marino,SM,SMR,33785,Europe,11,104,16
2020-03-19T00:00:00Z,19,3,2020,5,3,San_Marino,SM,SMR,33785,Europe,14,109,17
2020-03-20T00:00:00Z,20,3,2020,17,0,San_Marino,SM,SMR,33785,Europe,14,126,18
2020-03-21T00:00:00Z,21,3,2020,25,0,San_Marino,SM,SMR,33785,Europe,14,151,19
2020-03-22T00:00:00Z,22,3,2020,0,6,San_Marino,SM,SMR,33785,Europe,20,151,20
2020-03-23T00:00:00Z,23,3,2020,0,0,San_Marino,SM,SMR,33785,Europe,20,151,21
2020-03-24T00:00:00Z,24,3,2020,36,0,San_Marino,SM,SMR,33785,Europe,20,187,22
2020-03-25T00:00:00Z,25,3,2020,0,1,San_Marino,SM,SMR,33785,Europe,21,187,23
2020-03-26T00:00:00Z,26,3,2020,21,0,San_Marino,SM,SMR,33785,Europe,21,208,24
2020-03-27T00:00:00Z,27,3,2020,10,0,San_Marino,SM,SMR,33785,Europe,21,218,25
2020-03-28T00:00:00Z,28,3,2020,5,0,San_Marino,SM,SMR,33785,Europe,21,223,26
2020-03-29T00:00:00Z,29,3,2020,1,1,San_Marino,SM,SMR,33785,Europe,22,224,27
2020-03-30T00:00:00Z,30,3,2020,5,2,San_Marino,SM,SMR,33785,Europe,24,229,28
2020-03-31T00:00:00Z,31,3,2020,0,1,San_Marino,SM,SMR,33785,Europe,25,229,29
2020-04-01T00:00:00Z,1,4,2020,1,1,San_Marino,SM,SMR,33785,Europe,26,230,30
2020-04-02T00:00:00Z,2,4,2020,6,0,San_Marino,SM,SMR,33785,Europe,26,236,31
2020-04-03T00:00:00Z,3,4,2020,9,4,San_Marino,SM,SMR,33785,Europe,30,245,32
2020-04-04T00:00:00Z,4,4,2020,6,2,San_Marino,SM,SMR,33785,Europe,32,251,33
2020-04-05T00:00:00Z,5,4,2020,8,0,San_Marino,SM,SMR,33785,Europe,32,259,34
2020-04-06T00:00:00Z,6,4,2020,7,0,San_Marino,SM,SMR,33785,Europe,32,266,35
2020-04-07T00:00:00Z,7,4,2020,11,0,San_Marino,SM,SMR,33785,Europe,32,277,36
2020-04-08T00:00:00Z,8,4,2020,2,2,San_Marino,SM,SMR,33785,Europe,34,279,37
2020-04-09T00:00:00Z,9,4,2020,29,0,San_Marino,SM,SMR,33785,Europe,34,308,38
2020-04-10T00:00:00Z,10,4,2020,25,0,San_Marino,SM,SMR,33785,Europe,34,333,39
2020-04-11T00:00:00Z,11,4,2020,11,0,San_Marino,SM,SMR,33785,Europe,34,344,40
2020-04-12T00:00:00Z,12,4,2020,12,1,San_Marino,SM,SMR,33785,Europe,35,356,41
2020-04-13T00:00:00Z,13,4,2020,0,0,San_Marino,SM,SMR,33785,Europe,35,356,42
2020-04-14T00:00:00Z,14,4,2020,0,1,San_Marino,SM,SMR,33785,Europe,36,356,43
2020-04-15T00:00:00Z,15,4,2020,16,0,San_Marino,SM,SMR,33785,Europe,36,372,44
2020-04-16T00:00:00Z,16,4,2020,20,0,San_Marino,SM,SMR,33785,Europe,36,392,45
2020-04-17T00:00:00Z,17,4,2020,34,2,San_Marino,SM,SMR,33785,Europe,38,426,46
2020-04-18T00:00:00Z,18,4,2020,9,1,San_Marino,SM,SMR,33785,Europe,39,435,47
2020-04-19T00:00:00Z,19,4,2020,20,0,San_Marino,SM,SMR,33785,Europe,39,455,48
2020-04-20T00:00:00Z,20,4,2020,6,0,San_Marino,SM,SMR,33785,Europe,39,461,49
2020-04-21T00:00:00Z,21,4,2020,1,0,San_Marino,SM,SMR,33785,Europe,39,462,50
2020-04-22T00:00:00Z,22,4,2020,14,1,San_Marino,SM,SMR,33785,Europe,40,476,51
2020-04-23T00:00:00Z,23,4,2020,12,0,San_Marino,SM,SMR,33785,Europe,40,488,52
2020-04-24T00:00:00Z,24,4,2020,13,0,San_Marino,SM,SMR,33785,Europe,40,501,53
2020-04-25T00:00:00Z,25,4,2020,12,0,San_Marino,SM,SMR,33785,Europe,40,513,54
2020-04-26T00:00:00Z,26,4,2020,0,0,San_Marino,SM,SMR,33785,Europe,40,513,55
2020-04-27T00:00:00Z,27,4,2020,25,1,San_Marino,SM,SMR,33785,Europe,41,538,56
2020-04-28T00:00:00Z,28,4,2020,0,0,San_Marino,SM,SMR,33785,Europe,41,538,57
2020-04-29T00:00:00Z,29,4,2020,15,0,San_Marino,SM,SMR,33785,Europe,41,553,58
2020-04-30T00:00:00Z,30,4,2020,10,0,San_Marino,SM,SMR,33785,Europe,41,563,59
2020-05-01T00:00:00Z,1,5,2020,6,0,San_Marino,SM,SMR,33785,Europe,41,569,60
2020-05-02T00:00:00Z,2,5,2020,11,0,San_Marino,SM,SMR,33785,Europe,41,580,61
2020-05-03T00:00:00Z,3,5,2020,0,0,San_Marino,SM,SMR,33785,Europe,41,580,62
2020-05-04T00:00:00Z,4,5,2020,2,0,San_Marino,SM,SMR,33785,Europe,41,582,63
2020-05-05T00:00:00Z,5,5,2020,0,0,San_Marino,SM,SMR,33785,Europe,41,582,64
2020-05-06T00:00:00Z,6,5,2020,7,0,San_Marino,SM,SMR,33785,Europe,41,589,65
2020-05-07T00:00:00Z,7,5,2020,19,0,San_Marino,SM,SMR,33785,Europe,41,608,66
2020-05-08T00:00:00Z,8,5,2020,14,0,San_Marino,SM,SMR,33785,Europe,41,622,67
2020-05-09T00:00:00Z,9,5,2020,1,0,San_Marino,SM,SMR,33785,Europe,41,623,68
2020-05-10T00:00:00Z,10,5,2020,14,0,San_Marino,SM,SMR,33785,Europe,41,637,69
2020-05-11T00:00:00Z,11,5,2020,-9,0,San_Marino,SM,SMR,33785,Europe,41,628,70
2020-05-12T00:00:00Z,12,5,2020,0,0,San_Marino,SM,SMR,33785,Europe,41,628,71
2020-05-13T00:00:00Z,13,5,2020,10,0,San_Marino,SM,SMR,33785,Europe,41,638,72
2020-05-14T00:00:00Z,14,5,2020,5,0,San_Marino,SM,SMR,33785,Europe,41,643,73
2020-05-15T00:00:00Z,15,5,2020,5,0,San_Marino,SM,SMR,33785,Europe,41,648,74
2020-05-16T00:00:00Z,16,5,2020,4,0,San_Marino,SM,SMR,33785,Europe,41,652,75
2020-05-17T00:00:00Z,17,5,2020,1,0,San_Marino,SM,SMR,33785,Europe,41,653,76
2020-05-18T00:00:00Z,18,5,2020,1,0,San_Marino,SM,SMR,33785,Europe,41,654,77
2020-05-19T00:00:00Z,19,5,2020,0,0,San_Marino,SM,SMR,33785,Europe,41,654,78
2020-05-20T00:00:00Z,20,5,2020,1,0,San_Marino,SM,SMR,33785,Europe,41,655,79
2020-05-21T00:00:00Z,21,5,2020,1,0,San_Marino,SM,SMR,33785,Europe,41,656,80
2020-05-22T00:00:00Z,22,5,2020,2,0,San_Marino,SM,SMR,33785,Europe,41,658,81
2020-05-23T00:00:00Z,23,5,2020,3,0,San_Marino,SM,SMR,33785,Europe,41,661,82
2020-05-24T00:00:00Z,24,5,2020,4,1,San_Marino,SM,SMR,33785,Europe,42,665,83
2020-05-25T00:00:00Z,25,5,2020,0,0,San_Marino,SM,SMR,33785,Europe,42,665,84
2020-05-26T00:00:00Z,26,5,2020,1,0,San_Marino,SM,SMR,33785,Europe,42,666,85
2020-05-27T00:00:00Z,27,5,2020,0,0,San_Marino,SM,SMR,33785,Europe,42,666,86
2020-05-01T00:00:00Z,1,5,2020,2,1,Sao_Tome_and_Principe,ST,STP,211028,Africa,1,16,1
2020-05-02T00:00:00Z,2,5,2020,2,0,Sao_Tome_and_Principe,ST,STP,211028,Africa,1,18,2
2020-05-03T00:00:00Z,3,5,2020,0,0,Sao_Tome_and_Principe,ST,STP,211028,Africa,1,18,3
2020-05-04T00:00:00Z,4,5,2020,0,0,Sao_Tome_and_Principe,ST,STP,211028,Africa,1,18,4
2020-05-05T00:00:00Z,5,5,2020,156,2,Sao_Tome_and_Principe,ST,STP,211028,Africa,3,174,5
2020-05-06T00:00:00Z,6,5,2020,0,0,Sao_Tome_and_Principe,ST,STP,211028,Africa,3,174,6
2020-05-07T00:00:00Z,7,5,2020,0,0,Sao_Tome_and_Principe,ST,STP,211028,Africa,3,174,7
2020-05-08T00:00:00Z,8,5,2020,13,1,Sao_Tome_and_Principe,ST,STP,211028,Africa,4,187,8
2020-05-09T00:00:00Z,9,5,2020,21,1,Sao_Tome_and_Principe,ST,STP,211028,Africa,5,208,9
2020-05-10T00:00:00Z,10,5,2020,0,0,Sao_Tome_and_Principe,ST,STP,211028,Africa,5,208,10
2020-05-11T00:00:00Z,11,5,2020,0,0,Sao_Tome_and_Principe,ST,STP,211028,Africa,5,208,11
2020-05-12T00:00:00Z,12,5,2020,4,0,Sao_Tome_and_Principe,ST,STP,211028,Africa,5,212,12
2020-05-13T00:00:00Z,13,5,2020,8,1,Sao_Tome_and_Principe,ST,STP,211028,Africa,6,220,13
2020-05-14T00:00:00Z,14,5,2020,15,1,Sao_Tome_and_Principe,ST,STP,211028,Africa,7,235,14
2020-05-15T00:00:00Z,15,5,2020,0,0,Sao_Tome_and_Principe,ST,STP,211028,Africa,7,235,15
2020-05-16T00:00:00Z,16,5,2020,0,0,Sao_Tome_and_Principe,ST,STP,211028,Africa,7,235,16
2020-05-17T00:00:00Z,17,5,2020,0,0,Sao_Tome_and_Principe,ST,STP,211028,Africa,7,235,17
2020-05-18T00:00:00Z,18,5,2020,0,0,Sao_Tome_and_Principe,ST,STP,211028,Africa,7,235,18
2020-05-19T00:00:00Z,19,5,2020,11,0,Sao_Tome_and_Principe,ST,STP,211028,Africa,7,246,19
2020-05-20T00:00:00Z,20,5,2020,5,1,Sao_Tome_and_Principe,ST,STP,211028,Africa,8,251,20
2020-05-21T00:00:00Z,21,5,2020,0,0,Sao_Tome_and_Principe,ST,STP,211028,Africa,8,251,21
2020-05-22T00:00:00Z,22,5,2020,0,0,Sao_Tome_and_Principe,ST,STP,211028,Africa,8,251,22
2020-05-23T00:00:00Z,23,5,2020,0,0,Sao_Tome_and_Principe,ST,STP,211028,Africa,8,251,23
2020-05-24T00:00:00Z,24,5,2020,40,0,Sao_Tome_and_Principe,ST,STP,211028,Africa,8,291,24
2020-05-25T00:00:00Z,25,5,2020,8,1,Sao_Tome_and_Principe,ST,STP,211028,Africa,9,299,25
2020-05-26T00:00:00Z,26,5,2020,0,2,Sao_Tome_and_Principe,ST,STP,211028,Africa,11,299,26
2020-05-27T00:00:00Z,27,5,2020,142,1,Sao_Tome_and_Principe,ST,STP,211028,Africa,12,441,27
2020-03-25T00:00:00Z,25,3,2020,205,1,Saudi_Arabia,SA,SAU,33699947,Asia,1,767,1
2020-03-26T00:00:00Z,26,3,2020,133,1,Saudi_Arabia,SA,SAU,33699947,Asia,2,900,2
2020-03-27T00:00:00Z,27,3,2020,112,1,Saudi_Arabia,SA,SAU,33699947,Asia,3,1012,3
2020-03-28T00:00:00Z,28,3,2020,92,0,Saudi_Arabia,SA,SAU,33699947,Asia,3,1104,4
2020-03-29T00:00:00Z,29,3,2020,99,1,Saudi_Arabia,SA,SAU,33699947,Asia,4,1203,5
2020-03-30T00:00:00Z,30,3,2020,26,4,Saudi_Arabia,SA,SAU,33699947,Asia,8,1229,6
2020-03-31T00:00:00Z,31,3,2020,224,0,Saudi_Arabia,SA,SAU,33699947,Asia,8,1453,7
2020-04-01T00:00:00Z,1,4,2020,110,2,Saudi_Arabia,SA,SAU,33699947,Asia,10,1563,8
2020-04-02T00:00:00Z,2,4,2020,157,6,Saudi_Arabia,SA,SAU,33699947,Asia,16,1720,9
2020-04-03T00:00:00Z,3,4,2020,165,5,Saudi_Arabia,SA,SAU,33699947,Asia,21,1885,10
2020-04-04T00:00:00Z,4,4,2020,0,0,Saudi_Arabia,SA,SAU,33699947,Asia,21,1885,11
2020-04-05T00:00:00Z,5,4,2020,294,8,Saudi_Arabia,SA,SAU,33699947,Asia,29,2179,12
2020-04-06T00:00:00Z,6,4,2020,206,5,Saudi_Arabia,SA,SAU,33699947,Asia,34,2385,13
2020-04-07T00:00:00Z,7,4,2020,138,4,Saudi_Arabia,SA,SAU,33699947,Asia,38,2523,14
2020-04-08T00:00:00Z,8,4,2020,272,3,Saudi_Arabia,SA,SAU,33699947,Asia,41,2795,15
2020-04-09T00:00:00Z,9,4,2020,137,0,Saudi_Arabia,SA,SAU,33699947,Asia,41,2932,16
2020-04-10T00:00:00Z,10,4,2020,355,3,Saudi_Arabia,SA,SAU,33699947,Asia,44,3287,17
2020-04-11T00:00:00Z,11,4,2020,364,3,Saudi_Arabia,SA,SAU,33699947,Asia,47,3651,18
2020-04-12T00:00:00Z,12,4,2020,382,5,Saudi_Arabia,SA,SAU,33699947,Asia,52,4033,19
2020-04-13T00:00:00Z,13,4,2020,429,7,Saudi_Arabia,SA,SAU,33699947,Asia,59,4462,20
2020-04-14T00:00:00Z,14,4,2020,472,6,Saudi_Arabia,SA,SAU,33699947,Asia,65,4934,21
2020-04-15T00:00:00Z,15,4,2020,435,8,Saudi_Arabia,SA,SAU,33699947,Asia,73,5369,22
2020-04-16T00:00:00Z,16,4,2020,493,6,Saudi_Arabia,SA,SAU,33699947,Asia,79,5862,23
2020-04-17T00:00:00Z,17,4,2020,518,4,Saudi_Arabia,SA,SAU,33699947,Asia,83,6380,24
2020-04-18T00:00:00Z,18,4,2020,762,4,Saudi_Arabia,SA,SAU,33699947,Asia,87,7142,25
2020-04-19T00:00:00Z,19,4,2020,1132,5,Saudi_Arabia,SA,SAU,33699947,Asia,92,8274,26
2020-04-20T00:00:00Z,20,4,2020,1088,5,Saudi_Arabia,SA,SAU,33699947,Asia,97,9362,27
2020-04-21T00:00:00Z,21,4,2020,1122,6,Saudi_Arabia,SA,SAU,33699947,Asia,103,10484,28
2020-04-22T00:00:00Z,22,4,2020,1147,6,Saudi_Arabia,SA,SAU,33699947,Asia,109,11631,29
2020-04-23T00:00:00Z,23,4,2020,1141,5,Saudi_Arabia,SA,SAU,33699947,Asia,114,12772,30
2020-04-24T00:00:00Z,24,4,2020,1158,7,Saudi_Arabia,SA,SAU,33699947,Asia,121,13930,31
2020-04-25T00:00:00Z,25,4,2020,1172,6,Saudi_Arabia,SA,SAU,33699947,Asia,127,15102,32
2020-04-26T00:00:00Z,26,4,2020,1197,9,Saudi_Arabia,SA,SAU,33699947,Asia,136,16299,33
2020-04-27T00:00:00Z,27,4,2020,1223,3,Saudi_Arabia,SA,SAU,33699947,Asia,139,17522,34
2020-04-28T00:00:00Z,28,4,2020,1289,5,Saudi_Arabia,SA,SAU,33699947,Asia,144,18811,35
2020-04-29T00:00:00Z,29,4,2020,1266,8,Saudi_Arabia,SA,SAU,33699947,Asia,152,20077,36
2020-04-30T00:00:00Z,30,4,2020,1325,5,Saudi_Arabia,SA,SAU,33699947,Asia,157,21402,37
2020-05-01T00:00:00Z,1,5,2020,1351,5,Saudi_Arabia,SA,SAU,33699947,Asia,162,22753,38
2020-05-02T00:00:00Z,2,5,2020,1344,7,Saudi_Arabia,SA,SAU,33699947,Asia,169,24097,39
2020-05-03T00:00:00Z,3,5,2020,1362,7,Saudi_Arabia,SA,SAU,33699947,Asia,176,25459,40
2020-05-04T00:00:00Z,4,5,2020,1552,8,Saudi_Arabia,SA,SAU,33699947,Asia,184,27011,41
2020-05-05T00:00:00Z,5,5,2020,1645,7,Saudi_Arabia,SA,SAU,33699947,Asia,191,28656,42
2020-05-06T00:00:00Z,6,5,2020,1595,9,Saudi_Arabia,SA,SAU,33699947,Asia,200,30251,43
2020-05-07T00:00:00Z,7,5,2020,1687,9,Saudi_Arabia,SA,SAU,33699947,Asia,209,31938,44
2020-05-08T00:00:00Z,8,5,2020,1793,10,Saudi_Arabia,SA,SAU,33699947,Asia,219,33731,45
2020-05-09T00:00:00Z,9,5,2020,1701,10,Saudi_Arabia,SA,SAU,33699947,Asia,229,35432,46
2020-05-10T00:00:00Z,10,5,2020,1704,10,Saudi_Arabia,SA,SAU,33699947,Asia,239,37136,47
2020-05-11T00:00:00Z,11,5,2020,1912,7,Saudi_Arabia,SA,SAU,33699947,Asia,246,39048,48
2020-05-12T00:00:00Z,12,5,2020,1966,9,Saudi_Arabia,SA,SAU,33699947,Asia,255,41014,49
2020-05-13T00:00:00Z,13,5,2020,1911,9,Saudi_Arabia,SA,SAU,33699947,Asia,264,42925,50
2020-05-14T00:00:00Z,14,5,2020,1905,9,Saudi_Arabia,SA,SAU,33699947,Asia,273,44830,51
2020-05-15T00:00:00Z,15,5,2020,2039,10,Saudi_Arabia,SA,SAU,33699947,Asia,283,46869,52
2020-05-16T00:00:00Z,16,5,2020,2307,9,Saudi_Arabia,SA,SAU,33699947,Asia,292,49176,53
2020-05-17T00:00:00Z,17,5,2020,2840,10,Saudi_Arabia,SA,SAU,33699947,Asia,302,52016,54
2020-05-18T00:00:00Z,18,5,2020,2736,10,Saudi_Arabia,SA,SAU,33699947,Asia,312,54752,55
2020-05-19T00:00:00Z,19,5,2020,2593,8,Saudi_Arabia,SA,SAU,33699947,Asia,320,57345,56
2020-05-20T00:00:00Z,20,5,2020,2509,9,Saudi_Arabia,SA,SAU,33699947,Asia,329,59854,57
2020-05-21T00:00:00Z,21,5,2020,2691,10,Saudi_Arabia,SA,SAU,33699947,Asia,339,62545,58
2020-05-22T00:00:00Z,22,5,2020,2532,12,Saudi_Arabia,SA,SAU,33699947,Asia,351,65077,59
2020-05-23T00:00:00Z,23,5,2020,2642,13,Saudi_Arabia,SA,SAU,33699947,Asia,364,67719,60
2020-05-24T00:00:00Z,24,5,2020,2442,15,Saudi_Arabia,SA,SAU,33699947,Asia,379,70161,61
2020-05-25T00:00:00Z,25,5,2020,2399,11,Saudi_Arabia,SA,SAU,33699947,Asia,390,72560,62
2020-05-26T00:00:00Z,26,5,2020,2235,9,Saudi_Arabia,SA,SAU,33699947,Asia,399,74795,63
2020-05-27T00:00:00Z,27,5,2020,1931,12,Saudi_Arabia,SA,SAU,33699947,Asia,411,76726,64
2020-04-02T00:00:00Z,2,4,2020,15,1,Senegal,SN,SEN,15854360,Africa,1,190,1
2020-04-03T00:00:00Z,3,4,2020,5,0,Senegal,SN,SEN,15854360,Africa,1,195,2
2020-04-04T00:00:00Z,4,4,2020,12,0,Senegal,SN,SEN,15854360,Africa,1,207,3
2020-04-05T00:00:00Z,5,4,2020,12,1,Senegal,SN,SEN,15854360,Africa,2,219,4
2020-04-06T00:00:00Z,6,4,2020,3,0,Senegal,SN,SEN,15854360,Africa,2,222,5
2020-04-07T00:00:00Z,7,4,2020,4,0,Senegal,SN,SEN,15854360,Africa,2,226,6
2020-04-08T00:00:00Z,8,4,2020,11,0,Senegal,SN,SEN,15854360,Africa,2,237,7
2020-04-09T00:00:00Z,9,4,2020,7,0,Senegal,SN,SEN,15854360,Africa,2,244,8
2020-04-10T00:00:00Z,10,4,2020,6,0,Senegal,SN,SEN,15854360,Africa,2,250,9
2020-04-11T00:00:00Z,11,4,2020,15,0,Senegal,SN,SEN,15854360,Africa,2,265,10
2020-04-12T00:00:00Z,12,4,2020,13,0,Senegal,SN,SEN,15854360,Africa,2,278,11
2020-04-13T00:00:00Z,13,4,2020,2,0,Senegal,SN,SEN,15854360,Africa,2,280,12
2020-04-14T00:00:00Z,14,4,2020,11,0,Senegal,SN,SEN,15854360,Africa,2,291,13
2020-04-15T00:00:00Z,15,4,2020,8,0,Senegal,SN,SEN,15854360,Africa,2,299,14
2020-04-16T00:00:00Z,16,4,2020,15,0,Senegal,SN,SEN,15854360,Africa,2,314,15
2020-04-17T00:00:00Z,17,4,2020,21,0,Senegal,SN,SEN,15854360,Africa,2,335,16
2020-04-18T00:00:00Z,18,4,2020,7,1,Senegal,SN,SEN,15854360,Africa,3,342,17
2020-04-19T00:00:00Z,19,4,2020,8,0,Senegal,SN,SEN,15854360,Africa,3,350,18
2020-04-20T00:00:00Z,20,4,2020,17,1,Senegal,SN,SEN,15854360,Africa,4,367,19
2020-04-21T00:00:00Z,21,4,2020,10,1,Senegal,SN,SEN,15854360,Africa,5,377,20
2020-04-22T00:00:00Z,22,4,2020,35,0,Senegal,SN,SEN,15854360,Africa,5,412,21
2020-04-23T00:00:00Z,23,4,2020,30,1,Senegal,SN,SEN,15854360,Africa,6,442,22
2020-04-24T00:00:00Z,24,4,2020,37,0,Senegal,SN,SEN,15854360,Africa,6,479,23
2020-04-25T00:00:00Z,25,4,2020,66,1,Senegal,SN,SEN,15854360,Africa,7,545,24
2020-04-26T00:00:00Z,26,4,2020,69,0,Senegal,SN,SEN,15854360,Africa,7,614,25
2020-04-27T00:00:00Z,27,4,2020,57,2,Senegal,SN,SEN,15854360,Africa,9,671,26
2020-04-28T00:00:00Z,28,4,2020,64,0,Senegal,SN,SEN,15854360,Africa,9,735,27
2020-04-29T00:00:00Z,29,4,2020,88,0,Senegal,SN,SEN,15854360,Africa,9,823,28
2020-04-30T00:00:00Z,30,4,2020,59,0,Senegal,SN,SEN,15854360,Africa,9,882,29
2020-05-01T00:00:00Z,1,5,2020,51,0,Senegal,SN,SEN,15854360,Africa,9,933,30
2020-05-02T00:00:00Z,2,5,2020,91,0,Senegal,SN,SEN,15854360,Africa,9,1024,31
2020-05-03T00:00:00Z,3,5,2020,91,0,Senegal,SN,SEN,15854360,Africa,9,1115,32
2020-05-04T00:00:00Z,4,5,2020,67,0,Senegal,SN,SEN,15854360,Africa,9,1182,33
2020-05-05T00:00:00Z,5,5,2020,89,1,Senegal,SN,SEN,15854360,Africa,10,1271,34
2020-05-06T00:00:00Z,6,5,2020,58,1,Senegal,SN,SEN,15854360,Africa,11,1329,35
2020-05-07T00:00:00Z,7,5,2020,104,1,Senegal,SN,SEN,15854360,Africa,12,1433,36
2020-05-08T00:00:00Z,8,5,2020,59,1,Senegal,SN,SEN,15854360,Africa,13,1492,37
2020-05-09T00:00:00Z,9,5,2020,59,1,Senegal,SN,SEN,15854360,Africa,14,1551,38
2020-05-10T00:00:00Z,10,5,2020,83,3,Senegal,SN,SEN,15854360,Africa,17,1634,39
2020-05-11T00:00:00Z,11,5,2020,75,2,Senegal,SN,SEN,15854360,Africa,19,1709,40
2020-05-12T00:00:00Z,12,5,2020,177,0,Senegal,SN,SEN,15854360,Africa,19,1886,41
2020-05-13T00:00:00Z,13,5,2020,109,0,Senegal,SN,SEN,15854360,Africa,19,1995,42
2020-05-14T00:00:00Z,14,5,2020,110,3,Senegal,SN,SEN,15854360,Africa,22,2105,43
2020-05-15T00:00:00Z,15,5,2020,84,1,Senegal,SN,SEN,15854360,Africa,23,2189,44
2020-05-16T00:00:00Z,16,5,2020,121,2,Senegal,SN,SEN,15854360,Africa,25,2310,45
2020-05-17T00:00:00Z,17,5,2020,119,0,Senegal,SN,SEN,15854360,Africa,25,2429,46
2020-05-18T00:00:00Z,18,5,2020,51,1,Senegal,SN,SEN,15854360,Africa,26,2480,47
2020-05-19T00:00:00Z,19,5,2020,64,0,Senegal,SN,SEN,15854360,Africa,26,2544,48
2020-05-20T00:00:00Z,20,5,2020,73,4,Senegal,SN,SEN,15854360,Africa,30,2617,49
2020-05-21T00:00:00Z,21,5,2020,97,0,Senegal,SN,SEN,15854360,Africa,30,2714,50
2020-05-22T00:00:00Z,22,5,2020,98,3,Senegal,SN,SEN,15854360,Africa,33,2812,51
2020-05-23T00:00:00Z,23,5,2020,97,0,Senegal,SN,SEN,15854360,Africa,33,2909,52
2020-05-24T00:00:00Z,24,5,2020,67,2,Senegal,SN,SEN,15854360,Africa,35,2976,53
2020-05-25T00:00:00Z,25,5,2020,71,0,Senegal,SN,SEN,15854360,Africa,35,3047,54
2020-05-26T00:00:00Z,26,5,2020,83,1,Senegal,SN,SEN,15854360,Africa,36,3130,55
2020-05-27T00:00:00Z,27,5,2020,31,1,Senegal,SN,SEN,15854360,Africa,37,3161,56
2020-03-21T00:00:00Z,21,3,2020,9,1,Serbia,RS,SRB,6982084,Europe,1,135,1
2020-03-22T00:00:00Z,22,3,2020,14,0,Serbia,RS,SRB,6982084,Europe,1,149,2
2020-03-23T00:00:00Z,23,3,2020,39,0,Serbia,RS,SRB,6982084,Europe,1,188,3
2020-03-24T00:00:00Z,24,3,2020,34,0,Serbia,RS,SRB,6982084,Europe,1,222,4
2020-03-25T00:00:00Z,25,3,2020,27,0,Serbia,RS,SRB,6982084,Europe,1,249,5
2020-03-26T00:00:00Z,26,3,2020,54,1,Serbia,RS,SRB,6982084,Europe,2,303,6
2020-03-27T00:00:00Z,27,3,2020,81,1,Serbia,RS,SRB,6982084,Europe,3,384,7
2020-03-28T00:00:00Z,28,3,2020,73,3,Serbia,RS,SRB,6982084,Europe,6,457,8
2020-03-29T00:00:00Z,29,3,2020,202,4,Serbia,RS,SRB,6982084,Europe,10,659,9
2020-03-30T00:00:00Z,30,3,2020,82,3,Serbia,RS,SRB,6982084,Europe,13,741,10
2020-03-31T00:00:00Z,31,3,2020,0,0,Serbia,RS,SRB,6982084,Europe,13,741,11
2020-04-01T00:00:00Z,1,4,2020,159,10,Serbia,RS,SRB,6982084,Europe,23,900,12
2020-04-02T00:00:00Z,2,4,2020,160,0,Serbia,RS,SRB,6982084,Europe,23,1060,13
2020-04-03T00:00:00Z,3,4,2020,111,8,Serbia,RS,SRB,6982084,Europe,31,1171,14
2020-04-04T00:00:00Z,4,4,2020,305,8,Serbia,RS,SRB,6982084,Europe,39,1476,15
2020-04-05T00:00:00Z,5,4,2020,148,5,Serbia,RS,SRB,6982084,Europe,44,1624,16
2020-04-06T00:00:00Z,6,4,2020,284,7,Serbia,RS,SRB,6982084,Europe,51,1908,17
2020-04-07T00:00:00Z,7,4,2020,292,7,Serbia,RS,SRB,6982084,Europe,58,2200,18
2020-04-08T00:00:00Z,8,4,2020,247,3,Serbia,RS,SRB,6982084,Europe,61,2447,19
2020-04-09T00:00:00Z,9,4,2020,219,4,Serbia,RS,SRB,6982084,Europe,65,2666,20
2020-04-10T00:00:00Z,10,4,2020,201,1,Serbia,RS,SRB,6982084,Europe,66,2867,21
2020-04-11T00:00:00Z,11,4,2020,238,5,Serbia,RS,SRB,6982084,Europe,71,3105,22
2020-04-12T00:00:00Z,12,4,2020,275,3,Serbia,RS,SRB,6982084,Europe,74,3380,23
2020-04-13T00:00:00Z,13,4,2020,250,6,Serbia,RS,SRB,6982084,Europe,80,3630,24
2020-04-14T00:00:00Z,14,4,2020,424,5,Serbia,RS,SRB,6982084,Europe,85,4054,25
2020-04-15T00:00:00Z,15,4,2020,411,9,Serbia,RS,SRB,6982084,Europe,94,4465,26
2020-04-16T00:00:00Z,16,4,2020,408,5,Serbia,RS,SRB,6982084,Europe,99,4873,27
2020-04-17T00:00:00Z,17,4,2020,445,4,Serbia,RS,SRB,6982084,Europe,103,5318,28
2020-04-18T00:00:00Z,18,4,2020,372,7,Serbia,RS,SRB,6982084,Europe,110,5690,29
2020-04-19T00:00:00Z,19,4,2020,304,7,Serbia,RS,SRB,6982084,Europe,117,5994,30
2020-04-20T00:00:00Z,20,4,2020,324,5,Serbia,RS,SRB,6982084,Europe,122,6318,31
2020-04-21T00:00:00Z,21,4,2020,312,3,Serbia,RS,SRB,6982084,Europe,125,6630,32
2020-04-22T00:00:00Z,22,4,2020,260,0,Serbia,RS,SRB,6982084,Europe,125,6890,33
2020-04-23T00:00:00Z,23,4,2020,224,9,Serbia,RS,SRB,6982084,Europe,134,7114,34
2020-04-24T00:00:00Z,24,4,2020,162,5,Serbia,RS,SRB,6982084,Europe,139,7276,35
2020-04-25T00:00:00Z,25,4,2020,207,5,Serbia,RS,SRB,6982084,Europe,144,7483,36
2020-04-26T00:00:00Z,26,4,2020,296,7,Serbia,RS,SRB,6982084,Europe,151,7779,37
2020-04-27T00:00:00Z,27,4,2020,263,5,Serbia,RS,SRB,6982084,Europe,156,8042,38
2020-04-28T00:00:00Z,28,4,2020,233,6,Serbia,RS,SRB,6982084,Europe,162,8275,39
2020-04-29T00:00:00Z,29,4,2020,222,6,Serbia,RS,SRB,6982084,Europe,168,8497,40
2020-04-30T00:00:00Z,30,4,2020,227,5,Serbia,RS,SRB,6982084,Europe,173,8724,41
2020-05-01T00:00:00Z,1,5,2020,285,6,Serbia,RS,SRB,6982084,Europe,179,9009,42
2020-05-02T00:00:00Z,2,5,2020,196,6,Serbia,RS,SRB,6982084,Europe,185,9205,43
2020-05-03T00:00:00Z,3,5,2020,157,4,Serbia,RS,SRB,6982084,Europe,189,9362,44
2020-05-04T00:00:00Z,4,5,2020,102,4,Serbia,RS,SRB,6982084,Europe,193,9464,45
2020-05-05T00:00:00Z,5,5,2020,93,4,Serbia,RS,SRB,6982084,Europe,197,9557,46
2020-05-06T00:00:00Z,6,5,2020,120,3,Serbia,RS,SRB,6982084,Europe,200,9677,47
2020-05-07T00:00:00Z,7,5,2020,114,3,Serbia,RS,SRB,6982084,Europe,203,9791,48
2020-05-08T00:00:00Z,8,5,2020,57,3,Serbia,RS,SRB,6982084,Europe,206,9848,49
2020-05-09T00:00:00Z,9,5,2020,95,3,Serbia,RS,SRB,6982084,Europe,209,9943,50
2020-05-10T00:00:00Z,10,5,2020,89,4,Serbia,RS,SRB,6982084,Europe,213,10032,51
2020-05-11T00:00:00Z,11,5,2020,82,2,Serbia,RS,SRB,6982084,Europe,215,10114,52
2020-05-12T00:00:00Z,12,5,2020,62,3,Serbia,RS,SRB,6982084,Europe,218,10176,53
2020-05-13T00:00:00Z,13,5,2020,67,2,Serbia,RS,SRB,6982084,Europe,220,10243,54
2020-05-14T00:00:00Z,14,5,2020,52,2,Serbia,RS,SRB,6982084,Europe,222,10295,55
2020-05-15T00:00:00Z,15,5,2020,79,2,Serbia,RS,SRB,6982084,Europe,224,10374,56
2020-05-16T00:00:00Z,16,5,2020,64,1,Serbia,RS,SRB,6982084,Europe,225,10438,57
2020-05-17T00:00:00Z,17,5,2020,58,3,Serbia,RS,SRB,6982084,Europe,228,10496,58
2020-05-18T00:00:00Z,18,5,2020,114,2,Serbia,RS,SRB,6982084,Europe,230,10610,59
2020-05-19T00:00:00Z,19,5,2020,89,1,Serbia,RS,SRB,6982084,Europe,231,10699,60
2020-05-20T00:00:00Z,20,5,2020,34,3,Serbia,RS,SRB,6982084,Europe,234,10733,61
2020-05-21T00:00:00Z,21,5,2020,100,1,Serbia,RS,SRB,6982084,Europe,235,10833,62
2020-05-22T00:00:00Z,22,5,2020,86,2,Serbia,RS,SRB,6982084,Europe,237,10919,63
2020-05-23T00:00:00Z,23,5,2020,105,0,Serbia,RS,SRB,6982084,Europe,237,11024,64
2020-05-24T00:00:00Z,24,5,2020,68,1,Serbia,RS,SRB,6982084,Europe,238,11092,65
2020-05-25T00:00:00Z,25,5,2020,67,0,Serbia,RS,SRB,6982084,Europe,238,11159,66
2020-05-26T00:00:00Z,26,5,2020,34,1,Serbia,RS,SRB,6982084,Europe,239,11193,67
2020-05-27T00:00:00Z,27,5,2020,34,0,Serbia,RS,SRB,6982084,Europe,239,11227,68
2020-04-24T00:00:00Z,24,4,2020,3,1,Sierra_Leone,SL,SLE,7650154,Africa,1,64,1
2020-04-25T00:00:00Z,25,4,2020,18,2,Sierra_Leone,SL,SLE,7650154,Africa,3,82,2
2020-04-26T00:00:00Z,26,4,2020,0,0,Sierra_Leone,SL,SLE,7650154,Africa,3,82,3
2020-04-27T00:00:00Z,27,4,2020,11,1,Sierra_Leone,SL,SLE,7650154,Africa,4,93,4
2020-04-28T00:00:00Z,28,4,2020,6,0,Sierra_Leone,SL,SLE,7650154,Africa,4,99,5
2020-04-29T00:00:00Z,29,4,2020,5,0,Sierra_Leone,SL,SLE,7650154,Africa,4,104,6
2020-04-30T00:00:00Z,30,4,2020,12,0,Sierra_Leone,SL,SLE,7650154,Africa,4,116,7
2020-05-01T00:00:00Z,1,5,2020,8,3,Sierra_Leone,SL,SLE,7650154,Africa,7,124,8
2020-05-02T00:00:00Z,2,5,2020,12,0,Sierra_Leone,SL,SLE,7650154,Africa,7,136,9
2020-05-03T00:00:00Z,3,5,2020,19,1,Sierra_Leone,SL,SLE,7650154,Africa,8,155,10
2020-05-04T00:00:00Z,4,5,2020,2,0,Sierra_Leone,SL,SLE,7650154,Africa,8,157,11
2020-05-05T00:00:00Z,5,5,2020,21,1,Sierra_Leone,SL,SLE,7650154,Africa,9,178,12
2020-05-06T00:00:00Z,6,5,2020,21,2,Sierra_Leone,SL,SLE,7650154,Africa,11,199,13
2020-05-07T00:00:00Z,7,5,2020,26,3,Sierra_Leone,SL,SLE,7650154,Africa,14,225,14
2020-05-08T00:00:00Z,8,5,2020,6,2,Sierra_Leone,SL,SLE,7650154,Africa,16,231,15
2020-05-09T00:00:00Z,9,5,2020,26,1,Sierra_Leone,SL,SLE,7650154,Africa,17,257,16
2020-05-10T00:00:00Z,10,5,2020,34,1,Sierra_Leone,SL,SLE,7650154,Africa,18,291,17
2020-05-11T00:00:00Z,11,5,2020,16,0,Sierra_Leone,SL,SLE,7650154,Africa,18,307,18
2020-05-12T00:00:00Z,12,5,2020,31,1,Sierra_Leone,SL,SLE,7650154,Africa,19,338,19
2020-05-13T00:00:00Z,13,5,2020,0,1,Sierra_Leone,SL,SLE,7650154,Africa,20,338,20
2020-05-14T00:00:00Z,14,5,2020,49,1,Sierra_Leone,SL,SLE,7650154,Africa,21,387,21
2020-05-15T00:00:00Z,15,5,2020,21,5,Sierra_Leone,SL,SLE,7650154,Africa,26,408,22
2020-05-16T00:00:00Z,16,5,2020,39,1,Sierra_Leone,SL,SLE,7650154,Africa,27,447,23
2020-05-17T00:00:00Z,17,5,2020,15,2,Sierra_Leone,SL,SLE,7650154,Africa,29,462,24
2020-05-18T00:00:00Z,18,5,2020,43,3,Sierra_Leone,SL,SLE,7650154,Africa,32,505,25
2020-05-19T00:00:00Z,19,5,2020,14,1,Sierra_Leone,SL,SLE,7650154,Africa,33,519,26
2020-05-20T00:00:00Z,20,5,2020,15,0,Sierra_Leone,SL,SLE,7650154,Africa,33,534,27
2020-05-21T00:00:00Z,21,5,2020,36,1,Sierra_Leone,SL,SLE,7650154,Africa,34,570,28
2020-05-22T00:00:00Z,22,5,2020,15,1,Sierra_Leone,SL,SLE,7650154,Africa,35,585,29
2020-05-23T00:00:00Z,23,5,2020,21,3,Sierra_Leone,SL,SLE,7650154,Africa,38,606,30
2020-05-24T00:00:00Z,24,5,2020,15,1,Sierra_Leone,SL,SLE,7650154,Africa,39,621,31
2020-05-25T00:00:00Z,25,5,2020,86,1,Sierra_Leone,SL,SLE,7650154,Africa,40,707,32
2020-05-26T00:00:00Z,26,5,2020,28,2,Sierra_Leone,SL,SLE,7650154,Africa,42,735,33
2020-05-27T00:00:00Z,27,5,2020,19,2,Sierra_Leone,SL,SLE,7650154,Africa,44,754,34
2020-03-22T00:00:00Z,22,3,2020,47,2,Singapore,SG,SGP,5638676,Asia,2,432,1
2020-03-23T00:00:00Z,23,3,2020,23,0,Singapore,SG,SGP,5638676,Asia,2,455,2
2020-03-24T00:00:00Z,24,3,2020,54,0,Singapore,SG,SGP,5638676,Asia,2,509,3
2020-03-25T00:00:00Z,25,3,2020,49,0,Singapore,SG,SGP,5638676,Asia,2,558,4
2020-03-26T00:00:00Z,26,3,2020,10,0,Singapore,SG,SGP,5638676,Asia,2,568,5
2020-03-27T00:00:00Z,27,3,2020,26,0,Singapore,SG,SGP,5638676,Asia,2,594,6
2020-03-28T00:00:00Z,28,3,2020,138,0,Singapore,SG,SGP,5638676,Asia,2,732,7
2020-03-29T00:00:00Z,29,3,2020,71,1,Singapore,SG,SGP,5638676,Asia,3,803,8
2020-03-30T00:00:00Z,30,3,2020,41,0,Singapore,SG,SGP,5638676,Asia,3,844,9
2020-03-31T00:00:00Z,31,3,2020,0,0,Singapore,SG,SGP,5638676,Asia,3,844,10
2020-04-01T00:00:00Z,1,4,2020,35,0,Singapore,SG,SGP,5638676,Asia,3,879,11
2020-04-02T00:00:00Z,2,4,2020,121,1,Singapore,SG,SGP,5638676,Asia,4,1000,12
2020-04-03T00:00:00Z,3,4,2020,49,1,Singapore,SG,SGP,5638676,Asia,5,1049,13
2020-04-04T00:00:00Z,4,4,2020,65,0,Singapore,SG,SGP,5638676,Asia,5,1114,14
2020-04-05T00:00:00Z,5,4,2020,75,1,Singapore,SG,SGP,5638676,Asia,6,1189,15
2020-04-06T00:00:00Z,6,4,2020,120,0,Singapore,SG,SGP,5638676,Asia,6,1309,16
2020-04-07T00:00:00Z,7,4,2020,66,0,Singapore,SG,SGP,5638676,Asia,6,1375,17
2020-04-08T00:00:00Z,8,4,2020,106,0,Singapore,SG,SGP,5638676,Asia,6,1481,18
2020-04-09T00:00:00Z,9,4,2020,142,0,Singapore,SG,SGP,5638676,Asia,6,1623,19
2020-04-10T00:00:00Z,10,4,2020,286,0,Singapore,SG,SGP,5638676,Asia,6,1909,20
2020-04-11T00:00:00Z,11,4,2020,0,0,Singapore,SG,SGP,5638676,Asia,6,1909,21
2020-04-12T00:00:00Z,12,4,2020,390,2,Singapore,SG,SGP,5638676,Asia,8,2299,22
2020-04-13T00:00:00Z,13,4,2020,233,0,Singapore,SG,SGP,5638676,Asia,8,2532,23
2020-04-14T00:00:00Z,14,4,2020,386,1,Singapore,SG,SGP,5638676,Asia,9,2918,24
2020-04-15T00:00:00Z,15,4,2020,334,1,Singapore,SG,SGP,5638676,Asia,10,3252,25
2020-04-16T00:00:00Z,16,4,2020,447,0,Singapore,SG,SGP,5638676,Asia,10,3699,26
2020-04-17T00:00:00Z,17,4,2020,728,0,Singapore,SG,SGP,5638676,Asia,10,4427,27
2020-04-18T00:00:00Z,18,4,2020,623,1,Singapore,SG,SGP,5638676,Asia,11,5050,28
2020-04-19T00:00:00Z,19,4,2020,942,0,Singapore,SG,SGP,5638676,Asia,11,5992,29
2020-04-20T00:00:00Z,20,4,2020,596,0,Singapore,SG,SGP,5638676,Asia,11,6588,30
2020-04-21T00:00:00Z,21,4,2020,1426,0,Singapore,SG,SGP,5638676,Asia,11,8014,31
2020-04-22T00:00:00Z,22,4,2020,1111,0,Singapore,SG,SGP,5638676,Asia,11,9125,32
2020-04-23T00:00:00Z,23,4,2020,1016,1,Singapore,SG,SGP,5638676,Asia,12,10141,33
2020-04-24T00:00:00Z,24,4,2020,1037,0,Singapore,SG,SGP,5638676,Asia,12,11178,34
2020-04-25T00:00:00Z,25,4,2020,897,0,Singapore,SG,SGP,5638676,Asia,12,12075,35
2020-04-26T00:00:00Z,26,4,2020,618,0,Singapore,SG,SGP,5638676,Asia,12,12693,36
2020-04-27T00:00:00Z,27,4,2020,931,0,Singapore,SG,SGP,5638676,Asia,12,13624,37
2020-04-28T00:00:00Z,28,4,2020,799,2,Singapore,SG,SGP,5638676,Asia,14,14423,38
2020-04-29T00:00:00Z,29,4,2020,528,0,Singapore,SG,SGP,5638676,Asia,14,14951,39
2020-04-30T00:00:00Z,30,4,2020,690,0,Singapore,SG,SGP,5638676,Asia,14,15641,40
2020-05-01T00:00:00Z,1,5,2020,528,1,Singapore,SG,SGP,5638676,Asia,15,16169,41
2020-05-02T00:00:00Z,2,5,2020,932,1,Singapore,SG,SGP,5638676,Asia,16,17101,42
2020-05-03T00:00:00Z,3,5,2020,447,1,Singapore,SG,SGP,5638676,Asia,17,17548,43
2020-05-04T00:00:00Z,4,5,2020,657,1,Singapore,SG,SGP,5638676,Asia,18,18205,44
2020-05-05T00:00:00Z,5,5,2020,573,0,Singapore,SG,SGP,5638676,Asia,18,18778,45
2020-05-06T00:00:00Z,6,5,2020,632,0,Singapore,SG,SGP,5638676,Asia,18,19410,46
2020-05-07T00:00:00Z,7,5,2020,788,2,Singapore,SG,SGP,5638676,Asia,20,20198,47
2020-05-08T00:00:00Z,8,5,2020,741,0,Singapore,SG,SGP,5638676,Asia,20,20939,48
2020-05-09T00:00:00Z,9,5,2020,768,0,Singapore,SG,SGP,5638676,Asia,20,21707,49
2020-05-10T00:00:00Z,10,5,2020,753,0,Singapore,SG,SGP,5638676,Asia,20,22460,50
2020-05-11T00:00:00Z,11,5,2020,876,0,Singapore,SG,SGP,5638676,Asia,20,23336,51
2020-05-12T00:00:00Z,12,5,2020,451,1,Singapore,SG,SGP,5638676,Asia,21,23787,52
2020-05-13T00:00:00Z,13,5,2020,884,0,Singapore,SG,SGP,5638676,Asia,21,24671,53
2020-05-14T00:00:00Z,14,5,2020,675,0,Singapore,SG,SGP,5638676,Asia,21,25346,54
2020-05-15T00:00:00Z,15,5,2020,752,0,Singapore,SG,SGP,5638676,Asia,21,26098,55
2020-05-16T00:00:00Z,16,5,2020,793,0,Singapore,SG,SGP,5638676,Asia,21,26891,56
2020-05-17T00:00:00Z,17,5,2020,465,1,Singapore,SG,SGP,5638676,Asia,22,27356,57
2020-05-18T00:00:00Z,18,5,2020,682,0,Singapore,SG,SGP,5638676,Asia,22,28038,58
2020-05-19T00:00:00Z,19,5,2020,305,0,Singapore,SG,SGP,5638676,Asia,22,28343,59
2020-05-20T00:00:00Z,20,5,2020,451,0,Singapore,SG,SGP,5638676,Asia,22,28794,60
2020-05-21T00:00:00Z,21,5,2020,570,0,Singapore,SG,SGP,5638676,Asia,22,29364,61
2020-05-22T00:00:00Z,22,5,2020,448,1,Singapore,SG,SGP,5638676,Asia,23,29812,62
2020-05-23T00:00:00Z,23,5,2020,614,0,Singapore,SG,SGP,5638676,Asia,23,30426,63
2020-05-24T00:00:00Z,24,5,2020,642,0,Singapore,SG,SGP,5638676,Asia,23,31068,64
2020-05-25T00:00:00Z,25,5,2020,548,0,Singapore,SG,SGP,5638676,Asia,23,31616,65
2020-05-26T00:00:00Z,26,5,2020,344,0,Singapore,SG,SGP,5638676,Asia,23,31960,66
2020-05-27T00:00:00Z,27,5,2020,383,0,Singapore,SG,SGP,5638676,Asia,23,32343,67
2020-04-02T00:00:00Z,2,4,2020,10,1,Sint_Maarten,SX,SXM,41486,America,1,16,1
2020-04-03T00:00:00Z,3,4,2020,7,1,Sint_Maarten,SX,SXM,41486,America,2,23,2
2020-04-04T00:00:00Z,4,4,2020,0,0,Sint_Maarten,SX,SXM,41486,America,2,23,3
2020-04-05T00:00:00Z,5,4,2020,0,0,Sint_Maarten,SX,SXM,41486,America,2,23,4
2020-04-06T00:00:00Z,6,4,2020,2,2,Sint_Maarten,SX,SXM,41486,America,4,25,5
2020-04-07T00:00:00Z,7,4,2020,0,0,Sint_Maarten,SX,SXM,41486,America,4,25,6
2020-04-08T00:00:00Z,8,4,2020,15,4,Sint_Maarten,SX,SXM,41486,America,8,40,7
2020-04-09T00:00:00Z,9,4,2020,0,0,Sint_Maarten,SX,SXM,41486,America,8,40,8
2020-04-10T00:00:00Z,10,4,2020,10,0,Sint_Maarten,SX,SXM,41486,America,8,50,9
2020-04-11T00:00:00Z,11,4,2020,0,1,Sint_Maarten,SX,SXM,41486,America,9,50,10
2020-04-12T00:00:00Z,12,4,2020,0,0,Sint_Maarten,SX,SXM,41486,America,9,50,11
2020-04-13T00:00:00Z,13,4,2020,0,0,Sint_Maarten,SX,SXM,41486,America,9,50,12
2020-04-14T00:00:00Z,14,4,2020,2,0,Sint_Maarten,SX,SXM,41486,America,9,52,13
2020-04-15T00:00:00Z,15,4,2020,0,0,Sint_Maarten,SX,SXM,41486,America,9,52,14
2020-04-16T00:00:00Z,16,4,2020,5,0,Sint_Maarten,SX,SXM,41486,America,9,57,15
2020-04-17T00:00:00Z,17,4,2020,0,0,Sint_Maarten,SX,SXM,41486,America,9,57,16
2020-04-18T00:00:00Z,18,4,2020,0,0,Sint_Maarten,SX,SXM,41486,America,9,57,17
2020-04-19T00:00:00Z,19,4,2020,7,0,Sint_Maarten,SX,SXM,41486,America,9,64,18
2020-04-20T00:00:00Z,20,4,2020,3,1,Sint_Maarten,SX,SXM,41486,America,10,67,19
2020-04-21T00:00:00Z,21,4,2020,1,0,Sint_Maarten,SX,SXM,41486,America,10,68,20
2020-04-22T00:00:00Z,22,4,2020,0,0,Sint_Maarten,SX,SXM,41486,America,10,68,21
2020-04-23T00:00:00Z,23,4,2020,5,2,Sint_Maarten,SX,SXM,41486,America,12,73,22
2020-04-24T00:00:00Z,24,4,2020,0,0,Sint_Maarten,SX,SXM,41486,America,12,73,23
2020-04-25T00:00:00Z,25,4,2020,0,0,Sint_Maarten,SX,SXM,41486,America,12,73,24
2020-04-26T00:00:00Z,26,4,2020,0,0,Sint_Maarten,SX,SXM,41486,America,12,73,25
2020-04-27T00:00:00Z,27,4,2020,1,1,Sint_Maarten,SX,SXM,41486,America,13,74,26
2020-04-28T00:00:00Z,28,4,2020,1,0,Sint_Maarten,SX,SXM,41486,America,13,75,27
2020-04-29T00:00:00Z,29,4,2020,0,0,Sint_Maarten,SX,SXM,41486,America,13,75,28
2020-04-30T00:00:00Z,30,4,2020,1,0,Sint_Maarten,SX,SXM,41486,America,13,76,29
2020-05-01T00:00:00Z,1,5,2020,0,0,Sint_Maarten,SX,SXM,41486,America,13,76,30
2020-05-02T00:00:00Z,2,5,2020,0,0,Sint_Maarten,SX,SXM,41486,America,13,76,31
2020-05-03T00:00:00Z,3,5,2020,0,0,Sint_Maarten,SX,SXM,41486,America,13,76,32
2020-05-04T00:00:00Z,4,5,2020,0,0,Sint_Maarten,SX,SXM,41486,America,13,76,33
2020-05-05T00:00:00Z,5,5,2020,0,0,Sint_Maarten,SX,SXM,41486,America,13,76,34
2020-05-06T00:00:00Z,6,5,2020,0,1,Sint_Maarten,SX,SXM,41486,America,14,76,35
2020-05-07T00:00:00Z,7,5,2020,0,0,Sint_Maarten,SX,SXM,41486,America,14,76,36
2020-05-08T00:00:00Z,8,5,2020,0,0,Sint_Maarten,SX,SXM,41486,America,14,76,37
2020-05-09T00:00:00Z,9,5,2020,0,1,Sint_Maarten,SX,SXM,41486,America,15,76,38
2020-05-10T00:00:00Z,10,5,2020,0,0,Sint_Maarten,SX,SXM,41486,America,15,76,39
2020-05-11T00:00:00Z,11,5,2020,0,0,Sint_Maarten,SX,SXM,41486,America,15,76,40
2020-05-12T00:00:00Z,12,5,2020,0,0,Sint_Maarten,SX,SXM,41486,America,15,76,41
2020-05-13T00:00:00Z,13,5,2020,1,0,Sint_Maarten,SX,SXM,41486,America,15,77,42
2020-05-14T00:00:00Z,14,5,2020,0,0,Sint_Maarten,SX,SXM,41486,America,15,77,43
2020-05-15T00:00:00Z,15,5,2020,0,0,Sint_Maarten,SX,SXM,41486,America,15,77,44
2020-05-16T00:00:00Z,16,5,2020,0,0,Sint_Maarten,SX,SXM,41486,America,15,77,45
2020-05-17T00:00:00Z,17,5,2020,0,0,Sint_Maarten,SX,SXM,41486,America,15,77,46
2020-05-18T00:00:00Z,18,5,2020,0,0,Sint_Maarten,SX,SXM,41486,America,15,77,47
2020-05-19T00:00:00Z,19,5,2020,0,0,Sint_Maarten,SX,SXM,41486,America,15,77,48
2020-05-20T00:00:00Z,20,5,2020,0,0,Sint_Maarten,SX,SXM,41486,America,15,77,49
2020-05-21T00:00:00Z,21,5,2020,0,0,Sint_Maarten,SX,SXM,41486,America,15,77,50
2020-05-22T00:00:00Z,22,5,2020,0,0,Sint_Maarten,SX,SXM,41486,America,15,77,51
2020-05-23T00:00:00Z,23,5,2020,0,0,Sint_Maarten,SX,SXM,41486,America,15,77,52
2020-05-24T00:00:00Z,24,5,2020,0,0,Sint_Maarten,SX,SXM,41486,America,15,77,53
2020-05-25T00:00:00Z,25,5,2020,0,0,Sint_Maarten,SX,SXM,41486,America,15,77,54
2020-05-26T00:00:00Z,26,5,2020,0,0,Sint_Maarten,SX,SXM,41486,America,15,77,55
2020-05-27T00:00:00Z,27,5,2020,0,0,Sint_Maarten,SX,SXM,41486,America,15,77,56
2020-04-07T00:00:00Z,7,4,2020,49,2,Slovakia,SK,SVK,5447011,Europe,2,534,1
2020-04-08T00:00:00Z,8,4,2020,47,0,Slovakia,SK,SVK,5447011,Europe,2,581,2
2020-04-09T00:00:00Z,9,4,2020,101,0,Slovakia,SK,SVK,5447011,Europe,2,682,3
2020-04-10T00:00:00Z,10,4,2020,19,0,Slovakia,SK,SVK,5447011,Europe,2,701,4
2020-04-11T00:00:00Z,11,4,2020,14,0,Slovakia,SK,SVK,5447011,Europe,2,715,5
2020-04-12T00:00:00Z,12,4,2020,13,0,Slovakia,SK,SVK,5447011,Europe,2,728,6
2020-04-13T00:00:00Z,13,4,2020,14,0,Slovakia,SK,SVK,5447011,Europe,2,742,7
2020-04-14T00:00:00Z,14,4,2020,27,0,Slovakia,SK,SVK,5447011,Europe,2,769,8
2020-04-15T00:00:00Z,15,4,2020,66,0,Slovakia,SK,SVK,5447011,Europe,2,835,9
2020-04-16T00:00:00Z,16,4,2020,28,4,Slovakia,SK,SVK,5447011,Europe,6,863,10
2020-04-17T00:00:00Z,17,4,2020,114,2,Slovakia,SK,SVK,5447011,Europe,8,977,11
2020-04-18T00:00:00Z,18,4,2020,72,1,Slovakia,SK,SVK,5447011,Europe,9,1049,12
2020-04-19T00:00:00Z,19,4,2020,40,2,Slovakia,SK,SVK,5447011,Europe,11,1089,13
2020-04-20T00:00:00Z,20,4,2020,72,1,Slovakia,SK,SVK,5447011,Europe,12,1161,14
2020-04-21T00:00:00Z,21,4,2020,12,1,Slovakia,SK,SVK,5447011,Europe,13,1173,15
2020-04-22T00:00:00Z,22,4,2020,26,1,Slovakia,SK,SVK,5447011,Europe,14,1199,16
2020-04-23T00:00:00Z,23,4,2020,45,0,Slovakia,SK,SVK,5447011,Europe,14,1244,17
2020-04-24T00:00:00Z,24,4,2020,81,1,Slovakia,SK,SVK,5447011,Europe,15,1325,18
2020-04-25T00:00:00Z,25,4,2020,35,2,Slovakia,SK,SVK,5447011,Europe,17,1360,19
2020-04-26T00:00:00Z,26,4,2020,13,0,Slovakia,SK,SVK,5447011,Europe,17,1373,20
2020-04-27T00:00:00Z,27,4,2020,6,1,Slovakia,SK,SVK,5447011,Europe,18,1379,21
2020-04-28T00:00:00Z,28,4,2020,2,0,Slovakia,SK,SVK,5447011,Europe,18,1381,22
2020-04-29T00:00:00Z,29,4,2020,3,2,Slovakia,SK,SVK,5447011,Europe,20,1384,23
2020-04-30T00:00:00Z,30,4,2020,7,2,Slovakia,SK,SVK,5447011,Europe,22,1391,24
2020-05-01T00:00:00Z,1,5,2020,5,1,Slovakia,SK,SVK,5447011,Europe,23,1396,25
2020-05-02T00:00:00Z,2,5,2020,7,0,Slovakia,SK,SVK,5447011,Europe,23,1403,26
2020-05-03T00:00:00Z,3,5,2020,4,1,Slovakia,SK,SVK,5447011,Europe,24,1407,27
2020-05-04T00:00:00Z,4,5,2020,1,0,Slovakia,SK,SVK,5447011,Europe,24,1408,28
2020-05-05T00:00:00Z,5,5,2020,5,1,Slovakia,SK,SVK,5447011,Europe,25,1413,29
2020-05-06T00:00:00Z,6,5,2020,8,0,Slovakia,SK,SVK,5447011,Europe,25,1421,30
2020-05-07T00:00:00Z,7,5,2020,8,0,Slovakia,SK,SVK,5447011,Europe,25,1429,31
2020-05-08T00:00:00Z,8,5,2020,16,1,Slovakia,SK,SVK,5447011,Europe,26,1445,32
2020-05-09T00:00:00Z,9,5,2020,10,0,Slovakia,SK,SVK,5447011,Europe,26,1455,33
2020-05-10T00:00:00Z,10,5,2020,0,0,Slovakia,SK,SVK,5447011,Europe,26,1455,34
2020-05-11T00:00:00Z,11,5,2020,2,0,Slovakia,SK,SVK,5447011,Europe,26,1457,35
2020-05-12T00:00:00Z,12,5,2020,0,0,Slovakia,SK,SVK,5447011,Europe,26,1457,36
2020-05-13T00:00:00Z,13,5,2020,8,1,Slovakia,SK,SVK,5447011,Europe,27,1465,37
2020-05-14T00:00:00Z,14,5,2020,4,0,Slovakia,SK,SVK,5447011,Europe,27,1469,38
2020-05-15T00:00:00Z,15,5,2020,8,0,Slovakia,SK,SVK,5447011,Europe,27,1477,39
2020-05-16T00:00:00Z,16,5,2020,3,0,Slovakia,SK,SVK,5447011,Europe,27,1480,40
2020-05-17T00:00:00Z,17,5,2020,13,1,Slovakia,SK,SVK,5447011,Europe,28,1493,41
2020-05-18T00:00:00Z,18,5,2020,1,0,Slovakia,SK,SVK,5447011,Europe,28,1494,42
2020-05-19T00:00:00Z,19,5,2020,1,0,Slovakia,SK,SVK,5447011,Europe,28,1495,43
2020-05-20T00:00:00Z,20,5,2020,0,0,Slovakia,SK,SVK,5447011,Europe,28,1495,44
2020-05-21T00:00:00Z,21,5,2020,1,0,Slovakia,SK,SVK,5447011,Europe,28,1496,45
2020-05-22T00:00:00Z,22,5,2020,6,0,Slovakia,SK,SVK,5447011,Europe,28,1502,46
2020-05-23T00:00:00Z,23,5,2020,1,0,Slovakia,SK,SVK,5447011,Europe,28,1503,47
2020-05-24T00:00:00Z,24,5,2020,1,0,Slovakia,SK,SVK,5447011,Europe,28,1504,48
2020-05-25T00:00:00Z,25,5,2020,5,0,Slovakia,SK,SVK,5447011,Europe,28,1509,49
2020-05-26T00:00:00Z,26,5,2020,2,0,Slovakia,SK,SVK,5447011,Europe,28,1511,50
2020-05-27T00:00:00Z,27,5,2020,2,0,Slovakia,SK,SVK,5447011,Europe,28,1513,51
2020-03-18T00:00:00Z,18,3,2020,22,1,Slovenia,SI,SVN,2067372,Europe,1,275,1
2020-03-19T00:00:00Z,19,3,2020,11,0,Slovenia,SI,SVN,2067372,Europe,1,286,2
2020-03-20T00:00:00Z,20,3,2020,33,0,Slovenia,SI,SVN,2067372,Europe,1,319,3
2020-03-21T00:00:00Z,21,3,2020,22,0,Slovenia,SI,SVN,2067372,Europe,1,341,4
2020-03-22T00:00:00Z,22,3,2020,42,0,Slovenia,SI,SVN,2067372,Europe,1,383,5
2020-03-23T00:00:00Z,23,3,2020,31,0,Slovenia,SI,SVN,2067372,Europe,1,414,6
2020-03-24T00:00:00Z,24,3,2020,28,0,Slovenia,SI,SVN,2067372,Europe,1,442,7
2020-03-25T00:00:00Z,25,3,2020,38,2,Slovenia,SI,SVN,2067372,Europe,3,480,8
2020-03-26T00:00:00Z,26,3,2020,48,1,Slovenia,SI,SVN,2067372,Europe,4,528,9
2020-03-27T00:00:00Z,27,3,2020,49,1,Slovenia,SI,SVN,2067372,Europe,5,577,10
2020-03-28T00:00:00Z,28,3,2020,55,4,Slovenia,SI,SVN,2067372,Europe,9,632,11
2020-03-29T00:00:00Z,29,3,2020,59,0,Slovenia,SI,SVN,2067372,Europe,9,691,12
2020-03-30T00:00:00Z,30,3,2020,39,2,Slovenia,SI,SVN,2067372,Europe,11,730,13
2020-03-31T00:00:00Z,31,3,2020,33,0,Slovenia,SI,SVN,2067372,Europe,11,763,14
2020-04-01T00:00:00Z,1,4,2020,51,2,Slovenia,SI,SVN,2067372,Europe,13,814,15
2020-04-02T00:00:00Z,2,4,2020,27,2,Slovenia,SI,SVN,2067372,Europe,15,841,16
2020-04-03T00:00:00Z,3,4,2020,56,1,Slovenia,SI,SVN,2067372,Europe,16,897,17
2020-04-04T00:00:00Z,4,4,2020,37,4,Slovenia,SI,SVN,2067372,Europe,20,934,18
2020-04-05T00:00:00Z,5,4,2020,43,2,Slovenia,SI,SVN,2067372,Europe,22,977,19
2020-04-06T00:00:00Z,6,4,2020,20,6,Slovenia,SI,SVN,2067372,Europe,28,997,20
2020-04-07T00:00:00Z,7,4,2020,24,2,Slovenia,SI,SVN,2067372,Europe,30,1021,21
2020-04-08T00:00:00Z,8,4,2020,34,6,Slovenia,SI,SVN,2067372,Europe,36,1055,22
2020-04-09T00:00:00Z,9,4,2020,36,4,Slovenia,SI,SVN,2067372,Europe,40,1091,23
2020-04-10T00:00:00Z,10,4,2020,33,3,Slovenia,SI,SVN,2067372,Europe,43,1124,24
2020-04-11T00:00:00Z,11,4,2020,36,2,Slovenia,SI,SVN,2067372,Europe,45,1160,25
2020-04-12T00:00:00Z,12,4,2020,28,5,Slovenia,SI,SVN,2067372,Europe,50,1188,26
2020-04-13T00:00:00Z,13,4,2020,17,3,Slovenia,SI,SVN,2067372,Europe,53,1205,27
2020-04-14T00:00:00Z,14,4,2020,7,2,Slovenia,SI,SVN,2067372,Europe,55,1212,28
2020-04-15T00:00:00Z,15,4,2020,8,1,Slovenia,SI,SVN,2067372,Europe,56,1220,29
2020-04-16T00:00:00Z,16,4,2020,28,5,Slovenia,SI,SVN,2067372,Europe,61,1248,30
2020-04-17T00:00:00Z,17,4,2020,20,0,Slovenia,SI,SVN,2067372,Europe,61,1268,31
2020-04-18T00:00:00Z,18,4,2020,36,5,Slovenia,SI,SVN,2067372,Europe,66,1304,32
2020-04-19T00:00:00Z,19,4,2020,13,4,Slovenia,SI,SVN,2067372,Europe,70,1317,33
2020-04-20T00:00:00Z,20,4,2020,13,4,Slovenia,SI,SVN,2067372,Europe,74,1330,34
2020-04-21T00:00:00Z,21,4,2020,5,0,Slovenia,SI,SVN,2067372,Europe,74,1335,35
2020-04-22T00:00:00Z,22,4,2020,5,3,Slovenia,SI,SVN,2067372,Europe,77,1340,36
2020-04-23T00:00:00Z,23,4,2020,13,2,Slovenia,SI,SVN,2067372,Europe,79,1353,37
2020-04-24T00:00:00Z,24,4,2020,13,0,Slovenia,SI,SVN,2067372,Europe,79,1366,38
2020-04-25T00:00:00Z,25,4,2020,7,1,Slovenia,SI,SVN,2067372,Europe,80,1373,39
2020-04-26T00:00:00Z,26,4,2020,15,1,Slovenia,SI,SVN,2067372,Europe,81,1388,40
2020-04-27T00:00:00Z,27,4,2020,19,1,Slovenia,SI,SVN,2067372,Europe,82,1407,41
2020-04-28T00:00:00Z,28,4,2020,0,1,Slovenia,SI,SVN,2067372,Europe,83,1407,42
2020-04-29T00:00:00Z,29,4,2020,1,3,Slovenia,SI,SVN,2067372,Europe,86,1408,43
2020-04-30T00:00:00Z,30,4,2020,10,3,Slovenia,SI,SVN,2067372,Europe,89,1418,44
2020-05-01T00:00:00Z,1,5,2020,11,2,Slovenia,SI,SVN,2067372,Europe,91,1429,45
2020-05-02T00:00:00Z,2,5,2020,5,2,Slovenia,SI,SVN,2067372,Europe,93,1434,46
2020-05-03T00:00:00Z,3,5,2020,5,1,Slovenia,SI,SVN,2067372,Europe,94,1439,47
2020-05-04T00:00:00Z,4,5,2020,0,2,Slovenia,SI,SVN,2067372,Europe,96,1439,48
2020-05-05T00:00:00Z,5,5,2020,6,1,Slovenia,SI,SVN,2067372,Europe,97,1445,49
2020-05-06T00:00:00Z,6,5,2020,3,1,Slovenia,SI,SVN,2067372,Europe,98,1448,50
2020-05-07T00:00:00Z,7,5,2020,1,1,Slovenia,SI,SVN,2067372,Europe,99,1449,51
2020-05-08T00:00:00Z,8,5,2020,1,0,Slovenia,SI,SVN,2067372,Europe,99,1450,52
2020-05-09T00:00:00Z,9,5,2020,4,1,Slovenia,SI,SVN,2067372,Europe,100,1454,53
2020-05-10T00:00:00Z,10,5,2020,3,1,Slovenia,SI,SVN,2067372,Europe,101,1457,54
2020-05-11T00:00:00Z,11,5,2020,3,1,Slovenia,SI,SVN,2067372,Europe,102,1460,55
2020-05-12T00:00:00Z,12,5,2020,1,0,Slovenia,SI,SVN,2067372,Europe,102,1461,56
2020-05-13T00:00:00Z,13,5,2020,2,0,Slovenia,SI,SVN,2067372,Europe,102,1463,57
2020-05-14T00:00:00Z,14,5,2020,1,1,Slovenia,SI,SVN,2067372,Europe,103,1464,58
2020-05-15T00:00:00Z,15,5,2020,1,0,Slovenia,SI,SVN,2067372,Europe,103,1465,59
2020-05-16T00:00:00Z,16,5,2020,0,0,Slovenia,SI,SVN,2067372,Europe,103,1465,60
2020-05-17T00:00:00Z,17,5,2020,1,0,Slovenia,SI,SVN,2067372,Europe,103,1466,61
2020-05-18T00:00:00Z,18,5,2020,0,1,Slovenia,SI,SVN,2067372,Europe,104,1466,62
2020-05-19T00:00:00Z,19,5,2020,1,0,Slovenia,SI,SVN,2067372,Europe,104,1467,63
2020-05-20T00:00:00Z,20,5,2020,1,0,Slovenia,SI,SVN,2067372,Europe,104,1468,64
2020-05-21T00:00:00Z,21,5,2020,0,2,Slovenia,SI,SVN,2067372,Europe,106,1468,65
2020-05-22T00:00:00Z,22,5,2020,0,0,Slovenia,SI,SVN,2067372,Europe,106,1468,66
2020-05-23T00:00:00Z,23,5,2020,0,0,Slovenia,SI,SVN,2067372,Europe,106,1468,67
2020-05-24T00:00:00Z,24,5,2020,0,0,Slovenia,SI,SVN,2067372,Europe,106,1468,68
2020-05-25T00:00:00Z,25,5,2020,1,0,Slovenia,SI,SVN,2067372,Europe,106,1469,69
2020-05-26T00:00:00Z,26,5,2020,0,0,Slovenia,SI,SVN,2067372,Europe,106,1469,70
2020-05-27T00:00:00Z,27,5,2020,0,0,Slovenia,SI,SVN,2067372,Europe,106,1469,71
2020-04-10T00:00:00Z,10,4,2020,4,1,Somalia,SO,SOM,15008154,Africa,1,12,1
2020-04-11T00:00:00Z,11,4,2020,9,0,Somalia,SO,SOM,15008154,Africa,1,21,2
2020-04-12T00:00:00Z,12,4,2020,0,0,Somalia,SO,SOM,15008154,Africa,1,21,3
2020-04-13T00:00:00Z,13,4,2020,4,1,Somalia,SO,SOM,15008154,Africa,2,25,4
2020-04-14T00:00:00Z,14,4,2020,0,0,Somalia,SO,SOM,15008154,Africa,2,25,5
2020-04-15T00:00:00Z,15,4,2020,35,0,Somalia,SO,SOM,15008154,Africa,2,60,6
2020-04-16T00:00:00Z,16,4,2020,20,3,Somalia,SO,SOM,15008154,Africa,5,80,7
2020-04-17T00:00:00Z,17,4,2020,0,0,Somalia,SO,SOM,15008154,Africa,5,80,8
2020-04-18T00:00:00Z,18,4,2020,36,0,Somalia,SO,SOM,15008154,Africa,5,116,9
2020-04-19T00:00:00Z,19,4,2020,19,2,Somalia,SO,SOM,15008154,Africa,7,135,10
2020-04-20T00:00:00Z,20,4,2020,29,0,Somalia,SO,SOM,15008154,Africa,7,164,11
2020-04-21T00:00:00Z,21,4,2020,73,1,Somalia,SO,SOM,15008154,Africa,8,237,12
2020-04-22T00:00:00Z,22,4,2020,49,0,Somalia,SO,SOM,15008154,Africa,8,286,13
2020-04-23T00:00:00Z,23,4,2020,0,6,Somalia,SO,SOM,15008154,Africa,14,286,14
2020-04-24T00:00:00Z,24,4,2020,42,0,Somalia,SO,SOM,15008154,Africa,14,328,15
2020-04-25T00:00:00Z,25,4,2020,0,2,Somalia,SO,SOM,15008154,Africa,16,328,16
2020-04-26T00:00:00Z,26,4,2020,62,2,Somalia,SO,SOM,15008154,Africa,18,390,17
2020-04-27T00:00:00Z,27,4,2020,46,5,Somalia,SO,SOM,15008154,Africa,23,436,18
2020-04-28T00:00:00Z,28,4,2020,44,3,Somalia,SO,SOM,15008154,Africa,26,480,19
2020-04-29T00:00:00Z,29,4,2020,48,2,Somalia,SO,SOM,15008154,Africa,28,528,20
2020-04-30T00:00:00Z,30,4,2020,54,0,Somalia,SO,SOM,15008154,Africa,28,582,21
2020-05-01T00:00:00Z,1,5,2020,19,0,Somalia,SO,SOM,15008154,Africa,28,601,22
2020-05-02T00:00:00Z,2,5,2020,0,0,Somalia,SO,SOM,15008154,Africa,28,601,23
2020-05-03T00:00:00Z,3,5,2020,70,3,Somalia,SO,SOM,15008154,Africa,31,671,24
2020-05-04T00:00:00Z,4,5,2020,51,1,Somalia,SO,SOM,15008154,Africa,32,722,25
2020-05-05T00:00:00Z,5,5,2020,34,3,Somalia,SO,SOM,15008154,Africa,35,756,26
2020-05-06T00:00:00Z,6,5,2020,79,3,Somalia,SO,SOM,15008154,Africa,38,835,27
2020-05-07T00:00:00Z,7,5,2020,38,1,Somalia,SO,SOM,15008154,Africa,39,873,28
2020-05-08T00:00:00Z,8,5,2020,55,5,Somalia,SO,SOM,15008154,Africa,44,928,29
2020-05-09T00:00:00Z,9,5,2020,0,0,Somalia,SO,SOM,15008154,Africa,44,928,30
2020-05-10T00:00:00Z,10,5,2020,69,4,Somalia,SO,SOM,15008154,Africa,48,997,31
2020-05-11T00:00:00Z,11,5,2020,57,3,Somalia,SO,SOM,15008154,Africa,51,1054,32
2020-05-12T00:00:00Z,12,5,2020,35,1,Somalia,SO,SOM,15008154,Africa,52,1089,33
2020-05-13T00:00:00Z,13,5,2020,81,0,Somalia,SO,SOM,15008154,Africa,52,1170,34
2020-05-14T00:00:00Z,14,5,2020,49,0,Somalia,SO,SOM,15008154,Africa,52,1219,35
2020-05-15T00:00:00Z,15,5,2020,65,1,Somalia,SO,SOM,15008154,Africa,53,1284,36
2020-05-16T00:00:00Z,16,5,2020,0,0,Somalia,SO,SOM,15008154,Africa,53,1284,37
2020-05-17T00:00:00Z,17,5,2020,73,2,Somalia,SO,SOM,15008154,Africa,55,1357,38
2020-05-18T00:00:00Z,18,5,2020,64,1,Somalia,SO,SOM,15008154,Africa,56,1421,39
2020-05-19T00:00:00Z,19,5,2020,34,1,Somalia,SO,SOM,15008154,Africa,57,1455,40
2020-05-20T00:00:00Z,20,5,2020,47,2,Somalia,SO,SOM,15008154,Africa,59,1502,41
2020-05-21T00:00:00Z,21,5,2020,71,2,Somalia,SO,SOM,15008154,Africa,61,1573,42
2020-05-22T00:00:00Z,22,5,2020,21,0,Somalia,SO,SOM,15008154,Africa,61,1594,43
2020-05-23T00:00:00Z,23,5,2020,0,0,Somalia,SO,SOM,15008154,Africa,61,1594,44
2020-05-24T00:00:00Z,24,5,2020,0,0,Somalia,SO,SOM,15008154,Africa,61,1594,45
2020-05-25T00:00:00Z,25,5,2020,0,0,Somalia,SO,SOM,15008154,Africa,61,1594,46
2020-05-26T00:00:00Z,26,5,2020,95,5,Somalia,SO,SOM,15008154,Africa,66,1689,47
2020-05-27T00:00:00Z,27,5,2020,22,1,Somalia,SO,SOM,15008154,Africa,67,1711,48
2020-03-27T00:00:00Z,27,3,2020,218,2,South_Africa,ZA,ZAF,57779622,Africa,2,927,1
2020-03-28T00:00:00Z,28,3,2020,243,0,South_Africa,ZA,ZAF,57779622,Africa,2,1170,2
2020-03-29T00:00:00Z,29,3,2020,17,0,South_Africa,ZA,ZAF,57779622,Africa,2,1187,3
2020-03-30T00:00:00Z,30,3,2020,93,0,South_Africa,ZA,ZAF,57779622,Africa,2,1280,4
2020-03-31T00:00:00Z,31,3,2020,46,1,South_Africa,ZA,ZAF,57779622,Africa,3,1326,5
2020-04-01T00:00:00Z,1,4,2020,27,2,South_Africa,ZA,ZAF,57779622,Africa,5,1353,6
2020-04-02T00:00:00Z,2,4,2020,27,0,South_Africa,ZA,ZAF,57779622,Africa,5,1380,7
2020-04-03T00:00:00Z,3,4,2020,82,0,South_Africa,ZA,ZAF,57779622,Africa,5,1462,8
2020-04-04T00:00:00Z,4,4,2020,43,2,South_Africa,ZA,ZAF,57779622,Africa,7,1505,9
2020-04-05T00:00:00Z,5,4,2020,80,2,South_Africa,ZA,ZAF,57779622,Africa,9,1585,10
2020-04-06T00:00:00Z,6,4,2020,70,2,South_Africa,ZA,ZAF,57779622,Africa,11,1655,11
2020-04-07T00:00:00Z,7,4,2020,31,1,South_Africa,ZA,ZAF,57779622,Africa,12,1686,12
2020-04-08T00:00:00Z,8,4,2020,63,1,South_Africa,ZA,ZAF,57779622,Africa,13,1749,13
2020-04-09T00:00:00Z,9,4,2020,96,5,South_Africa,ZA,ZAF,57779622,Africa,18,1845,14
2020-04-10T00:00:00Z,10,4,2020,89,0,South_Africa,ZA,ZAF,57779622,Africa,18,1934,15
2020-04-11T00:00:00Z,11,4,2020,69,6,South_Africa,ZA,ZAF,57779622,Africa,24,2003,16
2020-04-12T00:00:00Z,12,4,2020,25,1,South_Africa,ZA,ZAF,57779622,Africa,25,2028,17
2020-04-13T00:00:00Z,13,4,2020,145,0,South_Africa,ZA,ZAF,57779622,Africa,25,2173,18
2020-04-14T00:00:00Z,14,4,2020,99,2,South_Africa,ZA,ZAF,57779622,Africa,27,2272,19
2020-04-15T00:00:00Z,15,4,2020,143,0,South_Africa,ZA,ZAF,57779622,Africa,27,2415,20
2020-04-16T00:00:00Z,16,4,2020,91,7,South_Africa,ZA,ZAF,57779622,Africa,34,2506,21
2020-04-17T00:00:00Z,17,4,2020,99,14,South_Africa,ZA,ZAF,57779622,Africa,48,2605,22
2020-04-18T00:00:00Z,18,4,2020,178,2,South_Africa,ZA,ZAF,57779622,Africa,50,2783,23
2020-04-19T00:00:00Z,19,4,2020,251,2,South_Africa,ZA,ZAF,57779622,Africa,52,3034,24
2020-04-20T00:00:00Z,20,4,2020,124,2,South_Africa,ZA,ZAF,57779622,Africa,54,3158,25
2020-04-21T00:00:00Z,21,4,2020,142,4,South_Africa,ZA,ZAF,57779622,Africa,58,3300,26
2020-04-22T00:00:00Z,22,4,2020,165,0,South_Africa,ZA,ZAF,57779622,Africa,58,3465,27
2020-04-23T00:00:00Z,23,4,2020,170,7,South_Africa,ZA,ZAF,57779622,Africa,65,3635,28
2020-04-24T00:00:00Z,24,4,2020,318,10,South_Africa,ZA,ZAF,57779622,Africa,75,3953,29
2020-04-25T00:00:00Z,25,4,2020,267,4,South_Africa,ZA,ZAF,57779622,Africa,79,4220,30
2020-04-26T00:00:00Z,26,4,2020,141,7,South_Africa,ZA,ZAF,57779622,Africa,86,4361,31
2020-04-27T00:00:00Z,27,4,2020,185,1,South_Africa,ZA,ZAF,57779622,Africa,87,4546,32
2020-04-28T00:00:00Z,28,4,2020,247,3,South_Africa,ZA,ZAF,57779622,Africa,90,4793,33
2020-04-29T00:00:00Z,29,4,2020,203,3,South_Africa,ZA,ZAF,57779622,Africa,93,4996,34
2020-04-30T00:00:00Z,30,4,2020,354,10,South_Africa,ZA,ZAF,57779622,Africa,103,5350,35
2020-05-01T00:00:00Z,1,5,2020,297,0,South_Africa,ZA,ZAF,57779622,Africa,103,5647,36
2020-05-02T00:00:00Z,2,5,2020,304,13,South_Africa,ZA,ZAF,57779622,Africa,116,5951,37
2020-05-03T00:00:00Z,3,5,2020,385,7,South_Africa,ZA,ZAF,57779622,Africa,123,6336,38
2020-05-04T00:00:00Z,4,5,2020,447,8,South_Africa,ZA,ZAF,57779622,Africa,131,6783,39
2020-05-05T00:00:00Z,5,5,2020,437,7,South_Africa,ZA,ZAF,57779622,Africa,138,7220,40
2020-05-06T00:00:00Z,6,5,2020,352,10,South_Africa,ZA,ZAF,57779622,Africa,148,7572,41
2020-05-07T00:00:00Z,7,5,2020,236,5,South_Africa,ZA,ZAF,57779622,Africa,153,7808,42
2020-05-08T00:00:00Z,8,5,2020,424,8,South_Africa,ZA,ZAF,57779622,Africa,161,8232,43
2020-05-09T00:00:00Z,9,5,2020,663,17,South_Africa,ZA,ZAF,57779622,Africa,178,8895,44
2020-05-10T00:00:00Z,10,5,2020,525,8,South_Africa,ZA,ZAF,57779622,Africa,186,9420,45
2020-05-11T00:00:00Z,11,5,2020,595,8,South_Africa,ZA,ZAF,57779622,Africa,194,10015,46
2020-05-12T00:00:00Z,12,5,2020,637,12,South_Africa,ZA,ZAF,57779622,Africa,206,10652,47
2020-05-13T00:00:00Z,13,5,2020,698,0,South_Africa,ZA,ZAF,57779622,Africa,206,11350,48
2020-05-14T00:00:00Z,14,5,2020,724,13,South_Africa,ZA,ZAF,57779622,Africa,219,12074,49
2020-05-15T00:00:00Z,15,5,2020,665,19,South_Africa,ZA,ZAF,57779622,Africa,238,12739,50
2020-05-16T00:00:00Z,16,5,2020,785,9,South_Africa,ZA,ZAF,57779622,Africa,247,13524,51
2020-05-17T00:00:00Z,17,5,2020,831,14,South_Africa,ZA,ZAF,57779622,Africa,261,14355,52
2020-05-18T00:00:00Z,18,5,2020,1160,3,South_Africa,ZA,ZAF,57779622,Africa,264,15515,53
2020-05-19T00:00:00Z,19,5,2020,918,22,South_Africa,ZA,ZAF,57779622,Africa,286,16433,54
2020-05-20T00:00:00Z,20,5,2020,767,26,South_Africa,ZA,ZAF,57779622,Africa,312,17200,55
2020-05-21T00:00:00Z,21,5,2020,803,27,South_Africa,ZA,ZAF,57779622,Africa,339,18003,56
2020-05-22T00:00:00Z,22,5,2020,1134,30,South_Africa,ZA,ZAF,57779622,Africa,369,19137,57
2020-05-23T00:00:00Z,23,5,2020,988,28,South_Africa,ZA,ZAF,57779622,Africa,397,20125,58
2020-05-24T00:00:00Z,24,5,2020,1218,10,South_Africa,ZA,ZAF,57779622,Africa,407,21343,59
2020-05-25T00:00:00Z,25,5,2020,1240,22,South_Africa,ZA,ZAF,57779622,Africa,429,22583,60
2020-05-26T00:00:00Z,26,5,2020,1032,52,South_Africa,ZA,ZAF,57779622,Africa,481,23615,61
2020-05-27T00:00:00Z,27,5,2020,649,43,South_Africa,ZA,ZAF,57779622,Africa,524,24264,62
2020-02-21T00:00:00Z,21,2,2020,75,1,South_Korea,KR,KOR,51635256,Asia,1,155,1
2020-02-22T00:00:00Z,22,2,2020,190,1,South_Korea,KR,KOR,51635256,Asia,2,345,2
2020-02-23T00:00:00Z,23,2,2020,256,3,South_Korea,KR,KOR,51635256,Asia,5,601,3
2020-02-24T00:00:00Z,24,2,2020,161,2,South_Korea,KR,KOR,51635256,Asia,7,762,4
2020-02-25T00:00:00Z,25,2,2020,130,1,South_Korea,KR,KOR,51635256,Asia,8,892,5
2020-02-26T00:00:00Z,26,2,2020,254,3,South_Korea,KR,KOR,51635256,Asia,11,1146,6
2020-02-27T00:00:00Z,27,2,2020,449,1,South_Korea,KR,KOR,51635256,Asia,12,1595,7
2020-02-28T00:00:00Z,28,2,2020,427,1,South_Korea,KR,KOR,51635256,Asia,13,2022,8
2020-02-29T00:00:00Z,29,2,2020,909,3,South_Korea,KR,KOR,51635256,Asia,16,2931,9
2020-03-01T00:00:00Z,1,3,2020,595,1,South_Korea,KR,KOR,51635256,Asia,17,3526,10
2020-03-02T00:00:00Z,2,3,2020,686,5,South_Korea,KR,KOR,51635256,Asia,22,4212,11
2020-03-03T00:00:00Z,3,3,2020,600,6,South_Korea,KR,KOR,51635256,Asia,28,4812,12
2020-03-04T00:00:00Z,4,3,2020,516,4,South_Korea,KR,KOR,51635256,Asia,32,5328,13
2020-03-05T00:00:00Z,5,3,2020,438,3,South_Korea,KR,KOR,51635256,Asia,35,5766,14
2020-03-06T00:00:00Z,6,3,2020,518,7,South_Korea,KR,KOR,51635256,Asia,42,6284,15
2020-03-07T00:00:00Z,7,3,2020,483,2,South_Korea,KR,KOR,51635256,Asia,44,6767,16
2020-03-08T00:00:00Z,8,3,2020,367,6,South_Korea,KR,KOR,51635256,Asia,50,7134,17
2020-03-09T00:00:00Z,9,3,2020,248,1,South_Korea,KR,KOR,51635256,Asia,51,7382,18
2020-03-10T00:00:00Z,10,3,2020,131,3,South_Korea,KR,KOR,51635256,Asia,54,7513,19
2020-03-11T00:00:00Z,11,3,2020,242,6,South_Korea,KR,KOR,51635256,Asia,60,7755,20
2020-03-12T00:00:00Z,12,3,2020,114,6,South_Korea,KR,KOR,51635256,Asia,66,7869,21
2020-03-13T00:00:00Z,13,3,2020,110,1,South_Korea,KR,KOR,51635256,Asia,67,7979,22
2020-03-14T00:00:00Z,14,3,2020,107,5,South_Korea,KR,KOR,51635256,Asia,72,8086,23
2020-03-15T00:00:00Z,15,3,2020,76,3,South_Korea,KR,KOR,51635256,Asia,75,8162,24
2020-03-16T00:00:00Z,16,3,2020,74,0,South_Korea,KR,KOR,51635256,Asia,75,8236,25
2020-03-17T00:00:00Z,17,3,2020,84,6,South_Korea,KR,KOR,51635256,Asia,81,8320,26
2020-03-18T00:00:00Z,18,3,2020,93,5,South_Korea,KR,KOR,51635256,Asia,86,8413,27
2020-03-19T00:00:00Z,19,3,2020,152,5,South_Korea,KR,KOR,51635256,Asia,91,8565,28
2020-03-20T00:00:00Z,20,3,2020,87,9,South_Korea,KR,KOR,51635256,Asia,100,8652,29
2020-03-21T00:00:00Z,21,3,2020,147,3,South_Korea,KR,KOR,51635256,Asia,103,8799,30
2020-03-22T00:00:00Z,22,3,2020,98,1,South_Korea,KR,KOR,51635256,Asia,104,8897,31
2020-03-23T00:00:00Z,23,3,2020,64,9,South_Korea,KR,KOR,51635256,Asia,113,8961,32
2020-03-24T00:00:00Z,24,3,2020,76,7,South_Korea,KR,KOR,51635256,Asia,120,9037,33
2020-03-25T00:00:00Z,25,3,2020,100,6,South_Korea,KR,KOR,51635256,Asia,126,9137,34
2020-03-26T00:00:00Z,26,3,2020,104,5,South_Korea,KR,KOR,51635256,Asia,131,9241,35
2020-03-27T00:00:00Z,27,3,2020,91,8,South_Korea,KR,KOR,51635256,Asia,139,9332,36
2020-03-28T00:00:00Z,28,3,2020,146,5,South_Korea,KR,KOR,51635256,Asia,144,9478,37
2020-03-29T00:00:00Z,29,3,2020,105,8,South_Korea,KR,KOR,51635256,Asia,152,9583,38
2020-03-30T00:00:00Z,30,3,2020,78,6,South_Korea,KR,KOR,51635256,Asia,158,9661,39
2020-03-31T00:00:00Z,31,3,2020,125,5,South_Korea,KR,KOR,51635256,Asia,163,9786,40
2020-04-01T00:00:00Z,1,4,2020,0,0,South_Korea,KR,KOR,51635256,Asia,163,9786,41
2020-04-02T00:00:00Z,2,4,2020,190,6,South_Korea,KR,KOR,51635256,Asia,169,9976,42
2020-04-03T00:00:00Z,3,4,2020,86,5,South_Korea,KR,KOR,51635256,Asia,174,10062,43
2020-04-04T00:00:00Z,4,4,2020,94,3,South_Korea,KR,KOR,51635256,Asia,177,10156,44
2020-04-05T00:00:00Z,5,4,2020,81,6,South_Korea,KR,KOR,51635256,Asia,183,10237,45
2020-04-06T00:00:00Z,6,4,2020,47,3,South_Korea,KR,KOR,51635256,Asia,186,10284,46
2020-04-07T00:00:00Z,7,4,2020,47,6,South_Korea,KR,KOR,51635256,Asia,192,10331,47
2020-04-08T00:00:00Z,8,4,2020,53,8,South_Korea,KR,KOR,51635256,Asia,200,10384,48
2020-04-09T00:00:00Z,9,4,2020,39,4,South_Korea,KR,KOR,51635256,Asia,204,10423,49
2020-04-10T00:00:00Z,10,4,2020,27,4,South_Korea,KR,KOR,51635256,Asia,208,10450,50
2020-04-11T00:00:00Z,11,4,2020,0,0,South_Korea,KR,KOR,51635256,Asia,208,10450,51
2020-04-12T00:00:00Z,12,4,2020,62,6,South_Korea,KR,KOR,51635256,Asia,214,10512,52
2020-04-13T00:00:00Z,13,4,2020,25,3,South_Korea,KR,KOR,51635256,Asia,217,10537,53
2020-04-14T00:00:00Z,14,4,2020,27,5,South_Korea,KR,KOR,51635256,Asia,222,10564,54
2020-04-15T00:00:00Z,15,4,2020,27,3,South_Korea,KR,KOR,51635256,Asia,225,10591,55
2020-04-16T00:00:00Z,16,4,2020,22,4,South_Korea,KR,KOR,51635256,Asia,229,10613,56
2020-04-17T00:00:00Z,17,4,2020,22,1,South_Korea,KR,KOR,51635256,Asia,230,10635,57
2020-04-18T00:00:00Z,18,4,2020,18,2,South_Korea,KR,KOR,51635256,Asia,232,10653,58
2020-04-19T00:00:00Z,19,4,2020,8,2,South_Korea,KR,KOR,51635256,Asia,234,10661,59
2020-04-20T00:00:00Z,20,4,2020,13,2,South_Korea,KR,KOR,51635256,Asia,236,10674,60
2020-04-21T00:00:00Z,21,4,2020,9,1,South_Korea,KR,KOR,51635256,Asia,237,10683,61
2020-04-22T00:00:00Z,22,4,2020,11,1,South_Korea,KR,KOR,51635256,Asia,238,10694,62
2020-04-23T00:00:00Z,23,4,2020,8,2,South_Korea,KR,KOR,51635256,Asia,240,10702,63
2020-04-24T00:00:00Z,24,4,2020,6,0,South_Korea,KR,KOR,51635256,Asia,240,10708,64
2020-04-25T00:00:00Z,25,4,2020,10,0,South_Korea,KR,KOR,51635256,Asia,240,10718,65
2020-04-26T00:00:00Z,26,4,2020,10,2,South_Korea,KR,KOR,51635256,Asia,242,10728,66
2020-04-27T00:00:00Z,27,4,2020,10,1,South_Korea,KR,KOR,51635256,Asia,243,10738,67
2020-04-28T00:00:00Z,28,4,2020,14,1,South_Korea,KR,KOR,51635256,Asia,244,10752,68
2020-04-29T00:00:00Z,29,4,2020,9,2,South_Korea,KR,KOR,51635256,Asia,246,10761,69
2020-04-30T00:00:00Z,30,4,2020,4,1,South_Korea,KR,KOR,51635256,Asia,247,10765,70
2020-05-01T00:00:00Z,1,5,2020,9,1,South_Korea,KR,KOR,51635256,Asia,248,10774,71
2020-05-02T00:00:00Z,2,5,2020,6,2,South_Korea,KR,KOR,51635256,Asia,250,10780,72
2020-05-03T00:00:00Z,3,5,2020,13,0,South_Korea,KR,KOR,51635256,Asia,250,10793,73
2020-05-04T00:00:00Z,4,5,2020,8,2,South_Korea,KR,KOR,51635256,Asia,252,10801,74
2020-05-05T00:00:00Z,5,5,2020,3,2,South_Korea,KR,KOR,51635256,Asia,254,10804,75
2020-05-06T00:00:00Z,6,5,2020,2,1,South_Korea,KR,KOR,51635256,Asia,255,10806,76
2020-05-07T00:00:00Z,7,5,2020,4,1,South_Korea,KR,KOR,51635256,Asia,256,10810,77
2020-05-08T00:00:00Z,8,5,2020,12,0,South_Korea,KR,KOR,51635256,Asia,256,10822,78
2020-05-09T00:00:00Z,9,5,2020,18,0,South_Korea,KR,KOR,51635256,Asia,256,10840,79
2020-05-10T00:00:00Z,10,5,2020,34,0,South_Korea,KR,KOR,51635256,Asia,256,10874,80
2020-05-11T00:00:00Z,11,5,2020,35,0,South_Korea,KR,KOR,51635256,Asia,256,10909,81
2020-05-12T00:00:00Z,12,5,2020,27,2,South_Korea,KR,KOR,51635256,Asia,258,10936,82
2020-05-13T00:00:00Z,13,5,2020,26,1,South_Korea,KR,KOR,51635256,Asia,259,10962,83
2020-05-14T00:00:00Z,14,5,2020,29,1,South_Korea,KR,KOR,51635256,Asia,260,10991,84
2020-05-15T00:00:00Z,15,5,2020,27,0,South_Korea,KR,KOR,51635256,Asia,260,11018,85
2020-05-16T00:00:00Z,16,5,2020,19,2,South_Korea,KR,KOR,51635256,Asia,262,11037,86
2020-05-17T00:00:00Z,17,5,2020,13,0,South_Korea,KR,KOR,51635256,Asia,262,11050,87
2020-05-18T00:00:00Z,18,5,2020,15,1,South_Korea,KR,KOR,51635256,Asia,263,11065,88
2020-05-19T00:00:00Z,19,5,2020,13,0,South_Korea,KR,KOR,51635256,Asia,263,11078,89
2020-05-20T00:00:00Z,20,5,2020,32,0,South_Korea,KR,KOR,51635256,Asia,263,11110,90
2020-05-21T00:00:00Z,21,5,2020,12,1,South_Korea,KR,KOR,51635256,Asia,264,11122,91
2020-05-22T00:00:00Z,22,5,2020,20,0,South_Korea,KR,KOR,51635256,Asia,264,11142,92
2020-05-23T00:00:00Z,23,5,2020,23,2,South_Korea,KR,KOR,51635256,Asia,266,11165,93
2020-05-24T00:00:00Z,24,5,2020,25,0,South_Korea,KR,KOR,51635256,Asia,266,11190,94
2020-05-25T00:00:00Z,25,5,2020,16,1,South_Korea,KR,KOR,51635256,Asia,267,11206,95
2020-05-26T00:00:00Z,26,5,2020,19,2,South_Korea,KR,KOR,51635256,Asia,269,11225,96
2020-05-27T00:00:00Z,27,5,2020,40,0,South_Korea,KR,KOR,51635256,Asia,269,11265,97
2020-05-15T00:00:00Z,15,5,2020,28,1,South_Sudan,SS,SSD,10975920,Africa,1,231,1
2020-05-16T00:00:00Z,16,5,2020,5,3,South_Sudan,SS,SSD,10975920,Africa,4,236,2
2020-05-17T00:00:00Z,17,5,2020,0,0,South_Sudan,SS,SSD,10975920,Africa,4,236,3
2020-05-18T00:00:00Z,18,5,2020,46,0,South_Sudan,SS,SSD,10975920,Africa,4,282,4
2020-05-19T00:00:00Z,19,5,2020,0,0,South_Sudan,SS,SSD,10975920,Africa,4,282,5
2020-05-20T00:00:00Z,20,5,2020,3,2,South_Sudan,SS,SSD,10975920,Africa,6,285,6
2020-05-21T00:00:00Z,21,5,2020,0,0,South_Sudan,SS,SSD,10975920,Africa,6,285,7
2020-05-22T00:00:00Z,22,5,2020,54,0,South_Sudan,SS,SSD,10975920,Africa,6,339,8
2020-05-23T00:00:00Z,23,5,2020,0,0,South_Sudan,SS,SSD,10975920,Africa,6,339,9
2020-05-24T00:00:00Z,24,5,2020,224,0,South_Sudan,SS,SSD,10975920,Africa,6,563,10
2020-05-25T00:00:00Z,25,5,2020,0,0,South_Sudan,SS,SSD,10975920,Africa,6,563,11
2020-05-26T00:00:00Z,26,5,2020,92,2,South_Sudan,SS,SSD,10975920,Africa,8,655,12
2020-05-27T00:00:00Z,27,5,2020,151,0,South_Sudan,SS,SSD,10975920,Africa,8,806,13
2020-03-05T00:00:00Z,5,3,2020,81,1,Spain,ES,ESP,46723749,Europe,1,348,1
2020-03-06T00:00:00Z,6,3,2020,183,2,Spain,ES,ESP,46723749,Europe,3,531,2
2020-03-07T00:00:00Z,7,3,2020,233,2,Spain,ES,ESP,46723749,Europe,5,764,3
2020-03-08T00:00:00Z,8,3,2020,330,0,Spain,ES,ESP,46723749,Europe,5,1094,4
2020-03-09T00:00:00Z,9,3,2020,433,0,Spain,ES,ESP,46723749,Europe,5,1527,5
2020-03-10T00:00:00Z,10,3,2020,772,23,Spain,ES,ESP,46723749,Europe,28,2299,6
2020-03-11T00:00:00Z,11,3,2020,975,7,Spain,ES,ESP,46723749,Europe,35,3274,7
2020-03-12T00:00:00Z,12,3,2020,1153,12,Spain,ES,ESP,46723749,Europe,47,4427,8
2020-03-13T00:00:00Z,13,3,2020,1531,37,Spain,ES,ESP,46723749,Europe,84,5958,9
2020-03-14T00:00:00Z,14,3,2020,1683,37,Spain,ES,ESP,46723749,Europe,121,7641,10
2020-03-15T00:00:00Z,15,3,2020,2144,15,Spain,ES,ESP,46723749,Europe,136,9785,11
2020-03-16T00:00:00Z,16,3,2020,1706,152,Spain,ES,ESP,46723749,Europe,288,11491,12
2020-03-17T00:00:00Z,17,3,2020,2503,21,Spain,ES,ESP,46723749,Europe,309,13994,13
2020-03-18T00:00:00Z,18,3,2020,3694,182,Spain,ES,ESP,46723749,Europe,491,17688,14
2020-03-19T00:00:00Z,19,3,2020,4047,107,Spain,ES,ESP,46723749,Europe,598,21735,15
2020-03-20T00:00:00Z,20,3,2020,4569,169,Spain,ES,ESP,46723749,Europe,767,26304,16
2020-03-21T00:00:00Z,21,3,2020,5446,235,Spain,ES,ESP,46723749,Europe,1002,31750,17
2020-03-22T00:00:00Z,22,3,2020,4866,324,Spain,ES,ESP,46723749,Europe,1326,36616,18
2020-03-23T00:00:00Z,23,3,2020,4646,394,Spain,ES,ESP,46723749,Europe,1720,41262,19
2020-03-24T00:00:00Z,24,3,2020,7691,462,Spain,ES,ESP,46723749,Europe,2182,48953,20
2020-03-25T00:00:00Z,25,3,2020,8553,514,Spain,ES,ESP,46723749,Europe,2696,57506,21
2020-03-26T00:00:00Z,26,3,2020,8954,738,Spain,ES,ESP,46723749,Europe,3434,66460,22
2020-03-27T00:00:00Z,27,3,2020,9181,655,Spain,ES,ESP,46723749,Europe,4089,75641,23
2020-03-28T00:00:00Z,28,3,2020,8244,769,Spain,ES,ESP,46723749,Europe,4858,83885,24
2020-03-29T00:00:00Z,29,3,2020,6424,832,Spain,ES,ESP,46723749,Europe,5690,90309,25
2020-03-30T00:00:00Z,30,3,2020,5813,838,Spain,ES,ESP,46723749,Europe,6528,96122,26
2020-03-31T00:00:00Z,31,3,2020,8145,812,Spain,ES,ESP,46723749,Europe,7340,104267,27
2020-04-01T00:00:00Z,1,4,2020,7413,849,Spain,ES,ESP,46723749,Europe,8189,111680,28
2020-04-02T00:00:00Z,2,4,2020,7583,864,Spain,ES,ESP,46723749,Europe,9053,119263,29
2020-04-03T00:00:00Z,3,4,2020,7272,950,Spain,ES,ESP,46723749,Europe,10003,126535,30
2020-04-04T00:00:00Z,4,4,2020,6663,932,Spain,ES,ESP,46723749,Europe,10935,133198,31
2020-04-05T00:00:00Z,5,4,2020,5533,809,Spain,ES,ESP,46723749,Europe,11744,138731,32
2020-04-06T00:00:00Z,6,4,2020,3667,674,Spain,ES,ESP,46723749,Europe,12418,142398,33
2020-04-07T00:00:00Z,7,4,2020,5209,637,Spain,ES,ESP,46723749,Europe,13055,147607,34
2020-04-08T00:00:00Z,8,4,2020,5583,743,Spain,ES,ESP,46723749,Europe,13798,153190,35
2020-04-09T00:00:00Z,9,4,2020,5745,757,Spain,ES,ESP,46723749,Europe,14555,158935,36
2020-04-10T00:00:00Z,10,4,2020,4537,683,Spain,ES,ESP,46723749,Europe,15238,163472,37
2020-04-11T00:00:00Z,11,4,2020,4550,605,Spain,ES,ESP,46723749,Europe,15843,168022,38
2020-04-12T00:00:00Z,12,4,2020,3899,510,Spain,ES,ESP,46723749,Europe,16353,171921,39
2020-04-13T00:00:00Z,13,4,2020,3030,619,Spain,ES,ESP,46723749,Europe,16972,174951,40
2020-04-14T00:00:00Z,14,4,2020,3116,517,Spain,ES,ESP,46723749,Europe,17489,178067,41
2020-04-15T00:00:00Z,15,4,2020,4424,787,Spain,ES,ESP,46723749,Europe,18276,182491,42
2020-04-16T00:00:00Z,16,4,2020,3820,617,Spain,ES,ESP,46723749,Europe,18893,186311,43
2020-04-17T00:00:00Z,17,4,2020,3818,585,Spain,ES,ESP,46723749,Europe,19478,190129,44
2020-04-18T00:00:00Z,18,4,2020,3836,565,Spain,ES,ESP,46723749,Europe,20043,193965,45
2020-04-19T00:00:00Z,19,4,2020,-713,410,Spain,ES,ESP,46723749,Europe,20453,193252,46
2020-04-20T00:00:00Z,20,4,2020,2218,399,Spain,ES,ESP,46723749,Europe,20852,195470,47
2020-04-21T00:00:00Z,21,4,2020,2951,430,Spain,ES,ESP,46723749,Europe,21282,198421,48
2020-04-22T00:00:00Z,22,4,2020,2312,435,Spain,ES,ESP,46723749,Europe,21717,200733,49
2020-04-23T00:00:00Z,23,4,2020,2916,440,Spain,ES,ESP,46723749,Europe,22157,203649,50
2020-04-24T00:00:00Z,24,4,2020,2114,367,Spain,ES,ESP,46723749,Europe,22524,205763,51
2020-04-25T00:00:00Z,25,4,2020,2506,378,Spain,ES,ESP,46723749,Europe,22902,208269,52
2020-04-26T00:00:00Z,26,4,2020,1641,288,Spain,ES,ESP,46723749,Europe,23190,209910,53
2020-04-27T00:00:00Z,27,4,2020,1660,0,Spain,ES,ESP,46723749,Europe,23190,211570,54
2020-04-28T00:00:00Z,28,4,2020,1525,632,Spain,ES,ESP,46723749,Europe,23822,213095,55
2020-04-29T00:00:00Z,29,4,2020,847,453,Spain,ES,ESP,46723749,Europe,24275,213942,56
2020-04-30T00:00:00Z,30,4,2020,1241,268,Spain,ES,ESP,46723749,Europe,24543,215183,57
2020-05-01T00:00:00Z,1,5,2020,1387,281,Spain,ES,ESP,46723749,Europe,24824,216570,58
2020-05-02T00:00:00Z,2,5,2020,1234,276,Spain,ES,ESP,46723749,Europe,25100,217804,59
2020-05-03T00:00:00Z,3,5,2020,935,164,Spain,ES,ESP,46723749,Europe,25264,218739,60
2020-05-04T00:00:00Z,4,5,2020,466,164,Spain,ES,ESP,46723749,Europe,25428,219205,61
2020-05-05T00:00:00Z,5,5,2020,1039,185,Spain,ES,ESP,46723749,Europe,25613,220244,62
2020-05-06T00:00:00Z,6,5,2020,880,244,Spain,ES,ESP,46723749,Europe,25857,221124,63
2020-05-07T00:00:00Z,7,5,2020,921,213,Spain,ES,ESP,46723749,Europe,26070,222045,64
2020-05-08T00:00:00Z,8,5,2020,1173,181,Spain,ES,ESP,46723749,Europe,26251,223218,65
2020-05-09T00:00:00Z,9,5,2020,743,227,Spain,ES,ESP,46723749,Europe,26478,223961,66
2020-05-10T00:00:00Z,10,5,2020,3416,143,Spain,ES,ESP,46723749,Europe,26621,227377,67
2020-05-11T00:00:00Z,11,5,2020,393,123,Spain,ES,ESP,46723749,Europe,26744,227770,68
2020-05-12T00:00:00Z,12,5,2020,482,176,Spain,ES,ESP,46723749,Europe,26920,228252,69
2020-05-13T00:00:00Z,13,5,2020,439,184,Spain,ES,ESP,46723749,Europe,27104,228691,70
2020-05-14T00:00:00Z,14,5,2020,849,217,Spain,ES,ESP,46723749,Europe,27321,229540,71
2020-05-15T00:00:00Z,15,5,2020,643,138,Spain,ES,ESP,46723749,Europe,27459,230183,72
2020-05-16T00:00:00Z,16,5,2020,515,104,Spain,ES,ESP,46723749,Europe,27563,230698,73
2020-05-17T00:00:00Z,17,5,2020,652,87,Spain,ES,ESP,46723749,Europe,27650,231350,74
2020-05-18T00:00:00Z,18,5,2020,256,59,Spain,ES,ESP,46723749,Europe,27709,231606,75
2020-05-19T00:00:00Z,19,5,2020,431,69,Spain,ES,ESP,46723749,Europe,27778,232037,76
2020-05-20T00:00:00Z,20,5,2020,518,110,Spain,ES,ESP,46723749,Europe,27888,232555,77
2020-05-21T00:00:00Z,21,5,2020,482,52,Spain,ES,ESP,46723749,Europe,27940,233037,78
2020-05-22T00:00:00Z,22,5,2020,1787,688,Spain,ES,ESP,46723749,Europe,28628,234824,79
2020-05-23T00:00:00Z,23,5,2020,466,50,Spain,ES,ESP,46723749,Europe,28678,235290,80
2020-05-24T00:00:00Z,24,5,2020,482,74,Spain,ES,ESP,46723749,Europe,28752,235772,81
2020-05-25T00:00:00Z,25,5,2020,-372,-1918,Spain,ES,ESP,46723749,Europe,26834,235400,82
2020-05-26T00:00:00Z,26,5,2020,859,283,Spain,ES,ESP,46723749,Europe,27117,236259,83
2020-03-29T00:00:00Z,29,3,2020,9,1,Sri_Lanka,LK,LKA,21670000,Asia,1,115,1
2020-03-30T00:00:00Z,30,3,2020,5,0,Sri_Lanka,LK,LKA,21670000,Asia,1,120,2
2020-03-31T00:00:00Z,31,3,2020,0,0,Sri_Lanka,LK,LKA,21670000,Asia,1,120,3
2020-04-01T00:00:00Z,1,4,2020,2,1,Sri_Lanka,LK,LKA,21670000,Asia,2,122,4
2020-04-02T00:00:00Z,2,4,2020,21,0,Sri_Lanka,LK,LKA,21670000,Asia,2,143,5
2020-04-03T00:00:00Z,3,4,2020,5,1,Sri_Lanka,LK,LKA,21670000,Asia,3,148,6
2020-04-04T00:00:00Z,4,4,2020,3,1,Sri_Lanka,LK,LKA,21670000,Asia,4,151,7
2020-04-05T00:00:00Z,5,4,2020,8,1,Sri_Lanka,LK,LKA,21670000,Asia,5,159,8
2020-04-06T00:00:00Z,6,4,2020,7,0,Sri_Lanka,LK,LKA,21670000,Asia,5,166,9
2020-04-07T00:00:00Z,7,4,2020,12,0,Sri_Lanka,LK,LKA,21670000,Asia,5,178,10
2020-04-08T00:00:00Z,8,4,2020,7,1,Sri_Lanka,LK,LKA,21670000,Asia,6,185,11
2020-04-09T00:00:00Z,9,4,2020,4,1,Sri_Lanka,LK,LKA,21670000,Asia,7,189,12
2020-04-10T00:00:00Z,10,4,2020,1,0,Sri_Lanka,LK,LKA,21670000,Asia,7,190,13
2020-04-11T00:00:00Z,11,4,2020,7,0,Sri_Lanka,LK,LKA,21670000,Asia,7,197,14
2020-04-12T00:00:00Z,12,4,2020,2,0,Sri_Lanka,LK,LKA,21670000,Asia,7,199,15
2020-04-13T00:00:00Z,13,4,2020,11,0,Sri_Lanka,LK,LKA,21670000,Asia,7,210,16
2020-04-14T00:00:00Z,14,4,2020,8,0,Sri_Lanka,LK,LKA,21670000,Asia,7,218,17
2020-04-15T00:00:00Z,15,4,2020,15,0,Sri_Lanka,LK,LKA,21670000,Asia,7,233,18
2020-04-16T00:00:00Z,16,4,2020,4,0,Sri_Lanka,LK,LKA,21670000,Asia,7,237,19
2020-04-17T00:00:00Z,17,4,2020,1,0,Sri_Lanka,LK,LKA,21670000,Asia,7,238,20
2020-04-18T00:00:00Z,18,4,2020,6,0,Sri_Lanka,LK,LKA,21670000,Asia,7,244,21
2020-04-19T00:00:00Z,19,4,2020,10,0,Sri_Lanka,LK,LKA,21670000,Asia,7,254,22
2020-04-20T00:00:00Z,20,4,2020,41,0,Sri_Lanka,LK,LKA,21670000,Asia,7,295,23
2020-04-21T00:00:00Z,21,4,2020,9,0,Sri_Lanka,LK,LKA,21670000,Asia,7,304,24
2020-04-22T00:00:00Z,22,4,2020,6,0,Sri_Lanka,LK,LKA,21670000,Asia,7,310,25
2020-04-23T00:00:00Z,23,4,2020,20,0,Sri_Lanka,LK,LKA,21670000,Asia,7,330,26
2020-04-24T00:00:00Z,24,4,2020,38,0,Sri_Lanka,LK,LKA,21670000,Asia,7,368,27
2020-04-25T00:00:00Z,25,4,2020,52,0,Sri_Lanka,LK,LKA,21670000,Asia,7,420,28
2020-04-26T00:00:00Z,26,4,2020,42,0,Sri_Lanka,LK,LKA,21670000,Asia,7,462,29
2020-04-27T00:00:00Z,27,4,2020,61,0,Sri_Lanka,LK,LKA,21670000,Asia,7,523,30
2020-04-28T00:00:00Z,28,4,2020,65,0,Sri_Lanka,LK,LKA,21670000,Asia,7,588,31
2020-04-29T00:00:00Z,29,4,2020,31,0,Sri_Lanka,LK,LKA,21670000,Asia,7,619,32
2020-04-30T00:00:00Z,30,4,2020,30,0,Sri_Lanka,LK,LKA,21670000,Asia,7,649,33
2020-05-01T00:00:00Z,1,5,2020,16,0,Sri_Lanka,LK,LKA,21670000,Asia,7,665,34
2020-05-02T00:00:00Z,2,5,2020,25,0,Sri_Lanka,LK,LKA,21670000,Asia,7,690,35
2020-05-03T00:00:00Z,3,5,2020,15,0,Sri_Lanka,LK,LKA,21670000,Asia,7,705,36
2020-05-04T00:00:00Z,4,5,2020,13,0,Sri_Lanka,LK,LKA,21670000,Asia,7,718,37
2020-05-05T00:00:00Z,5,5,2020,37,1,Sri_Lanka,LK,LKA,21670000,Asia,8,755,38
2020-05-06T00:00:00Z,6,5,2020,16,1,Sri_Lanka,LK,LKA,21670000,Asia,9,771,39
2020-05-07T00:00:00Z,7,5,2020,26,0,Sri_Lanka,LK,LKA,21670000,Asia,9,797,40
2020-05-08T00:00:00Z,8,5,2020,27,0,Sri_Lanka,LK,LKA,21670000,Asia,9,824,41
2020-05-09T00:00:00Z,9,5,2020,11,0,Sri_Lanka,LK,LKA,21670000,Asia,9,835,42
2020-05-10T00:00:00Z,10,5,2020,12,0,Sri_Lanka,LK,LKA,21670000,Asia,9,847,43
2020-05-11T00:00:00Z,11,5,2020,16,0,Sri_Lanka,LK,LKA,21670000,Asia,9,863,44
2020-05-12T00:00:00Z,12,5,2020,6,0,Sri_Lanka,LK,LKA,21670000,Asia,9,869,45
2020-05-13T00:00:00Z,13,5,2020,20,0,Sri_Lanka,LK,LKA,21670000,Asia,9,889,46
2020-05-14T00:00:00Z,14,5,2020,26,0,Sri_Lanka,LK,LKA,21670000,Asia,9,915,47
2020-05-15T00:00:00Z,15,5,2020,10,0,Sri_Lanka,LK,LKA,21670000,Asia,9,925,48
2020-05-16T00:00:00Z,16,5,2020,10,0,Sri_Lanka,LK,LKA,21670000,Asia,9,935,49
2020-05-17T00:00:00Z,17,5,2020,25,0,Sri_Lanka,LK,LKA,21670000,Asia,9,960,50
2020-05-18T00:00:00Z,18,5,2020,21,0,Sri_Lanka,LK,LKA,21670000,Asia,9,981,51
2020-05-19T00:00:00Z,19,5,2020,11,0,Sri_Lanka,LK,LKA,21670000,Asia,9,992,52
2020-05-20T00:00:00Z,20,5,2020,35,0,Sri_Lanka,LK,LKA,21670000,Asia,9,1027,53
2020-05-21T00:00:00Z,21,5,2020,1,0,Sri_Lanka,LK,LKA,21670000,Asia,9,1028,54
2020-05-22T00:00:00Z,22,5,2020,27,0,Sri_Lanka,LK,LKA,21670000,Asia,9,1055,55
2020-05-23T00:00:00Z,23,5,2020,13,0,Sri_Lanka,LK,LKA,21670000,Asia,9,1068,56
2020-05-24T00:00:00Z,24,5,2020,21,0,Sri_Lanka,LK,LKA,21670000,Asia,9,1089,57
2020-05-25T00:00:00Z,25,5,2020,52,0,Sri_Lanka,LK,LKA,21670000,Asia,9,1141,58
2020-05-26T00:00:00Z,26,5,2020,41,1,Sri_Lanka,LK,LKA,21670000,Asia,10,1182,59
2020-05-27T00:00:00Z,27,5,2020,137,0,Sri_Lanka,LK,LKA,21670000,Asia,10,1319,60
2020-03-15T00:00:00Z,15,3,2020,0,1,Sudan,SD,SDN,41801533,Africa,1,1,1
2020-03-16T00:00:00Z,16,3,2020,0,0,Sudan,SD,SDN,41801533,Africa,1,1,2
2020-03-17T00:00:00Z,17,3,2020,0,0,Sudan,SD,SDN,41801533,Africa,1,1,3
2020-03-18T00:00:00Z,18,3,2020,0,0,Sudan,SD,SDN,41801533,Africa,1,1,4
2020-03-19T00:00:00Z,19,3,2020,1,0,Sudan,SD,SDN,41801533,Africa,1,2,5
2020-03-20T00:00:00Z,20,3,2020,0,0,Sudan,SD,SDN,41801533,Africa,1,2,6
2020-03-21T00:00:00Z,21,3,2020,0,0,Sudan,SD,SDN,41801533,Africa,1,2,7
2020-03-22T00:00:00Z,22,3,2020,0,0,Sudan,SD,SDN,41801533,Africa,1,2,8
2020-03-23T00:00:00Z,23,3,2020,0,0,Sudan,SD,SDN,41801533,Africa,1,2,9
2020-03-24T00:00:00Z,24,3,2020,0,0,Sudan,SD,SDN,41801533,Africa,1,2,10
2020-03-25T00:00:00Z,25,3,2020,1,0,Sudan,SD,SDN,41801533,Africa,1,3,11
2020-03-26T00:00:00Z,26,3,2020,0,0,Sudan,SD,SDN,41801533,Africa,1,3,12
2020-03-27T00:00:00Z,27,3,2020,0,0,Sudan,SD,SDN,41801533,Africa,1,3,13
2020-03-28T00:00:00Z,28,3,2020,0,0,Sudan,SD,SDN,41801533,Africa,1,3,14
2020-03-29T00:00:00Z,29,3,2020,2,0,Sudan,SD,SDN,41801533,Africa,1,5,15
2020-03-30T00:00:00Z,30,3,2020,0,0,Sudan,SD,SDN,41801533,Africa,1,5,16
2020-03-31T00:00:00Z,31,3,2020,1,1,Sudan,SD,SDN,41801533,Africa,2,6,17
2020-04-01T00:00:00Z,1,4,2020,1,0,Sudan,SD,SDN,41801533,Africa,2,7,18
2020-04-02T00:00:00Z,2,4,2020,0,0,Sudan,SD,SDN,41801533,Africa,2,7,19
2020-04-03T00:00:00Z,3,4,2020,0,0,Sudan,SD,SDN,41801533,Africa,2,7,20
2020-04-04T00:00:00Z,4,4,2020,0,0,Sudan,SD,SDN,41801533,Africa,2,7,21
2020-04-05T00:00:00Z,5,4,2020,3,0,Sudan,SD,SDN,41801533,Africa,2,10,22
2020-04-06T00:00:00Z,6,4,2020,2,0,Sudan,SD,SDN,41801533,Africa,2,12,23
2020-04-07T00:00:00Z,7,4,2020,0,0,Sudan,SD,SDN,41801533,Africa,2,12,24
2020-04-08T00:00:00Z,8,4,2020,2,0,Sudan,SD,SDN,41801533,Africa,2,14,25
2020-04-09T00:00:00Z,9,4,2020,0,0,Sudan,SD,SDN,41801533,Africa,2,14,26
2020-04-10T00:00:00Z,10,4,2020,0,0,Sudan,SD,SDN,41801533,Africa,2,14,27
2020-04-11T00:00:00Z,11,4,2020,1,0,Sudan,SD,SDN,41801533,Africa,2,15,28
2020-04-12T00:00:00Z,12,4,2020,4,0,Sudan,SD,SDN,41801533,Africa,2,19,29
2020-04-13T00:00:00Z,13,4,2020,0,0,Sudan,SD,SDN,41801533,Africa,2,19,30
2020-04-14T00:00:00Z,14,4,2020,10,2,Sudan,SD,SDN,41801533,Africa,4,29,31
2020-04-15T00:00:00Z,15,4,2020,3,1,Sudan,SD,SDN,41801533,Africa,5,32,32
2020-04-16T00:00:00Z,16,4,2020,0,0,Sudan,SD,SDN,41801533,Africa,5,32,33
2020-04-17T00:00:00Z,17,4,2020,0,0,Sudan,SD,SDN,41801533,Africa,5,32,34
2020-04-18T00:00:00Z,18,4,2020,0,0,Sudan,SD,SDN,41801533,Africa,5,32,35
2020-04-19T00:00:00Z,19,4,2020,34,5,Sudan,SD,SDN,41801533,Africa,10,66,36
2020-04-20T00:00:00Z,20,4,2020,0,0,Sudan,SD,SDN,41801533,Africa,10,66,37
2020-04-21T00:00:00Z,21,4,2020,26,2,Sudan,SD,SDN,41801533,Africa,12,92,38
2020-04-22T00:00:00Z,22,4,2020,15,0,Sudan,SD,SDN,41801533,Africa,12,107,39
2020-04-23T00:00:00Z,23,4,2020,33,1,Sudan,SD,SDN,41801533,Africa,13,140,40
2020-04-24T00:00:00Z,24,4,2020,22,0,Sudan,SD,SDN,41801533,Africa,13,162,41
2020-04-25T00:00:00Z,25,4,2020,12,3,Sudan,SD,SDN,41801533,Africa,16,174,42
2020-04-26T00:00:00Z,26,4,2020,39,1,Sudan,SD,SDN,41801533,Africa,17,213,43
2020-04-27T00:00:00Z,27,4,2020,24,4,Sudan,SD,SDN,41801533,Africa,21,237,44
2020-04-28T00:00:00Z,28,4,2020,38,1,Sudan,SD,SDN,41801533,Africa,22,275,45
2020-04-29T00:00:00Z,29,4,2020,43,3,Sudan,SD,SDN,41801533,Africa,25,318,46
2020-04-30T00:00:00Z,30,4,2020,57,3,Sudan,SD,SDN,41801533,Africa,28,375,47
2020-05-01T00:00:00Z,1,5,2020,67,3,Sudan,SD,SDN,41801533,Africa,31,442,48
2020-05-02T00:00:00Z,2,5,2020,0,0,Sudan,SD,SDN,41801533,Africa,31,442,49
2020-05-03T00:00:00Z,3,5,2020,150,10,Sudan,SD,SDN,41801533,Africa,41,592,50
2020-05-04T00:00:00Z,4,5,2020,86,0,Sudan,SD,SDN,41801533,Africa,41,678,51
2020-05-05T00:00:00Z,5,5,2020,0,0,Sudan,SD,SDN,41801533,Africa,41,678,52
2020-05-06T00:00:00Z,6,5,2020,100,4,Sudan,SD,SDN,41801533,Africa,45,778,53
2020-05-07T00:00:00Z,7,5,2020,74,4,Sudan,SD,SDN,41801533,Africa,49,852,54
2020-05-08T00:00:00Z,8,5,2020,78,3,Sudan,SD,SDN,41801533,Africa,52,930,55
2020-05-09T00:00:00Z,9,5,2020,181,7,Sudan,SD,SDN,41801533,Africa,59,1111,56
2020-05-10T00:00:00Z,10,5,2020,53,5,Sudan,SD,SDN,41801533,Africa,64,1164,57
2020-05-11T00:00:00Z,11,5,2020,199,6,Sudan,SD,SDN,41801533,Africa,70,1363,58
2020-05-12T00:00:00Z,12,5,2020,163,4,Sudan,SD,SDN,41801533,Africa,74,1526,59
2020-05-13T00:00:00Z,13,5,2020,135,6,Sudan,SD,SDN,41801533,Africa,80,1661,60
2020-05-14T00:00:00Z,14,5,2020,157,10,Sudan,SD,SDN,41801533,Africa,90,1818,61
2020-05-15T00:00:00Z,15,5,2020,146,1,Sudan,SD,SDN,41801533,Africa,91,1964,62
2020-05-16T00:00:00Z,16,5,2020,0,0,Sudan,SD,SDN,41801533,Africa,91,1964,63
2020-05-17T00:00:00Z,17,5,2020,0,0,Sudan,SD,SDN,41801533,Africa,91,1964,64
2020-05-18T00:00:00Z,18,5,2020,325,6,Sudan,SD,SDN,41801533,Africa,97,2289,65
2020-05-19T00:00:00Z,19,5,2020,302,8,Sudan,SD,SDN,41801533,Africa,105,2591,66
2020-05-20T00:00:00Z,20,5,2020,0,0,Sudan,SD,SDN,41801533,Africa,105,2591,67
2020-05-21T00:00:00Z,21,5,2020,137,6,Sudan,SD,SDN,41801533,Africa,111,2728,68
2020-05-22T00:00:00Z,22,5,2020,410,10,Sudan,SD,SDN,41801533,Africa,121,3138,69
2020-05-23T00:00:00Z,23,5,2020,240,16,Sudan,SD,SDN,41801533,Africa,137,3378,70
2020-05-24T00:00:00Z,24,5,2020,250,9,Sudan,SD,SDN,41801533,Africa,146,3628,71
2020-05-25T00:00:00Z,25,5,2020,6,0,Sudan,SD,SDN,41801533,Africa,146,3634,72
2020-05-26T00:00:00Z,26,5,2020,192,19,Sudan,SD,SDN,41801533,Africa,165,3826,73
2020-05-27T00:00:00Z,27,5,2020,150,5,Sudan,SD,SDN,41801533,Africa,170,3976,74
2020-04-04T00:00:00Z,4,4,2020,0,1,Suriname,SR,SUR,575991,America,1,10,1
2020-04-05T00:00:00Z,5,4,2020,0,0,Suriname,SR,SUR,575991,America,1,10,2
2020-04-06T00:00:00Z,6,4,2020,0,0,Suriname,SR,SUR,575991,America,1,10,3
2020-04-07T00:00:00Z,7,4,2020,0,0,Suriname,SR,SUR,575991,America,1,10,4
2020-04-08T00:00:00Z,8,4,2020,0,0,Suriname,SR,SUR,575991,America,1,10,5
2020-04-09T00:00:00Z,9,4,2020,0,0,Suriname,SR,SUR,575991,America,1,10,6
2020-04-10T00:00:00Z,10,4,2020,0,0,Suriname,SR,SUR,575991,America,1,10,7
2020-04-11T00:00:00Z,11,4,2020,0,0,Suriname,SR,SUR,575991,America,1,10,8
2020-04-12T00:00:00Z,12,4,2020,0,0,Suriname,SR,SUR,575991,America,1,10,9
2020-04-13T00:00:00Z,13,4,2020,0,0,Suriname,SR,SUR,575991,America,1,10,10
2020-04-14T00:00:00Z,14,4,2020,0,0,Suriname,SR,SUR,575991,America,1,10,11
2020-04-15T00:00:00Z,15,4,2020,0,0,Suriname,SR,SUR,575991,America,1,10,12
2020-04-16T00:00:00Z,16,4,2020,0,0,Suriname,SR,SUR,575991,America,1,10,13
2020-04-17T00:00:00Z,17,4,2020,0,0,Suriname,SR,SUR,575991,America,1,10,14
2020-04-18T00:00:00Z,18,4,2020,0,0,Suriname,SR,SUR,575991,America,1,10,15
2020-04-19T00:00:00Z,19,4,2020,0,0,Suriname,SR,SUR,575991,America,1,10,16
2020-04-20T00:00:00Z,20,4,2020,0,0,Suriname,SR,SUR,575991,America,1,10,17
2020-04-21T00:00:00Z,21,4,2020,0,0,Suriname,SR,SUR,575991,America,1,10,18
2020-04-22T00:00:00Z,22,4,2020,0,0,Suriname,SR,SUR,575991,America,1,10,19
2020-04-23T00:00:00Z,23,4,2020,0,0,Suriname,SR,SUR,575991,America,1,10,20
2020-04-24T00:00:00Z,24,4,2020,0,0,Suriname,SR,SUR,575991,America,1,10,21
2020-04-25T00:00:00Z,25,4,2020,0,0,Suriname,SR,SUR,575991,America,1,10,22
2020-04-26T00:00:00Z,26,4,2020,0,0,Suriname,SR,SUR,575991,America,1,10,23
2020-04-27T00:00:00Z,27,4,2020,0,0,Suriname,SR,SUR,575991,America,1,10,24
2020-04-28T00:00:00Z,28,4,2020,0,0,Suriname,SR,SUR,575991,America,1,10,25
2020-04-29T00:00:00Z,29,4,2020,0,0,Suriname,SR,SUR,575991,America,1,10,26
2020-04-30T00:00:00Z,30,4,2020,0,0,Suriname,SR,SUR,575991,America,1,10,27
2020-05-01T00:00:00Z,1,5,2020,0,0,Suriname,SR,SUR,575991,America,1,10,28
2020-05-02T00:00:00Z,2,5,2020,0,0,Suriname,SR,SUR,575991,America,1,10,29
2020-05-03T00:00:00Z,3,5,2020,0,0,Suriname,SR,SUR,575991,America,1,10,30
2020-05-04T00:00:00Z,4,5,2020,0,0,Suriname,SR,SUR,575991,America,1,10,31
2020-05-05T00:00:00Z,5,5,2020,0,0,Suriname,SR,SUR,575991,America,1,10,32
2020-05-06T00:00:00Z,6,5,2020,0,0,Suriname,SR,SUR,575991,America,1,10,33
2020-05-07T00:00:00Z,7,5,2020,0,0,Suriname,SR,SUR,575991,America,1,10,34
2020-05-08T00:00:00Z,8,5,2020,0,0,Suriname,SR,SUR,575991,America,1,10,35
2020-05-09T00:00:00Z,9,5,2020,0,0,Suriname,SR,SUR,575991,America,1,10,36
2020-05-10T00:00:00Z,10,5,2020,0,0,Suriname,SR,SUR,575991,America,1,10,37
2020-05-11T00:00:00Z,11,5,2020,0,0,Suriname,SR,SUR,575991,America,1,10,38
2020-05-12T00:00:00Z,12,5,2020,0,0,Suriname,SR,SUR,575991,America,1,10,39
2020-05-13T00:00:00Z,13,5,2020,0,0,Suriname,SR,SUR,575991,America,1,10,40
2020-05-14T00:00:00Z,14,5,2020,0,0,Suriname,SR,SUR,575991,America,1,10,41
2020-05-15T00:00:00Z,15,5,2020,0,0,Suriname,SR,SUR,575991,America,1,10,42
2020-05-16T00:00:00Z,16,5,2020,0,0,Suriname,SR,SUR,575991,America,1,10,43
2020-05-17T00:00:00Z,17,5,2020,0,0,Suriname,SR,SUR,575991,America,1,10,44
2020-05-18T00:00:00Z,18,5,2020,0,0,Suriname,SR,SUR,575991,America,1,10,45
2020-05-19T00:00:00Z,19,5,2020,1,0,Suriname,SR,SUR,575991,America,1,11,46
2020-05-20T00:00:00Z,20,5,2020,0,0,Suriname,SR,SUR,575991,America,1,11,47
2020-05-21T00:00:00Z,21,5,2020,0,0,Suriname,SR,SUR,575991,America,1,11,48
2020-05-22T00:00:00Z,22,5,2020,0,0,Suriname,SR,SUR,575991,America,1,11,49
2020-05-23T00:00:00Z,23,5,2020,0,0,Suriname,SR,SUR,575991,America,1,11,50
2020-05-24T00:00:00Z,24,5,2020,0,0,Suriname,SR,SUR,575991,America,1,11,51
2020-05-25T00:00:00Z,25,5,2020,0,0,Suriname,SR,SUR,575991,America,1,11,52
2020-05-26T00:00:00Z,26,5,2020,0,0,Suriname,SR,SUR,575991,America,1,11,53
2020-05-27T00:00:00Z,27,5,2020,0,0,Suriname,SR,SUR,575991,America,1,11,54
2020-03-12T00:00:00Z,12,3,2020,136,1,Sweden,SE,SWE,10183175,Europe,1,462,1
2020-03-13T00:00:00Z,13,3,2020,158,0,Sweden,SE,SWE,10183175,Europe,1,620,2
2020-03-14T00:00:00Z,14,3,2020,155,0,Sweden,SE,SWE,10183175,Europe,1,775,3
2020-03-15T00:00:00Z,15,3,2020,149,0,Sweden,SE,SWE,10183175,Europe,1,924,4
2020-03-16T00:00:00Z,16,3,2020,108,2,Sweden,SE,SWE,10183175,Europe,3,1032,5
2020-03-17T00:00:00Z,17,3,2020,89,4,Sweden,SE,SWE,10183175,Europe,7,1121,6
2020-03-18T00:00:00Z,18,3,2020,46,1,Sweden,SE,SWE,10183175,Europe,8,1167,7
2020-03-19T00:00:00Z,19,3,2020,134,2,Sweden,SE,SWE,10183175,Europe,10,1301,8
2020-03-20T00:00:00Z,20,3,2020,122,0,Sweden,SE,SWE,10183175,Europe,10,1423,9
2020-03-21T00:00:00Z,21,3,2020,200,6,Sweden,SE,SWE,10183175,Europe,16,1623,10
2020-03-22T00:00:00Z,22,3,2020,123,4,Sweden,SE,SWE,10183175,Europe,20,1746,11
2020-03-23T00:00:00Z,23,3,2020,160,1,Sweden,SE,SWE,10183175,Europe,21,1906,12
2020-03-24T00:00:00Z,24,3,2020,110,4,Sweden,SE,SWE,10183175,Europe,25,2016,13
2020-03-25T00:00:00Z,25,3,2020,256,11,Sweden,SE,SWE,10183175,Europe,36,2272,14
2020-03-26T00:00:00Z,26,3,2020,238,6,Sweden,SE,SWE,10183175,Europe,42,2510,15
2020-03-27T00:00:00Z,27,3,2020,296,24,Sweden,SE,SWE,10183175,Europe,66,2806,16
2020-03-28T00:00:00Z,28,3,2020,240,26,Sweden,SE,SWE,10183175,Europe,92,3046,17
2020-03-29T00:00:00Z,29,3,2020,401,10,Sweden,SE,SWE,10183175,Europe,102,3447,18
2020-03-30T00:00:00Z,30,3,2020,253,8,Sweden,SE,SWE,10183175,Europe,110,3700,19
2020-03-31T00:00:00Z,31,3,2020,328,36,Sweden,SE,SWE,10183175,Europe,146,4028,20
2020-04-01T00:00:00Z,1,4,2020,407,34,Sweden,SE,SWE,10183175,Europe,180,4435,21
2020-04-02T00:00:00Z,2,4,2020,512,59,Sweden,SE,SWE,10183175,Europe,239,4947,22
2020-04-03T00:00:00Z,3,4,2020,519,43,Sweden,SE,SWE,10183175,Europe,282,5466,23
2020-04-04T00:00:00Z,4,4,2020,612,51,Sweden,SE,SWE,10183175,Europe,333,6078,24
2020-04-05T00:00:00Z,5,4,2020,365,40,Sweden,SE,SWE,10183175,Europe,373,6443,25
2020-04-06T00:00:00Z,6,4,2020,387,28,Sweden,SE,SWE,10183175,Europe,401,6830,26
2020-04-07T00:00:00Z,7,4,2020,376,76,Sweden,SE,SWE,10183175,Europe,477,7206,27
2020-04-08T00:00:00Z,8,4,2020,487,114,Sweden,SE,SWE,10183175,Europe,591,7693,28
2020-04-09T00:00:00Z,9,4,2020,726,96,Sweden,SE,SWE,10183175,Europe,687,8419,29
2020-04-10T00:00:00Z,10,4,2020,722,106,Sweden,SE,SWE,10183175,Europe,793,9141,30
2020-04-11T00:00:00Z,11,4,2020,544,77,Sweden,SE,SWE,10183175,Europe,870,9685,31
2020-04-12T00:00:00Z,12,4,2020,466,17,Sweden,SE,SWE,10183175,Europe,887,10151,32
2020-04-13T00:00:00Z,13,4,2020,332,12,Sweden,SE,SWE,10183175,Europe,899,10483,33
2020-04-14T00:00:00Z,14,4,2020,465,20,Sweden,SE,SWE,10183175,Europe,919,10948,34
2020-04-15T00:00:00Z,15,4,2020,497,114,Sweden,SE,SWE,10183175,Europe,1033,11445,35
2020-04-16T00:00:00Z,16,4,2020,482,170,Sweden,SE,SWE,10183175,Europe,1203,11927,36
2020-04-17T00:00:00Z,17,4,2020,613,130,Sweden,SE,SWE,10183175,Europe,1333,12540,37
2020-04-18T00:00:00Z,18,4,2020,676,67,Sweden,SE,SWE,10183175,Europe,1400,13216,38
2020-04-19T00:00:00Z,19,4,2020,606,111,Sweden,SE,SWE,10183175,Europe,1511,13822,39
2020-04-20T00:00:00Z,20,4,2020,563,29,Sweden,SE,SWE,10183175,Europe,1540,14385,40
2020-04-21T00:00:00Z,21,4,2020,392,40,Sweden,SE,SWE,10183175,Europe,1580,14777,41
2020-04-22T00:00:00Z,22,4,2020,545,185,Sweden,SE,SWE,10183175,Europe,1765,15322,42
2020-04-23T00:00:00Z,23,4,2020,682,172,Sweden,SE,SWE,10183175,Europe,1937,16004,43
2020-04-24T00:00:00Z,24,4,2020,751,84,Sweden,SE,SWE,10183175,Europe,2021,16755,44
2020-04-25T00:00:00Z,25,4,2020,812,131,Sweden,SE,SWE,10183175,Europe,2152,17567,45
2020-04-26T00:00:00Z,26,4,2020,610,40,Sweden,SE,SWE,10183175,Europe,2192,18177,46
2020-04-27T00:00:00Z,27,4,2020,463,2,Sweden,SE,SWE,10183175,Europe,2194,18640,47
2020-04-28T00:00:00Z,28,4,2020,286,80,Sweden,SE,SWE,10183175,Europe,2274,18926,48
2020-04-29T00:00:00Z,29,4,2020,695,81,Sweden,SE,SWE,10183175,Europe,2355,19621,49
2020-04-30T00:00:00Z,30,4,2020,681,107,Sweden,SE,SWE,10183175,Europe,2462,20302,50
2020-05-01T00:00:00Z,1,5,2020,790,124,Sweden,SE,SWE,10183175,Europe,2586,21092,51
2020-05-02T00:00:00Z,2,5,2020,428,67,Sweden,SE,SWE,10183175,Europe,2653,21520,52
2020-05-03T00:00:00Z,3,5,2020,562,16,Sweden,SE,SWE,10183175,Europe,2669,22082,53
2020-05-04T00:00:00Z,4,5,2020,235,10,Sweden,SE,SWE,10183175,Europe,2679,22317,54
2020-05-05T00:00:00Z,5,5,2020,404,90,Sweden,SE,SWE,10183175,Europe,2769,22721,55
2020-05-06T00:00:00Z,6,5,2020,495,85,Sweden,SE,SWE,10183175,Europe,2854,23216,56
2020-05-07T00:00:00Z,7,5,2020,702,87,Sweden,SE,SWE,10183175,Europe,2941,23918,57
2020-05-08T00:00:00Z,8,5,2020,705,99,Sweden,SE,SWE,10183175,Europe,3040,24623,58
2020-05-09T00:00:00Z,9,5,2020,642,135,Sweden,SE,SWE,10183175,Europe,3175,25265,59
2020-05-10T00:00:00Z,10,5,2020,656,45,Sweden,SE,SWE,10183175,Europe,3220,25921,60
2020-05-11T00:00:00Z,11,5,2020,401,5,Sweden,SE,SWE,10183175,Europe,3225,26322,61
2020-05-12T00:00:00Z,12,5,2020,348,31,Sweden,SE,SWE,10183175,Europe,3256,26670,62
2020-05-13T00:00:00Z,13,5,2020,602,57,Sweden,SE,SWE,10183175,Europe,3313,27272,63
2020-05-14T00:00:00Z,14,5,2020,637,147,Sweden,SE,SWE,10183175,Europe,3460,27909,64
2020-05-15T00:00:00Z,15,5,2020,673,69,Sweden,SE,SWE,10183175,Europe,3529,28582,65
2020-05-16T00:00:00Z,16,5,2020,625,117,Sweden,SE,SWE,10183175,Europe,3646,29207,66
2020-05-17T00:00:00Z,17,5,2020,470,28,Sweden,SE,SWE,10183175,Europe,3674,29677,67
2020-05-18T00:00:00Z,18,5,2020,466,5,Sweden,SE,SWE,10183175,Europe,3679,30143,68
2020-05-19T00:00:00Z,19,5,2020,234,19,Sweden,SE,SWE,10183175,Europe,3698,30377,69
2020-05-20T00:00:00Z,20,5,2020,422,45,Sweden,SE,SWE,10183175,Europe,3743,30799,70
2020-05-21T00:00:00Z,21,5,2020,724,88,Sweden,SE,SWE,10183175,Europe,3831,31523,71
2020-05-22T00:00:00Z,22,5,2020,649,40,Sweden,SE,SWE,10183175,Europe,3871,32172,72
2020-05-23T00:00:00Z,23,5,2020,637,54,Sweden,SE,SWE,10183175,Europe,3925,32809,73
2020-05-24T00:00:00Z,24,5,2020,379,67,Sweden,SE,SWE,10183175,Europe,3992,33188,74
2020-05-25T00:00:00Z,25,5,2020,271,6,Sweden,SE,SWE,10183175,Europe,3998,33459,75
2020-05-26T00:00:00Z,26,5,2020,384,31,Sweden,SE,SWE,10183175,Europe,4029,33843,76
2020-05-27T00:00:00Z,27,5,2020,597,96,Sweden,SE,SWE,10183175,Europe,4125,34440,77
2020-03-06T00:00:00Z,6,3,2020,30,1,Switzerland,CH,CHE,8516543,Europe,1,87,1
2020-03-07T00:00:00Z,7,3,2020,122,0,Switzerland,CH,CHE,8516543,Europe,1,209,2
2020-03-08T00:00:00Z,8,3,2020,55,0,Switzerland,CH,CHE,8516543,Europe,1,264,3
2020-03-09T00:00:00Z,9,3,2020,68,1,Switzerland,CH,CHE,8516543,Europe,2,332,4
2020-03-10T00:00:00Z,10,3,2020,42,0,Switzerland,CH,CHE,8516543,Europe,2,374,5
2020-03-11T00:00:00Z,11,3,2020,116,1,Switzerland,CH,CHE,8516543,Europe,3,490,6
2020-03-12T00:00:00Z,12,3,2020,152,1,Switzerland,CH,CHE,8516543,Europe,4,642,7
2020-03-13T00:00:00Z,13,3,2020,212,0,Switzerland,CH,CHE,8516543,Europe,4,854,8
2020-03-14T00:00:00Z,14,3,2020,267,3,Switzerland,CH,CHE,8516543,Europe,7,1121,9
2020-03-15T00:00:00Z,15,3,2020,238,4,Switzerland,CH,CHE,8516543,Europe,11,1359,10
2020-03-16T00:00:00Z,16,3,2020,841,2,Switzerland,CH,CHE,8516543,Europe,13,2200,11
2020-03-17T00:00:00Z,17,3,2020,0,1,Switzerland,CH,CHE,8516543,Europe,14,2200,12
2020-03-18T00:00:00Z,18,3,2020,450,5,Switzerland,CH,CHE,8516543,Europe,19,2650,13
2020-03-19T00:00:00Z,19,3,2020,360,2,Switzerland,CH,CHE,8516543,Europe,21,3010,14
2020-03-20T00:00:00Z,20,3,2020,878,12,Switzerland,CH,CHE,8516543,Europe,33,3888,15
2020-03-21T00:00:00Z,21,3,2020,952,10,Switzerland,CH,CHE,8516543,Europe,43,4840,16
2020-03-22T00:00:00Z,22,3,2020,1237,13,Switzerland,CH,CHE,8516543,Europe,56,6077,17
2020-03-23T00:00:00Z,23,3,2020,894,4,Switzerland,CH,CHE,8516543,Europe,60,6971,18
2020-03-24T00:00:00Z,24,3,2020,1044,6,Switzerland,CH,CHE,8516543,Europe,66,8015,19
2020-03-25T00:00:00Z,25,3,2020,774,20,Switzerland,CH,CHE,8516543,Europe,86,8789,20
2020-03-26T00:00:00Z,26,3,2020,925,17,Switzerland,CH,CHE,8516543,Europe,103,9714,21
2020-03-27T00:00:00Z,27,3,2020,1000,58,Switzerland,CH,CHE,8516543,Europe,161,10714,22
2020-03-28T00:00:00Z,28,3,2020,1390,36,Switzerland,CH,CHE,8516543,Europe,197,12104,23
2020-03-29T00:00:00Z,29,3,2020,1048,38,Switzerland,CH,CHE,8516543,Europe,235,13152,24
2020-03-30T00:00:00Z,30,3,2020,1122,22,Switzerland,CH,CHE,8516543,Europe,257,14274,25
2020-03-31T00:00:00Z,31,3,2020,1138,38,Switzerland,CH,CHE,8516543,Europe,295,15412,26
2020-04-01T00:00:00Z,1,4,2020,696,78,Switzerland,CH,CHE,8516543,Europe,373,16108,27
2020-04-02T00:00:00Z,2,4,2020,962,5,Switzerland,CH,CHE,8516543,Europe,378,17070,28
2020-04-03T00:00:00Z,3,4,2020,1124,54,Switzerland,CH,CHE,8516543,Europe,432,18194,29
2020-04-04T00:00:00Z,4,4,2020,1033,52,Switzerland,CH,CHE,8516543,Europe,484,19227,30
2020-04-05T00:00:00Z,5,4,2020,974,56,Switzerland,CH,CHE,8516543,Europe,540,20201,31
2020-04-06T00:00:00Z,6,4,2020,821,19,Switzerland,CH,CHE,8516543,Europe,559,21022,32
2020-04-07T00:00:00Z,7,4,2020,552,25,Switzerland,CH,CHE,8516543,Europe,584,21574,33
2020-04-08T00:00:00Z,8,4,2020,590,57,Switzerland,CH,CHE,8516543,Europe,641,22164,34
2020-04-09T00:00:00Z,9,4,2020,546,64,Switzerland,CH,CHE,8516543,Europe,705,22710,35
2020-04-10T00:00:00Z,10,4,2020,785,51,Switzerland,CH,CHE,8516543,Europe,756,23495,36
2020-04-11T00:00:00Z,11,4,2020,733,49,Switzerland,CH,CHE,8516543,Europe,805,24228,37
2020-04-12T00:00:00Z,12,4,2020,592,26,Switzerland,CH,CHE,8516543,Europe,831,24820,38
2020-04-13T00:00:00Z,13,4,2020,400,27,Switzerland,CH,CHE,8516543,Europe,858,25220,39
2020-04-14T00:00:00Z,14,4,2020,279,0,Switzerland,CH,CHE,8516543,Europe,858,25499,40
2020-04-15T00:00:00Z,15,4,2020,254,42,Switzerland,CH,CHE,8516543,Europe,900,25753,41
2020-04-16T00:00:00Z,16,4,2020,583,73,Switzerland,CH,CHE,8516543,Europe,973,26336,42
2020-04-17T00:00:00Z,17,4,2020,315,43,Switzerland,CH,CHE,8516543,Europe,1016,26651,43
2020-04-18T00:00:00Z,18,4,2020,346,42,Switzerland,CH,CHE,8516543,Europe,1058,26997,44
2020-04-19T00:00:00Z,19,4,2020,325,52,Switzerland,CH,CHE,8516543,Europe,1110,27322,45
2020-04-20T00:00:00Z,20,4,2020,336,24,Switzerland,CH,CHE,8516543,Europe,1134,27658,46
2020-04-21T00:00:00Z,21,4,2020,168,7,Switzerland,CH,CHE,8516543,Europe,1141,27826,47
2020-04-22T00:00:00Z,22,4,2020,155,45,Switzerland,CH,CHE,8516543,Europe,1186,27981,48
2020-04-23T00:00:00Z,23,4,2020,205,30,Switzerland,CH,CHE,8516543,Europe,1216,28186,49
2020-04-24T00:00:00Z,24,4,2020,228,51,Switzerland,CH,CHE,8516543,Europe,1267,28414,50
2020-04-25T00:00:00Z,25,4,2020,181,41,Switzerland,CH,CHE,8516543,Europe,1308,28595,51
2020-04-26T00:00:00Z,26,4,2020,216,20,Switzerland,CH,CHE,8516543,Europe,1328,28811,52
2020-04-27T00:00:00Z,27,4,2020,167,8,Switzerland,CH,CHE,8516543,Europe,1336,28978,53
2020-04-28T00:00:00Z,28,4,2020,103,16,Switzerland,CH,CHE,8516543,Europe,1352,29081,54
2020-04-29T00:00:00Z,29,4,2020,100,27,Switzerland,CH,CHE,8516543,Europe,1379,29181,55
2020-04-30T00:00:00Z,30,4,2020,143,28,Switzerland,CH,CHE,8516543,Europe,1407,29324,56
2020-05-01T00:00:00Z,1,5,2020,179,15,Switzerland,CH,CHE,8516543,Europe,1422,29503,57
2020-05-02T00:00:00Z,2,5,2020,119,12,Switzerland,CH,CHE,8516543,Europe,1434,29622,58
2020-05-03T00:00:00Z,3,5,2020,112,32,Switzerland,CH,CHE,8516543,Europe,1466,29734,59
2020-05-04T00:00:00Z,4,5,2020,88,6,Switzerland,CH,CHE,8516543,Europe,1472,29822,60
2020-05-05T00:00:00Z,5,5,2020,76,4,Switzerland,CH,CHE,8516543,Europe,1476,29898,61
2020-05-06T00:00:00Z,6,5,2020,28,6,Switzerland,CH,CHE,8516543,Europe,1482,29926,62
2020-05-07T00:00:00Z,7,5,2020,51,22,Switzerland,CH,CHE,8516543,Europe,1504,29977,63
2020-05-08T00:00:00Z,8,5,2020,66,13,Switzerland,CH,CHE,8516543,Europe,1517,30043,64
2020-05-09T00:00:00Z,9,5,2020,81,8,Switzerland,CH,CHE,8516543,Europe,1525,30124,65
2020-05-10T00:00:00Z,10,5,2020,44,6,Switzerland,CH,CHE,8516543,Europe,1531,30168,66
2020-05-11T00:00:00Z,11,5,2020,54,6,Switzerland,CH,CHE,8516543,Europe,1537,30222,67
2020-05-12T00:00:00Z,12,5,2020,39,5,Switzerland,CH,CHE,8516543,Europe,1542,30261,68
2020-05-13T00:00:00Z,13,5,2020,36,18,Switzerland,CH,CHE,8516543,Europe,1560,30297,69
2020-05-14T00:00:00Z,14,5,2020,33,3,Switzerland,CH,CHE,8516543,Europe,1563,30330,70
2020-05-15T00:00:00Z,15,5,2020,50,25,Switzerland,CH,CHE,8516543,Europe,1588,30380,71
2020-05-16T00:00:00Z,16,5,2020,51,6,Switzerland,CH,CHE,8516543,Europe,1594,30431,72
2020-05-17T00:00:00Z,17,5,2020,58,7,Switzerland,CH,CHE,8516543,Europe,1601,30489,73
2020-05-18T00:00:00Z,18,5,2020,15,1,Switzerland,CH,CHE,8516543,Europe,1602,30504,74
2020-05-19T00:00:00Z,19,5,2020,10,0,Switzerland,CH,CHE,8516543,Europe,1602,30514,75
2020-05-20T00:00:00Z,20,5,2020,21,11,Switzerland,CH,CHE,8516543,Europe,1613,30535,76
2020-05-21T00:00:00Z,21,5,2020,40,16,Switzerland,CH,CHE,8516543,Europe,1629,30575,77
2020-05-22T00:00:00Z,22,5,2020,36,8,Switzerland,CH,CHE,8516543,Europe,1637,30611,78
2020-05-23T00:00:00Z,23,5,2020,13,0,Switzerland,CH,CHE,8516543,Europe,1637,30624,79
2020-05-24T00:00:00Z,24,5,2020,18,4,Switzerland,CH,CHE,8516543,Europe,1641,30642,80
2020-05-25T00:00:00Z,25,5,2020,11,0,Switzerland,CH,CHE,8516543,Europe,1641,30653,81
2020-05-26T00:00:00Z,26,5,2020,10,0,Switzerland,CH,CHE,8516543,Europe,1641,30663,82
2020-05-27T00:00:00Z,27,5,2020,15,6,Switzerland,CH,CHE,8516543,Europe,1647,30678,83
2020-03-30T00:00:00Z,30,3,2020,4,1,Syria,SY,SYR,16906283,Asia,1,9,1
2020-03-31T00:00:00Z,31,3,2020,1,1,Syria,SY,SYR,16906283,Asia,2,10,2
2020-04-01T00:00:00Z,1,4,2020,0,0,Syria,SY,SYR,16906283,Asia,2,10,3
2020-04-02T00:00:00Z,2,4,2020,0,0,Syria,SY,SYR,16906283,Asia,2,10,4
2020-04-03T00:00:00Z,3,4,2020,6,0,Syria,SY,SYR,16906283,Asia,2,16,5
2020-04-04T00:00:00Z,4,4,2020,0,0,Syria,SY,SYR,16906283,Asia,2,16,6
2020-04-05T00:00:00Z,5,4,2020,0,0,Syria,SY,SYR,16906283,Asia,2,16,7
2020-04-06T00:00:00Z,6,4,2020,3,0,Syria,SY,SYR,16906283,Asia,2,19,8
2020-04-07T00:00:00Z,7,4,2020,0,0,Syria,SY,SYR,16906283,Asia,2,19,9
2020-04-08T00:00:00Z,8,4,2020,0,0,Syria,SY,SYR,16906283,Asia,2,19,10
2020-04-09T00:00:00Z,9,4,2020,0,0,Syria,SY,SYR,16906283,Asia,2,19,11
2020-04-10T00:00:00Z,10,4,2020,0,0,Syria,SY,SYR,16906283,Asia,2,19,12
2020-04-11T00:00:00Z,11,4,2020,0,0,Syria,SY,SYR,16906283,Asia,2,19,13
2020-04-12T00:00:00Z,12,4,2020,6,0,Syria,SY,SYR,16906283,Asia,2,25,14
2020-04-13T00:00:00Z,13,4,2020,0,0,Syria,SY,SYR,16906283,Asia,2,25,15
2020-04-14T00:00:00Z,14,4,2020,0,0,Syria,SY,SYR,16906283,Asia,2,25,16
2020-04-15T00:00:00Z,15,4,2020,4,0,Syria,SY,SYR,16906283,Asia,2,29,17
2020-04-16T00:00:00Z,16,4,2020,4,0,Syria,SY,SYR,16906283,Asia,2,33,18
2020-04-17T00:00:00Z,17,4,2020,0,0,Syria,SY,SYR,16906283,Asia,2,33,19
2020-04-18T00:00:00Z,18,4,2020,5,0,Syria,SY,SYR,16906283,Asia,2,38,20
2020-04-19T00:00:00Z,19,4,2020,0,0,Syria,SY,SYR,16906283,Asia,2,38,21
2020-04-20T00:00:00Z,20,4,2020,1,1,Syria,SY,SYR,16906283,Asia,3,39,22
2020-04-21T00:00:00Z,21,4,2020,0,0,Syria,SY,SYR,16906283,Asia,3,39,23
2020-04-22T00:00:00Z,22,4,2020,3,0,Syria,SY,SYR,16906283,Asia,3,42,24
2020-04-23T00:00:00Z,23,4,2020,0,0,Syria,SY,SYR,16906283,Asia,3,42,25
2020-04-24T00:00:00Z,24,4,2020,0,0,Syria,SY,SYR,16906283,Asia,3,42,26
2020-04-25T00:00:00Z,25,4,2020,0,0,Syria,SY,SYR,16906283,Asia,3,42,27
2020-04-26T00:00:00Z,26,4,2020,0,0,Syria,SY,SYR,16906283,Asia,3,42,28
2020-04-27T00:00:00Z,27,4,2020,1,0,Syria,SY,SYR,16906283,Asia,3,43,29
2020-04-28T00:00:00Z,28,4,2020,0,0,Syria,SY,SYR,16906283,Asia,3,43,30
2020-04-29T00:00:00Z,29,4,2020,0,0,Syria,SY,SYR,16906283,Asia,3,43,31
2020-04-30T00:00:00Z,30,4,2020,0,0,Syria,SY,SYR,16906283,Asia,3,43,32
2020-05-01T00:00:00Z,1,5,2020,0,0,Syria,SY,SYR,16906283,Asia,3,43,33
2020-05-02T00:00:00Z,2,5,2020,1,0,Syria,SY,SYR,16906283,Asia,3,44,34
2020-05-03T00:00:00Z,3,5,2020,0,0,Syria,SY,SYR,16906283,Asia,3,44,35
2020-05-04T00:00:00Z,4,5,2020,0,0,Syria,SY,SYR,16906283,Asia,3,44,36
2020-05-05T00:00:00Z,5,5,2020,0,0,Syria,SY,SYR,16906283,Asia,3,44,37
2020-05-06T00:00:00Z,6,5,2020,0,0,Syria,SY,SYR,16906283,Asia,3,44,38
2020-05-07T00:00:00Z,7,5,2020,1,0,Syria,SY,SYR,16906283,Asia,3,45,39
2020-05-08T00:00:00Z,8,5,2020,0,0,Syria,SY,SYR,16906283,Asia,3,45,40
2020-05-09T00:00:00Z,9,5,2020,2,0,Syria,SY,SYR,16906283,Asia,3,47,41
2020-05-10T00:00:00Z,10,5,2020,0,0,Syria,SY,SYR,16906283,Asia,3,47,42
2020-05-11T00:00:00Z,11,5,2020,0,0,Syria,SY,SYR,16906283,Asia,3,47,43
2020-05-12T00:00:00Z,12,5,2020,0,0,Syria,SY,SYR,16906283,Asia,3,47,44
2020-05-13T00:00:00Z,13,5,2020,0,0,Syria,SY,SYR,16906283,Asia,3,47,45
2020-05-14T00:00:00Z,14,5,2020,1,0,Syria,SY,SYR,16906283,Asia,3,48,46
2020-05-15T00:00:00Z,15,5,2020,0,0,Syria,SY,SYR,16906283,Asia,3,48,47
2020-05-16T00:00:00Z,16,5,2020,2,0,Syria,SY,SYR,16906283,Asia,3,50,48
2020-05-17T00:00:00Z,17,5,2020,1,0,Syria,SY,SYR,16906283,Asia,3,51,49
2020-05-18T00:00:00Z,18,5,2020,7,0,Syria,SY,SYR,16906283,Asia,3,58,50
2020-05-19T00:00:00Z,19,5,2020,0,0,Syria,SY,SYR,16906283,Asia,3,58,51
2020-05-20T00:00:00Z,20,5,2020,0,0,Syria,SY,SYR,16906283,Asia,3,58,52
2020-05-21T00:00:00Z,21,5,2020,0,0,Syria,SY,SYR,16906283,Asia,3,58,53
2020-05-22T00:00:00Z,22,5,2020,0,0,Syria,SY,SYR,16906283,Asia,3,58,54
2020-05-23T00:00:00Z,23,5,2020,1,1,Syria,SY,SYR,16906283,Asia,4,59,55
2020-05-24T00:00:00Z,24,5,2020,11,0,Syria,SY,SYR,16906283,Asia,4,70,56
2020-05-25T00:00:00Z,25,5,2020,16,0,Syria,SY,SYR,16906283,Asia,4,86,57
2020-05-26T00:00:00Z,26,5,2020,20,0,Syria,SY,SYR,16906283,Asia,4,106,58
2020-05-27T00:00:00Z,27,5,2020,15,0,Syria,SY,SYR,16906283,Asia,4,121,59
2020-02-17T00:00:00Z,17,2,2020,2,1,Taiwan,TW,TWN,23780452,Asia,1,20,1
2020-02-18T00:00:00Z,18,2,2020,2,0,Taiwan,TW,TWN,23780452,Asia,1,22,2
2020-02-19T00:00:00Z,19,2,2020,0,0,Taiwan,TW,TWN,23780452,Asia,1,22,3
2020-02-20T00:00:00Z,20,2,2020,2,0,Taiwan,TW,TWN,23780452,Asia,1,24,4
2020-02-21T00:00:00Z,21,2,2020,0,0,Taiwan,TW,TWN,23780452,Asia,1,24,5
2020-02-22T00:00:00Z,22,2,2020,2,0,Taiwan,TW,TWN,23780452,Asia,1,26,6
2020-02-23T00:00:00Z,23,2,2020,0,0,Taiwan,TW,TWN,23780452,Asia,1,26,7
2020-02-24T00:00:00Z,24,2,2020,2,0,Taiwan,TW,TWN,23780452,Asia,1,28,8
2020-02-25T00:00:00Z,25,2,2020,2,0,Taiwan,TW,TWN,23780452,Asia,1,30,9
2020-02-26T00:00:00Z,26,2,2020,1,0,Taiwan,TW,TWN,23780452,Asia,1,31,10
2020-02-27T00:00:00Z,27,2,2020,1,0,Taiwan,TW,TWN,23780452,Asia,1,32,11
2020-02-28T00:00:00Z,28,2,2020,2,0,Taiwan,TW,TWN,23780452,Asia,1,34,12
2020-02-29T00:00:00Z,29,2,2020,5,0,Taiwan,TW,TWN,23780452,Asia,1,39,13
2020-03-01T00:00:00Z,1,3,2020,1,0,Taiwan,TW,TWN,23780452,Asia,1,40,14
2020-03-02T00:00:00Z,2,3,2020,0,0,Taiwan,TW,TWN,23780452,Asia,1,40,15
2020-03-03T00:00:00Z,3,3,2020,1,0,Taiwan,TW,TWN,23780452,Asia,1,41,16
2020-03-04T00:00:00Z,4,3,2020,1,0,Taiwan,TW,TWN,23780452,Asia,1,42,17
2020-03-06T00:00:00Z,6,3,2020,2,0,Taiwan,TW,TWN,23780452,Asia,1,44,18
2020-03-07T00:00:00Z,7,3,2020,1,0,Taiwan,TW,TWN,23780452,Asia,1,45,19
2020-03-08T00:00:00Z,8,3,2020,0,0,Taiwan,TW,TWN,23780452,Asia,1,45,20
2020-03-09T00:00:00Z,9,3,2020,0,0,Taiwan,TW,TWN,23780452,Asia,1,45,21
2020-03-11T00:00:00Z,11,3,2020,3,0,Taiwan,TW,TWN,23780452,Asia,1,48,22
2020-03-12T00:00:00Z,12,3,2020,0,0,Taiwan,TW,TWN,23780452,Asia,1,48,23
2020-03-13T00:00:00Z,13,3,2020,1,0,Taiwan,TW,TWN,23780452,Asia,1,49,24
2020-03-14T00:00:00Z,14,3,2020,4,0,Taiwan,TW,TWN,23780452,Asia,1,53,25
2020-03-15T00:00:00Z,15,3,2020,6,0,Taiwan,TW,TWN,23780452,Asia,1,59,26
2020-03-16T00:00:00Z,16,3,2020,0,0,Taiwan,TW,TWN,23780452,Asia,1,59,27
2020-03-17T00:00:00Z,17,3,2020,8,0,Taiwan,TW,TWN,23780452,Asia,1,67,28
2020-03-18T00:00:00Z,18,3,2020,10,0,Taiwan,TW,TWN,23780452,Asia,1,77,29
2020-03-19T00:00:00Z,19,3,2020,31,0,Taiwan,TW,TWN,23780452,Asia,1,108,30
2020-03-20T00:00:00Z,20,3,2020,0,0,Taiwan,TW,TWN,23780452,Asia,1,108,31
2020-03-21T00:00:00Z,21,3,2020,27,1,Taiwan,TW,TWN,23780452,Asia,2,135,32
2020-03-22T00:00:00Z,22,3,2020,18,0,Taiwan,TW,TWN,23780452,Asia,2,153,33
2020-03-23T00:00:00Z,23,3,2020,12,0,Taiwan,TW,TWN,23780452,Asia,2,165,34
2020-03-24T00:00:00Z,24,3,2020,30,0,Taiwan,TW,TWN,23780452,Asia,2,195,35
2020-03-25T00:00:00Z,25,3,2020,21,0,Taiwan,TW,TWN,23780452,Asia,2,216,36
2020-03-26T00:00:00Z,26,3,2020,19,0,Taiwan,TW,TWN,23780452,Asia,2,235,37
2020-03-27T00:00:00Z,27,3,2020,17,0,Taiwan,TW,TWN,23780452,Asia,2,252,38
2020-03-28T00:00:00Z,28,3,2020,15,0,Taiwan,TW,TWN,23780452,Asia,2,267,39
2020-03-29T00:00:00Z,29,3,2020,16,0,Taiwan,TW,TWN,23780452,Asia,2,283,40
2020-03-30T00:00:00Z,30,3,2020,23,3,Taiwan,TW,TWN,23780452,Asia,5,306,41
2020-03-31T00:00:00Z,31,3,2020,0,0,Taiwan,TW,TWN,23780452,Asia,5,306,42
2020-04-01T00:00:00Z,1,4,2020,16,0,Taiwan,TW,TWN,23780452,Asia,5,322,43
2020-04-02T00:00:00Z,2,4,2020,17,0,Taiwan,TW,TWN,23780452,Asia,5,339,44
2020-04-03T00:00:00Z,3,4,2020,0,0,Taiwan,TW,TWN,23780452,Asia,5,339,45
2020-04-04T00:00:00Z,4,4,2020,16,0,Taiwan,TW,TWN,23780452,Asia,5,355,46
2020-04-05T00:00:00Z,5,4,2020,8,0,Taiwan,TW,TWN,23780452,Asia,5,363,47
2020-04-06T00:00:00Z,6,4,2020,0,0,Taiwan,TW,TWN,23780452,Asia,5,363,48
2020-04-07T00:00:00Z,7,4,2020,10,0,Taiwan,TW,TWN,23780452,Asia,5,373,49
2020-04-08T00:00:00Z,8,4,2020,3,0,Taiwan,TW,TWN,23780452,Asia,5,376,50
2020-04-09T00:00:00Z,9,4,2020,3,0,Taiwan,TW,TWN,23780452,Asia,5,379,51
2020-04-10T00:00:00Z,10,4,2020,1,0,Taiwan,TW,TWN,23780452,Asia,5,380,52
2020-04-11T00:00:00Z,11,4,2020,0,0,Taiwan,TW,TWN,23780452,Asia,5,380,53
2020-04-12T00:00:00Z,12,4,2020,5,1,Taiwan,TW,TWN,23780452,Asia,6,385,54
2020-04-13T00:00:00Z,13,4,2020,3,0,Taiwan,TW,TWN,23780452,Asia,6,388,55
2020-04-14T00:00:00Z,14,4,2020,5,0,Taiwan,TW,TWN,23780452,Asia,6,393,56
2020-04-15T00:00:00Z,15,4,2020,2,0,Taiwan,TW,TWN,23780452,Asia,6,395,57
2020-04-16T00:00:00Z,16,4,2020,0,0,Taiwan,TW,TWN,23780452,Asia,6,395,58
2020-04-17T00:00:00Z,17,4,2020,0,0,Taiwan,TW,TWN,23780452,Asia,6,395,59
2020-04-18T00:00:00Z,18,4,2020,0,0,Taiwan,TW,TWN,23780452,Asia,6,395,60
2020-04-19T00:00:00Z,19,4,2020,3,0,Taiwan,TW,TWN,23780452,Asia,6,398,61
2020-04-20T00:00:00Z,20,4,2020,22,0,Taiwan,TW,TWN,23780452,Asia,6,420,62
2020-04-21T00:00:00Z,21,4,2020,2,0,Taiwan,TW,TWN,23780452,Asia,6,422,63
2020-04-22T00:00:00Z,22,4,2020,3,0,Taiwan,TW,TWN,23780452,Asia,6,425,64
2020-04-23T00:00:00Z,23,4,2020,1,0,Taiwan,TW,TWN,23780452,Asia,6,426,65
2020-04-24T00:00:00Z,24,4,2020,1,0,Taiwan,TW,TWN,23780452,Asia,6,427,66
2020-04-25T00:00:00Z,25,4,2020,1,0,Taiwan,TW,TWN,23780452,Asia,6,428,67
2020-04-26T00:00:00Z,26,4,2020,1,0,Taiwan,TW,TWN,23780452,Asia,6,429,68
2020-04-27T00:00:00Z,27,4,2020,0,0,Taiwan,TW,TWN,23780452,Asia,6,429,69
2020-04-28T00:00:00Z,28,4,2020,0,0,Taiwan,TW,TWN,23780452,Asia,6,429,70
2020-04-29T00:00:00Z,29,4,2020,0,0,Taiwan,TW,TWN,23780452,Asia,6,429,71
2020-04-30T00:00:00Z,30,4,2020,0,0,Taiwan,TW,TWN,23780452,Asia,6,429,72
2020-05-01T00:00:00Z,1,5,2020,0,0,Taiwan,TW,TWN,23780452,Asia,6,429,73
2020-05-02T00:00:00Z,2,5,2020,0,0,Taiwan,TW,TWN,23780452,Asia,6,429,74
2020-05-03T00:00:00Z,3,5,2020,3,0,Taiwan,TW,TWN,23780452,Asia,6,432,75
2020-05-04T00:00:00Z,4,5,2020,4,0,Taiwan,TW,TWN,23780452,Asia,6,436,76
2020-05-05T00:00:00Z,5,5,2020,2,0,Taiwan,TW,TWN,23780452,Asia,6,438,77
2020-05-06T00:00:00Z,6,5,2020,0,0,Taiwan,TW,TWN,23780452,Asia,6,438,78
2020-05-07T00:00:00Z,7,5,2020,1,0,Taiwan,TW,TWN,23780452,Asia,6,439,79
2020-05-08T00:00:00Z,8,5,2020,1,0,Taiwan,TW,TWN,23780452,Asia,6,440,80
2020-05-09T00:00:00Z,9,5,2020,0,0,Taiwan,TW,TWN,23780452,Asia,6,440,81
2020-05-10T00:00:00Z,10,5,2020,0,0,Taiwan,TW,TWN,23780452,Asia,6,440,82
2020-05-11T00:00:00Z,11,5,2020,0,0,Taiwan,TW,TWN,23780452,Asia,6,440,83
2020-05-12T00:00:00Z,12,5,2020,0,1,Taiwan,TW,TWN,23780452,Asia,7,440,84
2020-05-13T00:00:00Z,13,5,2020,0,0,Taiwan,TW,TWN,23780452,Asia,7,440,85
2020-05-14T00:00:00Z,14,5,2020,0,0,Taiwan,TW,TWN,23780452,Asia,7,440,86
2020-05-15T00:00:00Z,15,5,2020,0,0,Taiwan,TW,TWN,23780452,Asia,7,440,87
2020-05-16T00:00:00Z,16,5,2020,0,0,Taiwan,TW,TWN,23780452,Asia,7,440,88
2020-05-17T00:00:00Z,17,5,2020,0,0,Taiwan,TW,TWN,23780452,Asia,7,440,89
2020-05-18T00:00:00Z,18,5,2020,0,0,Taiwan,TW,TWN,23780452,Asia,7,440,90
2020-05-19T00:00:00Z,19,5,2020,0,0,Taiwan,TW,TWN,23780452,Asia,7,440,91
2020-05-20T00:00:00Z,20,5,2020,0,0,Taiwan,TW,TWN,23780452,Asia,7,440,92
2020-05-21T00:00:00Z,21,5,2020,1,0,Taiwan,TW,TWN,23780452,Asia,7,441,93
2020-05-22T00:00:00Z,22,5,2020,0,0,Taiwan,TW,TWN,23780452,Asia,7,441,94
2020-05-23T00:00:00Z,23,5,2020,0,0,Taiwan,TW,TWN,23780452,Asia,7,441,95
2020-05-24T00:00:00Z,24,5,2020,0,0,Taiwan,TW,TWN,23780452,Asia,7,441,96
2020-05-25T00:00:00Z,25,5,2020,0,0,Taiwan,TW,TWN,23780452,Asia,7,441,97
2020-05-26T00:00:00Z,26,5,2020,0,0,Taiwan,TW,TWN,23780452,Asia,7,441,98
2020-05-27T00:00:00Z,27,5,2020,0,0,Taiwan,TW,TWN,23780452,Asia,7,441,99
2020-05-04T00:00:00Z,4,5,2020,44,2,Tajikistan,TJ,TJK,9100837,Asia,2,76,1
2020-05-05T00:00:00Z,5,5,2020,154,1,Tajikistan,TJ,TJK,9100837,Asia,3,230,2
2020-05-06T00:00:00Z,6,5,2020,63,2,Tajikistan,TJ,TJK,9100837,Asia,5,293,3
2020-05-07T00:00:00Z,7,5,2020,86,3,Tajikistan,TJ,TJK,9100837,Asia,8,379,4
2020-05-08T00:00:00Z,8,5,2020,82,4,Tajikistan,TJ,TJK,9100837,Asia,12,461,5
2020-05-09T00:00:00Z,9,5,2020,61,0,Tajikistan,TJ,TJK,9100837,Asia,12,522,6
2020-05-10T00:00:00Z,10,5,2020,90,8,Tajikistan,TJ,TJK,9100837,Asia,20,612,7
2020-05-11T00:00:00Z,11,5,2020,0,0,Tajikistan,TJ,TJK,9100837,Asia,20,612,8
2020-05-12T00:00:00Z,12,5,2020,49,1,Tajikistan,TJ,TJK,9100837,Asia,21,661,9
2020-05-13T00:00:00Z,13,5,2020,68,2,Tajikistan,TJ,TJK,9100837,Asia,23,729,10
2020-05-14T00:00:00Z,14,5,2020,72,0,Tajikistan,TJ,TJK,9100837,Asia,23,801,11
2020-05-15T00:00:00Z,15,5,2020,106,6,Tajikistan,TJ,TJK,9100837,Asia,29,907,12
2020-05-16T00:00:00Z,16,5,2020,211,4,Tajikistan,TJ,TJK,9100837,Asia,33,1118,13
2020-05-17T00:00:00Z,17,5,2020,204,3,Tajikistan,TJ,TJK,9100837,Asia,36,1322,14
2020-05-18T00:00:00Z,18,5,2020,202,3,Tajikistan,TJ,TJK,9100837,Asia,39,1524,15
2020-05-19T00:00:00Z,19,5,2020,205,2,Tajikistan,TJ,TJK,9100837,Asia,41,1729,16
2020-05-20T00:00:00Z,20,5,2020,0,0,Tajikistan,TJ,TJK,9100837,Asia,41,1729,17
2020-05-21T00:00:00Z,21,5,2020,207,3,Tajikistan,TJ,TJK,9100837,Asia,44,1936,18
2020-05-22T00:00:00Z,22,5,2020,204,0,Tajikistan,TJ,TJK,9100837,Asia,44,2140,19
2020-05-23T00:00:00Z,23,5,2020,210,0,Tajikistan,TJ,TJK,9100837,Asia,44,2350,20
2020-05-24T00:00:00Z,24,5,2020,201,0,Tajikistan,TJ,TJK,9100837,Asia,44,2551,21
2020-05-25T00:00:00Z,25,5,2020,187,0,Tajikistan,TJ,TJK,9100837,Asia,44,2738,22
2020-05-26T00:00:00Z,26,5,2020,362,2,Tajikistan,TJ,TJK,9100837,Asia,46,3100,23
2020-05-27T00:00:00Z,27,5,2020,0,0,Tajikistan,TJ,TJK,9100837,Asia,46,3100,24
2020-03-01T00:00:00Z,1,3,2020,0,1,Thailand,TH,THA,69428524,Asia,1,42,1
2020-03-02T00:00:00Z,2,3,2020,1,0,Thailand,TH,THA,69428524,Asia,1,43,2
2020-03-05T00:00:00Z,5,3,2020,4,0,Thailand,TH,THA,69428524,Asia,1,47,3
2020-03-07T00:00:00Z,7,3,2020,3,0,Thailand,TH,THA,69428524,Asia,1,50,4
2020-03-11T00:00:00Z,11,3,2020,9,0,Thailand,TH,THA,69428524,Asia,1,59,5
2020-03-12T00:00:00Z,12,3,2020,11,0,Thailand,TH,THA,69428524,Asia,1,70,6
2020-03-14T00:00:00Z,14,3,2020,12,0,Thailand,TH,THA,69428524,Asia,1,82,7
2020-03-15T00:00:00Z,15,3,2020,0,0,Thailand,TH,THA,69428524,Asia,1,82,8
2020-03-16T00:00:00Z,16,3,2020,32,0,Thailand,TH,THA,69428524,Asia,1,114,9
2020-03-17T00:00:00Z,17,3,2020,63,0,Thailand,TH,THA,69428524,Asia,1,177,10
2020-03-18T00:00:00Z,18,3,2020,0,0,Thailand,TH,THA,69428524,Asia,1,177,11
2020-03-19T00:00:00Z,19,3,2020,0,0,Thailand,TH,THA,69428524,Asia,1,177,12
2020-03-20T00:00:00Z,20,3,2020,35,0,Thailand,TH,THA,69428524,Asia,1,212,13
2020-03-21T00:00:00Z,21,3,2020,154,0,Thailand,TH,THA,69428524,Asia,1,366,14
2020-03-22T00:00:00Z,22,3,2020,233,0,Thailand,TH,THA,69428524,Asia,1,599,15
2020-03-23T00:00:00Z,23,3,2020,122,0,Thailand,TH,THA,69428524,Asia,1,721,16
2020-03-24T00:00:00Z,24,3,2020,106,3,Thailand,TH,THA,69428524,Asia,4,827,17
2020-03-25T00:00:00Z,25,3,2020,107,0,Thailand,TH,THA,69428524,Asia,4,934,18
2020-03-26T00:00:00Z,26,3,2020,111,0,Thailand,TH,THA,69428524,Asia,4,1045,19
2020-03-27T00:00:00Z,27,3,2020,91,1,Thailand,TH,THA,69428524,Asia,5,1136,20
2020-03-28T00:00:00Z,28,3,2020,0,0,Thailand,TH,THA,69428524,Asia,5,1136,21
2020-03-29T00:00:00Z,29,3,2020,109,1,Thailand,TH,THA,69428524,Asia,6,1245,22
2020-03-30T00:00:00Z,30,3,2020,143,1,Thailand,TH,THA,69428524,Asia,7,1388,23
2020-03-31T00:00:00Z,31,3,2020,263,3,Thailand,TH,THA,69428524,Asia,10,1651,24
2020-04-01T00:00:00Z,1,4,2020,0,0,Thailand,TH,THA,69428524,Asia,10,1651,25
2020-04-02T00:00:00Z,2,4,2020,120,2,Thailand,TH,THA,69428524,Asia,12,1771,26
2020-04-03T00:00:00Z,3,4,2020,104,3,Thailand,TH,THA,69428524,Asia,15,1875,27
2020-04-04T00:00:00Z,4,4,2020,103,4,Thailand,TH,THA,69428524,Asia,19,1978,28
2020-04-05T00:00:00Z,5,4,2020,191,4,Thailand,TH,THA,69428524,Asia,23,2169,29
2020-04-06T00:00:00Z,6,4,2020,51,3,Thailand,TH,THA,69428524,Asia,26,2220,30
2020-04-07T00:00:00Z,7,4,2020,38,0,Thailand,TH,THA,69428524,Asia,26,2258,31
2020-04-08T00:00:00Z,8,4,2020,111,4,Thailand,TH,THA,69428524,Asia,30,2369,32
2020-04-09T00:00:00Z,9,4,2020,54,2,Thailand,TH,THA,69428524,Asia,32,2423,33
2020-04-10T00:00:00Z,10,4,2020,50,1,Thailand,TH,THA,69428524,Asia,33,2473,34
2020-04-11T00:00:00Z,11,4,2020,45,2,Thailand,TH,THA,69428524,Asia,35,2518,35
2020-04-12T00:00:00Z,12,4,2020,33,3,Thailand,TH,THA,69428524,Asia,38,2551,36
2020-04-13T00:00:00Z,13,4,2020,28,2,Thailand,TH,THA,69428524,Asia,40,2579,37
2020-04-14T00:00:00Z,14,4,2020,34,1,Thailand,TH,THA,69428524,Asia,41,2613,38
2020-04-15T00:00:00Z,15,4,2020,30,2,Thailand,TH,THA,69428524,Asia,43,2643,39
2020-04-16T00:00:00Z,16,4,2020,29,3,Thailand,TH,THA,69428524,Asia,46,2672,40
2020-04-17T00:00:00Z,17,4,2020,28,1,Thailand,TH,THA,69428524,Asia,47,2700,41
2020-04-18T00:00:00Z,18,4,2020,0,0,Thailand,TH,THA,69428524,Asia,47,2700,42
2020-04-19T00:00:00Z,19,4,2020,33,0,Thailand,TH,THA,69428524,Asia,47,2733,43
2020-04-20T00:00:00Z,20,4,2020,32,0,Thailand,TH,THA,69428524,Asia,47,2765,44
2020-04-21T00:00:00Z,21,4,2020,27,0,Thailand,TH,THA,69428524,Asia,47,2792,45
2020-04-22T00:00:00Z,22,4,2020,19,1,Thailand,TH,THA,69428524,Asia,48,2811,46
2020-04-23T00:00:00Z,23,4,2020,28,2,Thailand,TH,THA,69428524,Asia,50,2839,47
2020-04-24T00:00:00Z,24,4,2020,0,0,Thailand,TH,THA,69428524,Asia,50,2839,48
2020-04-25T00:00:00Z,25,4,2020,15,0,Thailand,TH,THA,69428524,Asia,50,2854,49
2020-04-26T00:00:00Z,26,4,2020,68,1,Thailand,TH,THA,69428524,Asia,51,2922,50
2020-04-27T00:00:00Z,27,4,2020,0,0,Thailand,TH,THA,69428524,Asia,51,2922,51
2020-04-28T00:00:00Z,28,4,2020,16,3,Thailand,TH,THA,69428524,Asia,54,2938,52
2020-04-29T00:00:00Z,29,4,2020,0,0,Thailand,TH,THA,69428524,Asia,54,2938,53
2020-04-30T00:00:00Z,30,4,2020,16,0,Thailand,TH,THA,69428524,Asia,54,2954,54
2020-05-01T00:00:00Z,1,5,2020,6,0,Thailand,TH,THA,69428524,Asia,54,2960,55
2020-05-02T00:00:00Z,2,5,2020,0,0,Thailand,TH,THA,69428524,Asia,54,2960,56
2020-05-03T00:00:00Z,3,5,2020,6,0,Thailand,TH,THA,69428524,Asia,54,2966,57
2020-05-04T00:00:00Z,4,5,2020,3,0,Thailand,TH,THA,69428524,Asia,54,2969,58
2020-05-05T00:00:00Z,5,5,2020,18,0,Thailand,TH,THA,69428524,Asia,54,2987,59
2020-05-06T00:00:00Z,6,5,2020,1,0,Thailand,TH,THA,69428524,Asia,54,2988,60
2020-05-07T00:00:00Z,7,5,2020,1,1,Thailand,TH,THA,69428524,Asia,55,2989,61
2020-05-08T00:00:00Z,8,5,2020,3,0,Thailand,TH,THA,69428524,Asia,55,2992,62
2020-05-09T00:00:00Z,9,5,2020,8,0,Thailand,TH,THA,69428524,Asia,55,3000,63
2020-05-10T00:00:00Z,10,5,2020,4,1,Thailand,TH,THA,69428524,Asia,56,3004,64
2020-05-11T00:00:00Z,11,5,2020,11,0,Thailand,TH,THA,69428524,Asia,56,3015,65
2020-05-12T00:00:00Z,12,5,2020,0,0,Thailand,TH,THA,69428524,Asia,56,3015,66
2020-05-13T00:00:00Z,13,5,2020,2,0,Thailand,TH,THA,69428524,Asia,56,3017,67
2020-05-14T00:00:00Z,14,5,2020,0,0,Thailand,TH,THA,69428524,Asia,56,3017,68
2020-05-15T00:00:00Z,15,5,2020,1,0,Thailand,TH,THA,69428524,Asia,56,3018,69
2020-05-16T00:00:00Z,16,5,2020,7,0,Thailand,TH,THA,69428524,Asia,56,3025,70
2020-05-17T00:00:00Z,17,5,2020,3,0,Thailand,TH,THA,69428524,Asia,56,3028,71
2020-05-18T00:00:00Z,18,5,2020,0,0,Thailand,TH,THA,69428524,Asia,56,3028,72
2020-05-19T00:00:00Z,19,5,2020,3,0,Thailand,TH,THA,69428524,Asia,56,3031,73
2020-05-20T00:00:00Z,20,5,2020,3,0,Thailand,TH,THA,69428524,Asia,56,3034,74
2020-05-21T00:00:00Z,21,5,2020,0,0,Thailand,TH,THA,69428524,Asia,56,3034,75
2020-05-22T00:00:00Z,22,5,2020,3,0,Thailand,TH,THA,69428524,Asia,56,3037,76
2020-05-23T00:00:00Z,23,5,2020,3,0,Thailand,TH,THA,69428524,Asia,56,3040,77
2020-05-24T00:00:00Z,24,5,2020,0,0,Thailand,TH,THA,69428524,Asia,56,3040,78
2020-05-25T00:00:00Z,25,5,2020,2,1,Thailand,TH,THA,69428524,Asia,57,3042,79
2020-05-26T00:00:00Z,26,5,2020,0,0,Thailand,TH,THA,69428524,Asia,57,3042,80
2020-05-27T00:00:00Z,27,5,2020,3,0,Thailand,TH,THA,69428524,Asia,57,3045,81
2020-03-28T00:00:00Z,28,3,2020,1,1,Togo,TG,TGO,7889094,Africa,1,25,1
2020-03-29T00:00:00Z,29,3,2020,3,0,Togo,TG,TGO,7889094,Africa,1,28,2
2020-03-30T00:00:00Z,30,3,2020,2,0,Togo,TG,TGO,7889094,Africa,1,30,3
2020-03-31T00:00:00Z,31,3,2020,4,0,Togo,TG,TGO,7889094,Africa,1,34,4
2020-04-01T00:00:00Z,1,4,2020,0,0,Togo,TG,TGO,7889094,Africa,1,34,5
2020-04-02T00:00:00Z,2,4,2020,2,1,Togo,TG,TGO,7889094,Africa,2,36,6
2020-04-03T00:00:00Z,3,4,2020,3,0,Togo,TG,TGO,7889094,Africa,2,39,7
2020-04-04T00:00:00Z,4,4,2020,1,1,Togo,TG,TGO,7889094,Africa,3,40,8
2020-04-05T00:00:00Z,5,4,2020,1,0,Togo,TG,TGO,7889094,Africa,3,41,9
2020-04-06T00:00:00Z,6,4,2020,3,0,Togo,TG,TGO,7889094,Africa,3,44,10
2020-04-07T00:00:00Z,7,4,2020,14,0,Togo,TG,TGO,7889094,Africa,3,58,11
2020-04-08T00:00:00Z,8,4,2020,7,0,Togo,TG,TGO,7889094,Africa,3,65,12
2020-04-09T00:00:00Z,9,4,2020,5,0,Togo,TG,TGO,7889094,Africa,3,70,13
2020-04-10T00:00:00Z,10,4,2020,3,0,Togo,TG,TGO,7889094,Africa,3,73,14
2020-04-11T00:00:00Z,11,4,2020,3,0,Togo,TG,TGO,7889094,Africa,3,76,15
2020-04-12T00:00:00Z,12,4,2020,0,0,Togo,TG,TGO,7889094,Africa,3,76,16
2020-04-13T00:00:00Z,13,4,2020,0,0,Togo,TG,TGO,7889094,Africa,3,76,17
2020-04-14T00:00:00Z,14,4,2020,1,0,Togo,TG,TGO,7889094,Africa,3,77,18
2020-04-15T00:00:00Z,15,4,2020,0,0,Togo,TG,TGO,7889094,Africa,3,77,19
2020-04-16T00:00:00Z,16,4,2020,4,0,Togo,TG,TGO,7889094,Africa,3,81,20
2020-04-17T00:00:00Z,17,4,2020,0,2,Togo,TG,TGO,7889094,Africa,5,81,21
2020-04-18T00:00:00Z,18,4,2020,2,0,Togo,TG,TGO,7889094,Africa,5,83,22
2020-04-19T00:00:00Z,19,4,2020,1,0,Togo,TG,TGO,7889094,Africa,5,84,23
2020-04-20T00:00:00Z,20,4,2020,0,0,Togo,TG,TGO,7889094,Africa,5,84,24
2020-04-21T00:00:00Z,21,4,2020,0,1,Togo,TG,TGO,7889094,Africa,6,84,25
2020-04-22T00:00:00Z,22,4,2020,2,0,Togo,TG,TGO,7889094,Africa,6,86,26
2020-04-23T00:00:00Z,23,4,2020,2,0,Togo,TG,TGO,7889094,Africa,6,88,27
2020-04-24T00:00:00Z,24,4,2020,0,0,Togo,TG,TGO,7889094,Africa,6,88,28
2020-04-25T00:00:00Z,25,4,2020,2,0,Togo,TG,TGO,7889094,Africa,6,90,29
2020-04-26T00:00:00Z,26,4,2020,6,0,Togo,TG,TGO,7889094,Africa,6,96,30
2020-04-27T00:00:00Z,27,4,2020,2,0,Togo,TG,TGO,7889094,Africa,6,98,31
2020-04-28T00:00:00Z,28,4,2020,1,0,Togo,TG,TGO,7889094,Africa,6,99,32
2020-04-29T00:00:00Z,29,4,2020,0,0,Togo,TG,TGO,7889094,Africa,6,99,33
2020-04-30T00:00:00Z,30,4,2020,10,1,Togo,TG,TGO,7889094,Africa,7,109,34
2020-05-01T00:00:00Z,1,5,2020,7,2,Togo,TG,TGO,7889094,Africa,9,116,35
2020-05-02T00:00:00Z,2,5,2020,7,0,Togo,TG,TGO,7889094,Africa,9,123,36
2020-05-03T00:00:00Z,3,5,2020,0,0,Togo,TG,TGO,7889094,Africa,9,123,37
2020-05-04T00:00:00Z,4,5,2020,1,0,Togo,TG,TGO,7889094,Africa,9,124,38
2020-05-05T00:00:00Z,5,5,2020,2,0,Togo,TG,TGO,7889094,Africa,9,126,39
2020-05-06T00:00:00Z,6,5,2020,2,0,Togo,TG,TGO,7889094,Africa,9,128,40
2020-05-07T00:00:00Z,7,5,2020,0,0,Togo,TG,TGO,7889094,Africa,9,128,41
2020-05-08T00:00:00Z,8,5,2020,7,0,Togo,TG,TGO,7889094,Africa,9,135,42
2020-05-09T00:00:00Z,9,5,2020,10,1,Togo,TG,TGO,7889094,Africa,10,145,43
2020-05-10T00:00:00Z,10,5,2020,8,0,Togo,TG,TGO,7889094,Africa,10,153,44
2020-05-11T00:00:00Z,11,5,2020,21,1,Togo,TG,TGO,7889094,Africa,11,174,45
2020-05-12T00:00:00Z,12,5,2020,7,0,Togo,TG,TGO,7889094,Africa,11,181,46
2020-05-13T00:00:00Z,13,5,2020,18,0,Togo,TG,TGO,7889094,Africa,11,199,47
2020-05-14T00:00:00Z,14,5,2020,20,0,Togo,TG,TGO,7889094,Africa,11,219,48
2020-05-15T00:00:00Z,15,5,2020,19,0,Togo,TG,TGO,7889094,Africa,11,238,49
2020-05-16T00:00:00Z,16,5,2020,25,0,Togo,TG,TGO,7889094,Africa,11,263,50
2020-05-17T00:00:00Z,17,5,2020,35,0,Togo,TG,TGO,7889094,Africa,11,298,51
2020-05-18T00:00:00Z,18,5,2020,3,0,Togo,TG,TGO,7889094,Africa,11,301,52
2020-05-19T00:00:00Z,19,5,2020,29,1,Togo,TG,TGO,7889094,Africa,12,330,53
2020-05-20T00:00:00Z,20,5,2020,8,0,Togo,TG,TGO,7889094,Africa,12,338,54
2020-05-21T00:00:00Z,21,5,2020,2,0,Togo,TG,TGO,7889094,Africa,12,340,55
2020-05-22T00:00:00Z,22,5,2020,14,0,Togo,TG,TGO,7889094,Africa,12,354,56
2020-05-23T00:00:00Z,23,5,2020,9,0,Togo,TG,TGO,7889094,Africa,12,363,57
2020-05-24T00:00:00Z,24,5,2020,10,0,Togo,TG,TGO,7889094,Africa,12,373,58
2020-05-25T00:00:00Z,25,5,2020,8,0,Togo,TG,TGO,7889094,Africa,12,381,59
2020-05-26T00:00:00Z,26,5,2020,5,1,Togo,TG,TGO,7889094,Africa,13,386,60
2020-05-27T00:00:00Z,27,5,2020,5,0,Togo,TG,TGO,7889094,Africa,13,391,61
2020-03-26T00:00:00Z,26,3,2020,3,1,Trinidad_and_Tobago,TT,TTO,1389858,America,1,60,1
2020-03-27T00:00:00Z,27,3,2020,5,0,Trinidad_and_Tobago,TT,TTO,1389858,America,1,65,2
2020-03-28T00:00:00Z,28,3,2020,1,1,Trinidad_and_Tobago,TT,TTO,1389858,America,2,66,3
2020-03-29T00:00:00Z,29,3,2020,8,0,Trinidad_and_Tobago,TT,TTO,1389858,America,2,74,4
2020-03-30T00:00:00Z,30,3,2020,4,1,Trinidad_and_Tobago,TT,TTO,1389858,America,3,78,5
2020-03-31T00:00:00Z,31,3,2020,7,0,Trinidad_and_Tobago,TT,TTO,1389858,America,3,85,6
2020-04-01T00:00:00Z,1,4,2020,2,0,Trinidad_and_Tobago,TT,TTO,1389858,America,3,87,7
2020-04-02T00:00:00Z,2,4,2020,2,2,Trinidad_and_Tobago,TT,TTO,1389858,America,5,89,8
2020-04-03T00:00:00Z,3,4,2020,8,1,Trinidad_and_Tobago,TT,TTO,1389858,America,6,97,9
2020-04-04T00:00:00Z,4,4,2020,3,0,Trinidad_and_Tobago,TT,TTO,1389858,America,6,100,10
2020-04-05T00:00:00Z,5,4,2020,3,0,Trinidad_and_Tobago,TT,TTO,1389858,America,6,103,11
2020-04-06T00:00:00Z,6,4,2020,1,1,Trinidad_and_Tobago,TT,TTO,1389858,America,7,104,12
2020-04-07T00:00:00Z,7,4,2020,1,1,Trinidad_and_Tobago,TT,TTO,1389858,America,8,105,13
2020-04-08T00:00:00Z,8,4,2020,2,0,Trinidad_and_Tobago,TT,TTO,1389858,America,8,107,14
2020-04-09T00:00:00Z,9,4,2020,0,0,Trinidad_and_Tobago,TT,TTO,1389858,America,8,107,15
2020-04-10T00:00:00Z,10,4,2020,2,0,Trinidad_and_Tobago,TT,TTO,1389858,America,8,109,16
2020-04-11T00:00:00Z,11,4,2020,0,0,Trinidad_and_Tobago,TT,TTO,1389858,America,8,109,17
2020-04-12T00:00:00Z,12,4,2020,3,0,Trinidad_and_Tobago,TT,TTO,1389858,America,8,112,18
2020-04-13T00:00:00Z,13,4,2020,1,0,Trinidad_and_Tobago,TT,TTO,1389858,America,8,113,19
2020-04-14T00:00:00Z,14,4,2020,0,0,Trinidad_and_Tobago,TT,TTO,1389858,America,8,113,20
2020-04-15T00:00:00Z,15,4,2020,0,0,Trinidad_and_Tobago,TT,TTO,1389858,America,8,113,21
2020-04-16T00:00:00Z,16,4,2020,1,0,Trinidad_and_Tobago,TT,TTO,1389858,America,8,114,22
2020-04-17T00:00:00Z,17,4,2020,0,0,Trinidad_and_Tobago,TT,TTO,1389858,America,8,114,23
2020-04-18T00:00:00Z,18,4,2020,0,0,Trinidad_and_Tobago,TT,TTO,1389858,America,8,114,24
2020-04-19T00:00:00Z,19,4,2020,0,0,Trinidad_and_Tobago,TT,TTO,1389858,America,8,114,25
2020-04-20T00:00:00Z,20,4,2020,0,0,Trinidad_and_Tobago,TT,TTO,1389858,America,8,114,26
2020-04-21T00:00:00Z,21,4,2020,0,0,Trinidad_and_Tobago,TT,TTO,1389858,America,8,114,27
2020-04-22T00:00:00Z,22,4,2020,1,0,Trinidad_and_Tobago,TT,TTO,1389858,America,8,115,28
2020-04-23T00:00:00Z,23,4,2020,0,0,Trinidad_and_Tobago,TT,TTO,1389858,America,8,115,29
2020-04-24T00:00:00Z,24,4,2020,0,0,Trinidad_and_Tobago,TT,TTO,1389858,America,8,115,30
2020-04-25T00:00:00Z,25,4,2020,0,0,Trinidad_and_Tobago,TT,TTO,1389858,America,8,115,31
2020-04-26T00:00:00Z,26,4,2020,0,0,Trinidad_and_Tobago,TT,TTO,1389858,America,8,115,32
2020-04-27T00:00:00Z,27,4,2020,1,0,Trinidad_and_Tobago,TT,TTO,1389858,America,8,116,33
2020-04-28T00:00:00Z,28,4,2020,0,0,Trinidad_and_Tobago,TT,TTO,1389858,America,8,116,34
2020-04-29T00:00:00Z,29,4,2020,0,0,Trinidad_and_Tobago,TT,TTO,1389858,America,8,116,35
2020-04-30T00:00:00Z,30,4,2020,0,0,Trinidad_and_Tobago,TT,TTO,1389858,America,8,116,36
2020-05-01T00:00:00Z,1,5,2020,0,0,Trinidad_and_Tobago,TT,TTO,1389858,America,8,116,37
2020-05-02T00:00:00Z,2,5,2020,0,0,Trinidad_and_Tobago,TT,TTO,1389858,America,8,116,38
2020-05-03T00:00:00Z,3,5,2020,0,0,Trinidad_and_Tobago,TT,TTO,1389858,America,8,116,39
2020-05-04T00:00:00Z,4,5,2020,0,0,Trinidad_and_Tobago,TT,TTO,1389858,America,8,116,40
2020-05-05T00:00:00Z,5,5,2020,0,0,Trinidad_and_Tobago,TT,TTO,1389858,America,8,116,41
2020-05-06T00:00:00Z,6,5,2020,0,0,Trinidad_and_Tobago,TT,TTO,1389858,America,8,116,42
2020-05-07T00:00:00Z,7,5,2020,0,0,Trinidad_and_Tobago,TT,TTO,1389858,America,8,116,43
2020-05-08T00:00:00Z,8,5,2020,0,0,Trinidad_and_Tobago,TT,TTO,1389858,America,8,116,44
2020-05-09T00:00:00Z,9,5,2020,0,0,Trinidad_and_Tobago,TT,TTO,1389858,America,8,116,45
2020-05-10T00:00:00Z,10,5,2020,0,0,Trinidad_and_Tobago,TT,TTO,1389858,America,8,116,46
2020-05-11T00:00:00Z,11,5,2020,0,0,Trinidad_and_Tobago,TT,TTO,1389858,America,8,116,47
2020-05-12T00:00:00Z,12,5,2020,0,0,Trinidad_and_Tobago,TT,TTO,1389858,America,8,116,48
2020-05-13T00:00:00Z,13,5,2020,0,0,Trinidad_and_Tobago,TT,TTO,1389858,America,8,116,49
2020-05-14T00:00:00Z,14,5,2020,0,0,Trinidad_and_Tobago,TT,TTO,1389858,America,8,116,50
2020-05-15T00:00:00Z,15,5,2020,0,0,Trinidad_and_Tobago,TT,TTO,1389858,America,8,116,51
2020-05-16T00:00:00Z,16,5,2020,0,0,Trinidad_and_Tobago,TT,TTO,1389858,America,8,116,52
2020-05-17T00:00:00Z,17,5,2020,0,0,Trinidad_and_Tobago,TT,TTO,1389858,America,8,116,53
2020-05-18T00:00:00Z,18,5,2020,0,0,Trinidad_and_Tobago,TT,TTO,1389858,America,8,116,54
2020-05-19T00:00:00Z,19,5,2020,0,0,Trinidad_and_Tobago,TT,TTO,1389858,America,8,116,55
2020-05-20T00:00:00Z,20,5,2020,0,0,Trinidad_and_Tobago,TT,TTO,1389858,America,8,116,56
2020-05-21T00:00:00Z,21,5,2020,0,0,Trinidad_and_Tobago,TT,TTO,1389858,America,8,116,57
2020-05-22T00:00:00Z,22,5,2020,0,0,Trinidad_and_Tobago,TT,TTO,1389858,America,8,116,58
2020-05-23T00:00:00Z,23,5,2020,0,0,Trinidad_and_Tobago,TT,TTO,1389858,America,8,116,59
2020-05-24T00:00:00Z,24,5,2020,0,0,Trinidad_and_Tobago,TT,TTO,1389858,America,8,116,60
2020-05-25T00:00:00Z,25,5,2020,0,0,Trinidad_and_Tobago,TT,TTO,1389858,America,8,116,61
2020-05-26T00:00:00Z,26,5,2020,0,0,Trinidad_and_Tobago,TT,TTO,1389858,America,8,116,62
2020-05-27T00:00:00Z,27,5,2020,0,0,Trinidad_and_Tobago,TT,TTO,1389858,America,8,116,63
2020-03-21T00:00:00Z,21,3,2020,15,1,Tunisia,TN,TUN,11565204,Africa,1,54,1
2020-03-22T00:00:00Z,22,3,2020,6,0,Tunisia,TN,TUN,11565204,Africa,1,60,2
2020-03-23T00:00:00Z,23,3,2020,15,2,Tunisia,TN,TUN,11565204,Africa,3,75,3
2020-03-24T00:00:00Z,24,3,2020,14,0,Tunisia,TN,TUN,11565204,Africa,3,89,4
2020-03-25T00:00:00Z,25,3,2020,25,0,Tunisia,TN,TUN,11565204,Africa,3,114,5
2020-03-26T00:00:00Z,26,3,2020,59,2,Tunisia,TN,TUN,11565204,Africa,5,173,6
2020-03-27T00:00:00Z,27,3,2020,0,0,Tunisia,TN,TUN,11565204,Africa,5,173,7
2020-03-28T00:00:00Z,28,3,2020,54,1,Tunisia,TN,TUN,11565204,Africa,6,227,8
2020-03-29T00:00:00Z,29,3,2020,0,0,Tunisia,TN,TUN,11565204,Africa,6,227,9
2020-03-30T00:00:00Z,30,3,2020,51,2,Tunisia,TN,TUN,11565204,Africa,8,278,10
2020-03-31T00:00:00Z,31,3,2020,34,0,Tunisia,TN,TUN,11565204,Africa,8,312,11
2020-04-01T00:00:00Z,1,4,2020,50,1,Tunisia,TN,TUN,11565204,Africa,9,362,12
2020-04-02T00:00:00Z,2,4,2020,32,1,Tunisia,TN,TUN,11565204,Africa,10,394,13
2020-04-03T00:00:00Z,3,4,2020,61,3,Tunisia,TN,TUN,11565204,Africa,13,455,14
2020-04-04T00:00:00Z,4,4,2020,0,0,Tunisia,TN,TUN,11565204,Africa,13,455,15
2020-04-05T00:00:00Z,5,4,2020,40,5,Tunisia,TN,TUN,11565204,Africa,18,495,16
2020-04-06T00:00:00Z,6,4,2020,58,1,Tunisia,TN,TUN,11565204,Africa,19,553,17
2020-04-07T00:00:00Z,7,4,2020,21,3,Tunisia,TN,TUN,11565204,Africa,22,574,18
2020-04-08T00:00:00Z,8,4,2020,22,0,Tunisia,TN,TUN,11565204,Africa,22,596,19
2020-04-09T00:00:00Z,9,4,2020,27,1,Tunisia,TN,TUN,11565204,Africa,23,623,20
2020-04-10T00:00:00Z,10,4,2020,20,2,Tunisia,TN,TUN,11565204,Africa,25,643,21
2020-04-11T00:00:00Z,11,4,2020,28,0,Tunisia,TN,TUN,11565204,Africa,25,671,22
2020-04-12T00:00:00Z,12,4,2020,14,3,Tunisia,TN,TUN,11565204,Africa,28,685,23
2020-04-13T00:00:00Z,13,4,2020,22,3,Tunisia,TN,TUN,11565204,Africa,31,707,24
2020-04-14T00:00:00Z,14,4,2020,19,3,Tunisia,TN,TUN,11565204,Africa,34,726,25
2020-04-15T00:00:00Z,15,4,2020,21,0,Tunisia,TN,TUN,11565204,Africa,34,747,26
2020-04-16T00:00:00Z,16,4,2020,33,1,Tunisia,TN,TUN,11565204,Africa,35,780,27
2020-04-17T00:00:00Z,17,4,2020,42,2,Tunisia,TN,TUN,11565204,Africa,37,822,28
2020-04-18T00:00:00Z,18,4,2020,42,0,Tunisia,TN,TUN,11565204,Africa,37,864,29
2020-04-19T00:00:00Z,19,4,2020,2,0,Tunisia,TN,TUN,11565204,Africa,37,866,30
2020-04-20T00:00:00Z,20,4,2020,13,1,Tunisia,TN,TUN,11565204,Africa,38,879,31
2020-04-21T00:00:00Z,21,4,2020,5,0,Tunisia,TN,TUN,11565204,Africa,38,884,32
2020-04-22T00:00:00Z,22,4,2020,17,0,Tunisia,TN,TUN,11565204,Africa,38,901,33
2020-04-23T00:00:00Z,23,4,2020,0,0,Tunisia,TN,TUN,11565204,Africa,38,901,34
2020-04-24T00:00:00Z,24,4,2020,17,0,Tunisia,TN,TUN,11565204,Africa,38,918,35
2020-04-25T00:00:00Z,25,4,2020,4,0,Tunisia,TN,TUN,11565204,Africa,38,922,36
2020-04-26T00:00:00Z,26,4,2020,17,0,Tunisia,TN,TUN,11565204,Africa,38,939,37
2020-04-27T00:00:00Z,27,4,2020,10,0,Tunisia,TN,TUN,11565204,Africa,38,949,38
2020-04-28T00:00:00Z,28,4,2020,18,1,Tunisia,TN,TUN,11565204,Africa,39,967,39
2020-04-29T00:00:00Z,29,4,2020,8,1,Tunisia,TN,TUN,11565204,Africa,40,975,40
2020-04-30T00:00:00Z,30,4,2020,5,0,Tunisia,TN,TUN,11565204,Africa,40,980,41
2020-05-01T00:00:00Z,1,5,2020,14,0,Tunisia,TN,TUN,11565204,Africa,40,994,42
2020-05-02T00:00:00Z,2,5,2020,4,1,Tunisia,TN,TUN,11565204,Africa,41,998,43
2020-05-03T00:00:00Z,3,5,2020,11,1,Tunisia,TN,TUN,11565204,Africa,42,1009,44
2020-05-04T00:00:00Z,4,5,2020,4,0,Tunisia,TN,TUN,11565204,Africa,42,1013,45
2020-05-05T00:00:00Z,5,5,2020,5,1,Tunisia,TN,TUN,11565204,Africa,43,1018,46
2020-05-06T00:00:00Z,6,5,2020,4,0,Tunisia,TN,TUN,11565204,Africa,43,1022,47
2020-05-07T00:00:00Z,7,5,2020,3,0,Tunisia,TN,TUN,11565204,Africa,43,1025,48
2020-05-08T00:00:00Z,8,5,2020,1,1,Tunisia,TN,TUN,11565204,Africa,44,1026,49
2020-05-09T00:00:00Z,9,5,2020,4,1,Tunisia,TN,TUN,11565204,Africa,45,1030,50
2020-05-10T00:00:00Z,10,5,2020,2,0,Tunisia,TN,TUN,11565204,Africa,45,1032,51
2020-05-11T00:00:00Z,11,5,2020,0,0,Tunisia,TN,TUN,11565204,Africa,45,1032,52
2020-05-12T00:00:00Z,12,5,2020,0,0,Tunisia,TN,TUN,11565204,Africa,45,1032,53
2020-05-13T00:00:00Z,13,5,2020,0,0,Tunisia,TN,TUN,11565204,Africa,45,1032,54
2020-05-14T00:00:00Z,14,5,2020,0,0,Tunisia,TN,TUN,11565204,Africa,45,1032,55
2020-05-15T00:00:00Z,15,5,2020,0,0,Tunisia,TN,TUN,11565204,Africa,45,1032,56
2020-05-16T00:00:00Z,16,5,2020,3,0,Tunisia,TN,TUN,11565204,Africa,45,1035,57
2020-05-17T00:00:00Z,17,5,2020,0,0,Tunisia,TN,TUN,11565204,Africa,45,1035,58
2020-05-18T00:00:00Z,18,5,2020,2,0,Tunisia,TN,TUN,11565204,Africa,45,1037,59
2020-05-19T00:00:00Z,19,5,2020,6,1,Tunisia,TN,TUN,11565204,Africa,46,1043,60
2020-05-20T00:00:00Z,20,5,2020,1,1,Tunisia,TN,TUN,11565204,Africa,47,1044,61
2020-05-21T00:00:00Z,21,5,2020,1,0,Tunisia,TN,TUN,11565204,Africa,47,1045,62
2020-05-22T00:00:00Z,22,5,2020,1,0,Tunisia,TN,TUN,11565204,Africa,47,1046,63
2020-05-23T00:00:00Z,23,5,2020,2,0,Tunisia,TN,TUN,11565204,Africa,47,1048,64
2020-05-24T00:00:00Z,24,5,2020,0,1,Tunisia,TN,TUN,11565204,Africa,48,1048,65
2020-05-25T00:00:00Z,25,5,2020,3,0,Tunisia,TN,TUN,11565204,Africa,48,1051,66
2020-05-26T00:00:00Z,26,5,2020,0,0,Tunisia,TN,TUN,11565204,Africa,48,1051,67
2020-05-27T00:00:00Z,27,5,2020,0,0,Tunisia,TN,TUN,11565204,Africa,48,1051,68
2020-03-19T00:00:00Z,19,3,2020,93,1,Turkey,TR,TUR,82319724,Asia,1,191,1
2020-03-20T00:00:00Z,20,3,2020,168,3,Turkey,TR,TUR,82319724,Asia,4,359,2
2020-03-21T00:00:00Z,21,3,2020,311,5,Turkey,TR,TUR,82319724,Asia,9,670,3
2020-03-22T00:00:00Z,22,3,2020,277,12,Turkey,TR,TUR,82319724,Asia,21,947,4
2020-03-23T00:00:00Z,23,3,2020,289,9,Turkey,TR,TUR,82319724,Asia,30,1236,5
2020-03-24T00:00:00Z,24,3,2020,293,7,Turkey,TR,TUR,82319724,Asia,37,1529,6
2020-03-25T00:00:00Z,25,3,2020,343,7,Turkey,TR,TUR,82319724,Asia,44,1872,7
2020-03-26T00:00:00Z,26,3,2020,561,15,Turkey,TR,TUR,82319724,Asia,59,2433,8
2020-03-27T00:00:00Z,27,3,2020,1196,16,Turkey,TR,TUR,82319724,Asia,75,3629,9
2020-03-28T00:00:00Z,28,3,2020,2069,17,Turkey,TR,TUR,82319724,Asia,92,5698,10
2020-03-29T00:00:00Z,29,3,2020,1704,16,Turkey,TR,TUR,82319724,Asia,108,7402,11
2020-03-30T00:00:00Z,30,3,2020,1815,23,Turkey,TR,TUR,82319724,Asia,131,9217,12
2020-03-31T00:00:00Z,31,3,2020,1610,37,Turkey,TR,TUR,82319724,Asia,168,10827,13
2020-04-01T00:00:00Z,1,4,2020,2704,46,Turkey,TR,TUR,82319724,Asia,214,13531,14
2020-04-02T00:00:00Z,2,4,2020,2148,63,Turkey,TR,TUR,82319724,Asia,277,15679,15
2020-04-03T00:00:00Z,3,4,2020,2456,79,Turkey,TR,TUR,82319724,Asia,356,18135,16
2020-04-04T00:00:00Z,4,4,2020,2786,69,Turkey,TR,TUR,82319724,Asia,425,20921,17
2020-04-05T00:00:00Z,5,4,2020,3013,76,Turkey,TR,TUR,82319724,Asia,501,23934,18
2020-04-06T00:00:00Z,6,4,2020,3135,73,Turkey,TR,TUR,82319724,Asia,574,27069,19
2020-04-07T00:00:00Z,7,4,2020,3148,75,Turkey,TR,TUR,82319724,Asia,649,30217,20
2020-04-08T00:00:00Z,8,4,2020,3892,76,Turkey,TR,TUR,82319724,Asia,725,34109,21
2020-04-09T00:00:00Z,9,4,2020,4117,87,Turkey,TR,TUR,82319724,Asia,812,38226,22
2020-04-10T00:00:00Z,10,4,2020,4056,96,Turkey,TR,TUR,82319724,Asia,908,42282,23
2020-04-11T00:00:00Z,11,4,2020,4747,98,Turkey,TR,TUR,82319724,Asia,1006,47029,24
2020-04-12T00:00:00Z,12,4,2020,5138,95,Turkey,TR,TUR,82319724,Asia,1101,52167,25
2020-04-13T00:00:00Z,13,4,2020,4789,97,Turkey,TR,TUR,82319724,Asia,1198,56956,26
2020-04-14T00:00:00Z,14,4,2020,4093,98,Turkey,TR,TUR,82319724,Asia,1296,61049,27
2020-04-15T00:00:00Z,15,4,2020,4062,107,Turkey,TR,TUR,82319724,Asia,1403,65111,28
2020-04-16T00:00:00Z,16,4,2020,4281,115,Turkey,TR,TUR,82319724,Asia,1518,69392,29
2020-04-17T00:00:00Z,17,4,2020,4801,125,Turkey,TR,TUR,82319724,Asia,1643,74193,30
2020-04-18T00:00:00Z,18,4,2020,4353,126,Turkey,TR,TUR,82319724,Asia,1769,78546,31
2020-04-19T00:00:00Z,19,4,2020,3783,121,Turkey,TR,TUR,82319724,Asia,1890,82329,32
2020-04-20T00:00:00Z,20,4,2020,3977,127,Turkey,TR,TUR,82319724,Asia,2017,86306,33
2020-04-21T00:00:00Z,21,4,2020,4674,123,Turkey,TR,TUR,82319724,Asia,2140,90980,34
2020-04-22T00:00:00Z,22,4,2020,4611,119,Turkey,TR,TUR,82319724,Asia,2259,95591,35
2020-04-23T00:00:00Z,23,4,2020,3083,117,Turkey,TR,TUR,82319724,Asia,2376,98674,36
2020-04-24T00:00:00Z,24,4,2020,3116,115,Turkey,TR,TUR,82319724,Asia,2491,101790,37
2020-04-25T00:00:00Z,25,4,2020,3122,109,Turkey,TR,TUR,82319724,Asia,2600,104912,38
2020-04-26T00:00:00Z,26,4,2020,2861,106,Turkey,TR,TUR,82319724,Asia,2706,107773,39
2020-04-27T00:00:00Z,27,4,2020,2357,99,Turkey,TR,TUR,82319724,Asia,2805,110130,40
2020-04-28T00:00:00Z,28,4,2020,2131,95,Turkey,TR,TUR,82319724,Asia,2900,112261,41
2020-04-29T00:00:00Z,29,4,2020,2392,92,Turkey,TR,TUR,82319724,Asia,2992,114653,42
2020-04-30T00:00:00Z,30,4,2020,2936,89,Turkey,TR,TUR,82319724,Asia,3081,117589,43
2020-05-01T00:00:00Z,1,5,2020,2615,93,Turkey,TR,TUR,82319724,Asia,3174,120204,44
2020-05-02T00:00:00Z,2,5,2020,2188,84,Turkey,TR,TUR,82319724,Asia,3258,122392,45
2020-05-03T00:00:00Z,3,5,2020,1983,78,Turkey,TR,TUR,82319724,Asia,3336,124375,46
2020-05-04T00:00:00Z,4,5,2020,1670,61,Turkey,TR,TUR,82319724,Asia,3397,126045,47
2020-05-05T00:00:00Z,5,5,2020,1614,64,Turkey,TR,TUR,82319724,Asia,3461,127659,48
2020-05-06T00:00:00Z,6,5,2020,1832,59,Turkey,TR,TUR,82319724,Asia,3520,129491,49
2020-05-07T00:00:00Z,7,5,2020,2253,64,Turkey,TR,TUR,82319724,Asia,3584,131744,50
2020-05-08T00:00:00Z,8,5,2020,1977,57,Turkey,TR,TUR,82319724,Asia,3641,133721,51
2020-05-09T00:00:00Z,9,5,2020,1848,48,Turkey,TR,TUR,82319724,Asia,3689,135569,52
2020-05-10T00:00:00Z,10,5,2020,1546,50,Turkey,TR,TUR,82319724,Asia,3739,137115,53
2020-05-11T00:00:00Z,11,5,2020,1542,47,Turkey,TR,TUR,82319724,Asia,3786,138657,54
2020-05-12T00:00:00Z,12,5,2020,1114,55,Turkey,TR,TUR,82319724,Asia,3841,139771,55
2020-05-13T00:00:00Z,13,5,2020,1704,53,Turkey,TR,TUR,82319724,Asia,3894,141475,56
2020-05-14T00:00:00Z,14,5,2020,1639,58,Turkey,TR,TUR,82319724,Asia,3952,143114,57
2020-05-15T00:00:00Z,15,5,2020,1635,55,Turkey,TR,TUR,82319724,Asia,4007,144749,58
2020-05-16T00:00:00Z,16,5,2020,1708,48,Turkey,TR,TUR,82319724,Asia,4055,146457,59
2020-05-17T00:00:00Z,17,5,2020,1610,41,Turkey,TR,TUR,82319724,Asia,4096,148067,60
2020-05-18T00:00:00Z,18,5,2020,1368,44,Turkey,TR,TUR,82319724,Asia,4140,149435,61
2020-05-19T00:00:00Z,19,5,2020,1158,31,Turkey,TR,TUR,82319724,Asia,4171,150593,62
2020-05-20T00:00:00Z,20,5,2020,1022,28,Turkey,TR,TUR,82319724,Asia,4199,151615,63
2020-05-21T00:00:00Z,21,5,2020,972,23,Turkey,TR,TUR,82319724,Asia,4222,152587,64
2020-05-22T00:00:00Z,22,5,2020,961,27,Turkey,TR,TUR,82319724,Asia,4249,153548,65
2020-05-23T00:00:00Z,23,5,2020,952,27,Turkey,TR,TUR,82319724,Asia,4276,154500,66
2020-05-24T00:00:00Z,24,5,2020,1186,32,Turkey,TR,TUR,82319724,Asia,4308,155686,67
2020-05-25T00:00:00Z,25,5,2020,1141,32,Turkey,TR,TUR,82319724,Asia,4340,156827,68
2020-05-26T00:00:00Z,26,5,2020,987,29,Turkey,TR,TUR,82319724,Asia,4369,157814,69
2020-05-27T00:00:00Z,27,5,2020,948,28,Turkey,TR,TUR,82319724,Asia,4397,158762,70
2020-04-06T00:00:00Z,6,4,2020,0,1,Turks_and_Caicos_islands,TC,TCA,31458,America,1,5,1
2020-04-07T00:00:00Z,7,4,2020,3,0,Turks_and_Caicos_islands,TC,TCA,31458,America,1,8,2
2020-04-08T00:00:00Z,8,4,2020,0,0,Turks_and_Caicos_islands,TC,TCA,31458,America,1,8,3
2020-04-09T00:00:00Z,9,4,2020,0,0,Turks_and_Caicos_islands,TC,TCA,31458,America,1,8,4
2020-04-10T00:00:00Z,10,4,2020,0,0,Turks_and_Caicos_islands,TC,TCA,31458,America,1,8,5
2020-04-11T00:00:00Z,11,4,2020,1,0,Turks_and_Caicos_islands,TC,TCA,31458,America,1,9,6
2020-04-12T00:00:00Z,12,4,2020,0,0,Turks_and_Caicos_islands,TC,TCA,31458,America,1,9,7
2020-04-13T00:00:00Z,13,4,2020,0,0,Turks_and_Caicos_islands,TC,TCA,31458,America,1,9,8
2020-04-14T00:00:00Z,14,4,2020,1,0,Turks_and_Caicos_islands,TC,TCA,31458,America,1,10,9
2020-04-15T00:00:00Z,15,4,2020,0,0,Turks_and_Caicos_islands,TC,TCA,31458,America,1,10,10
2020-04-16T00:00:00Z,16,4,2020,1,0,Turks_and_Caicos_islands,TC,TCA,31458,America,1,11,11
2020-04-17T00:00:00Z,17,4,2020,0,0,Turks_and_Caicos_islands,TC,TCA,31458,America,1,11,12
2020-04-18T00:00:00Z,18,4,2020,0,0,Turks_and_Caicos_islands,TC,TCA,31458,America,1,11,13
2020-04-19T00:00:00Z,19,4,2020,0,0,Turks_and_Caicos_islands,TC,TCA,31458,America,1,11,14
2020-04-20T00:00:00Z,20,4,2020,0,0,Turks_and_Caicos_islands,TC,TCA,31458,America,1,11,15
2020-04-21T00:00:00Z,21,4,2020,0,0,Turks_and_Caicos_islands,TC,TCA,31458,America,1,11,16
2020-04-22T00:00:00Z,22,4,2020,0,0,Turks_and_Caicos_islands,TC,TCA,31458,America,1,11,17
2020-04-23T00:00:00Z,23,4,2020,0,0,Turks_and_Caicos_islands,TC,TCA,31458,America,1,11,18
2020-04-24T00:00:00Z,24,4,2020,0,0,Turks_and_Caicos_islands,TC,TCA,31458,America,1,11,19
2020-04-25T00:00:00Z,25,4,2020,0,0,Turks_and_Caicos_islands,TC,TCA,31458,America,1,11,20
2020-04-26T00:00:00Z,26,4,2020,0,0,Turks_and_Caicos_islands,TC,TCA,31458,America,1,11,21
2020-04-27T00:00:00Z,27,4,2020,0,0,Turks_and_Caicos_islands,TC,TCA,31458,America,1,11,22
2020-04-28T00:00:00Z,28,4,2020,1,0,Turks_and_Caicos_islands,TC,TCA,31458,America,1,12,23
2020-04-29T00:00:00Z,29,4,2020,0,0,Turks_and_Caicos_islands,TC,TCA,31458,America,1,12,24
2020-04-30T00:00:00Z,30,4,2020,0,0,Turks_and_Caicos_islands,TC,TCA,31458,America,1,12,25
2020-05-01T00:00:00Z,1,5,2020,0,0,Turks_and_Caicos_islands,TC,TCA,31458,America,1,12,26
2020-05-02T00:00:00Z,2,5,2020,0,0,Turks_and_Caicos_islands,TC,TCA,31458,America,1,12,27
2020-05-03T00:00:00Z,3,5,2020,0,0,Turks_and_Caicos_islands,TC,TCA,31458,America,1,12,28
2020-05-04T00:00:00Z,4,5,2020,0,0,Turks_and_Caicos_islands,TC,TCA,31458,America,1,12,29
2020-05-05T00:00:00Z,5,5,2020,0,0,Turks_and_Caicos_islands,TC,TCA,31458,America,1,12,30
2020-05-06T00:00:00Z,6,5,2020,0,0,Turks_and_Caicos_islands,TC,TCA,31458,America,1,12,31
2020-05-07T00:00:00Z,7,5,2020,0,0,Turks_and_Caicos_islands,TC,TCA,31458,America,1,12,32
2020-05-08T00:00:00Z,8,5,2020,0,0,Turks_and_Caicos_islands,TC,TCA,31458,America,1,12,33
2020-05-09T00:00:00Z,9,5,2020,0,0,Turks_and_Caicos_islands,TC,TCA,31458,America,1,12,34
2020-05-10T00:00:00Z,10,5,2020,0,0,Turks_and_Caicos_islands,TC,TCA,31458,America,1,12,35
2020-05-11T00:00:00Z,11,5,2020,0,0,Turks_and_Caicos_islands,TC,TCA,31458,America,1,12,36
2020-05-12T00:00:00Z,12,5,2020,0,0,Turks_and_Caicos_islands,TC,TCA,31458,America,1,12,37
2020-05-13T00:00:00Z,13,5,2020,0,0,Turks_and_Caicos_islands,TC,TCA,31458,America,1,12,38
2020-05-14T00:00:00Z,14,5,2020,0,0,Turks_and_Caicos_islands,TC,TCA,31458,America,1,12,39
2020-05-15T00:00:00Z,15,5,2020,0,0,Turks_and_Caicos_islands,TC,TCA,31458,America,1,12,40
2020-05-16T00:00:00Z,16,5,2020,0,0,Turks_and_Caicos_islands,TC,TCA,31458,America,1,12,41
2020-05-17T00:00:00Z,17,5,2020,0,0,Turks_and_Caicos_islands,TC,TCA,31458,America,1,12,42
2020-05-18T00:00:00Z,18,5,2020,0,0,Turks_and_Caicos_islands,TC,TCA,31458,America,1,12,43
2020-05-19T00:00:00Z,19,5,2020,0,0,Turks_and_Caicos_islands,TC,TCA,31458,America,1,12,44
2020-05-20T00:00:00Z,20,5,2020,0,0,Turks_and_Caicos_islands,TC,TCA,31458,America,1,12,45
2020-05-21T00:00:00Z,21,5,2020,0,0,Turks_and_Caicos_islands,TC,TCA,31458,America,1,12,46
2020-05-22T00:00:00Z,22,5,2020,0,0,Turks_and_Caicos_islands,TC,TCA,31458,America,1,12,47
2020-05-23T00:00:00Z,23,5,2020,0,0,Turks_and_Caicos_islands,TC,TCA,31458,America,1,12,48
2020-05-24T00:00:00Z,24,5,2020,0,0,Turks_and_Caicos_islands,TC,TCA,31458,America,1,12,49
2020-05-25T00:00:00Z,25,5,2020,0,0,Turks_and_Caicos_islands,TC,TCA,31458,America,1,12,50
2020-05-26T00:00:00Z,26,5,2020,0,0,Turks_and_Caicos_islands,TC,TCA,31458,America,1,12,51
2020-05-27T00:00:00Z,27,5,2020,0,0,Turks_and_Caicos_islands,TC,TCA,31458,America,1,12,52
2020-03-19T00:00:00Z,19,3,2020,5,2,Ukraine,UA,UKR,44622516,Europe,2,19,1
2020-03-20T00:00:00Z,20,3,2020,7,0,Ukraine,UA,UKR,44622516,Europe,2,26,2
2020-03-21T00:00:00Z,21,3,2020,0,1,Ukraine,UA,UKR,44622516,Europe,3,26,3
2020-03-22T00:00:00Z,22,3,2020,15,0,Ukraine,UA,UKR,44622516,Europe,3,41,4
2020-03-23T00:00:00Z,23,3,2020,6,0,Ukraine,UA,UKR,44622516,Europe,3,47,5
2020-03-24T00:00:00Z,24,3,2020,26,0,Ukraine,UA,UKR,44622516,Europe,3,73,6
2020-03-25T00:00:00Z,25,3,2020,11,0,Ukraine,UA,UKR,44622516,Europe,3,84,7
2020-03-26T00:00:00Z,26,3,2020,29,1,Ukraine,UA,UKR,44622516,Europe,4,113,8
2020-03-27T00:00:00Z,27,3,2020,43,1,Ukraine,UA,UKR,44622516,Europe,5,156,9
2020-03-28T00:00:00Z,28,3,2020,62,0,Ukraine,UA,UKR,44622516,Europe,5,218,10
2020-03-29T00:00:00Z,29,3,2020,93,3,Ukraine,UA,UKR,44622516,Europe,8,311,11
2020-03-30T00:00:00Z,30,3,2020,107,1,Ukraine,UA,UKR,44622516,Europe,9,418,12
2020-03-31T00:00:00Z,31,3,2020,62,2,Ukraine,UA,UKR,44622516,Europe,11,480,13
2020-04-01T00:00:00Z,1,4,2020,69,2,Ukraine,UA,UKR,44622516,Europe,13,549,14
2020-04-02T00:00:00Z,2,4,2020,245,7,Ukraine,UA,UKR,44622516,Europe,20,794,15
2020-04-03T00:00:00Z,3,4,2020,10,0,Ukraine,UA,UKR,44622516,Europe,20,804,16
2020-04-04T00:00:00Z,4,4,2020,183,3,Ukraine,UA,UKR,44622516,Europe,23,987,17
2020-04-05T00:00:00Z,5,4,2020,109,5,Ukraine,UA,UKR,44622516,Europe,28,1096,18
2020-04-06T00:00:00Z,6,4,2020,155,4,Ukraine,UA,UKR,44622516,Europe,32,1251,19
2020-04-07T00:00:00Z,7,4,2020,68,6,Ukraine,UA,UKR,44622516,Europe,38,1319,20
2020-04-08T00:00:00Z,8,4,2020,143,7,Ukraine,UA,UKR,44622516,Europe,45,1462,21
2020-04-09T00:00:00Z,9,4,2020,206,7,Ukraine,UA,UKR,44622516,Europe,52,1668,22
2020-04-10T00:00:00Z,10,4,2020,224,5,Ukraine,UA,UKR,44622516,Europe,57,1892,23
2020-04-11T00:00:00Z,11,4,2020,311,12,Ukraine,UA,UKR,44622516,Europe,69,2203,24
2020-04-12T00:00:00Z,12,4,2020,308,4,Ukraine,UA,UKR,44622516,Europe,73,2511,25
2020-04-13T00:00:00Z,13,4,2020,266,10,Ukraine,UA,UKR,44622516,Europe,83,2777,26
2020-04-14T00:00:00Z,14,4,2020,325,10,Ukraine,UA,UKR,44622516,Europe,93,3102,27
2020-04-15T00:00:00Z,15,4,2020,270,5,Ukraine,UA,UKR,44622516,Europe,98,3372,28
2020-04-16T00:00:00Z,16,4,2020,789,18,Ukraine,UA,UKR,44622516,Europe,116,4161,29
2020-04-17T00:00:00Z,17,4,2020,301,9,Ukraine,UA,UKR,44622516,Europe,125,4462,30
2020-04-18T00:00:00Z,18,4,2020,644,8,Ukraine,UA,UKR,44622516,Europe,133,5106,31
2020-04-19T00:00:00Z,19,4,2020,343,8,Ukraine,UA,UKR,44622516,Europe,141,5449,32
2020-04-20T00:00:00Z,20,4,2020,261,10,Ukraine,UA,UKR,44622516,Europe,151,5710,33
2020-04-21T00:00:00Z,21,4,2020,415,10,Ukraine,UA,UKR,44622516,Europe,161,6125,34
2020-04-22T00:00:00Z,22,4,2020,467,13,Ukraine,UA,UKR,44622516,Europe,174,6592,35
2020-04-23T00:00:00Z,23,4,2020,578,13,Ukraine,UA,UKR,44622516,Europe,187,7170,36
2020-04-24T00:00:00Z,24,4,2020,477,6,Ukraine,UA,UKR,44622516,Europe,193,7647,37
2020-04-25T00:00:00Z,25,4,2020,478,8,Ukraine,UA,UKR,44622516,Europe,201,8125,38
2020-04-26T00:00:00Z,26,4,2020,492,8,Ukraine,UA,UKR,44622516,Europe,209,8617,39
2020-04-27T00:00:00Z,27,4,2020,392,11,Ukraine,UA,UKR,44622516,Europe,220,9009,40
2020-04-28T00:00:00Z,28,4,2020,0,0,Ukraine,UA,UKR,44622516,Europe,220,9009,41
2020-04-29T00:00:00Z,29,4,2020,401,19,Ukraine,UA,UKR,44622516,Europe,239,9410,42
2020-04-30T00:00:00Z,30,4,2020,456,11,Ukraine,UA,UKR,44622516,Europe,250,9866,43
2020-05-01T00:00:00Z,1,5,2020,540,0,Ukraine,UA,UKR,44622516,Europe,250,10406,44
2020-05-02T00:00:00Z,2,5,2020,455,29,Ukraine,UA,UKR,44622516,Europe,279,10861,45
2020-05-03T00:00:00Z,3,5,2020,550,0,Ukraine,UA,UKR,44622516,Europe,279,11411,46
2020-05-04T00:00:00Z,4,5,2020,502,9,Ukraine,UA,UKR,44622516,Europe,288,11913,47
2020-05-05T00:00:00Z,5,5,2020,418,15,Ukraine,UA,UKR,44622516,Europe,303,12331,48
2020-05-06T00:00:00Z,6,5,2020,366,13,Ukraine,UA,UKR,44622516,Europe,316,12697,49
2020-05-07T00:00:00Z,7,5,2020,487,11,Ukraine,UA,UKR,44622516,Europe,327,13184,50
2020-05-08T00:00:00Z,8,5,2020,507,13,Ukraine,UA,UKR,44622516,Europe,340,13691,51
2020-05-09T00:00:00Z,9,5,2020,504,21,Ukraine,UA,UKR,44622516,Europe,361,14195,52
2020-05-10T00:00:00Z,10,5,2020,515,15,Ukraine,UA,UKR,44622516,Europe,376,14710,53
2020-05-11T00:00:00Z,11,5,2020,522,15,Ukraine,UA,UKR,44622516,Europe,391,15232,54
2020-05-12T00:00:00Z,12,5,2020,416,17,Ukraine,UA,UKR,44622516,Europe,408,15648,55
2020-05-13T00:00:00Z,13,5,2020,375,17,Ukraine,UA,UKR,44622516,Europe,425,16023,56
2020-05-14T00:00:00Z,14,5,2020,402,14,Ukraine,UA,UKR,44622516,Europe,439,16425,57
2020-05-15T00:00:00Z,15,5,2020,422,17,Ukraine,UA,UKR,44622516,Europe,456,16847,58
2020-05-16T00:00:00Z,16,5,2020,483,27,Ukraine,UA,UKR,44622516,Europe,483,17330,59
2020-05-17T00:00:00Z,17,5,2020,528,14,Ukraine,UA,UKR,44622516,Europe,497,17858,60
2020-05-18T00:00:00Z,18,5,2020,433,17,Ukraine,UA,UKR,44622516,Europe,514,18291,61
2020-05-19T00:00:00Z,19,5,2020,325,21,Ukraine,UA,UKR,44622516,Europe,535,18616,62
2020-05-20T00:00:00Z,20,5,2020,260,13,Ukraine,UA,UKR,44622516,Europe,548,18876,63
2020-05-21T00:00:00Z,21,5,2020,354,16,Ukraine,UA,UKR,44622516,Europe,564,19230,64
2020-05-22T00:00:00Z,22,5,2020,476,15,Ukraine,UA,UKR,44622516,Europe,579,19706,65
2020-05-23T00:00:00Z,23,5,2020,442,9,Ukraine,UA,UKR,44622516,Europe,588,20148,66
2020-05-24T00:00:00Z,24,5,2020,432,17,Ukraine,UA,UKR,44622516,Europe,605,20580,67
2020-05-25T00:00:00Z,25,5,2020,406,12,Ukraine,UA,UKR,44622516,Europe,617,20986,68
2020-05-26T00:00:00Z,26,5,2020,259,6,Ukraine,UA,UKR,44622516,Europe,623,21245,69
2020-05-27T00:00:00Z,27,5,2020,339,21,Ukraine,UA,UKR,44622516,Europe,644,21584,70
2020-03-22T00:00:00Z,22,3,2020,13,2,United_Arab_Emirates,AE,ARE,9630959,Asia,2,153,1
2020-03-23T00:00:00Z,23,3,2020,0,0,United_Arab_Emirates,AE,ARE,9630959,Asia,2,153,2
2020-03-24T00:00:00Z,24,3,2020,45,0,United_Arab_Emirates,AE,ARE,9630959,Asia,2,198,3
2020-03-25T00:00:00Z,25,3,2020,50,0,United_Arab_Emirates,AE,ARE,9630959,Asia,2,248,4
2020-03-26T00:00:00Z,26,3,2020,85,0,United_Arab_Emirates,AE,ARE,9630959,Asia,2,333,5
2020-03-27T00:00:00Z,27,3,2020,0,0,United_Arab_Emirates,AE,ARE,9630959,Asia,2,333,6
2020-03-28T00:00:00Z,28,3,2020,72,0,United_Arab_Emirates,AE,ARE,9630959,Asia,2,405,7
2020-03-29T00:00:00Z,29,3,2020,63,0,United_Arab_Emirates,AE,ARE,9630959,Asia,2,468,8
2020-03-30T00:00:00Z,30,3,2020,0,0,United_Arab_Emirates,AE,ARE,9630959,Asia,2,468,9
2020-03-31T00:00:00Z,31,3,2020,143,3,United_Arab_Emirates,AE,ARE,9630959,Asia,5,611,10
2020-04-01T00:00:00Z,1,4,2020,53,1,United_Arab_Emirates,AE,ARE,9630959,Asia,6,664,11
2020-04-02T00:00:00Z,2,4,2020,0,0,United_Arab_Emirates,AE,ARE,9630959,Asia,6,664,12
2020-04-03T00:00:00Z,3,4,2020,360,2,United_Arab_Emirates,AE,ARE,9630959,Asia,8,1024,13
2020-04-04T00:00:00Z,4,4,2020,0,0,United_Arab_Emirates,AE,ARE,9630959,Asia,8,1024,14
2020-04-05T00:00:00Z,5,4,2020,481,2,United_Arab_Emirates,AE,ARE,9630959,Asia,10,1505,15
2020-04-06T00:00:00Z,6,4,2020,294,0,United_Arab_Emirates,AE,ARE,9630959,Asia,10,1799,16
2020-04-07T00:00:00Z,7,4,2020,277,1,United_Arab_Emirates,AE,ARE,9630959,Asia,11,2076,17
2020-04-08T00:00:00Z,8,4,2020,283,1,United_Arab_Emirates,AE,ARE,9630959,Asia,12,2359,18
2020-04-09T00:00:00Z,9,4,2020,300,0,United_Arab_Emirates,AE,ARE,9630959,Asia,12,2659,19
2020-04-10T00:00:00Z,10,4,2020,331,2,United_Arab_Emirates,AE,ARE,9630959,Asia,14,2990,20
2020-04-11T00:00:00Z,11,4,2020,370,2,United_Arab_Emirates,AE,ARE,9630959,Asia,16,3360,21
2020-04-12T00:00:00Z,12,4,2020,376,4,United_Arab_Emirates,AE,ARE,9630959,Asia,20,3736,22
2020-04-13T00:00:00Z,13,4,2020,387,2,United_Arab_Emirates,AE,ARE,9630959,Asia,22,4123,23
2020-04-14T00:00:00Z,14,4,2020,398,3,United_Arab_Emirates,AE,ARE,9630959,Asia,25,4521,24
2020-04-15T00:00:00Z,15,4,2020,412,3,United_Arab_Emirates,AE,ARE,9630959,Asia,28,4933,25
2020-04-16T00:00:00Z,16,4,2020,432,5,United_Arab_Emirates,AE,ARE,9630959,Asia,33,5365,26
2020-04-17T00:00:00Z,17,4,2020,460,0,United_Arab_Emirates,AE,ARE,9630959,Asia,33,5825,27
2020-04-18T00:00:00Z,18,4,2020,0,2,United_Arab_Emirates,AE,ARE,9630959,Asia,35,5825,28
2020-04-19T00:00:00Z,19,4,2020,477,2,United_Arab_Emirates,AE,ARE,9630959,Asia,37,6302,29
2020-04-20T00:00:00Z,20,4,2020,479,4,United_Arab_Emirates,AE,ARE,9630959,Asia,41,6781,30
2020-04-21T00:00:00Z,21,4,2020,484,2,United_Arab_Emirates,AE,ARE,9630959,Asia,43,7265,31
2020-04-22T00:00:00Z,22,4,2020,490,3,United_Arab_Emirates,AE,ARE,9630959,Asia,46,7755,32
2020-04-23T00:00:00Z,23,4,2020,483,6,United_Arab_Emirates,AE,ARE,9630959,Asia,52,8238,33
2020-04-24T00:00:00Z,24,4,2020,518,4,United_Arab_Emirates,AE,ARE,9630959,Asia,56,8756,34
2020-04-25T00:00:00Z,25,4,2020,525,8,United_Arab_Emirates,AE,ARE,9630959,Asia,64,9281,35
2020-04-26T00:00:00Z,26,4,2020,532,0,United_Arab_Emirates,AE,ARE,9630959,Asia,64,9813,36
2020-04-27T00:00:00Z,27,4,2020,536,12,United_Arab_Emirates,AE,ARE,9630959,Asia,76,10349,37
2020-04-28T00:00:00Z,28,4,2020,490,6,United_Arab_Emirates,AE,ARE,9630959,Asia,82,10839,38
2020-04-29T00:00:00Z,29,4,2020,541,7,United_Arab_Emirates,AE,ARE,9630959,Asia,89,11380,39
2020-04-30T00:00:00Z,30,4,2020,549,9,United_Arab_Emirates,AE,ARE,9630959,Asia,98,11929,40
2020-05-01T00:00:00Z,1,5,2020,552,7,United_Arab_Emirates,AE,ARE,9630959,Asia,105,12481,41
2020-05-02T00:00:00Z,2,5,2020,557,6,United_Arab_Emirates,AE,ARE,9630959,Asia,111,13038,42
2020-05-03T00:00:00Z,3,5,2020,561,8,United_Arab_Emirates,AE,ARE,9630959,Asia,119,13599,43
2020-05-04T00:00:00Z,4,5,2020,564,7,United_Arab_Emirates,AE,ARE,9630959,Asia,126,14163,44
2020-05-05T00:00:00Z,5,5,2020,567,11,United_Arab_Emirates,AE,ARE,9630959,Asia,137,14730,45
2020-05-06T00:00:00Z,6,5,2020,462,9,United_Arab_Emirates,AE,ARE,9630959,Asia,146,15192,46
2020-05-07T00:00:00Z,7,5,2020,546,11,United_Arab_Emirates,AE,ARE,9630959,Asia,157,15738,47
2020-05-08T00:00:00Z,8,5,2020,502,8,United_Arab_Emirates,AE,ARE,9630959,Asia,165,16240,48
2020-05-09T00:00:00Z,9,5,2020,553,9,United_Arab_Emirates,AE,ARE,9630959,Asia,174,16793,49
2020-05-10T00:00:00Z,10,5,2020,624,11,United_Arab_Emirates,AE,ARE,9630959,Asia,185,17417,50
2020-05-11T00:00:00Z,11,5,2020,781,13,United_Arab_Emirates,AE,ARE,9630959,Asia,198,18198,51
2020-05-12T00:00:00Z,12,5,2020,680,3,United_Arab_Emirates,AE,ARE,9630959,Asia,201,18878,52
2020-05-13T00:00:00Z,13,5,2020,783,2,United_Arab_Emirates,AE,ARE,9630959,Asia,203,19661,53
2020-05-14T00:00:00Z,14,5,2020,725,3,United_Arab_Emirates,AE,ARE,9630959,Asia,206,20386,54
2020-05-15T00:00:00Z,15,5,2020,698,2,United_Arab_Emirates,AE,ARE,9630959,Asia,208,21084,55
2020-05-16T00:00:00Z,16,5,2020,747,2,United_Arab_Emirates,AE,ARE,9630959,Asia,210,21831,56
2020-05-17T00:00:00Z,17,5,2020,796,4,United_Arab_Emirates,AE,ARE,9630959,Asia,214,22627,57
2020-05-18T00:00:00Z,18,5,2020,731,6,United_Arab_Emirates,AE,ARE,9630959,Asia,220,23358,58
2020-05-19T00:00:00Z,19,5,2020,832,4,United_Arab_Emirates,AE,ARE,9630959,Asia,224,24190,59
2020-05-20T00:00:00Z,20,5,2020,873,3,United_Arab_Emirates,AE,ARE,9630959,Asia,227,25063,60
2020-05-21T00:00:00Z,21,5,2020,941,6,United_Arab_Emirates,AE,ARE,9630959,Asia,233,26004,61
2020-05-22T00:00:00Z,22,5,2020,894,4,United_Arab_Emirates,AE,ARE,9630959,Asia,237,26898,62
2020-05-23T00:00:00Z,23,5,2020,994,4,United_Arab_Emirates,AE,ARE,9630959,Asia,241,27892,63
2020-05-24T00:00:00Z,24,5,2020,812,3,United_Arab_Emirates,AE,ARE,9630959,Asia,244,28704,64
2020-05-25T00:00:00Z,25,5,2020,781,1,United_Arab_Emirates,AE,ARE,9630959,Asia,245,29485,65
2020-05-26T00:00:00Z,26,5,2020,822,3,United_Arab_Emirates,AE,ARE,9630959,Asia,248,30307,66
2020-05-27T00:00:00Z,27,5,2020,779,5,United_Arab_Emirates,AE,ARE,9630959,Asia,253,31086,67
2020-03-07T00:00:00Z,7,3,2020,48,1,United_Kingdom,UK,GBR,66488991,Europe,1,163,1
2020-03-08T00:00:00Z,8,3,2020,43,1,United_Kingdom,UK,GBR,66488991,Europe,2,206,2
2020-03-09T00:00:00Z,9,3,2020,67,0,United_Kingdom,UK,GBR,66488991,Europe,2,273,3
2020-03-10T00:00:00Z,10,3,2020,48,1,United_Kingdom,UK,GBR,66488991,Europe,3,321,4
2020-03-11T00:00:00Z,11,3,2020,52,4,United_Kingdom,UK,GBR,66488991,Europe,7,373,5
2020-03-12T00:00:00Z,12,3,2020,83,0,United_Kingdom,UK,GBR,66488991,Europe,7,456,6
2020-03-13T00:00:00Z,13,3,2020,134,2,United_Kingdom,UK,GBR,66488991,Europe,9,590,7
2020-03-14T00:00:00Z,14,3,2020,117,1,United_Kingdom,UK,GBR,66488991,Europe,10,707,8
2020-03-15T00:00:00Z,15,3,2020,433,18,United_Kingdom,UK,GBR,66488991,Europe,28,1140,9
2020-03-16T00:00:00Z,16,3,2020,251,15,United_Kingdom,UK,GBR,66488991,Europe,43,1391,10
2020-03-17T00:00:00Z,17,3,2020,152,22,United_Kingdom,UK,GBR,66488991,Europe,65,1543,11
2020-03-18T00:00:00Z,18,3,2020,407,16,United_Kingdom,UK,GBR,66488991,Europe,81,1950,12
2020-03-19T00:00:00Z,19,3,2020,680,34,United_Kingdom,UK,GBR,66488991,Europe,115,2630,13
2020-03-20T00:00:00Z,20,3,2020,647,43,United_Kingdom,UK,GBR,66488991,Europe,158,3277,14
2020-03-21T00:00:00Z,21,3,2020,706,36,United_Kingdom,UK,GBR,66488991,Europe,194,3983,15
2020-03-22T00:00:00Z,22,3,2020,1035,56,United_Kingdom,UK,GBR,66488991,Europe,250,5018,16
2020-03-23T00:00:00Z,23,3,2020,665,35,United_Kingdom,UK,GBR,66488991,Europe,285,5683,17
2020-03-24T00:00:00Z,24,3,2020,967,74,United_Kingdom,UK,GBR,66488991,Europe,359,6650,18
2020-03-25T00:00:00Z,25,3,2020,1427,149,United_Kingdom,UK,GBR,66488991,Europe,508,8077,19
2020-03-26T00:00:00Z,26,3,2020,1452,186,United_Kingdom,UK,GBR,66488991,Europe,694,9529,20
2020-03-27T00:00:00Z,27,3,2020,2129,183,United_Kingdom,UK,GBR,66488991,Europe,877,11658,21
2020-03-28T00:00:00Z,28,3,2020,2885,284,United_Kingdom,UK,GBR,66488991,Europe,1161,14543,22
2020-03-29T00:00:00Z,29,3,2020,2546,294,United_Kingdom,UK,GBR,66488991,Europe,1455,17089,23
2020-03-30T00:00:00Z,30,3,2020,2433,214,United_Kingdom,UK,GBR,66488991,Europe,1669,19522,24
2020-03-31T00:00:00Z,31,3,2020,2619,374,United_Kingdom,UK,GBR,66488991,Europe,2043,22141,25
2020-04-01T00:00:00Z,1,4,2020,3009,382,United_Kingdom,UK,GBR,66488991,Europe,2425,25150,26
2020-04-02T00:00:00Z,2,4,2020,4324,670,United_Kingdom,UK,GBR,66488991,Europe,3095,29474,27
2020-04-03T00:00:00Z,3,4,2020,4244,652,United_Kingdom,UK,GBR,66488991,Europe,3747,33718,28
2020-04-04T00:00:00Z,4,4,2020,4450,714,United_Kingdom,UK,GBR,66488991,Europe,4461,38168,29
2020-04-05T00:00:00Z,5,4,2020,3735,760,United_Kingdom,UK,GBR,66488991,Europe,5221,41903,30
2020-04-06T00:00:00Z,6,4,2020,5903,644,United_Kingdom,UK,GBR,66488991,Europe,5865,47806,31
2020-04-07T00:00:00Z,7,4,2020,3802,568,United_Kingdom,UK,GBR,66488991,Europe,6433,51608,32
2020-04-08T00:00:00Z,8,4,2020,3634,1038,United_Kingdom,UK,GBR,66488991,Europe,7471,55242,33
2020-04-09T00:00:00Z,9,4,2020,5491,1034,United_Kingdom,UK,GBR,66488991,Europe,8505,60733,34
2020-04-10T00:00:00Z,10,4,2020,4344,1103,United_Kingdom,UK,GBR,66488991,Europe,9608,65077,35
2020-04-11T00:00:00Z,11,4,2020,5195,1152,United_Kingdom,UK,GBR,66488991,Europe,10760,70272,36
2020-04-12T00:00:00Z,12,4,2020,8719,839,United_Kingdom,UK,GBR,66488991,Europe,11599,78991,37
2020-04-13T00:00:00Z,13,4,2020,5288,686,United_Kingdom,UK,GBR,66488991,Europe,12285,84279,38
2020-04-14T00:00:00Z,14,4,2020,4342,744,United_Kingdom,UK,GBR,66488991,Europe,13029,88621,39
2020-04-15T00:00:00Z,15,4,2020,5252,1044,United_Kingdom,UK,GBR,66488991,Europe,14073,93873,40
2020-04-16T00:00:00Z,16,4,2020,4603,842,United_Kingdom,UK,GBR,66488991,Europe,14915,98476,41
2020-04-17T00:00:00Z,17,4,2020,4617,1029,United_Kingdom,UK,GBR,66488991,Europe,15944,103093,42
2020-04-18T00:00:00Z,18,4,2020,5599,935,United_Kingdom,UK,GBR,66488991,Europe,16879,108692,43
2020-04-19T00:00:00Z,19,4,2020,5525,1115,United_Kingdom,UK,GBR,66488991,Europe,17994,114217,44
2020-04-20T00:00:00Z,20,4,2020,5850,498,United_Kingdom,UK,GBR,66488991,Europe,18492,120067,45
2020-04-21T00:00:00Z,21,4,2020,4676,559,United_Kingdom,UK,GBR,66488991,Europe,19051,124743,46
2020-04-22T00:00:00Z,22,4,2020,4301,1172,United_Kingdom,UK,GBR,66488991,Europe,20223,129044,47
2020-04-23T00:00:00Z,23,4,2020,4451,837,United_Kingdom,UK,GBR,66488991,Europe,21060,133495,48
2020-04-24T00:00:00Z,24,4,2020,4583,727,United_Kingdom,UK,GBR,66488991,Europe,21787,138078,49
2020-04-25T00:00:00Z,25,4,2020,5386,1005,United_Kingdom,UK,GBR,66488991,Europe,22792,143464,50
2020-04-26T00:00:00Z,26,4,2020,4913,843,United_Kingdom,UK,GBR,66488991,Europe,23635,148377,51
2020-04-27T00:00:00Z,27,4,2020,4463,420,United_Kingdom,UK,GBR,66488991,Europe,24055,152840,52
2020-04-28T00:00:00Z,28,4,2020,4309,338,United_Kingdom,UK,GBR,66488991,Europe,24393,157149,53
2020-04-29T00:00:00Z,29,4,2020,3996,909,United_Kingdom,UK,GBR,66488991,Europe,25302,161145,54
2020-04-30T00:00:00Z,30,4,2020,4076,795,United_Kingdom,UK,GBR,66488991,Europe,26097,165221,55
2020-05-01T00:00:00Z,1,5,2020,6032,674,United_Kingdom,UK,GBR,66488991,Europe,26771,171253,56
2020-05-02T00:00:00Z,2,5,2020,6201,739,United_Kingdom,UK,GBR,66488991,Europe,27510,177454,57
2020-05-03T00:00:00Z,3,5,2020,4806,621,United_Kingdom,UK,GBR,66488991,Europe,28131,182260,58
2020-05-04T00:00:00Z,4,5,2020,4339,315,United_Kingdom,UK,GBR,66488991,Europe,28446,186599,59
2020-05-05T00:00:00Z,5,5,2020,3985,288,United_Kingdom,UK,GBR,66488991,Europe,28734,190584,60
2020-05-06T00:00:00Z,6,5,2020,4406,693,United_Kingdom,UK,GBR,66488991,Europe,29427,194990,61
2020-05-07T00:00:00Z,7,5,2020,6211,649,United_Kingdom,UK,GBR,66488991,Europe,30076,201201,62
2020-05-08T00:00:00Z,8,5,2020,5514,539,United_Kingdom,UK,GBR,66488991,Europe,30615,206715,63
2020-05-09T00:00:00Z,9,5,2020,4649,626,United_Kingdom,UK,GBR,66488991,Europe,31241,211364,64
2020-05-10T00:00:00Z,10,5,2020,3896,346,United_Kingdom,UK,GBR,66488991,Europe,31587,215260,65
2020-05-11T00:00:00Z,11,5,2020,3923,268,United_Kingdom,UK,GBR,66488991,Europe,31855,219183,66
2020-05-12T00:00:00Z,12,5,2020,3877,210,United_Kingdom,UK,GBR,66488991,Europe,32065,223060,67
2020-05-13T00:00:00Z,13,5,2020,3403,627,United_Kingdom,UK,GBR,66488991,Europe,32692,226463,68
2020-05-14T00:00:00Z,14,5,2020,3242,494,United_Kingdom,UK,GBR,66488991,Europe,33186,229705,69
2020-05-15T00:00:00Z,15,5,2020,3446,428,United_Kingdom,UK,GBR,66488991,Europe,33614,233151,70
2020-05-16T00:00:00Z,16,5,2020,3560,384,United_Kingdom,UK,GBR,66488991,Europe,33998,236711,71
2020-05-17T00:00:00Z,17,5,2020,3450,468,United_Kingdom,UK,GBR,66488991,Europe,34466,240161,72
2020-05-18T00:00:00Z,18,5,2020,3534,170,United_Kingdom,UK,GBR,66488991,Europe,34636,243695,73
2020-05-19T00:00:00Z,19,5,2020,2711,160,United_Kingdom,UK,GBR,66488991,Europe,34796,246406,74
2020-05-20T00:00:00Z,20,5,2020,2412,545,United_Kingdom,UK,GBR,66488991,Europe,35341,248818,75
2020-05-21T00:00:00Z,21,5,2020,-525,363,United_Kingdom,UK,GBR,66488991,Europe,35704,248293,76
2020-05-22T00:00:00Z,22,5,2020,2615,338,United_Kingdom,UK,GBR,66488991,Europe,36042,250908,77
2020-05-23T00:00:00Z,23,5,2020,3287,351,United_Kingdom,UK,GBR,66488991,Europe,36393,254195,78
2020-05-24T00:00:00Z,24,5,2020,2959,282,United_Kingdom,UK,GBR,66488991,Europe,36675,257154,79
2020-05-25T00:00:00Z,25,5,2020,2405,118,United_Kingdom,UK,GBR,66488991,Europe,36793,259559,80
2020-05-26T00:00:00Z,26,5,2020,1625,121,United_Kingdom,UK,GBR,66488991,Europe,36914,261184,81
2020-05-27T00:00:00Z,27,5,2020,4043,134,United_Kingdom,UK,GBR,66488991,Europe,37048,265227,82
2020-03-29T00:00:00Z,29,3,2020,0,1,United_Republic_of_Tanzania,TZ,TZA,56318348,Africa,1,13,1
2020-03-30T00:00:00Z,30,3,2020,1,0,United_Republic_of_Tanzania,TZ,TZA,56318348,Africa,1,14,2
2020-03-31T00:00:00Z,31,3,2020,5,0,United_Republic_of_Tanzania,TZ,TZA,56318348,Africa,1,19,3
2020-04-01T00:00:00Z,1,4,2020,0,0,United_Republic_of_Tanzania,TZ,TZA,56318348,Africa,1,19,4
2020-04-02T00:00:00Z,2,4,2020,1,0,United_Republic_of_Tanzania,TZ,TZA,56318348,Africa,1,20,5
2020-04-03T00:00:00Z,3,4,2020,1,0,United_Republic_of_Tanzania,TZ,TZA,56318348,Africa,1,21,6
2020-04-04T00:00:00Z,4,4,2020,0,0,United_Republic_of_Tanzania,TZ,TZA,56318348,Africa,1,21,7
2020-04-05T00:00:00Z,5,4,2020,0,0,United_Republic_of_Tanzania,TZ,TZA,56318348,Africa,1,21,8
2020-04-06T00:00:00Z,6,4,2020,1,0,United_Republic_of_Tanzania,TZ,TZA,56318348,Africa,1,22,9
2020-04-07T00:00:00Z,7,4,2020,2,0,United_Republic_of_Tanzania,TZ,TZA,56318348,Africa,1,24,10
2020-04-08T00:00:00Z,8,4,2020,0,0,United_Republic_of_Tanzania,TZ,TZA,56318348,Africa,1,24,11
2020-04-09T00:00:00Z,9,4,2020,1,0,United_Republic_of_Tanzania,TZ,TZA,56318348,Africa,1,25,12
2020-04-10T00:00:00Z,10,4,2020,0,0,United_Republic_of_Tanzania,TZ,TZA,56318348,Africa,1,25,13
2020-04-11T00:00:00Z,11,4,2020,7,2,United_Republic_of_Tanzania,TZ,TZA,56318348,Africa,3,32,14
2020-04-12T00:00:00Z,12,4,2020,0,0,United_Republic_of_Tanzania,TZ,TZA,56318348,Africa,3,32,15
2020-04-13T00:00:00Z,13,4,2020,0,0,United_Republic_of_Tanzania,TZ,TZA,56318348,Africa,3,32,16
2020-04-14T00:00:00Z,14,4,2020,14,0,United_Republic_of_Tanzania,TZ,TZA,56318348,Africa,3,46,17
2020-04-15T00:00:00Z,15,4,2020,7,0,United_Republic_of_Tanzania,TZ,TZA,56318348,Africa,3,53,18
2020-04-16T00:00:00Z,16,4,2020,35,1,United_Republic_of_Tanzania,TZ,TZA,56318348,Africa,4,88,19
2020-04-17T00:00:00Z,17,4,2020,6,0,United_Republic_of_Tanzania,TZ,TZA,56318348,Africa,4,94,20
2020-04-18T00:00:00Z,18,4,2020,53,1,United_Republic_of_Tanzania,TZ,TZA,56318348,Africa,5,147,21
2020-04-19T00:00:00Z,19,4,2020,1,0,United_Republic_of_Tanzania,TZ,TZA,56318348,Africa,5,148,22
2020-04-20T00:00:00Z,20,4,2020,22,0,United_Republic_of_Tanzania,TZ,TZA,56318348,Africa,5,170,23
2020-04-21T00:00:00Z,21,4,2020,0,0,United_Republic_of_Tanzania,TZ,TZA,56318348,Africa,5,170,24
2020-04-22T00:00:00Z,22,4,2020,84,3,United_Republic_of_Tanzania,TZ,TZA,56318348,Africa,8,254,25
2020-04-23T00:00:00Z,23,4,2020,31,2,United_Republic_of_Tanzania,TZ,TZA,56318348,Africa,10,285,26
2020-04-24T00:00:00Z,24,4,2020,0,0,United_Republic_of_Tanzania,TZ,TZA,56318348,Africa,10,285,27
2020-04-25T00:00:00Z,25,4,2020,15,0,United_Republic_of_Tanzania,TZ,TZA,56318348,Africa,10,300,28
2020-04-26T00:00:00Z,26,4,2020,0,0,United_Republic_of_Tanzania,TZ,TZA,56318348,Africa,10,300,29
2020-04-27T00:00:00Z,27,4,2020,0,0,United_Republic_of_Tanzania,TZ,TZA,56318348,Africa,10,300,30
2020-04-28T00:00:00Z,28,4,2020,0,0,United_Republic_of_Tanzania,TZ,TZA,56318348,Africa,10,300,31
2020-04-29T00:00:00Z,29,4,2020,6,0,United_Republic_of_Tanzania,TZ,TZA,56318348,Africa,10,306,32
2020-04-30T00:00:00Z,30,4,2020,174,6,United_Republic_of_Tanzania,TZ,TZA,56318348,Africa,16,480,33
2020-05-01T00:00:00Z,1,5,2020,0,0,United_Republic_of_Tanzania,TZ,TZA,56318348,Africa,16,480,34
2020-05-02T00:00:00Z,2,5,2020,0,0,United_Republic_of_Tanzania,TZ,TZA,56318348,Africa,16,480,35
2020-05-03T00:00:00Z,3,5,2020,0,0,United_Republic_of_Tanzania,TZ,TZA,56318348,Africa,16,480,36
2020-05-04T00:00:00Z,4,5,2020,0,0,United_Republic_of_Tanzania,TZ,TZA,56318348,Africa,16,480,37
2020-05-05T00:00:00Z,5,5,2020,0,2,United_Republic_of_Tanzania,TZ,TZA,56318348,Africa,18,480,38
2020-05-06T00:00:00Z,6,5,2020,0,0,United_Republic_of_Tanzania,TZ,TZA,56318348,Africa,18,480,39
2020-05-07T00:00:00Z,7,5,2020,0,0,United_Republic_of_Tanzania,TZ,TZA,56318348,Africa,18,480,40
2020-05-08T00:00:00Z,8,5,2020,29,3,United_Republic_of_Tanzania,TZ,TZA,56318348,Africa,21,509,41
2020-05-09T00:00:00Z,9,5,2020,0,0,United_Republic_of_Tanzania,TZ,TZA,56318348,Africa,21,509,42
2020-05-10T00:00:00Z,10,5,2020,0,0,United_Republic_of_Tanzania,TZ,TZA,56318348,Africa,21,509,43
2020-05-11T00:00:00Z,11,5,2020,0,0,United_Republic_of_Tanzania,TZ,TZA,56318348,Africa,21,509,44
2020-05-12T00:00:00Z,12,5,2020,0,0,United_Republic_of_Tanzania,TZ,TZA,56318348,Africa,21,509,45
2020-05-13T00:00:00Z,13,5,2020,0,0,United_Republic_of_Tanzania,TZ,TZA,56318348,Africa,21,509,46
2020-05-14T00:00:00Z,14,5,2020,0,0,United_Republic_of_Tanzania,TZ,TZA,56318348,Africa,21,509,47
2020-05-15T00:00:00Z,15,5,2020,0,0,United_Republic_of_Tanzania,TZ,TZA,56318348,Africa,21,509,48
2020-05-16T00:00:00Z,16,5,2020,0,0,United_Republic_of_Tanzania,TZ,TZA,56318348,Africa,21,509,49
2020-05-17T00:00:00Z,17,5,2020,0,0,United_Republic_of_Tanzania,TZ,TZA,56318348,Africa,21,509,50
2020-05-18T00:00:00Z,18,5,2020,0,0,United_Republic_of_Tanzania,TZ,TZA,56318348,Africa,21,509,51
2020-05-19T00:00:00Z,19,5,2020,0,0,United_Republic_of_Tanzania,TZ,TZA,56318348,Africa,21,509,52
2020-05-20T00:00:00Z,20,5,2020,0,0,United_Republic_of_Tanzania,TZ,TZA,56318348,Africa,21,509,53
2020-05-21T00:00:00Z,21,5,2020,0,0,United_Republic_of_Tanzania,TZ,TZA,56318348,Africa,21,509,54
2020-05-22T00:00:00Z,22,5,2020,0,0,United_Republic_of_Tanzania,TZ,TZA,56318348,Africa,21,509,55
2020-05-23T00:00:00Z,23,5,2020,0,0,United_Republic_of_Tanzania,TZ,TZA,56318348,Africa,21,509,56
2020-05-24T00:00:00Z,24,5,2020,0,0,United_Republic_of_Tanzania,TZ,TZA,56318348,Africa,21,509,57
2020-05-25T00:00:00Z,25,5,2020,0,0,United_Republic_of_Tanzania,TZ,TZA,56318348,Africa,21,509,58
2020-05-26T00:00:00Z,26,5,2020,0,0,United_Republic_of_Tanzania,TZ,TZA,56318348,Africa,21,509,59
2020-05-27T00:00:00Z,27,5,2020,0,0,United_Republic_of_Tanzania,TZ,TZA,56318348,Africa,21,509,60
2020-03-01T00:00:00Z,1,3,2020,3,1,United_States_of_America,US,USA,327167434,America,1,69,1
2020-03-02T00:00:00Z,2,3,2020,20,1,United_States_of_America,US,USA,327167434,America,2,89,2
2020-03-03T00:00:00Z,3,3,2020,14,4,United_States_of_America,US,USA,327167434,America,6,103,3
2020-03-04T00:00:00Z,4,3,2020,22,3,United_States_of_America,US,USA,327167434,America,9,125,4
2020-03-05T00:00:00Z,5,3,2020,34,2,United_States_of_America,US,USA,327167434,America,11,159,5
2020-03-06T00:00:00Z,6,3,2020,74,1,United_States_of_America,US,USA,327167434,America,12,233,6
2020-03-07T00:00:00Z,7,3,2020,105,2,United_States_of_America,US,USA,327167434,America,14,338,7
2020-03-08T00:00:00Z,8,3,2020,95,3,United_States_of_America,US,USA,327167434,America,17,433,8
2020-03-09T00:00:00Z,9,3,2020,121,4,United_States_of_America,US,USA,327167434,America,21,554,9
2020-03-10T00:00:00Z,10,3,2020,200,5,United_States_of_America,US,USA,327167434,America,26,754,10
2020-03-11T00:00:00Z,11,3,2020,271,2,United_States_of_America,US,USA,327167434,America,28,1025,11
2020-03-12T00:00:00Z,12,3,2020,287,2,United_States_of_America,US,USA,327167434,America,30,1312,12
2020-03-13T00:00:00Z,13,3,2020,351,10,United_States_of_America,US,USA,327167434,America,40,1663,13
2020-03-14T00:00:00Z,14,3,2020,511,7,United_States_of_America,US,USA,327167434,America,47,2174,14
2020-03-15T00:00:00Z,15,3,2020,777,10,United_States_of_America,US,USA,327167434,America,57,2951,15
2020-03-16T00:00:00Z,16,3,2020,823,12,United_States_of_America,US,USA,327167434,America,69,3774,16
2020-03-17T00:00:00Z,17,3,2020,887,16,United_States_of_America,US,USA,327167434,America,85,4661,17
2020-03-18T00:00:00Z,18,3,2020,1766,23,United_States_of_America,US,USA,327167434,America,108,6427,18
2020-03-19T00:00:00Z,19,3,2020,2988,42,United_States_of_America,US,USA,327167434,America,150,9415,19
2020-03-20T00:00:00Z,20,3,2020,4835,0,United_States_of_America,US,USA,327167434,America,150,14250,20
2020-03-21T00:00:00Z,21,3,2020,5374,110,United_States_of_America,US,USA,327167434,America,260,19624,21
2020-03-22T00:00:00Z,22,3,2020,7123,80,United_States_of_America,US,USA,327167434,America,340,26747,22
2020-03-23T00:00:00Z,23,3,2020,8459,131,United_States_of_America,US,USA,327167434,America,471,35206,23
2020-03-24T00:00:00Z,24,3,2020,11236,119,United_States_of_America,US,USA,327167434,America,590,46442,24
2020-03-25T00:00:00Z,25,3,2020,8789,211,United_States_of_America,US,USA,327167434,America,801,55231,25
2020-03-26T00:00:00Z,26,3,2020,13963,249,United_States_of_America,US,USA,327167434,America,1050,69194,26
2020-03-27T00:00:00Z,27,3,2020,16797,246,United_States_of_America,US,USA,327167434,America,1296,85991,27
2020-03-28T00:00:00Z,28,3,2020,18695,411,United_States_of_America,US,USA,327167434,America,1707,104686,28
2020-03-29T00:00:00Z,29,3,2020,19979,484,United_States_of_America,US,USA,327167434,America,2191,124665,29
2020-03-30T00:00:00Z,30,3,2020,18360,318,United_States_of_America,US,USA,327167434,America,2509,143025,30
2020-03-31T00:00:00Z,31,3,2020,21595,661,United_States_of_America,US,USA,327167434,America,3170,164620,31
2020-04-01T00:00:00Z,1,4,2020,24998,909,United_States_of_America,US,USA,327167434,America,4079,189618,32
2020-04-02T00:00:00Z,2,4,2020,27103,1059,United_States_of_America,US,USA,327167434,America,5138,216721,33
2020-04-03T00:00:00Z,3,4,2020,28819,915,United_States_of_America,US,USA,327167434,America,6053,245540,34
2020-04-04T00:00:00Z,4,4,2020,32425,1104,United_States_of_America,US,USA,327167434,America,7157,277965,35
2020-04-05T00:00:00Z,5,4,2020,34272,1344,United_States_of_America,US,USA,327167434,America,8501,312237,36
2020-04-06T00:00:00Z,6,4,2020,25398,1146,United_States_of_America,US,USA,327167434,America,9647,337635,37
2020-04-07T00:00:00Z,7,4,2020,30561,1342,United_States_of_America,US,USA,327167434,America,10989,368196,38
2020-04-08T00:00:00Z,8,4,2020,30613,1906,United_States_of_America,US,USA,327167434,America,12895,398809,39
2020-04-09T00:00:00Z,9,4,2020,33323,1922,United_States_of_America,US,USA,327167434,America,14817,432132,40
2020-04-10T00:00:00Z,10,4,2020,33901,1873,United_States_of_America,US,USA,327167434,America,16690,466033,41
2020-04-11T00:00:00Z,11,4,2020,35527,2087,United_States_of_America,US,USA,327167434,America,18777,501560,42
2020-04-12T00:00:00Z,12,4,2020,28391,1831,United_States_of_America,US,USA,327167434,America,20608,529951,43
2020-04-13T00:00:00Z,13,4,2020,27620,1500,United_States_of_America,US,USA,327167434,America,22108,557571,44
2020-04-14T00:00:00Z,14,4,2020,25023,1541,United_States_of_America,US,USA,327167434,America,23649,582594,45
2020-04-15T00:00:00Z,15,4,2020,26922,2408,United_States_of_America,US,USA,327167434,America,26057,609516,46
2020-04-16T00:00:00Z,16,4,2020,30148,4928,United_States_of_America,US,USA,327167434,America,30985,639664,47
2020-04-17T00:00:00Z,17,4,2020,31667,2299,United_States_of_America,US,USA,327167434,America,33284,671331,48
2020-04-18T00:00:00Z,18,4,2020,30833,3770,United_States_of_America,US,USA,327167434,America,37054,702164,49
2020-04-19T00:00:00Z,19,4,2020,32922,1856,United_States_of_America,US,USA,327167434,America,38910,735086,50
2020-04-20T00:00:00Z,20,4,2020,24601,1772,United_States_of_America,US,USA,327167434,America,40682,759687,51
2020-04-21T00:00:00Z,21,4,2020,28065,1857,United_States_of_America,US,USA,327167434,America,42539,787752,52
2020-04-22T00:00:00Z,22,4,2020,37289,2524,United_States_of_America,US,USA,327167434,America,45063,825041,53
2020-04-23T00:00:00Z,23,4,2020,17588,1721,United_States_of_America,US,USA,327167434,America,46784,842629,54
2020-04-24T00:00:00Z,24,4,2020,26543,3179,United_States_of_America,US,USA,327167434,America,49963,869172,55
2020-04-25T00:00:00Z,25,4,2020,21352,1054,United_States_of_America,US,USA,327167434,America,51017,890524,56
2020-04-26T00:00:00Z,26,4,2020,48529,2172,United_States_of_America,US,USA,327167434,America,53189,939053,57
2020-04-27T00:00:00Z,27,4,2020,26857,1687,United_States_of_America,US,USA,327167434,America,54876,965910,58
2020-04-28T00:00:00Z,28,4,2020,22541,1369,United_States_of_America,US,USA,327167434,America,56245,988451,59
2020-04-29T00:00:00Z,29,4,2020,24132,2110,United_States_of_America,US,USA,327167434,America,58355,1012583,60
2020-04-30T00:00:00Z,30,4,2020,27326,2611,United_States_of_America,US,USA,327167434,America,60966,1039909,61
2020-05-01T00:00:00Z,1,5,2020,29917,2040,United_States_of_America,US,USA,327167434,America,63006,1069826,62
2020-05-02T00:00:00Z,2,5,2020,33955,2062,United_States_of_America,US,USA,327167434,America,65068,1103781,63
2020-05-03T00:00:00Z,3,5,2020,29288,1317,United_States_of_America,US,USA,327167434,America,66385,1133069,64
2020-05-04T00:00:00Z,4,5,2020,24972,1297,United_States_of_America,US,USA,327167434,America,67682,1158041,65
2020-05-05T00:00:00Z,5,5,2020,22593,1252,United_States_of_America,US,USA,327167434,America,68934,1180634,66
2020-05-06T00:00:00Z,6,5,2020,23841,2144,United_States_of_America,US,USA,327167434,America,71078,1204475,67
2020-05-07T00:00:00Z,7,5,2020,24128,2353,United_States_of_America,US,USA,327167434,America,73431,1228603,68
2020-05-08T00:00:00Z,8,5,2020,28369,2239,United_States_of_America,US,USA,327167434,America,75670,1256972,69
2020-05-09T00:00:00Z,9,5,2020,26957,1510,United_States_of_America,US,USA,327167434,America,77180,1283929,70
2020-05-10T00:00:00Z,10,5,2020,25612,1614,United_States_of_America,US,USA,327167434,America,78794,1309541,71
2020-05-11T00:00:00Z,11,5,2020,20258,734,United_States_of_America,US,USA,327167434,America,79528,1329799,72
2020-05-12T00:00:00Z,12,5,2020,18117,1156,United_States_of_America,US,USA,327167434,America,80684,1347916,73
2020-05-13T00:00:00Z,13,5,2020,22048,1703,United_States_of_America,US,USA,327167434,America,82387,1369964,74
2020-05-14T00:00:00Z,14,5,2020,20782,1746,United_States_of_America,US,USA,327167434,America,84133,1390746,75
2020-05-15T00:00:00Z,15,5,2020,27143,1773,United_States_of_America,US,USA,327167434,America,85906,1417889,76
2020-05-16T00:00:00Z,16,5,2020,25508,1662,United_States_of_America,US,USA,327167434,America,87568,1443397,77
2020-05-17T00:00:00Z,17,5,2020,24487,1186,United_States_of_America,US,USA,327167434,America,88754,1467884,78
2020-05-18T00:00:00Z,18,5,2020,18873,808,United_States_of_America,US,USA,327167434,America,89562,1486757,79
2020-05-19T00:00:00Z,19,5,2020,21841,791,United_States_of_America,US,USA,327167434,America,90353,1508598,80
2020-05-20T00:00:00Z,20,5,2020,19970,1568,United_States_of_America,US,USA,327167434,America,91921,1528568,81
2020-05-21T00:00:00Z,21,5,2020,23285,1518,United_States_of_America,US,USA,327167434,America,93439,1551853,82
2020-05-22T00:00:00Z,22,5,2020,25434,1263,United_States_of_America,US,USA,327167434,America,94702,1577287,83
2020-05-23T00:00:00Z,23,5,2020,24147,1305,United_States_of_America,US,USA,327167434,America,96007,1601434,84
2020-05-24T00:00:00Z,24,5,2020,21236,1080,United_States_of_America,US,USA,327167434,America,97087,1622670,85
2020-05-25T00:00:00Z,25,5,2020,20568,633,United_States_of_America,US,USA,327167434,America,97720,1643238,86
2020-05-26T00:00:00Z,26,5,2020,19064,500,United_States_of_America,US,USA,327167434,America,98220,1662302,87
2020-05-27T00:00:00Z,27,5,2020,18910,696,United_States_of_America,US,USA,327167434,America,98916,1681212,88
2020-04-06T00:00:00Z,6,4,2020,2,1,United_States_Virgin_Islands,VI,VIR,106977,America,1,42,1
2020-04-07T00:00:00Z,7,4,2020,0,0,United_States_Virgin_Islands,VI,VIR,106977,America,1,42,2
2020-04-08T00:00:00Z,8,4,2020,3,0,United_States_Virgin_Islands,VI,VIR,106977,America,1,45,3
2020-04-09T00:00:00Z,9,4,2020,0,0,United_States_Virgin_Islands,VI,VIR,106977,America,1,45,4
2020-04-10T00:00:00Z,10,4,2020,5,0,United_States_Virgin_Islands,VI,VIR,106977,America,1,50,5
2020-04-11T00:00:00Z,11,4,2020,0,0,United_States_Virgin_Islands,VI,VIR,106977,America,1,50,6
2020-04-12T00:00:00Z,12,4,2020,1,0,United_States_Virgin_Islands,VI,VIR,106977,America,1,51,7
2020-04-13T00:00:00Z,13,4,2020,0,0,United_States_Virgin_Islands,VI,VIR,106977,America,1,51,8
2020-04-14T00:00:00Z,14,4,2020,0,0,United_States_Virgin_Islands,VI,VIR,106977,America,1,51,9
2020-04-15T00:00:00Z,15,4,2020,0,0,United_States_Virgin_Islands,VI,VIR,106977,America,1,51,10
2020-04-16T00:00:00Z,16,4,2020,0,0,United_States_Virgin_Islands,VI,VIR,106977,America,1,51,11
2020-04-17T00:00:00Z,17,4,2020,0,0,United_States_Virgin_Islands,VI,VIR,106977,America,1,51,12
2020-04-18T00:00:00Z,18,4,2020,0,1,United_States_Virgin_Islands,VI,VIR,106977,America,2,51,13
2020-04-19T00:00:00Z,19,4,2020,2,1,United_States_Virgin_Islands,VI,VIR,106977,America,3,53,14
2020-04-20T00:00:00Z,20,4,2020,0,0,United_States_Virgin_Islands,VI,VIR,106977,America,3,53,15
2020-04-21T00:00:00Z,21,4,2020,1,0,United_States_Virgin_Islands,VI,VIR,106977,America,3,54,16
2020-04-22T00:00:00Z,22,4,2020,0,0,United_States_Virgin_Islands,VI,VIR,106977,America,3,54,17
2020-04-23T00:00:00Z,23,4,2020,0,0,United_States_Virgin_Islands,VI,VIR,106977,America,3,54,18
2020-04-24T00:00:00Z,24,4,2020,0,0,United_States_Virgin_Islands,VI,VIR,106977,America,3,54,19
2020-04-25T00:00:00Z,25,4,2020,0,0,United_States_Virgin_Islands,VI,VIR,106977,America,3,54,20
2020-04-26T00:00:00Z,26,4,2020,1,0,United_States_Virgin_Islands,VI,VIR,106977,America,3,55,21
2020-04-27T00:00:00Z,27,4,2020,0,0,United_States_Virgin_Islands,VI,VIR,106977,America,3,55,22
2020-04-28T00:00:00Z,28,4,2020,4,1,United_States_Virgin_Islands,VI,VIR,106977,America,4,59,23
2020-04-29T00:00:00Z,29,4,2020,0,0,United_States_Virgin_Islands,VI,VIR,106977,America,4,59,24
2020-04-30T00:00:00Z,30,4,2020,7,0,United_States_Virgin_Islands,VI,VIR,106977,America,4,66,25
2020-05-01T00:00:00Z,1,5,2020,0,0,United_States_Virgin_Islands,VI,VIR,106977,America,4,66,26
2020-05-02T00:00:00Z,2,5,2020,0,0,United_States_Virgin_Islands,VI,VIR,106977,America,4,66,27
2020-05-03T00:00:00Z,3,5,2020,0,0,United_States_Virgin_Islands,VI,VIR,106977,America,4,66,28
2020-05-04T00:00:00Z,4,5,2020,0,0,United_States_Virgin_Islands,VI,VIR,106977,America,4,66,29
2020-05-05T00:00:00Z,5,5,2020,0,0,United_States_Virgin_Islands,VI,VIR,106977,America,4,66,30
2020-05-06T00:00:00Z,6,5,2020,0,0,United_States_Virgin_Islands,VI,VIR,106977,America,4,66,31
2020-05-07T00:00:00Z,7,5,2020,0,0,United_States_Virgin_Islands,VI,VIR,106977,America,4,66,32
2020-05-08T00:00:00Z,8,5,2020,0,0,United_States_Virgin_Islands,VI,VIR,106977,America,4,66,33
2020-05-09T00:00:00Z,9,5,2020,2,0,United_States_Virgin_Islands,VI,VIR,106977,America,4,68,34
2020-05-10T00:00:00Z,10,5,2020,1,0,United_States_Virgin_Islands,VI,VIR,106977,America,4,69,35
2020-05-11T00:00:00Z,11,5,2020,0,0,United_States_Virgin_Islands,VI,VIR,106977,America,4,69,36
2020-05-12T00:00:00Z,12,5,2020,0,1,United_States_Virgin_Islands,VI,VIR,106977,America,5,69,37
2020-05-13T00:00:00Z,13,5,2020,0,0,United_States_Virgin_Islands,VI,VIR,106977,America,5,69,38
2020-05-14T00:00:00Z,14,5,2020,0,1,United_States_Virgin_Islands,VI,VIR,106977,America,6,69,39
2020-05-15T00:00:00Z,15,5,2020,0,0,United_States_Virgin_Islands,VI,VIR,106977,America,6,69,40
2020-05-16T00:00:00Z,16,5,2020,0,0,United_States_Virgin_Islands,VI,VIR,106977,America,6,69,41
2020-05-17T00:00:00Z,17,5,2020,0,0,United_States_Virgin_Islands,VI,VIR,106977,America,6,69,42
2020-05-18T00:00:00Z,18,5,2020,0,0,United_States_Virgin_Islands,VI,VIR,106977,America,6,69,43
2020-05-19T00:00:00Z,19,5,2020,0,0,United_States_Virgin_Islands,VI,VIR,106977,America,6,69,44
2020-05-20T00:00:00Z,20,5,2020,0,0,United_States_Virgin_Islands,VI,VIR,106977,America,6,69,45
2020-05-21T00:00:00Z,21,5,2020,0,0,United_States_Virgin_Islands,VI,VIR,106977,America,6,69,46
2020-05-22T00:00:00Z,22,5,2020,0,0,United_States_Virgin_Islands,VI,VIR,106977,America,6,69,47
2020-05-23T00:00:00Z,23,5,2020,0,0,United_States_Virgin_Islands,VI,VIR,106977,America,6,69,48
2020-05-24T00:00:00Z,24,5,2020,0,0,United_States_Virgin_Islands,VI,VIR,106977,America,6,69,49
2020-05-25T00:00:00Z,25,5,2020,0,0,United_States_Virgin_Islands,VI,VIR,106977,America,6,69,50
2020-05-26T00:00:00Z,26,5,2020,0,0,United_States_Virgin_Islands,VI,VIR,106977,America,6,69,51
2020-05-27T00:00:00Z,27,5,2020,0,0,United_States_Virgin_Islands,VI,VIR,106977,America,6,69,52
2020-03-30T00:00:00Z,30,3,2020,36,1,Uruguay,UY,URY,3449299,America,1,295,1
2020-03-31T00:00:00Z,31,3,2020,29,0,Uruguay,UY,URY,3449299,America,1,324,2
2020-04-01T00:00:00Z,1,4,2020,6,0,Uruguay,UY,URY,3449299,America,1,330,3
2020-04-02T00:00:00Z,2,4,2020,11,1,Uruguay,UY,URY,3449299,America,2,341,4
2020-04-03T00:00:00Z,3,4,2020,18,2,Uruguay,UY,URY,3449299,America,4,359,5
2020-04-04T00:00:00Z,4,4,2020,12,0,Uruguay,UY,URY,3449299,America,4,371,6
2020-04-05T00:00:00Z,5,4,2020,19,1,Uruguay,UY,URY,3449299,America,5,390,7
2020-04-06T00:00:00Z,6,4,2020,17,1,Uruguay,UY,URY,3449299,America,6,407,8
2020-04-07T00:00:00Z,7,4,2020,4,0,Uruguay,UY,URY,3449299,America,6,411,9
2020-04-08T00:00:00Z,8,4,2020,6,1,Uruguay,UY,URY,3449299,America,7,417,10
2020-04-09T00:00:00Z,9,4,2020,9,0,Uruguay,UY,URY,3449299,America,7,426,11
2020-04-10T00:00:00Z,10,4,2020,7,0,Uruguay,UY,URY,3449299,America,7,433,12
2020-04-11T00:00:00Z,11,4,2020,13,0,Uruguay,UY,URY,3449299,America,7,446,13
2020-04-12T00:00:00Z,12,4,2020,7,0,Uruguay,UY,URY,3449299,America,7,453,14
2020-04-13T00:00:00Z,13,4,2020,12,1,Uruguay,UY,URY,3449299,America,8,465,15
2020-04-14T00:00:00Z,14,4,2020,7,0,Uruguay,UY,URY,3449299,America,8,472,16
2020-04-15T00:00:00Z,15,4,2020,11,0,Uruguay,UY,URY,3449299,America,8,483,17
2020-04-16T00:00:00Z,16,4,2020,10,1,Uruguay,UY,URY,3449299,America,9,493,18
2020-04-17T00:00:00Z,17,4,2020,9,0,Uruguay,UY,URY,3449299,America,9,502,19
2020-04-18T00:00:00Z,18,4,2020,6,0,Uruguay,UY,URY,3449299,America,9,508,20
2020-04-19T00:00:00Z,19,4,2020,9,0,Uruguay,UY,URY,3449299,America,9,517,21
2020-04-20T00:00:00Z,20,4,2020,11,1,Uruguay,UY,URY,3449299,America,10,528,22
2020-04-21T00:00:00Z,21,4,2020,7,0,Uruguay,UY,URY,3449299,America,10,535,23
2020-04-22T00:00:00Z,22,4,2020,8,2,Uruguay,UY,URY,3449299,America,12,543,24
2020-04-23T00:00:00Z,23,4,2020,6,0,Uruguay,UY,URY,3449299,America,12,549,25
2020-04-24T00:00:00Z,24,4,2020,8,0,Uruguay,UY,URY,3449299,America,12,557,26
2020-04-25T00:00:00Z,25,4,2020,6,0,Uruguay,UY,URY,3449299,America,12,563,27
2020-04-26T00:00:00Z,26,4,2020,33,2,Uruguay,UY,URY,3449299,America,14,596,28
2020-04-27T00:00:00Z,27,4,2020,10,1,Uruguay,UY,URY,3449299,America,15,606,29
2020-04-28T00:00:00Z,28,4,2020,14,0,Uruguay,UY,URY,3449299,America,15,620,30
2020-04-29T00:00:00Z,29,4,2020,5,0,Uruguay,UY,URY,3449299,America,15,625,31
2020-04-30T00:00:00Z,30,4,2020,5,0,Uruguay,UY,URY,3449299,America,15,630,32
2020-05-01T00:00:00Z,1,5,2020,13,2,Uruguay,UY,URY,3449299,America,17,643,33
2020-05-02T00:00:00Z,2,5,2020,5,0,Uruguay,UY,URY,3449299,America,17,648,34
2020-05-03T00:00:00Z,3,5,2020,4,0,Uruguay,UY,URY,3449299,America,17,652,35
2020-05-04T00:00:00Z,4,5,2020,3,0,Uruguay,UY,URY,3449299,America,17,655,36
2020-05-05T00:00:00Z,5,5,2020,2,0,Uruguay,UY,URY,3449299,America,17,657,37
2020-05-06T00:00:00Z,6,5,2020,13,0,Uruguay,UY,URY,3449299,America,17,670,38
2020-05-07T00:00:00Z,7,5,2020,3,0,Uruguay,UY,URY,3449299,America,17,673,39
2020-05-08T00:00:00Z,8,5,2020,11,0,Uruguay,UY,URY,3449299,America,17,684,40
2020-05-09T00:00:00Z,9,5,2020,10,1,Uruguay,UY,URY,3449299,America,18,694,41
2020-05-10T00:00:00Z,10,5,2020,8,0,Uruguay,UY,URY,3449299,America,18,702,42
2020-05-11T00:00:00Z,11,5,2020,5,1,Uruguay,UY,URY,3449299,America,19,707,43
2020-05-12T00:00:00Z,12,5,2020,4,0,Uruguay,UY,URY,3449299,America,19,711,44
2020-05-13T00:00:00Z,13,5,2020,6,0,Uruguay,UY,URY,3449299,America,19,717,45
2020-05-14T00:00:00Z,14,5,2020,2,0,Uruguay,UY,URY,3449299,America,19,719,46
2020-05-15T00:00:00Z,15,5,2020,5,0,Uruguay,UY,URY,3449299,America,19,724,47
2020-05-16T00:00:00Z,16,5,2020,8,0,Uruguay,UY,URY,3449299,America,19,732,48
2020-05-17T00:00:00Z,17,5,2020,1,0,Uruguay,UY,URY,3449299,America,19,733,49
2020-05-18T00:00:00Z,18,5,2020,1,1,Uruguay,UY,URY,3449299,America,20,734,50
2020-05-19T00:00:00Z,19,5,2020,3,0,Uruguay,UY,URY,3449299,America,20,737,51
2020-05-20T00:00:00Z,20,5,2020,1,0,Uruguay,UY,URY,3449299,America,20,738,52
2020-05-21T00:00:00Z,21,5,2020,8,0,Uruguay,UY,URY,3449299,America,20,746,53
2020-05-22T00:00:00Z,22,5,2020,3,0,Uruguay,UY,URY,3449299,America,20,749,54
2020-05-23T00:00:00Z,23,5,2020,4,0,Uruguay,UY,URY,3449299,America,20,753,55
2020-05-24T00:00:00Z,24,5,2020,11,2,Uruguay,UY,URY,3449299,America,22,764,56
2020-05-25T00:00:00Z,25,5,2020,5,0,Uruguay,UY,URY,3449299,America,22,769,57
2020-05-26T00:00:00Z,26,5,2020,18,0,Uruguay,UY,URY,3449299,America,22,787,58
2020-05-27T00:00:00Z,27,5,2020,2,0,Uruguay,UY,URY,3449299,America,22,789,59
2020-03-29T00:00:00Z,29,3,2020,29,1,Uzbekistan,UZ,UZB,32955400,Asia,1,133,1
2020-03-30T00:00:00Z,30,3,2020,12,0,Uzbekistan,UZ,UZB,32955400,Asia,1,145,2
2020-03-31T00:00:00Z,31,3,2020,4,1,Uzbekistan,UZ,UZB,32955400,Asia,2,149,3
2020-04-01T00:00:00Z,1,4,2020,24,0,Uzbekistan,UZ,UZB,32955400,Asia,2,173,4
2020-04-02T00:00:00Z,2,4,2020,14,0,Uzbekistan,UZ,UZB,32955400,Asia,2,187,5
2020-04-03T00:00:00Z,3,4,2020,3,0,Uzbekistan,UZ,UZB,32955400,Asia,2,190,6
2020-04-04T00:00:00Z,4,4,2020,37,0,Uzbekistan,UZ,UZB,32955400,Asia,2,227,7
2020-04-05T00:00:00Z,5,4,2020,39,0,Uzbekistan,UZ,UZB,32955400,Asia,2,266,8
2020-04-06T00:00:00Z,6,4,2020,76,0,Uzbekistan,UZ,UZB,32955400,Asia,2,342,9
2020-04-07T00:00:00Z,7,4,2020,55,0,Uzbekistan,UZ,UZB,32955400,Asia,2,397,10
2020-04-08T00:00:00Z,8,4,2020,107,0,Uzbekistan,UZ,UZB,32955400,Asia,2,504,11
2020-04-09T00:00:00Z,9,4,2020,51,1,Uzbekistan,UZ,UZB,32955400,Asia,3,555,12
2020-04-10T00:00:00Z,10,4,2020,27,0,Uzbekistan,UZ,UZB,32955400,Asia,3,582,13
2020-04-11T00:00:00Z,11,4,2020,42,0,Uzbekistan,UZ,UZB,32955400,Asia,3,624,14
2020-04-12T00:00:00Z,12,4,2020,172,1,Uzbekistan,UZ,UZB,32955400,Asia,4,796,15
2020-04-13T00:00:00Z,13,4,2020,69,0,Uzbekistan,UZ,UZB,32955400,Asia,4,865,16
2020-04-14T00:00:00Z,14,4,2020,133,0,Uzbekistan,UZ,UZB,32955400,Asia,4,998,17
2020-04-15T00:00:00Z,15,4,2020,167,0,Uzbekistan,UZ,UZB,32955400,Asia,4,1165,18
2020-04-16T00:00:00Z,16,4,2020,137,0,Uzbekistan,UZ,UZB,32955400,Asia,4,1302,19
2020-04-17T00:00:00Z,17,4,2020,78,0,Uzbekistan,UZ,UZB,32955400,Asia,4,1380,20
2020-04-18T00:00:00Z,18,4,2020,70,0,Uzbekistan,UZ,UZB,32955400,Asia,4,1450,21
2020-04-19T00:00:00Z,19,4,2020,45,1,Uzbekistan,UZ,UZB,32955400,Asia,5,1495,22
2020-04-20T00:00:00Z,20,4,2020,70,0,Uzbekistan,UZ,UZB,32955400,Asia,5,1565,23
2020-04-21T00:00:00Z,21,4,2020,92,0,Uzbekistan,UZ,UZB,32955400,Asia,5,1657,24
2020-04-22T00:00:00Z,22,4,2020,35,1,Uzbekistan,UZ,UZB,32955400,Asia,6,1692,25
2020-04-23T00:00:00Z,23,4,2020,24,1,Uzbekistan,UZ,UZB,32955400,Asia,7,1716,26
2020-04-24T00:00:00Z,24,4,2020,62,0,Uzbekistan,UZ,UZB,32955400,Asia,7,1778,27
2020-04-25T00:00:00Z,25,4,2020,58,1,Uzbekistan,UZ,UZB,32955400,Asia,8,1836,28
2020-04-26T00:00:00Z,26,4,2020,29,0,Uzbekistan,UZ,UZB,32955400,Asia,8,1865,29
2020-04-27T00:00:00Z,27,4,2020,22,0,Uzbekistan,UZ,UZB,32955400,Asia,8,1887,30
2020-04-28T00:00:00Z,28,4,2020,17,0,Uzbekistan,UZ,UZB,32955400,Asia,8,1904,31
2020-04-29T00:00:00Z,29,4,2020,35,0,Uzbekistan,UZ,UZB,32955400,Asia,8,1939,32
2020-04-30T00:00:00Z,30,4,2020,63,1,Uzbekistan,UZ,UZB,32955400,Asia,9,2002,33
2020-05-01T00:00:00Z,1,5,2020,44,0,Uzbekistan,UZ,UZB,32955400,Asia,9,2046,34
2020-05-02T00:00:00Z,2,5,2020,48,0,Uzbekistan,UZ,UZB,32955400,Asia,9,2094,35
2020-05-03T00:00:00Z,3,5,2020,33,0,Uzbekistan,UZ,UZB,32955400,Asia,9,2127,36
2020-05-04T00:00:00Z,4,5,2020,22,1,Uzbekistan,UZ,UZB,32955400,Asia,10,2149,37
2020-05-05T00:00:00Z,5,5,2020,40,0,Uzbekistan,UZ,UZB,32955400,Asia,10,2189,38
2020-05-06T00:00:00Z,6,5,2020,18,0,Uzbekistan,UZ,UZB,32955400,Asia,10,2207,39
2020-05-07T00:00:00Z,7,5,2020,26,0,Uzbekistan,UZ,UZB,32955400,Asia,10,2233,40
2020-05-08T00:00:00Z,8,5,2020,65,0,Uzbekistan,UZ,UZB,32955400,Asia,10,2298,41
2020-05-09T00:00:00Z,9,5,2020,38,0,Uzbekistan,UZ,UZB,32955400,Asia,10,2336,42
2020-05-10T00:00:00Z,10,5,2020,51,0,Uzbekistan,UZ,UZB,32955400,Asia,10,2387,43
2020-05-11T00:00:00Z,11,5,2020,31,0,Uzbekistan,UZ,UZB,32955400,Asia,10,2418,44
2020-05-12T00:00:00Z,12,5,2020,91,0,Uzbekistan,UZ,UZB,32955400,Asia,10,2509,45
2020-05-13T00:00:00Z,13,5,2020,38,0,Uzbekistan,UZ,UZB,32955400,Asia,10,2547,46
2020-05-14T00:00:00Z,14,5,2020,65,1,Uzbekistan,UZ,UZB,32955400,Asia,11,2612,47
2020-05-15T00:00:00Z,15,5,2020,33,0,Uzbekistan,UZ,UZB,32955400,Asia,11,2645,48
2020-05-16T00:00:00Z,16,5,2020,46,0,Uzbekistan,UZ,UZB,32955400,Asia,11,2691,49
2020-05-17T00:00:00Z,17,5,2020,50,0,Uzbekistan,UZ,UZB,32955400,Asia,11,2741,50
2020-05-18T00:00:00Z,18,5,2020,12,1,Uzbekistan,UZ,UZB,32955400,Asia,12,2753,51
2020-05-19T00:00:00Z,19,5,2020,49,1,Uzbekistan,UZ,UZB,32955400,Asia,13,2802,52
2020-05-20T00:00:00Z,20,5,2020,78,0,Uzbekistan,UZ,UZB,32955400,Asia,13,2880,53
2020-05-21T00:00:00Z,21,5,2020,70,0,Uzbekistan,UZ,UZB,32955400,Asia,13,2950,54
2020-05-22T00:00:00Z,22,5,2020,56,0,Uzbekistan,UZ,UZB,32955400,Asia,13,3006,55
2020-05-23T00:00:00Z,23,5,2020,72,0,Uzbekistan,UZ,UZB,32955400,Asia,13,3078,56
2020-05-24T00:00:00Z,24,5,2020,54,0,Uzbekistan,UZ,UZB,32955400,Asia,13,3132,57
2020-05-25T00:00:00Z,25,5,2020,32,0,Uzbekistan,UZ,UZB,32955400,Asia,13,3164,58
2020-05-26T00:00:00Z,26,5,2020,97,0,Uzbekistan,UZ,UZB,32955400,Asia,13,3261,59
2020-05-27T00:00:00Z,27,5,2020,72,1,Uzbekistan,UZ,UZB,32955400,Asia,14,3333,60
2020-03-27T00:00:00Z,27,3,2020,1,1,Venezuela,VE,VEN,28870195,America,1,107,1
2020-03-28T00:00:00Z,28,3,2020,12,0,Venezuela,VE,VEN,28870195,America,1,119,2
2020-03-29T00:00:00Z,29,3,2020,0,0,Venezuela,VE,VEN,28870195,America,1,119,3
2020-03-30T00:00:00Z,30,3,2020,0,0,Venezuela,VE,VEN,28870195,America,1,119,4
2020-03-31T00:00:00Z,31,3,2020,16,2,Venezuela,VE,VEN,28870195,America,3,135,5
2020-04-01T00:00:00Z,1,4,2020,0,0,Venezuela,VE,VEN,28870195,America,3,135,6
2020-04-02T00:00:00Z,2,4,2020,8,0,Venezuela,VE,VEN,28870195,America,3,143,7
2020-04-03T00:00:00Z,3,4,2020,1,0,Venezuela,VE,VEN,28870195,America,3,144,8
2020-04-04T00:00:00Z,4,4,2020,0,0,Venezuela,VE,VEN,28870195,America,3,144,9
2020-04-05T00:00:00Z,5,4,2020,0,2,Venezuela,VE,VEN,28870195,America,5,144,10
2020-04-06T00:00:00Z,6,4,2020,4,0,Venezuela,VE,VEN,28870195,America,5,148,11
2020-04-07T00:00:00Z,7,4,2020,11,0,Venezuela,VE,VEN,28870195,America,5,159,12
2020-04-08T00:00:00Z,8,4,2020,7,2,Venezuela,VE,VEN,28870195,America,7,166,13
2020-04-09T00:00:00Z,9,4,2020,1,1,Venezuela,VE,VEN,28870195,America,8,167,14
2020-04-10T00:00:00Z,10,4,2020,4,1,Venezuela,VE,VEN,28870195,America,9,171,15
2020-04-11T00:00:00Z,11,4,2020,4,0,Venezuela,VE,VEN,28870195,America,9,175,16
2020-04-12T00:00:00Z,12,4,2020,0,0,Venezuela,VE,VEN,28870195,America,9,175,17
2020-04-13T00:00:00Z,13,4,2020,6,0,Venezuela,VE,VEN,28870195,America,9,181,18
2020-04-14T00:00:00Z,14,4,2020,8,0,Venezuela,VE,VEN,28870195,America,9,189,19
2020-04-15T00:00:00Z,15,4,2020,4,0,Venezuela,VE,VEN,28870195,America,9,193,20
2020-04-16T00:00:00Z,16,4,2020,4,0,Venezuela,VE,VEN,28870195,America,9,197,21
2020-04-17T00:00:00Z,17,4,2020,7,0,Venezuela,VE,VEN,28870195,America,9,204,22
2020-04-18T00:00:00Z,18,4,2020,23,0,Venezuela,VE,VEN,28870195,America,9,227,23
2020-04-19T00:00:00Z,19,4,2020,0,0,Venezuela,VE,VEN,28870195,America,9,227,24
2020-04-20T00:00:00Z,20,4,2020,29,0,Venezuela,VE,VEN,28870195,America,9,256,25
2020-04-21T00:00:00Z,21,4,2020,0,0,Venezuela,VE,VEN,28870195,America,9,256,26
2020-04-22T00:00:00Z,22,4,2020,29,1,Venezuela,VE,VEN,28870195,America,10,285,27
2020-04-23T00:00:00Z,23,4,2020,3,0,Venezuela,VE,VEN,28870195,America,10,288,28
2020-04-24T00:00:00Z,24,4,2020,10,0,Venezuela,VE,VEN,28870195,America,10,298,29
2020-04-25T00:00:00Z,25,4,2020,20,0,Venezuela,VE,VEN,28870195,America,10,318,30
2020-04-26T00:00:00Z,26,4,2020,5,0,Venezuela,VE,VEN,28870195,America,10,323,31
2020-04-27T00:00:00Z,27,4,2020,2,0,Venezuela,VE,VEN,28870195,America,10,325,32
2020-04-28T00:00:00Z,28,4,2020,4,0,Venezuela,VE,VEN,28870195,America,10,329,33
2020-04-29T00:00:00Z,29,4,2020,0,0,Venezuela,VE,VEN,28870195,America,10,329,34
2020-04-30T00:00:00Z,30,4,2020,2,0,Venezuela,VE,VEN,28870195,America,10,331,35
2020-05-01T00:00:00Z,1,5,2020,2,0,Venezuela,VE,VEN,28870195,America,10,333,36
2020-05-02T00:00:00Z,2,5,2020,2,0,Venezuela,VE,VEN,28870195,America,10,335,37
2020-05-03T00:00:00Z,3,5,2020,10,0,Venezuela,VE,VEN,28870195,America,10,345,38
2020-05-04T00:00:00Z,4,5,2020,12,0,Venezuela,VE,VEN,28870195,America,10,357,39
2020-05-05T00:00:00Z,5,5,2020,4,0,Venezuela,VE,VEN,28870195,America,10,361,40
2020-05-06T00:00:00Z,6,5,2020,6,0,Venezuela,VE,VEN,28870195,America,10,367,41
2020-05-07T00:00:00Z,7,5,2020,12,0,Venezuela,VE,VEN,28870195,America,10,379,42
2020-05-08T00:00:00Z,8,5,2020,2,0,Venezuela,VE,VEN,28870195,America,10,381,43
2020-05-09T00:00:00Z,9,5,2020,7,0,Venezuela,VE,VEN,28870195,America,10,388,44
2020-05-10T00:00:00Z,10,5,2020,14,0,Venezuela,VE,VEN,28870195,America,10,402,45
2020-05-11T00:00:00Z,11,5,2020,12,0,Venezuela,VE,VEN,28870195,America,10,414,46
2020-05-12T00:00:00Z,12,5,2020,8,0,Venezuela,VE,VEN,28870195,America,10,422,47
2020-05-13T00:00:00Z,13,5,2020,1,0,Venezuela,VE,VEN,28870195,America,10,423,48
2020-05-14T00:00:00Z,14,5,2020,17,0,Venezuela,VE,VEN,28870195,America,10,440,49
2020-05-15T00:00:00Z,15,5,2020,15,0,Venezuela,VE,VEN,28870195,America,10,455,50
2020-05-16T00:00:00Z,16,5,2020,4,0,Venezuela,VE,VEN,28870195,America,10,459,51
2020-05-17T00:00:00Z,17,5,2020,45,0,Venezuela,VE,VEN,28870195,America,10,504,52
2020-05-18T00:00:00Z,18,5,2020,37,0,Venezuela,VE,VEN,28870195,America,10,541,53
2020-05-19T00:00:00Z,19,5,2020,77,0,Venezuela,VE,VEN,28870195,America,10,618,54
2020-05-20T00:00:00Z,20,5,2020,131,0,Venezuela,VE,VEN,28870195,America,10,749,55
2020-05-21T00:00:00Z,21,5,2020,75,0,Venezuela,VE,VEN,28870195,America,10,824,56
2020-05-22T00:00:00Z,22,5,2020,58,0,Venezuela,VE,VEN,28870195,America,10,882,57
2020-05-23T00:00:00Z,23,5,2020,62,0,Venezuela,VE,VEN,28870195,America,10,944,58
2020-05-24T00:00:00Z,24,5,2020,0,0,Venezuela,VE,VEN,28870195,America,10,944,59
2020-05-25T00:00:00Z,25,5,2020,177,0,Venezuela,VE,VEN,28870195,America,10,1121,60
2020-05-26T00:00:00Z,26,5,2020,56,0,Venezuela,VE,VEN,28870195,America,10,1177,61
2020-05-27T00:00:00Z,27,5,2020,34,1,Venezuela,VE,VEN,28870195,America,11,1211,62
2020-05-01T00:00:00Z,1,5,2020,0,2,Yemen,YE,YEM,28498687,Asia,2,6,1
2020-05-02T00:00:00Z,2,5,2020,1,0,Yemen,YE,YEM,28498687,Asia,2,7,2
2020-05-03T00:00:00Z,3,5,2020,3,0,Yemen,YE,YEM,28498687,Asia,2,10,3
2020-05-04T00:00:00Z,4,5,2020,0,0,Yemen,YE,YEM,28498687,Asia,2,10,4
2020-05-05T00:00:00Z,5,5,2020,2,0,Yemen,YE,YEM,28498687,Asia,2,12,5
2020-05-06T00:00:00Z,6,5,2020,9,1,Yemen,YE,YEM,28498687,Asia,3,21,6
2020-05-07T00:00:00Z,7,5,2020,4,2,Yemen,YE,YEM,28498687,Asia,5,25,7
2020-05-08T00:00:00Z,8,5,2020,1,1,Yemen,YE,YEM,28498687,Asia,6,26,8
2020-05-09T00:00:00Z,9,5,2020,8,1,Yemen,YE,YEM,28498687,Asia,7,34,9
2020-05-10T00:00:00Z,10,5,2020,0,0,Yemen,YE,YEM,28498687,Asia,7,34,10
2020-05-11T00:00:00Z,11,5,2020,17,1,Yemen,YE,YEM,28498687,Asia,8,51,11
2020-05-12T00:00:00Z,12,5,2020,5,1,Yemen,YE,YEM,28498687,Asia,9,56,12
2020-05-13T00:00:00Z,13,5,2020,11,2,Yemen,YE,YEM,28498687,Asia,11,67,13
2020-05-14T00:00:00Z,14,5,2020,3,1,Yemen,YE,YEM,28498687,Asia,12,70,14
2020-05-15T00:00:00Z,15,5,2020,17,1,Yemen,YE,YEM,28498687,Asia,13,87,15
2020-05-16T00:00:00Z,16,5,2020,19,2,Yemen,YE,YEM,28498687,Asia,15,106,16
2020-05-17T00:00:00Z,17,5,2020,18,4,Yemen,YE,YEM,28498687,Asia,19,124,17
2020-05-18T00:00:00Z,18,5,2020,4,1,Yemen,YE,YEM,28498687,Asia,20,128,18
2020-05-19T00:00:00Z,19,5,2020,2,0,Yemen,YE,YEM,28498687,Asia,20,130,19
2020-05-20T00:00:00Z,20,5,2020,37,8,Yemen,YE,YEM,28498687,Asia,28,167,20
2020-05-21T00:00:00Z,21,5,2020,13,1,Yemen,YE,YEM,28498687,Asia,29,180,21
2020-05-22T00:00:00Z,22,5,2020,13,4,Yemen,YE,YEM,28498687,Asia,33,193,22
2020-05-23T00:00:00Z,23,5,2020,12,0,Yemen,YE,YEM,28498687,Asia,33,205,23
2020-05-24T00:00:00Z,24,5,2020,7,6,Yemen,YE,YEM,28498687,Asia,39,212,24
2020-05-25T00:00:00Z,25,5,2020,10,3,Yemen,YE,YEM,28498687,Asia,42,222,25
2020-05-26T00:00:00Z,26,5,2020,15,3,Yemen,YE,YEM,28498687,Asia,45,237,26
2020-05-27T00:00:00Z,27,5,2020,12,4,Yemen,YE,YEM,28498687,Asia,49,249,27
2020-04-03T00:00:00Z,3,4,2020,3,1,Zambia,ZM,ZMB,17351822,Africa,1,39,1
2020-04-04T00:00:00Z,4,4,2020,0,0,Zambia,ZM,ZMB,17351822,Africa,1,39,2
2020-04-05T00:00:00Z,5,4,2020,0,0,Zambia,ZM,ZMB,17351822,Africa,1,39,3
2020-04-06T00:00:00Z,6,4,2020,0,0,Zambia,ZM,ZMB,17351822,Africa,1,39,4
2020-04-07T00:00:00Z,7,4,2020,0,0,Zambia,ZM,ZMB,17351822,Africa,1,39,5
2020-04-08T00:00:00Z,8,4,2020,0,0,Zambia,ZM,ZMB,17351822,Africa,1,39,6
2020-04-09T00:00:00Z,9,4,2020,0,0,Zambia,ZM,ZMB,17351822,Africa,1,39,7
2020-04-10T00:00:00Z,10,4,2020,0,0,Zambia,ZM,ZMB,17351822,Africa,1,39,8
2020-04-11T00:00:00Z,11,4,2020,1,1,Zambia,ZM,ZMB,17351822,Africa,2,40,9
2020-04-12T00:00:00Z,12,4,2020,0,0,Zambia,ZM,ZMB,17351822,Africa,2,40,10
2020-04-13T00:00:00Z,13,4,2020,3,0,Zambia,ZM,ZMB,17351822,Africa,2,43,11
2020-04-14T00:00:00Z,14,4,2020,2,0,Zambia,ZM,ZMB,17351822,Africa,2,45,12
2020-04-15T00:00:00Z,15,4,2020,0,0,Zambia,ZM,ZMB,17351822,Africa,2,45,13
2020-04-16T00:00:00Z,16,4,2020,3,0,Zambia,ZM,ZMB,17351822,Africa,2,48,14
2020-04-17T00:00:00Z,17,4,2020,0,0,Zambia,ZM,ZMB,17351822,Africa,2,48,15
2020-04-18T00:00:00Z,18,4,2020,4,0,Zambia,ZM,ZMB,17351822,Africa,2,52,16
2020-04-19T00:00:00Z,19,4,2020,5,0,Zambia,ZM,ZMB,17351822,Africa,2,57,17
2020-04-20T00:00:00Z,20,4,2020,4,1,Zambia,ZM,ZMB,17351822,Africa,3,61,18
2020-04-21T00:00:00Z,21,4,2020,4,0,Zambia,ZM,ZMB,17351822,Africa,3,65,19
2020-04-22T00:00:00Z,22,4,2020,0,0,Zambia,ZM,ZMB,17351822,Africa,3,65,20
2020-04-23T00:00:00Z,23,4,2020,9,0,Zambia,ZM,ZMB,17351822,Africa,3,74,21
2020-04-24T00:00:00Z,24,4,2020,2,0,Zambia,ZM,ZMB,17351822,Africa,3,76,22
2020-04-25T00:00:00Z,25,4,2020,8,0,Zambia,ZM,ZMB,17351822,Africa,3,84,23
2020-04-26T00:00:00Z,26,4,2020,0,0,Zambia,ZM,ZMB,17351822,Africa,3,84,24
2020-04-27T00:00:00Z,27,4,2020,4,0,Zambia,ZM,ZMB,17351822,Africa,3,88,25
2020-04-28T00:00:00Z,28,4,2020,1,0,Zambia,ZM,ZMB,17351822,Africa,3,89,26
2020-04-29T00:00:00Z,29,4,2020,6,0,Zambia,ZM,ZMB,17351822,Africa,3,95,27
2020-04-30T00:00:00Z,30,4,2020,2,0,Zambia,ZM,ZMB,17351822,Africa,3,97,28
2020-05-01T00:00:00Z,1,5,2020,9,0,Zambia,ZM,ZMB,17351822,Africa,3,106,29
2020-05-02T00:00:00Z,2,5,2020,3,0,Zambia,ZM,ZMB,17351822,Africa,3,109,30
2020-05-03T00:00:00Z,3,5,2020,10,0,Zambia,ZM,ZMB,17351822,Africa,3,119,31
2020-05-04T00:00:00Z,4,5,2020,5,0,Zambia,ZM,ZMB,17351822,Africa,3,124,32
2020-05-05T00:00:00Z,5,5,2020,13,0,Zambia,ZM,ZMB,17351822,Africa,3,137,33
2020-05-06T00:00:00Z,6,5,2020,2,1,Zambia,ZM,ZMB,17351822,Africa,4,139,34
2020-05-07T00:00:00Z,7,5,2020,7,0,Zambia,ZM,ZMB,17351822,Africa,4,146,35
2020-05-08T00:00:00Z,8,5,2020,7,0,Zambia,ZM,ZMB,17351822,Africa,4,153,36
2020-05-09T00:00:00Z,9,5,2020,14,0,Zambia,ZM,ZMB,17351822,Africa,4,167,37
2020-05-10T00:00:00Z,10,5,2020,85,3,Zambia,ZM,ZMB,17351822,Africa,7,252,38
2020-05-11T00:00:00Z,11,5,2020,15,0,Zambia,ZM,ZMB,17351822,Africa,7,267,39
2020-05-12T00:00:00Z,12,5,2020,0,0,Zambia,ZM,ZMB,17351822,Africa,7,267,40
2020-05-13T00:00:00Z,13,5,2020,174,0,Zambia,ZM,ZMB,17351822,Africa,7,441,41
2020-05-14T00:00:00Z,14,5,2020,5,0,Zambia,ZM,ZMB,17351822,Africa,7,446,42
2020-05-15T00:00:00Z,15,5,2020,208,0,Zambia,ZM,ZMB,17351822,Africa,7,654,43
2020-05-16T00:00:00Z,16,5,2020,14,0,Zambia,ZM,ZMB,17351822,Africa,7,668,44
2020-05-17T00:00:00Z,17,5,2020,11,0,Zambia,ZM,ZMB,17351822,Africa,7,679,45
2020-05-18T00:00:00Z,18,5,2020,74,0,Zambia,ZM,ZMB,17351822,Africa,7,753,46
2020-05-19T00:00:00Z,19,5,2020,8,0,Zambia,ZM,ZMB,17351822,Africa,7,761,47
2020-05-20T00:00:00Z,20,5,2020,11,0,Zambia,ZM,ZMB,17351822,Africa,7,772,48
2020-05-21T00:00:00Z,21,5,2020,60,0,Zambia,ZM,ZMB,17351822,Africa,7,832,49
2020-05-22T00:00:00Z,22,5,2020,34,0,Zambia,ZM,ZMB,17351822,Africa,7,866,50
2020-05-23T00:00:00Z,23,5,2020,54,0,Zambia,ZM,ZMB,17351822,Africa,7,920,51
2020-05-24T00:00:00Z,24,5,2020,0,0,Zambia,ZM,ZMB,17351822,Africa,7,920,52
2020-05-25T00:00:00Z,25,5,2020,0,0,Zambia,ZM,ZMB,17351822,Africa,7,920,53
2020-05-26T00:00:00Z,26,5,2020,0,0,Zambia,ZM,ZMB,17351822,Africa,7,920,54
2020-05-27T00:00:00Z,27,5,2020,0,0,Zambia,ZM,ZMB,17351822,Africa,7,920,55
2020-03-24T00:00:00Z,24,3,2020,0,1,Zimbabwe,ZW,ZWE,14439018,Africa,1,2,1
2020-03-25T00:00:00Z,25,3,2020,0,0,Zimbabwe,ZW,ZWE,14439018,Africa,1,2,2
2020-03-26T00:00:00Z,26,3,2020,1,0,Zimbabwe,ZW,ZWE,14439018,Africa,1,3,3
2020-03-27T00:00:00Z,27,3,2020,0,0,Zimbabwe,ZW,ZWE,14439018,Africa,1,3,4
2020-03-28T00:00:00Z,28,3,2020,2,0,Zimbabwe,ZW,ZWE,14439018,Africa,1,5,5
2020-03-29T00:00:00Z,29,3,2020,2,0,Zimbabwe,ZW,ZWE,14439018,Africa,1,7,6
2020-03-30T00:00:00Z,30,3,2020,0,0,Zimbabwe,ZW,ZWE,14439018,Africa,1,7,7
2020-03-31T00:00:00Z,31,3,2020,0,0,Zimbabwe,ZW,ZWE,14439018,Africa,1,7,8
2020-04-01T00:00:00Z,1,4,2020,1,0,Zimbabwe,ZW,ZWE,14439018,Africa,1,8,9
2020-04-02T00:00:00Z,2,4,2020,0,0,Zimbabwe,ZW,ZWE,14439018,Africa,1,8,10
2020-04-03T00:00:00Z,3,4,2020,0,0,Zimbabwe,ZW,ZWE,14439018,Africa,1,8,11
2020-04-04T00:00:00Z,4,4,2020,1,0,Zimbabwe,ZW,ZWE,14439018,Africa,1,9,12
2020-04-05T00:00:00Z,5,4,2020,0,0,Zimbabwe,ZW,ZWE,14439018,Africa,1,9,13
2020-04-06T00:00:00Z,6,4,2020,0,0,Zimbabwe,ZW,ZWE,14439018,Africa,1,9,14
2020-04-07T00:00:00Z,7,4,2020,0,0,Zimbabwe,ZW,ZWE,14439018,Africa,1,9,15
2020-04-08T00:00:00Z,8,4,2020,1,0,Zimbabwe,ZW,ZWE,14439018,Africa,1,10,16
2020-04-09T00:00:00Z,9,4,2020,1,1,Zimbabwe,ZW,ZWE,14439018,Africa,2,11,17
2020-04-10T00:00:00Z,10,4,2020,0,1,Zimbabwe,ZW,ZWE,14439018,Africa,3,11,18
2020-04-11T00:00:00Z,11,4,2020,0,0,Zimbabwe,ZW,ZWE,14439018,Africa,3,11,19
2020-04-12T00:00:00Z,12,4,2020,3,0,Zimbabwe,ZW,ZWE,14439018,Africa,3,14,20
2020-04-13T00:00:00Z,13,4,2020,0,0,Zimbabwe,ZW,ZWE,14439018,Africa,3,14,21
2020-04-14T00:00:00Z,14,4,2020,3,0,Zimbabwe,ZW,ZWE,14439018,Africa,3,17,22
2020-04-15T00:00:00Z,15,4,2020,0,0,Zimbabwe,ZW,ZWE,14439018,Africa,3,17,23
2020-04-16T00:00:00Z,16,4,2020,6,0,Zimbabwe,ZW,ZWE,14439018,Africa,3,23,24
2020-04-17T00:00:00Z,17,4,2020,1,0,Zimbabwe,ZW,ZWE,14439018,Africa,3,24,25
2020-04-18T00:00:00Z,18,4,2020,0,0,Zimbabwe,ZW,ZWE,14439018,Africa,3,24,26
2020-04-19T00:00:00Z,19,4,2020,1,0,Zimbabwe,ZW,ZWE,14439018,Africa,3,25,27
2020-04-20T00:00:00Z,20,4,2020,0,0,Zimbabwe,ZW,ZWE,14439018,Africa,3,25,28
2020-04-21T00:00:00Z,21,4,2020,0,0,Zimbabwe,ZW,ZWE,14439018,Africa,3,25,29
2020-04-22T00:00:00Z,22,4,2020,3,0,Zimbabwe,ZW,ZWE,14439018,Africa,3,28,30
2020-04-23T00:00:00Z,23,4,2020,0,0,Zimbabwe,ZW,ZWE,14439018,Africa,3,28,31
2020-04-24T00:00:00Z,24,4,2020,1,0,Zimbabwe,ZW,ZWE,14439018,Africa,3,29,32
2020-04-25T00:00:00Z,25,4,2020,0,1,Zimbabwe,ZW,ZWE,14439018,Africa,4,29,33
2020-04-26T00:00:00Z,26,4,2020,2,0,Zimbabwe,ZW,ZWE,14439018,Africa,4,31,34
2020-04-27T00:00:00Z,27,4,2020,0,0,Zimbabwe,ZW,ZWE,14439018,Africa,4,31,35
2020-04-28T00:00:00Z,28,4,2020,1,0,Zimbabwe,ZW,ZWE,14439018,Africa,4,32,36
2020-04-29T00:00:00Z,29,4,2020,0,0,Zimbabwe,ZW,ZWE,14439018,Africa,4,32,37
2020-04-30T00:00:00Z,30,4,2020,2,0,Zimbabwe,ZW,ZWE,14439018,Africa,4,34,38
2020-05-01T00:00:00Z,1,5,2020,0,0,Zimbabwe,ZW,ZWE,14439018,Africa,4,34,39
2020-05-02T00:00:00Z,2,5,2020,0,0,Zimbabwe,ZW,ZWE,14439018,Africa,4,34,40
2020-05-03T00:00:00Z,3,5,2020,0,0,Zimbabwe,ZW,ZWE,14439018,Africa,4,34,41
2020-05-04T00:00:00Z,4,5,2020,0,0,Zimbabwe,ZW,ZWE,14439018,Africa,4,34,42
2020-05-05T00:00:00Z,5,5,2020,0,0,Zimbabwe,ZW,ZWE,14439018,Africa,4,34,43
2020-05-06T00:00:00Z,6,5,2020,0,0,Zimbabwe,ZW,ZWE,14439018,Africa,4,34,44
2020-05-07T00:00:00Z,7,5,2020,0,0,Zimbabwe,ZW,ZWE,14439018,Africa,4,34,45
2020-05-08T00:00:00Z,8,5,2020,0,0,Zimbabwe,ZW,ZWE,14439018,Africa,4,34,46
2020-05-09T00:00:00Z,9,5,2020,1,0,Zimbabwe,ZW,ZWE,14439018,Africa,4,35,47
2020-05-10T00:00:00Z,10,5,2020,1,0,Zimbabwe,ZW,ZWE,14439018,Africa,4,36,48
2020-05-11T00:00:00Z,11,5,2020,0,0,Zimbabwe,ZW,ZWE,14439018,Africa,4,36,49
2020-05-12T00:00:00Z,12,5,2020,1,0,Zimbabwe,ZW,ZWE,14439018,Africa,4,37,50
2020-05-13T00:00:00Z,13,5,2020,0,0,Zimbabwe,ZW,ZWE,14439018,Africa,4,37,51
2020-05-14T00:00:00Z,14,5,2020,0,0,Zimbabwe,ZW,ZWE,14439018,Africa,4,37,52
2020-05-15T00:00:00Z,15,5,2020,0,0,Zimbabwe,ZW,ZWE,14439018,Africa,4,37,53
2020-05-16T00:00:00Z,16,5,2020,5,0,Zimbabwe,ZW,ZWE,14439018,Africa,4,42,54
2020-05-17T00:00:00Z,17,5,2020,2,0,Zimbabwe,ZW,ZWE,14439018,Africa,4,44,55
2020-05-18T00:00:00Z,18,5,2020,2,0,Zimbabwe,ZW,ZWE,14439018,Africa,4,46,56
2020-05-19T00:00:00Z,19,5,2020,0,0,Zimbabwe,ZW,ZWE,14439018,Africa,4,46,57
2020-05-20T00:00:00Z,20,5,2020,0,0,Zimbabwe,ZW,ZWE,14439018,Africa,4,46,58
2020-05-21T00:00:00Z,21,5,2020,2,0,Zimbabwe,ZW,ZWE,14439018,Africa,4,48,59
2020-05-22T00:00:00Z,22,5,2020,3,0,Zimbabwe,ZW,ZWE,14439018,Africa,4,51,60
2020-05-23T00:00:00Z,23,5,2020,5,0,Zimbabwe,ZW,ZWE,14439018,Africa,4,56,61
2020-05-24T00:00:00Z,24,5,2020,0,0,Zimbabwe,ZW,ZWE,14439018,Africa,4,56,62
2020-05-25T00:00:00Z,25,5,2020,0,0,Zimbabwe,ZW,ZWE,14439018,Africa,4,56,63
2020-05-26T00:00:00Z,26,5,2020,0,0,Zimbabwe,ZW,ZWE,14439018,Africa,4,56,64
2020-05-27T00:00:00Z,27,5,2020,0,0,Zimbabwe,ZW,ZWE,14439018,Africa,4,56,65
